//MAP CONVERTED BY dmm2tgm.py THIS HEADER COMMENT PREVENTS RECONVERSION, DO NOT REMOVE
"au" = (
/obj/effect/turf_decal/siding/wood,
/obj/effect/turf_decal/siding/wood{
	dir = 1
	},
/turf/open/misc/dirt/icemoon,
/area/space)
"aM" = (
/obj/machinery/smartfridge/drying_rack{
	idle_power_usage = 0;
	use_power = 0
	},
/turf/open/floor/wood/icemoon,
/area/space)
"bo" = (
/obj/structure/chair/sofa/bench/woodlike/right{
	dir = 1
	},
/turf/open/misc/dirt/icemoon,
/area/space)
"bJ" = (
/obj/structure/chair/sofa/bench/woodlike/left,
/turf/open/misc/dirt/icemoon,
/area/space)
"ce" = (
/obj/structure/closet/crate/wooden/storage_barrel,
/obj/item/food/raw_sausage{
	pixel_y = -5
	},
/obj/item/food/raw_sausage{
	pixel_y = -2
	},
/obj/item/food/raw_sausage{
	pixel_y = 1
	},
/obj/item/food/raw_sausage{
	pixel_y = 4
	},
/turf/open/misc/dirt/icemoon,
/area/space)
"cg" = (
/obj/structure/bed/maint,
/obj/structure/curtain/bounty,
/obj/effect/turf_decal/siding/wood{
	dir = 4
	},
/turf/open/misc/dirt/icemoon,
/area/space)
"cj" = (
/obj/effect/turf_decal/siding/wood/corner,
/turf/open/misc/dirt/icemoon,
/area/space)
"cJ" = (
/obj/effect/turf_decal/siding/wood/corner{
	dir = 8
	},
/obj/structure/curtain/bounty,
/turf/open/misc/dirt/icemoon,
/area/space)
"dv" = (
/obj/item/flashlight/flare/torch{
	on = 1
	},
/turf/closed/indestructible/stone,
/area/space)
"dF" = (
/obj/structure/decorative/shelf,
/obj/item/ore_sensor{
	pixel_y = -1;
	pixel_x = 7
	},
/obj/item/reagent_containers/cup/mortar{
	pixel_y = 9;
	pixel_x = -3
	},
/obj/item/pestle{
	pixel_y = -9;
	pixel_x = -7
	},
/turf/open/floor/wood/icemoon,
/area/space)
"ef" = (
/obj/structure/flora/grass/both/style_random,
/turf/open/misc/asteroid/snow/icemoon,
/area/space)
"eT" = (
/obj/item/flashlight/flare/torch,
/turf/closed/indestructible/stone,
/area/space)
"fe" = (
/obj/effect/turf_decal/weather/snow/corner{
	dir = 4
	},
/turf/open/misc/dirt/icemoon,
/area/space)
"fl" = (
/obj/effect/turf_decal/siding/wood/corner{
	dir = 4
	},
/turf/open/misc/dirt/icemoon,
/area/space)
"fY" = (
/obj/structure/loom,
/turf/open/floor/wood/icemoon,
/area/space)
"gs" = (
/obj/item/cultivator/rake,
/turf/open/misc/asteroid/basalt{
	initial_gas_mix = "ICEMOON_ATMOS"
	},
/area/space)
"hj" = (
/obj/effect/turf_decal/siding/wood/corner,
/obj/effect/turf_decal/siding/wood/corner{
	dir = 4
	},
/turf/open/misc/dirt/icemoon,
/area/space)
"hl" = (
/obj/structure/reagent_forge,
/obj/effect/turf_decal/weather/dirt{
	dir = 4
	},
/turf/open/floor/stone/icemoon,
/area/space)
"hS" = (
/obj/structure/closet/crate/wooden,
/obj/item/stack/sheet/mineral/wood{
	amount = 15
	},
/obj/item/stack/sheet/mineral/coal/ten,
/obj/effect/turf_decal/siding/wood/corner{
	dir = 4
	},
/turf/open/misc/dirt/icemoon,
/area/space)
"ig" = (
/obj/item/shovel,
/turf/open/misc/asteroid/snow/icemoon,
/area/space)
"ij" = (
/obj/structure/closet/crate/wooden,
/obj/item/clothing/head/pelt/wolf/black,
/obj/item/clothing/head/pelt/snow_tiger,
/obj/item/clothing/shoes/winterboots/ice_boots/icebox_catgirl_boots,
/obj/item/clothing/shoes/winterboots/ice_boots/icebox_catgirl_boots,
/obj/item/clothing/under/dress/skirt/icebox_catgirl_body_wraps,
/obj/item/clothing/gloves/fingerless/icebox_catgirl_armwraps,
/obj/item/clothing/gloves/fingerless/icebox_catgirl_armwraps,
/obj/item/clothing/suit/jacket/icebox_catgirl_coat,
/obj/item/clothing/suit/jacket/icebox_catgirl_coat,
/obj/item/clothing/neck/scarf/icebox_catgirl_scarf,
/obj/item/clothing/neck/mantle/recolorable,
/obj/item/clothing/suit/ashwalkermantle,
/obj/item/clothing/head/standalone_hood,
/obj/item/clothing/head/standalone_hood,
/obj/item/clothing/suit/ashwalkermantle,
/turf/open/misc/dirt/icemoon,
/area/space)
"kr" = (
/obj/structure/closet/crate/wooden/storage_barrel,
/obj/item/food/raw_headcheese{
	pixel_y = -2
	},
/obj/item/food/raw_headcheese,
/turf/open/misc/dirt/icemoon,
/area/space)
"kU" = (
/obj/structure/decorative/shelf,
/obj/effect/turf_decal/siding/wood/corner{
	dir = 4
	},
/turf/open/misc/dirt/icemoon,
/area/space)
"kZ" = (
/obj/effect/turf_decal/weather/snow/corner{
	dir = 8
	},
/obj/effect/turf_decal/siding/wood{
	dir = 4
	},
/turf/open/misc/dirt/icemoon,
/area/space)
"lp" = (
/obj/structure/deployable_barricade/wooden{
	dir = 1;
	pixel_y = 23
	},
/obj/structure/deployable_barricade/wooden{
	dir = 4
	},
/turf/open/misc/dirt/icemoon,
/area/space)
"lB" = (
/obj/item/pickaxe/mini,
/turf/open/misc/asteroid/snow/icemoon,
/area/space)
"ms" = (
/obj/structure/curtain/bounty,
/obj/effect/turf_decal/siding/wood{
	dir = 8
	},
/turf/open/misc/dirt/icemoon,
/area/space)
"mZ" = (
/turf/open/misc/asteroid/snow/icemoon,
/area/space)
"ne" = (
/obj/effect/turf_decal/weather/snow/corner{
	dir = 6
	},
/obj/effect/turf_decal/siding/wood/corner{
	dir = 1
	},
/turf/open/misc/dirt/icemoon,
/area/space)
"nu" = (
/turf/closed/mineral/snowmountain/icemoon,
/area/space)
"ok" = (
/obj/structure/table/wood,
/obj/item/plate,
/obj/item/plate{
	pixel_y = 2;
	pixel_x = 2
	},
/obj/item/plate{
	pixel_y = 5;
	pixel_x = 1
	},
/turf/open/misc/dirt/icemoon,
/area/space)
"oo" = (
/obj/item/clothing/head/pelt/white{
	pixel_y = -2
	},
/obj/item/clothing/head/pelt/wolf/white{
	pixel_y = 6
	},
/obj/structure/closet/crate/wooden,
/obj/item/clothing/shoes/winterboots/ice_boots/icebox_catgirl_boots,
/obj/item/clothing/under/dress/skirt/icebox_catgirl_body_wraps,
/obj/item/clothing/under/dress/skirt/icebox_catgirl_body_wraps,
/obj/item/clothing/under/dress/skirt/icebox_catgirl_body_wraps,
/obj/item/clothing/gloves/fingerless/icebox_catgirl_armwraps,
/obj/item/clothing/suit/jacket/icebox_catgirl_coat,
/obj/item/clothing/suit/jacket/icebox_catgirl_coat,
/obj/item/clothing/suit/jacket/icebox_catgirl_coat,
/obj/item/clothing/neck/scarf/icebox_catgirl_scarf,
/obj/item/clothing/neck/scarf/icebox_catgirl_scarf,
/obj/item/clothing/neck/mantle/recolorable,
/obj/item/clothing/neck/security_cape/armplate{
	name = "gauntlet"
	},
/obj/item/clothing/neck/security_cape/armplate{
	name = "gauntlet"
	},
/obj/item/clothing/head/standalone_hood,
/turf/open/misc/dirt/icemoon,
/area/space)
"oN" = (
/turf/template_noop,
/area/template_noop)
"oO" = (
/obj/effect/turf_decal/siding/wood,
/obj/structure/closet/crate/wooden/storage_barrel,
/obj/item/food/cheese/mozzarella{
	pixel_y = -6
	},
/obj/item/food/cheese/mozzarella{
	pixel_y = -3;
	pixel_x = -3
	},
/obj/item/food/cheese/mozzarella,
/obj/item/food/cheese/mozzarella{
	pixel_y = 3;
	pixel_x = -3
	},
/obj/item/food/cheese/mozzarella{
	pixel_y = 7
	},
/turf/open/misc/dirt/icemoon,
/area/space)
"pd" = (
/obj/structure/reagent_forge{
	pixel_y = 12
	},
/obj/effect/turf_decal/weather/dirt,
/turf/open/floor/stone/icemoon,
/area/space)
"pn" = (
/obj/structure/deployable_barricade/wooden{
	dir = 1;
	pixel_y = 23
	},
/turf/open/misc/dirt/icemoon,
/area/space)
"pS" = (
/obj/item/shovel/serrated,
/turf/open/misc/asteroid/basalt{
	initial_gas_mix = "ICEMOON_ATMOS"
	},
/area/space)
"pZ" = (
/obj/structure/table/wood,
/obj/structure/large_mortar,
/obj/item/pestle,
/turf/open/floor/stone/icemoon,
/area/space)
"qc" = (
/obj/structure/deployable_barricade/wooden{
	dir = 8
	},
/turf/open/misc/asteroid/snow/icemoon,
/area/space)
"qs" = (
/obj/effect/turf_decal/weather/dirt,
/obj/structure/closet/crate/wooden/storage_barrel,
/obj/item/food/plumphelmetbiscuit{
	pixel_y = -5
	},
/obj/item/food/plumphelmetbiscuit{
	pixel_y = -2
	},
/obj/item/food/plumphelmetbiscuit{
	pixel_y = 1
	},
/obj/item/food/plumphelmetbiscuit{
	pixel_y = 4
	},
/turf/open/floor/stone/icemoon,
/area/space)
"qw" = (
/turf/closed/indestructible/stone,
/area/space)
"qC" = (
/obj/effect/turf_decal/siding/wood{
	dir = 6
	},
/turf/open/misc/dirt/icemoon,
/area/space)
"qN" = (
/obj/structure/rack/shelf/wooden,
/obj/item/bedsheet/black{
	pixel_x = 5;
	pixel_y = -2
	},
/obj/item/bedsheet/black{
	pixel_x = 5;
	pixel_y = 12
	},
/obj/effect/turf_decal/siding/wood{
	dir = 4
	},
/turf/open/misc/dirt/icemoon,
/area/space)
"rm" = (
/turf/open/misc/dirt/icemoon,
/area/space)
"rz" = (
/obj/effect/turf_decal/siding/wood/corner{
	dir = 1
	},
/obj/effect/turf_decal/siding/wood/corner{
	dir = 8
	},
/turf/open/misc/dirt/icemoon,
/area/space)
"rG" = (
/obj/structure/table/wood,
/obj/item/candle/infinite{
	pixel_x = -12;
	pixel_y = 4
	},
/turf/open/misc/dirt/icemoon,
/area/space)
"rY" = (
/obj/structure/decorative/shelf,
/obj/item/reagent_containers/cup/glass/bottle/moonshine{
	pixel_y = 12;
	pixel_x = 5;
	name = "high quality wound number"
	},
/obj/item/stack/medical/splint/improvised{
	pixel_y = -2;
	pixel_x = -3;
	amount = 6
	},
/turf/open/floor/stone/icemoon,
/area/space)
"sl" = (
/obj/structure/table/wood,
/obj/item/plate/oven_tray,
/obj/item/food/rootdoughslice{
	pixel_y = 6;
	pixel_x = 2
	},
/obj/item/food/rootdoughslice{
	pixel_y = 1;
	pixel_x = -4
	},
/turf/open/misc/dirt/icemoon,
/area/space)
"us" = (
/obj/structure/deployable_barricade/wooden{
	dir = 1;
	pixel_y = 23
	},
/obj/effect/turf_decal/siding/wood/corner{
	dir = 8
	},
/turf/open/misc/dirt/icemoon,
/area/space)
"uM" = (
/obj/structure/table/wood,
/obj/structure/chem_separator,
/turf/open/floor/wood/icemoon,
/area/space)
"uZ" = (
/obj/item/shovel,
/turf/open/misc/asteroid/basalt{
	initial_gas_mix = "ICEMOON_ATMOS"
	},
/area/space)
"vf" = (
/obj/effect/turf_decal/weather/dirt,
/turf/open/floor/stone/icemoon,
/area/space)
"vl" = (
/obj/structure/reagent_water_basin,
/turf/open/floor/wood/icemoon,
/area/space)
"vo" = (
/mob/living/simple_animal/chicken,
/turf/open/misc/dirt/icemoon,
/area/space)
"vE" = (
/obj/structure/deployable_barricade/wooden{
	dir = 4
	},
/turf/open/misc/asteroid/snow/icemoon,
/area/space)
"vP" = (
/turf/open/floor/stone/icemoon,
/area/space)
"wE" = (
/turf/closed/wall/mineral/wood/nonmetal,
/area/space)
"xr" = (
/obj/structure/decorative/shelf,
/obj/item/reagent_containers/cup/bowl/mushroom_bowl{
	pixel_y = 8;
	pixel_x = 3
	},
/obj/item/reagent_containers/cup/bowl/mushroom_bowl{
	pixel_y = 12;
	pixel_x = 3
	},
/obj/item/reagent_containers/cup/mortar{
	pixel_y = -5;
	pixel_x = 2
	},
/obj/item/pestle{
	pixel_y = -7;
	pixel_x = -5
	},
/turf/open/misc/dirt/icemoon,
/area/space)
"zm" = (
/obj/structure/deployable_barricade/wooden{
	dir = 1;
	pixel_y = 23
	},
/obj/effect/turf_decal/siding/wood,
/turf/open/misc/dirt/icemoon,
/area/space)
"zO" = (
/obj/structure/decorative/shelf,
/obj/item/forging/reagent_weapon/axe/fake_copper{
	pixel_x = -8;
	pixel_y = -4
	},
/obj/item/forging/reagent_weapon/axe/fake_copper{
	pixel_x = -2;
	pixel_y = -4
	},
/obj/item/forging/reagent_weapon/axe/fake_copper{
	pixel_x = 4;
	pixel_y = -4
	},
/turf/open/misc/dirt/icemoon,
/area/space)
"Ag" = (
/obj/structure/bonfire/oh_yeah_its_grilling_time,
/turf/open/floor/stone/icemoon,
/area/space)
"Ar" = (
/obj/structure/table/wood,
/obj/item/paper_bin/bundlenatural,
/obj/item/pen/charcoal,
/turf/open/floor/wood/icemoon,
/area/space)
"AP" = (
/obj/effect/turf_decal/siding/wood{
	dir = 10
	},
/turf/open/misc/dirt/icemoon,
/area/space)
"Ba" = (
/obj/structure/chair/sofa/bench/woodlike/left{
	dir = 1
	},
/turf/open/misc/dirt/icemoon,
/area/space)
"Bs" = (
/obj/structure/mineral_door/wood,
/obj/effect/turf_decal/weather/snow/corner,
/turf/open/misc/dirt/icemoon,
/area/space)
"BN" = (
/obj/effect/turf_decal/siding/wood{
	dir = 8
	},
/turf/open/misc/dirt/icemoon,
/area/space)
"CG" = (
/obj/machinery/smartfridge/drying_rack{
	idle_power_usage = 0;
	use_power = 0
	},
/turf/open/floor/stone/icemoon,
/area/space)
"CN" = (
/obj/effect/turf_decal/weather/snow/corner{
	dir = 9
	},
/obj/effect/turf_decal/siding/wood/corner,
/turf/open/misc/dirt/icemoon,
/area/space)
"DO" = (
/obj/effect/turf_decal/weather/snow/corner,
/obj/effect/turf_decal/siding/wood/corner{
	dir = 4
	},
/turf/open/misc/dirt/icemoon,
/area/space)
"Em" = (
/obj/structure/chair/sofa/bench/woodlike,
/turf/open/misc/dirt/icemoon,
/area/space)
"EH" = (
/obj/effect/turf_decal/siding/wood,
/turf/open/misc/dirt/icemoon,
/area/space)
"EQ" = (
/obj/structure/deployable_barricade/wooden{
	dir = 8
	},
/obj/structure/deployable_barricade/wooden,
/turf/open/misc/asteroid/snow/icemoon,
/area/space)
"Fp" = (
/obj/effect/turf_decal/weather/snow/corner{
	dir = 8
	},
/obj/effect/turf_decal/siding/wood/corner,
/turf/open/misc/dirt/icemoon,
/area/space)
"FL" = (
/obj/structure/decorative/shelf,
/obj/item/circular_saw/ashwalker{
	pixel_y = -9
	},
/obj/item/surgicaldrill/ashwalker{
	pixel_y = -7;
	pixel_x = 7
	},
/obj/item/cautery/ashwalker{
	pixel_y = 10
	},
/obj/item/scalpel/ashwalker{
	pixel_y = 6
	},
/turf/open/floor/stone/icemoon,
/area/space)
"FS" = (
/obj/structure/mineral_door/wood,
/obj/effect/turf_decal/weather/snow/corner{
	dir = 1
	},
/turf/open/misc/dirt/icemoon,
/area/space)
"FZ" = (
/obj/effect/turf_decal/siding/wood,
/obj/structure/decorative/shelf,
/obj/item/storage/bag/plants/portaseeder{
	pixel_y = -8
	},
/obj/item/hatchet/wooden{
	pixel_y = 5;
	pixel_x = 4
	},
/obj/item/hatchet/wooden{
	pixel_y = 5;
	pixel_x = -3
	},
/turf/open/misc/dirt/icemoon,
/area/space)
"Gh" = (
/obj/effect/turf_decal/siding/wood/corner{
	dir = 8
	},
/turf/open/misc/dirt/icemoon,
/area/space)
"Gj" = (
/obj/effect/turf_decal/weather/snow/corner,
/turf/open/misc/dirt/icemoon,
/area/space)
"Gq" = (
/obj/effect/turf_decal/siding/wood/corner{
	dir = 1
	},
/turf/open/misc/dirt/icemoon,
/area/space)
"Gr" = (
/obj/structure/reagent_crafting_bench,
/obj/item/forging/tongs/primitive,
/turf/open/floor/wood/icemoon,
/area/space)
"GR" = (
/obj/structure/table/wood,
/obj/item/candle/infinite{
	pixel_x = 13;
	pixel_y = 7
	},
/turf/open/misc/dirt/icemoon,
/area/space)
"HJ" = (
/turf/open/misc/asteroid/basalt{
	initial_gas_mix = "ICEMOON_ATMOS"
	},
/area/space)
"IP" = (
/obj/item/flashlight/flare/torch{
	on = 1
	},
/turf/closed/wall/mineral/wood/nonmetal,
/area/space)
"Jh" = (
/obj/structure/decorative/shelf,
/obj/item/shield/buckler{
	pixel_y = 7;
	pixel_x = -3
	},
/obj/item/shield/buckler{
	pixel_y = -5;
	pixel_x = 5
	},
/turf/open/misc/dirt/icemoon,
/area/space)
"Jt" = (
/obj/structure/deployable_barricade/wooden{
	dir = 1;
	pixel_y = 23
	},
/obj/structure/deployable_barricade/wooden{
	dir = 4
	},
/turf/open/misc/asteroid/snow/icemoon,
/area/space)
"Jv" = (
/obj/effect/turf_decal/weather/dirt{
	dir = 4
	},
/turf/open/floor/stone/icemoon,
/area/space)
"JF" = (
/obj/structure/curtain/bounty,
/obj/effect/turf_decal/siding/wood/corner{
	dir = 1
	},
/turf/open/misc/dirt/icemoon,
/area/space)
"JH" = (
/obj/structure/table/wood,
/obj/item/cutting_board,
/turf/open/misc/dirt/icemoon,
/area/space)
"Kh" = (
/obj/structure/table/wood,
/obj/structure/large_mortar,
/obj/item/pestle,
/turf/open/floor/wood/icemoon,
/area/space)
"Kl" = (
/obj/structure/decorative/shelf,
/obj/item/storage/box/matches{
	pixel_y = -8;
	pixel_x = -3
	},
/obj/item/soap/homemade{
	pixel_y = 7
	},
/turf/open/floor/stone/icemoon,
/area/space)
"Ko" = (
/obj/effect/turf_decal/weather/snow/corner,
/obj/effect/turf_decal/siding/wood/corner{
	dir = 1
	},
/turf/open/misc/dirt/icemoon,
/area/space)
"Kp" = (
/obj/structure/closet/crate/wooden/storage_barrel,
/obj/item/stack/medical/aloe{
	pixel_y = -2
	},
/obj/item/stack/medical/aloe{
	pixel_y = 2;
	pixel_x = 2
	},
/obj/item/stack/medical/gauze/improvised{
	pixel_y = 6
	},
/obj/effect/turf_decal/siding/wood/corner{
	dir = 8
	},
/obj/effect/turf_decal/siding/wood{
	dir = 1
	},
/turf/open/misc/dirt/icemoon,
/area/space)
"Ky" = (
/obj/structure/deployable_barricade/wooden{
	dir = 1;
	pixel_y = 23
	},
/turf/open/misc/asteroid/snow/icemoon,
/area/space)
"Le" = (
/obj/structure/table/wood,
/obj/item/restraints/handcuffs/cable/sinew,
/turf/open/floor/stone/icemoon,
/area/space)
"LV" = (
/obj/structure/table/wood,
/turf/open/misc/dirt/icemoon,
/area/space)
"Mu" = (
/mob/living/basic/sheep,
/turf/open/misc/dirt/icemoon,
/area/space)
"MO" = (
/obj/structure/closet/crate/wooden/storage_barrel,
/turf/open/floor/wood/icemoon,
/area/space)
"Oe" = (
/obj/structure/decorative/shelf,
/obj/item/reagent_containers/cup/glass/bottle/lizardwine{
	pixel_y = 8;
	pixel_x = -5
	},
/obj/item/reagent_containers/cup/glass/bottle/moonshine{
	pixel_x = 5;
	pixel_y = -1
	},
/turf/open/misc/dirt/icemoon,
/area/space)
"Oj" = (
/obj/structure/decorative/shelf,
/obj/item/storage/box/matches{
	pixel_y = 7;
	pixel_x = 3
	},
/obj/item/stack/sheet/cloth/ten{
	pixel_y = -5
	},
/turf/open/floor/stone/icemoon,
/area/space)
"Om" = (
/obj/item/flashlight/flare/torch,
/turf/closed/wall/mineral/wood/nonmetal,
/area/space)
"Ox" = (
/obj/structure/closet/crate/wooden,
/obj/item/stack/sheet/copporcitite{
	amount = 7;
	pixel_x = -4
	},
/obj/item/stack/sheet/cobolterium{
	amount = 3;
	pixel_x = 5
	},
/obj/item/stack/sheet/tinumium{
	amount = 5;
	pixel_y = 4
	},
/turf/open/floor/wood/icemoon,
/area/space)
"OS" = (
/obj/structure/closet/crate/wooden/storage_barrel,
/obj/item/food/meat/slab/human/mutant/lizard{
	pixel_y = -9
	},
/obj/item/food/meat/slab/bear{
	pixel_y = -4
	},
/obj/item/food/meat/slab/bear{
	pixel_y = -1
	},
/obj/item/food/meat/slab/penguin{
	pixel_y = 1
	},
/obj/item/food/meat/slab/penguin{
	pixel_y = 5
	},
/turf/open/misc/dirt/icemoon,
/area/space)
"Qi" = (
/obj/effect/turf_decal/siding/wood{
	dir = 9
	},
/turf/open/misc/dirt/icemoon,
/area/space)
"Rp" = (
/obj/structure/rack/shelf/wooden,
/obj/item/forging/billow/primitive{
	pixel_y = 4
	},
/obj/effect/turf_decal/siding/wood{
	dir = 4
	},
/turf/open/misc/dirt/icemoon,
/area/space)
"Rq" = (
/turf/open/floor/wood/icemoon,
/area/space)
"RI" = (
/obj/structure/closet/crate/wooden/storage_barrel,
/obj/item/food/cheese/firm_cheese{
	pixel_y = -2
	},
/obj/item/food/cheese/firm_cheese{
	pixel_y = 1
	},
/obj/item/food/cheese/firm_cheese{
	pixel_y = 3
	},
/turf/open/misc/dirt/icemoon,
/area/space)
"RP" = (
/obj/structure/bed/maint,
/obj/item/bedsheet/black{
	dir = 1
	},
/turf/open/misc/dirt/icemoon,
/area/space)
"Sb" = (
/obj/structure/decorative/shelf,
/obj/item/gun/ballistic/tribalbow{
	pixel_x = -7
	},
/obj/item/gun/ballistic/tribalbow{
	pixel_x = 3
	},
/obj/effect/turf_decal/siding/wood/corner{
	dir = 1
	},
/turf/open/misc/dirt/icemoon,
/area/space)
"Sk" = (
/obj/structure/deployable_barricade/wooden{
	dir = 1;
	pixel_y = 23
	},
/obj/effect/turf_decal/siding/wood{
	dir = 4
	},
/turf/open/misc/dirt/icemoon,
/area/space)
"Sw" = (
/obj/effect/turf_decal/siding/wood/corner{
	dir = 4
	},
/obj/effect/turf_decal/siding/wood/corner,
/turf/open/misc/dirt/icemoon,
/area/space)
"Tw" = (
/obj/structure/decorative/shelf,
/obj/item/shield/goliath{
	pixel_x = -6
	},
/obj/item/shield/goliath{
	pixel_x = 8
	},
/obj/effect/turf_decal/siding/wood{
	dir = 8
	},
/turf/open/misc/dirt/icemoon,
/area/space)
"Uj" = (
/obj/structure/deployable_barricade/wooden,
/turf/open/misc/asteroid/snow/icemoon,
/area/space)
"UA" = (
/obj/structure/table/wood,
/obj/item/knife/hunting{
	pixel_y = 5
	},
/obj/item/kitchen/rollingpin,
/turf/open/misc/dirt/icemoon,
/area/space)
"Vi" = (
/obj/structure/rack/shelf/wooden,
/obj/item/reagent_containers/cup/glass/bottle/small{
	pixel_y = 12;
	pixel_x = -6
	},
/obj/item/reagent_containers/cup/glass/bottle/small{
	pixel_y = 12;
	pixel_x = 3
	},
/obj/item/reagent_containers/cup/mortar{
	pixel_y = -5;
	pixel_x = 4
	},
/turf/open/floor/wood/icemoon,
/area/space)
"Vy" = (
/obj/structure/decorative/shelf,
/obj/item/retractor/ashwalker{
	pixel_y = -9
	},
/obj/item/hemostat/ashwalker{
	pixel_y = 6
	},
/turf/open/floor/stone/icemoon,
/area/space)
"VM" = (
/obj/effect/turf_decal/weather/snow/corner{
	dir = 6
	},
/turf/open/misc/dirt/icemoon,
/area/space)
"Wd" = (
/obj/structure/reagent_anvil,
/obj/item/forging/hammer/primitive,
/turf/open/floor/wood/icemoon,
/area/space)
"Wf" = (
/obj/structure/chair/sofa/bench/woodlike/right,
/turf/open/misc/dirt/icemoon,
/area/space)
"Wh" = (
/obj/effect/turf_decal/siding/wood{
	dir = 5
	},
/turf/open/misc/dirt/icemoon,
/area/space)
"Wl" = (
/obj/structure/water_source/puddle,
/turf/open/misc/dirt/icemoon,
/area/space)
"Ws" = (
/obj/effect/turf_decal/siding/wood{
	dir = 4
	},
/turf/open/misc/dirt/icemoon,
/area/space)
"Xs" = (
/obj/effect/mob_spawn/ghost_role/human/icebox_catgirl,
/turf/open/misc/asteroid/snow/icemoon,
/area/space)
"XQ" = (
/obj/structure/deployable_barricade/wooden{
	dir = 4
	},
/obj/structure/deployable_barricade/wooden,
/turf/open/misc/asteroid/snow/icemoon,
/area/space)
"XS" = (
/obj/effect/turf_decal/weather/snow/corner,
/obj/effect/turf_decal/siding/wood{
	dir = 1
	},
/turf/open/misc/dirt/icemoon,
/area/space)
"Yd" = (
/obj/structure/chair/sofa/bench/woodlike{
	dir = 1
	},
/turf/open/misc/dirt/icemoon,
/area/space)
"YF" = (
/obj/structure/decorative/shelf,
/obj/item/storage/bag/quiver{
	pixel_x = -5
	},
/obj/item/storage/bag/quiver{
	pixel_x = 6
	},
/turf/open/misc/dirt/icemoon,
/area/space)
"Za" = (
/obj/effect/turf_decal/siding/wood{
	dir = 1
	},
/obj/effect/turf_decal/siding/wood,
/turf/open/misc/dirt/icemoon,
/area/space)
"Zn" = (
/obj/structure/bed/maint,
/obj/item/bedsheet/black,
/turf/open/misc/dirt/icemoon,
/area/space)
"Zt" = (
/obj/effect/turf_decal/siding/wood{
	dir = 1
	},
/turf/open/misc/dirt/icemoon,
/area/space)

(1,1,1) = {"
oN
oN
oN
oN
nu
nu
nu
oN
oN
oN
oN
oN
oN
oN
oN
oN
oN
oN
oN
oN
oN
oN
oN
"}
(2,1,1) = {"
oN
oN
nu
nu
nu
nu
nu
nu
nu
oN
oN
oN
oN
oN
oN
oN
oN
oN
oN
oN
oN
oN
oN
"}
(3,1,1) = {"
oN
nu
nu
qw
qw
qw
qw
qw
nu
nu
oN
oN
oN
oN
qw
wE
wE
wE
qw
oN
oN
oN
oN
"}
(4,1,1) = {"
oN
nu
nu
eT
Jv
hl
Jv
eT
nu
nu
qc
qc
eT
qw
eT
qN
hj
cg
eT
qw
eT
oN
oN
"}
(5,1,1) = {"
nu
nu
nu
Rp
Sw
Ws
Ws
hS
nu
IP
ef
mZ
mZ
wE
uM
Kh
au
rY
FL
wE
oN
oN
oN
"}
(6,1,1) = {"
nu
Om
Ox
Rq
Za
Rq
Rq
Wh
DO
mZ
mZ
mZ
mZ
wE
Ar
Rq
au
vP
Le
wE
oN
oN
oN
"}
(7,1,1) = {"
nu
nu
Gr
Rq
Za
Wd
vl
Rq
XS
mZ
mZ
ef
mZ
wE
Vi
Rq
Kp
AP
Vy
wE
oN
oN
oN
"}
(8,1,1) = {"
nu
nu
Rq
Qi
rz
AP
Rq
Qi
Ko
ef
mZ
mZ
mZ
qw
dv
ms
JF
cJ
eT
qw
qw
oN
oN
"}
(9,1,1) = {"
nu
IP
Tw
Gq
zO
Gh
BN
Sb
nu
Om
mZ
ef
mZ
wE
Zn
cj
Ws
fl
RP
wE
oN
oN
oN
"}
(10,1,1) = {"
nu
nu
Jh
rm
rm
fe
YF
nu
nu
nu
mZ
mZ
mZ
wE
RP
EH
Oj
Zt
ij
wE
oN
oN
oN
"}
(11,1,1) = {"
nu
nu
nu
fe
VM
mZ
nu
nu
nu
nu
ef
mZ
mZ
wE
oo
EH
Ag
Zt
Zn
wE
oN
oN
oN
"}
(12,1,1) = {"
oN
nu
Om
mZ
mZ
ef
Om
nu
nu
mZ
mZ
mZ
eT
qw
eT
EH
CG
Zt
eT
qw
eT
EQ
oN
"}
(13,1,1) = {"
oN
Ky
ef
mZ
mZ
mZ
mZ
mZ
mZ
ef
mZ
mZ
lB
wE
rm
Gh
BN
Gq
rm
wE
Ky
mZ
EQ
"}
(14,1,1) = {"
oN
Jt
mZ
mZ
mZ
mZ
mZ
ef
mZ
mZ
Xs
mZ
mZ
FS
rm
Wf
LV
Ba
rm
Bs
mZ
mZ
Uj
"}
(15,1,1) = {"
oN
oN
Ky
ef
mZ
mZ
mZ
nu
nu
lB
mZ
mZ
ef
wE
rm
Em
rG
Yd
rm
wE
Ky
mZ
Uj
"}
(16,1,1) = {"
oN
oN
nu
nu
mZ
mZ
CN
Om
nu
nu
mZ
ef
dv
qw
eT
Em
GR
bo
dv
qw
eT
vE
XQ
"}
(17,1,1) = {"
oN
nu
nu
nu
Fp
kZ
qC
HJ
nu
nu
ig
mZ
mZ
wE
kr
bJ
LV
rm
RP
wE
oN
oN
oN
"}
(18,1,1) = {"
oN
nu
nu
Om
FZ
HJ
HJ
pS
HJ
nu
nu
mZ
mZ
wE
RI
cj
Ws
fl
Zn
wE
oN
oN
oN
"}
(19,1,1) = {"
nu
nu
nu
rm
zm
gs
HJ
HJ
HJ
Om
nu
mZ
ef
wE
OS
EH
pZ
Zt
Zn
wE
oN
oN
oN
"}
(20,1,1) = {"
nu
nu
Mu
rm
zm
HJ
HJ
HJ
HJ
nu
nu
mZ
qw
qw
dv
oO
Ag
Zt
eT
qw
oN
oN
oN
"}
(21,1,1) = {"
nu
nu
Mu
rm
us
AP
uZ
HJ
HJ
IP
ef
mZ
mZ
qw
vf
EH
Kl
Zt
ce
wE
oN
oN
oN
"}
(22,1,1) = {"
nu
Om
rm
rm
lp
EH
HJ
HJ
Qi
ne
mZ
mZ
mZ
qw
pd
Gh
BN
Gq
Oe
wE
oN
oN
oN
"}
(23,1,1) = {"
nu
rm
vo
Mu
rm
us
BN
BN
Ko
mZ
mZ
mZ
ef
qw
qs
rm
rm
sl
xr
wE
oN
oN
oN
"}
(24,1,1) = {"
nu
vo
vo
rm
rm
pn
Wl
rm
Gj
ef
mZ
mZ
eT
qw
eT
ok
JH
UA
eT
qw
eT
oN
oN
"}
(25,1,1) = {"
nu
IP
rm
vo
cj
Sk
Ws
Ws
kU
Om
vE
XQ
oN
oN
qw
wE
wE
wE
qw
oN
oN
oN
oN
"}
(26,1,1) = {"
nu
nu
nu
nu
Om
aM
Rq
MO
nu
nu
oN
oN
oN
oN
oN
oN
oN
oN
oN
oN
oN
oN
oN
"}
(27,1,1) = {"
oN
nu
nu
nu
nu
fY
Rq
MO
Om
nu
oN
oN
oN
oN
oN
oN
oN
oN
oN
oN
oN
oN
oN
"}
(28,1,1) = {"
oN
nu
nu
nu
nu
nu
dF
MO
nu
nu
oN
oN
oN
oN
oN
oN
oN
oN
oN
oN
oN
oN
oN
"}
(29,1,1) = {"
oN
oN
nu
nu
nu
nu
IP
nu
nu
nu
oN
oN
oN
oN
oN
oN
oN
oN
oN
oN
oN
oN
oN
"}
(30,1,1) = {"
oN
oN
oN
oN
nu
nu
nu
nu
oN
oN
oN
oN
oN
oN
oN
oN
oN
oN
oN
oN
oN
oN
oN
"}
