//MAP CONVERTED BY dmm2tgm.py THIS HEADER COMMENT PREVENTS RECONVERSION, DO NOT REMOVE
"bg" = (
/obj/structure/rack/shelf{
	icon = 'modular_skyrat/modules/mapping/icons/unique/furniture.dmi';
	icon_state = "empty_shelf_1"
	},
/obj/item/gun/ballistic/tribalbow,
/obj/item/storage/bag/quiver,
/turf/open/space/basic,
/area/space)
"bj" = (
/obj/effect/turf_decal/siding/wideplating/dark{
	dir = 8
	},
/obj/structure/rack/shelf{
	icon = 'modular_skyrat/modules/mapping/icons/unique/furniture.dmi';
	icon_state = "empty_shelf_1"
	},
/obj/item/flashlight/flare/torch{
	on = 1;
	pixel_x = 12
	},
/obj/item/flashlight/flare/torch{
	on = 1;
	pixel_x = 8;
	pixel_y = 4
	},
/obj/item/flashlight/flare/torch{
	on = 1;
	pixel_x = -4;
	pixel_y = 7
	},
/obj/item/flashlight/flare/torch{
	on = 1
	},
/turf/open/floor/stone{
	color = "#878787"
	},
/area/space)
"bs" = (
/obj/structure/deployable_barricade/wooden{
	dir = 1;
	pixel_y = 23
	},
/turf/open/space/basic,
/area/space)
"ev" = (
/obj/structure/stone_tile/center,
/obj/structure/lattice/lava,
/obj/structure/stone_tile/surrounding_tile{
	dir = 4
	},
/turf/open/lava/plasma,
/area/space)
"eQ" = (
/obj/item/flashlight/flare/torch{
	on = 1
	},
/turf/closed/indestructible/stone{
	color = "#878787"
	},
/area/space)
"fo" = (
/obj/structure/rack/shelf{
	icon = 'modular_skyrat/modules/mapping/icons/unique/furniture.dmi';
	icon_state = "empty_shelf_1"
	},
/obj/item/storage/bag/ore{
	pixel_y = 3
	},
/obj/item/storage/bag/ore,
/obj/item/pickaxe/mini{
	pixel_y = 5
	},
/obj/item/pickaxe/mini,
/turf/open/space/basic,
/area/space)
"fx" = (
/turf/open/floor/stone{
	color = "#878787"
	},
/area/space)
"fP" = (
/obj/effect/turf_decal/siding/wideplating/dark{
	dir = 1
	},
/obj/structure/table/wood,
/turf/open/floor/stone{
	color = "#878787"
	},
/area/space)
"gx" = (
/obj/effect/turf_decal/siding/wideplating/dark{
	dir = 1
	},
/turf/open/floor/stone{
	color = "#878787"
	},
/area/space)
"hG" = (
/turf/closed/mineral/snowmountain/icemoon,
/area/space)
"jM" = (
/obj/structure/water_source/puddle,
/turf/open/space/basic,
/area/space)
"lb" = (
/obj/effect/mapping_helpers/no_lava,
/turf/open/space/basic,
/area/space)
"lj" = (
/obj/machinery/hydroponics/soil,
/turf/open/space/basic,
/area/space)
"lD" = (
/obj/structure/reagent_forge{
	primitive = 1
	},
/turf/open/floor/stone{
	color = "#878787"
	},
/area/space)
"lW" = (
/obj/structure/closet/crate/wooden,
/obj/item/storage/bag/plants/portaseeder{
	pixel_y = 4
	},
/obj/item/storage/bag/plants/portaseeder,
/turf/open/floor/stone{
	color = "#878787"
	},
/area/space)
"mT" = (
/obj/structure/reagent_crafting_bench,
/obj/item/forging/tongs/primitive,
/turf/open/floor/stone{
	color = "#878787"
	},
/area/space)
"nS" = (
/obj/structure/deployable_barricade/wooden{
	dir = 4
	},
/turf/open/space/basic,
/area/space)
"oe" = (
/obj/structure/closet/crate/wooden,
/obj/item/stack/sheet/leather{
	amount = 35
	},
/obj/item/stack/sheet/leather{
	amount = 35
	},
/obj/item/stack/sheet/cloth/ten,
/obj/item/stack/sheet/cloth/ten,
/turf/open/space/basic,
/area/space)
"os" = (
/obj/effect/turf_decal/siding/wideplating/dark,
/obj/effect/turf_decal/siding/wideplating/dark{
	dir = 1
	},
/obj/structure/mineral_door/dungeon{
	color = "#878787"
	},
/obj/structure/fans/tiny/invisible,
/turf/open/floor/stone{
	color = "#878787"
	},
/area/space)
"oA" = (
/obj/machinery/hydroponics/soil,
/obj/item/shovel,
/turf/open/space/basic,
/area/space)
"oL" = (
/obj/machinery/hydroponics/soil,
/obj/item/cultivator/rake,
/turf/open/space/basic,
/area/space)
"oX" = (
/obj/structure/decorative/shelf,
/obj/item/reagent_containers/glass/bottle/nutrient/rh{
	pixel_x = -6;
	pixel_y = 6
	},
/obj/item/reagent_containers/glass/bottle/nutrient/rh{
	pixel_x = -6;
	pixel_y = 2
	},
/obj/item/reagent_containers/glass/bottle/nutrient/l4z{
	pixel_x = 6;
	pixel_y = 6
	},
/obj/item/reagent_containers/glass/bottle/nutrient/l4z{
	pixel_x = 6;
	pixel_y = 2
	},
/obj/item/reagent_containers/glass/bottle/nutrient/ez{
	pixel_y = 4
	},
/obj/item/reagent_containers/glass/bottle/nutrient/ez,
/turf/open/floor/stone{
	color = "#878787"
	},
/area/space)
"pn" = (
/obj/effect/turf_decal/siding/wideplating/dark{
	dir = 4
	},
/turf/open/floor/stone{
	color = "#878787"
	},
/area/space)
"qm" = (
/obj/structure/bonfire/dense,
/turf/open/space/basic,
/area/space)
"qJ" = (
/obj/structure/decorative/shelf,
/obj/item/stack/rods/fifty,
/turf/open/floor/stone{
	color = "#878787"
	},
/area/space)
"rp" = (
/obj/structure/reagent_anvil{
	primitive = 1
	},
/obj/item/forging/hammer/primitive,
/turf/open/floor/stone{
	color = "#878787"
	},
/area/space)
"rM" = (
/obj/structure/reagent_water_basin,
/turf/open/floor/stone{
	color = "#878787"
	},
/area/space)
"sa" = (
/obj/structure/deployable_barricade/wooden{
	dir = 1;
	pixel_y = 23
	},
/obj/structure/deployable_barricade/wooden{
	dir = 8
	},
/turf/open/space/basic,
/area/space)
"sC" = (
/obj/structure/rack/shelf{
	icon = 'modular_skyrat/modules/mapping/icons/unique/furniture.dmi';
	icon_state = "empty_shelf_1"
	},
/obj/item/restraints/handcuffs/cable/sinew,
/obj/item/restraints/handcuffs/cable/sinew{
	pixel_y = 4
	},
/obj/item/knife/combat/bone{
	pixel_y = -5
	},
/obj/item/knife/combat/bone,
/obj/item/knife/combat/bone{
	pixel_y = 5
	},
/turf/open/space/basic,
/area/space)
"sX" = (
/obj/effect/turf_decal/siding/wideplating/dark{
	dir = 1
	},
/obj/structure/statue/bone/rib{
	dir = 1
	},
/turf/open/floor/stone{
	color = "#878787"
	},
/area/space)
"uc" = (
/obj/effect/turf_decal/siding/wideplating/dark{
	dir = 8
	},
/obj/structure/table/wood,
/turf/open/floor/stone{
	color = "#878787"
	},
/area/space)
"uj" = (
/obj/structure/lattice/lava,
/obj/structure/deployable_barricade/metal{
	color = "#878787";
	dir = 4
	},
/turf/open/space/basic,
/area/space)
"uw" = (
/obj/structure/lavaland/ash_walker,
/turf/open/lava/plasma,
/area/space)
"uG" = (
/obj/structure/fermenting_barrel,
/turf/open/space/basic,
/area/space)
"wB" = (
/obj/structure/decorative/shelf,
/obj/item/secateurs,
/turf/open/floor/stone{
	color = "#878787"
	},
/area/space)
"wC" = (
/obj/structure/table/wood,
/obj/item/forging/billow/primitive,
/turf/open/floor/stone{
	color = "#878787"
	},
/area/space)
"Al" = (
/obj/structure/closet/crate/miningcar,
/obj/item/stack/sheet/mineral/coal/ten,
/turf/open/floor/stone{
	color = "#878787"
	},
/area/space)
"Bz" = (
/obj/structure/lattice/lava,
/obj/structure/stone_tile/block,
/turf/open/lava/plasma,
/area/space)
"Cp" = (
/obj/structure/deployable_barricade/wooden{
	dir = 8
	},
/obj/structure/deployable_barricade/wooden,
/turf/open/space/basic,
/area/space)
"EB" = (
/obj/effect/turf_decal/siding/wideplating/dark,
/obj/structure/table/wood,
/turf/open/floor/stone{
	color = "#878787"
	},
/area/space)
"FB" = (
/turf/closed/wall/mineral/snow,
/area/space)
"GU" = (
/obj/structure/lattice/lava,
/obj/structure/deployable_barricade/metal{
	color = "#878787";
	dir = 8
	},
/turf/open/lava/plasma/ice_moon,
/area/space)
"Hb" = (
/obj/item/flashlight/flare/torch{
	on = 1
	},
/turf/closed/wall/mineral/wood/nonmetal,
/area/space)
"Ix" = (
/obj/structure/rack/shelf{
	icon = 'modular_skyrat/modules/mapping/icons/unique/furniture.dmi';
	icon_state = "empty_shelf_1"
	},
/obj/item/spear/bonespear{
	pixel_y = 7
	},
/obj/item/spear/bonespear,
/obj/item/claymore/bone{
	pixel_x = 5;
	pixel_y = -4
	},
/turf/open/space/basic,
/area/space)
"Ja" = (
/obj/effect/turf_decal/siding/wideplating/dark{
	dir = 4
	},
/obj/effect/turf_decal/siding/wideplating/dark{
	dir = 8
	},
/obj/structure/mineral_door/dungeon{
	color = "#878787"
	},
/turf/open/floor/stone{
	color = "#878787"
	},
/area/space)
"Kd" = (
/obj/effect/turf_decal/siding/wideplating/dark{
	dir = 4
	},
/obj/structure/statue/bone/rib{
	dir = 1
	},
/turf/open/floor/stone{
	color = "#878787"
	},
/area/space)
"Kg" = (
/obj/machinery/vending/ashclothingvendor,
/turf/open/space/basic,
/area/space)
"Lc" = (
/obj/structure/lattice/lava,
/obj/structure/deployable_barricade/metal{
	color = "#878787";
	dir = 4
	},
/obj/structure/deployable_barricade/metal{
	color = "#878787";
	dir = 8
	},
/turf/open/lava/plasma/ice_moon,
/area/space)
"Lw" = (
/obj/effect/turf_decal/siding/wideplating/dark{
	dir = 4
	},
/obj/effect/turf_decal/siding/wideplating/dark{
	dir = 8
	},
/obj/structure/fans/tiny/invisible,
/obj/structure/mineral_door/dungeon{
	color = "#878787"
	},
/turf/open/floor/stone{
	color = "#878787"
	},
/area/space)
"Mk" = (
/obj/structure/stone_tile/center,
/obj/structure/lattice/lava,
/obj/structure/stone_tile/surrounding_tile,
/turf/open/lava/plasma,
/area/space)
"MJ" = (
/obj/effect/turf_decal/siding/wideplating/dark{
	dir = 1
	},
/obj/effect/turf_decal/siding/wideplating/dark,
/obj/structure/fans/tiny/invisible,
/obj/structure/mineral_door/dungeon{
	color = "#878787"
	},
/turf/open/floor/stone{
	color = "#878787"
	},
/area/space)
"OF" = (
/obj/effect/turf_decal/siding/wideplating/dark{
	dir = 4
	},
/obj/effect/turf_decal/siding/wideplating/dark{
	dir = 8
	},
/turf/open/floor/stone{
	color = "#878787"
	},
/area/space)
"Pj" = (
/turf/open/lava/plasma/ice_moon,
/area/space)
"Pv" = (
/turf/closed/indestructible/stone{
	color = "#878787"
	},
/area/space)
"PB" = (
/turf/open/space/basic,
/area/space)
"Qa" = (
/obj/structure/closet/crate/wooden,
/obj/item/stack/sheet/mineral/sandstone/thirty,
/obj/item/stack/sheet/iron/twenty,
/turf/open/space/basic,
/area/space)
"Qo" = (
/obj/effect/turf_decal/siding/wideplating/dark,
/obj/structure/destructible/cult/pants_altar,
/obj/item/knife/hunting,
/turf/open/floor/stone{
	color = "#878787"
	},
/area/space)
"QV" = (
/obj/structure/rack/shelf{
	icon = 'modular_skyrat/modules/mapping/icons/unique/furniture.dmi';
	icon_state = "empty_shelf_1"
	},
/obj/item/storage/belt/utility/full,
/obj/item/storage/belt/utility/full{
	pixel_y = 6
	},
/turf/open/space/basic,
/area/space)
"Rb" = (
/obj/structure/stone_tile/center,
/obj/structure/lattice/lava,
/obj/structure/stone_tile/surrounding_tile{
	dir = 8
	},
/turf/open/lava/plasma,
/area/space)
"RF" = (
/obj/effect/turf_decal/siding/wideplating/dark{
	dir = 8
	},
/obj/structure/statue/bone/rib,
/turf/open/floor/stone{
	color = "#878787"
	},
/area/space)
"RG" = (
/obj/structure/deployable_barricade/wooden{
	dir = 8
	},
/turf/open/space/basic,
/area/space)
"RV" = (
/obj/structure/lattice/lava,
/obj/structure/deployable_barricade/metal{
	color = "#878787";
	dir = 8
	},
/turf/open/space/basic,
/area/space)
"SR" = (
/obj/structure/lattice/lava,
/obj/structure/stone_tile/block{
	dir = 8
	},
/turf/open/lava/plasma,
/area/space)
"TC" = (
/obj/structure/stone_tile/center,
/obj/structure/lattice/lava,
/obj/structure/stone_tile/surrounding_tile{
	dir = 1
	},
/turf/open/lava/plasma,
/area/space)
"Vl" = (
/obj/structure/lattice/lava,
/obj/structure/stone_tile/block{
	dir = 1
	},
/turf/open/lava/plasma,
/area/space)
"VZ" = (
/obj/effect/turf_decal/siding/wideplating/dark{
	dir = 8
	},
/obj/effect/turf_decal/siding/wideplating/dark{
	dir = 4
	},
/obj/structure/fans/tiny/invisible,
/obj/structure/mineral_door/dungeon{
	color = "#878787"
	},
/turf/open/floor/stone{
	color = "#878787"
	},
/area/space)
"Wf" = (
/turf/closed/wall/mineral/wood/nonmetal,
/area/space)
"WL" = (
/obj/structure/lattice/lava,
/obj/structure/stone_tile/block{
	dir = 4
	},
/turf/open/lava/plasma,
/area/space)
"Xo" = (
/obj/effect/turf_decal/siding/wideplating/dark{
	dir = 1
	},
/obj/effect/turf_decal/siding/wideplating/dark,
/obj/structure/mineral_door/dungeon{
	color = "#878787"
	},
/obj/structure/fans/tiny/invisible,
/turf/open/floor/stone{
	color = "#878787"
	},
/area/space)
"Yl" = (
/obj/item/reagent_containers/glass/bucket/wooden,
/turf/open/space/basic,
/area/space)
"YQ" = (
/obj/structure/lattice/lava,
/obj/structure/deployable_barricade/metal{
	color = "#878787";
	dir = 4
	},
/turf/open/lava/plasma/ice_moon,
/area/space)

(1,1,1) = {"
PB
PB
PB
PB
PB
PB
PB
PB
PB
PB
hG
hG
hG
hG
PB
PB
PB
PB
PB
PB
PB
PB
PB
"}
(2,1,1) = {"
PB
PB
PB
Pv
PB
PB
PB
PB
PB
hG
hG
hG
hG
hG
hG
hG
PB
PB
PB
PB
PB
PB
PB
"}
(3,1,1) = {"
PB
PB
Pv
eQ
Pv
FB
Hb
FB
FB
hG
hG
hG
hG
hG
hG
hG
Pv
PB
Pv
PB
PB
PB
PB
"}
(4,1,1) = {"
PB
Pv
Pv
lW
PB
RG
PB
Cp
FB
FB
Wf
PB
Pj
hG
hG
Pv
Pv
Pv
Pv
Pv
PB
PB
PB
"}
(5,1,1) = {"
Pv
eQ
oX
PB
lj
lj
lj
PB
RG
RG
PB
PB
Pj
PB
Pv
eQ
PB
PB
PB
eQ
Pv
PB
PB
"}
(6,1,1) = {"
PB
Pv
wB
lj
oA
PB
PB
PB
lj
PB
PB
RV
GU
RV
Pv
PB
PB
PB
PB
PB
Pv
Pv
PB
"}
(7,1,1) = {"
PB
FB
bs
Yl
PB
PB
lj
lj
oL
PB
PB
OF
OF
OF
MJ
PB
PB
PB
PB
PB
Pv
PB
PB
"}
(8,1,1) = {"
PB
Hb
nS
jM
oL
lj
PB
PB
lj
PB
PB
PB
YQ
uj
Pv
PB
PB
PB
PB
PB
Pv
Pv
PB
"}
(9,1,1) = {"
PB
FB
FB
bs
PB
lj
oA
PB
PB
PB
PB
PB
Pj
PB
Pv
eQ
PB
PB
PB
eQ
Pv
PB
PB
"}
(10,1,1) = {"
PB
PB
FB
bs
PB
PB
PB
PB
PB
PB
qm
PB
Pj
PB
PB
Pv
Pv
Lw
Pv
Pv
PB
PB
PB
"}
(11,1,1) = {"
PB
PB
FB
Pv
Pv
Ja
Pv
Pv
PB
PB
PB
PB
Pj
Pj
PB
PB
PB
PB
PB
lb
PB
PB
PB
"}
(12,1,1) = {"
PB
PB
Pv
eQ
PB
PB
PB
eQ
Pv
PB
PB
PB
PB
Pj
Pj
Pj
PB
PB
PB
lb
PB
PB
PB
"}
(13,1,1) = {"
PB
Pv
Pv
PB
PB
PB
PB
PB
Pv
PB
PB
PB
PB
PB
PB
Pj
Pj
PB
PB
lb
PB
PB
PB
"}
(14,1,1) = {"
PB
PB
Pv
PB
PB
PB
PB
PB
FB
bs
PB
fx
rp
eQ
PB
PB
Pj
PB
PB
lb
PB
PB
PB
"}
(15,1,1) = {"
PB
Pv
eQ
PB
PB
PB
PB
PB
FB
bs
wC
fx
fx
lD
PB
PB
Lc
PB
PB
lb
PB
PB
PB
"}
(16,1,1) = {"
PB
PB
Pv
PB
PB
PB
PB
PB
Wf
PB
mT
fx
fx
rM
PB
PB
Pj
PB
PB
lb
PB
PB
PB
"}
(17,1,1) = {"
PB
Pv
Pv
PB
PB
PB
PB
FB
FB
bs
Pv
qJ
fx
fx
PB
PB
Pj
PB
PB
lb
PB
PB
PB
"}
(18,1,1) = {"
PB
PB
Pv
eQ
PB
PB
PB
FB
sa
PB
eQ
Pv
Al
PB
PB
Pj
Pj
PB
PB
lb
PB
PB
PB
"}
(19,1,1) = {"
PB
PB
PB
Pv
Pv
Ja
FB
eQ
PB
PB
PB
PB
PB
PB
PB
Pj
PB
PB
PB
lb
PB
PB
PB
"}
(20,1,1) = {"
PB
PB
PB
PB
PB
PB
RG
PB
PB
PB
PB
PB
Pj
Pj
Pj
Pj
PB
PB
PB
lb
PB
PB
PB
"}
(21,1,1) = {"
PB
PB
PB
PB
PB
PB
PB
PB
PB
qm
PB
PB
Lc
PB
PB
PB
PB
PB
PB
lb
PB
PB
PB
"}
(22,1,1) = {"
PB
PB
PB
PB
PB
PB
PB
PB
PB
PB
PB
Pj
Pj
PB
PB
PB
PB
PB
PB
lb
PB
PB
PB
"}
(23,1,1) = {"
PB
PB
PB
PB
Pv
Pv
Lw
Pv
Pv
PB
PB
Pj
PB
PB
Pv
Pv
VZ
Pv
Pv
lb
PB
PB
PB
"}
(24,1,1) = {"
PB
PB
PB
Pv
eQ
pn
pn
Kd
eQ
Pv
PB
Pj
PB
Pv
eQ
Kg
PB
fo
eQ
Pv
PB
PB
PB
"}
(25,1,1) = {"
PB
PB
Pv
Pv
EB
ev
SR
Rb
sX
Pv
RV
GU
RV
Pv
Ix
sC
PB
PB
Kg
Pv
Pv
PB
PB
"}
(26,1,1) = {"
PB
PB
PB
Pv
Qo
Vl
uw
Bz
gx
Xo
OF
OF
OF
os
PB
PB
PB
Qa
uG
Pv
PB
PB
PB
"}
(27,1,1) = {"
PB
PB
Pv
Pv
EB
TC
WL
Mk
fP
Pv
uj
YQ
uj
Pv
bg
PB
PB
PB
uG
Pv
Pv
PB
PB
"}
(28,1,1) = {"
PB
PB
PB
Pv
eQ
RF
bj
uc
eQ
Pv
PB
Pj
PB
Pv
eQ
QV
PB
oe
eQ
Pv
PB
PB
PB
"}
(29,1,1) = {"
PB
PB
PB
lb
Pv
Pv
Pv
Pv
Pv
hG
hG
Pj
PB
hG
Pv
Pv
Pv
Pv
Pv
lb
PB
PB
PB
"}
(30,1,1) = {"
PB
PB
PB
PB
PB
Pv
PB
Pv
hG
hG
hG
hG
hG
hG
hG
Pv
PB
Pv
PB
PB
PB
PB
PB
"}
(31,1,1) = {"
PB
PB
PB
PB
PB
PB
PB
PB
hG
hG
hG
hG
hG
hG
hG
hG
PB
PB
PB
PB
PB
PB
PB
"}
(32,1,1) = {"
PB
PB
PB
PB
PB
PB
PB
PB
PB
PB
hG
hG
hG
hG
hG
PB
PB
PB
PB
PB
PB
PB
PB
"}
