//MAP CONVERTED BY dmm2tgm.py THIS HEADER COMMENT PREVENTS RECONVERSION, DO NOT REMOVE
"aQ" = (
/obj/structure/bonfire/grill_pre_attached,
/turf/open/floor/stone/icemoon,
/area/ruin/unpowered/primitive_catgirl_den)
"ba" = (
/obj/structure/rack/shelf/wooden,
/obj/item/retractor/ashwalker{
	pixel_y = -9
	},
/obj/item/hemostat/ashwalker{
	pixel_y = 6
	},
/turf/open/floor/stone/icemoon,
/area/ruin/unpowered/primitive_catgirl_den)
"bn" = (
/obj/effect/turf_decal/siding/wood{
	dir = 8
	},
/obj/structure/chair/wood{
	dir = 4
	},
/turf/open/misc/dirt/icemoon,
/area/ruin/unpowered/primitive_catgirl_den)
"ci" = (
/obj/structure/closet/crate/wooden,
/obj/item/stack/sheet/cobolterium{
	amount = 32;
	pixel_x = 5
	},
/obj/item/stack/sheet/copporcitite{
	amount = 37;
	pixel_x = -4
	},
/obj/item/stack/sheet/tinumium{
	amount = 28;
	pixel_y = 4
	},
/obj/effect/turf_decal/siding/wood/corner{
	dir = 4
	},
/turf/open/misc/dirt/icemoon,
/area/ruin/unpowered/primitive_catgirl_den)
"cE" = (
/obj/structure/table/wood,
/obj/item/paper_bin/bundlenatural,
/obj/item/pen/charcoal,
/turf/open/floor/wood/icemoon,
/area/ruin/unpowered/primitive_catgirl_den)
"db" = (
/obj/structure/table/wood,
/obj/item/cutting_board,
/turf/open/misc/dirt/icemoon,
/area/ruin/unpowered/primitive_catgirl_den)
"dq" = (
/obj/effect/turf_decal/siding/wood{
	dir = 1
	},
/obj/effect/turf_decal/siding/wood,
/turf/open/misc/dirt/icemoon,
/area/ruin/unpowered/primitive_catgirl_den)
"dy" = (
/obj/effect/turf_decal/siding/wood,
/turf/open/misc/dirt/icemoon,
/area/ruin/unpowered/primitive_catgirl_den)
"dE" = (
/obj/structure/closet/crate/wooden/storage_barrel,
/obj/item/food/cheese/mozzarella{
	pixel_y = -6
	},
/obj/item/food/cheese/mozzarella{
	pixel_y = -3;
	pixel_x = -3
	},
/obj/item/food/cheese/mozzarella,
/obj/item/food/cheese/mozzarella{
	pixel_y = 3;
	pixel_x = -3
	},
/obj/item/food/cheese/mozzarella{
	pixel_y = 7
	},
/turf/open/floor/stone/icemoon,
/area/ruin/unpowered/primitive_catgirl_den)
"dR" = (
/obj/structure/reagent_crafting_bench,
/obj/item/forging/tongs/primitive,
/turf/open/misc/dirt/icemoon,
/area/ruin/unpowered/primitive_catgirl_den)
"ed" = (
/obj/effect/turf_decal/siding/wood/corner,
/turf/open/misc/dirt/icemoon,
/area/ruin/unpowered/primitive_catgirl_den)
"ew" = (
/obj/structure/deployable_barricade/wooden{
	dir = 4;
	pixel_y = 6
	},
/turf/open/misc/asteroid/snow/icemoon,
/area/ruin/unpowered/primitive_catgirl_den)
"fN" = (
/obj/effect/turf_decal/weather/snow/corner{
	dir = 8
	},
/obj/effect/turf_decal/siding/wood/corner,
/turf/open/misc/dirt/icemoon,
/area/ruin/unpowered/primitive_catgirl_den)
"gq" = (
/obj/item/storage/box/matches{
	pixel_y = 7;
	pixel_x = 3
	},
/obj/item/stack/sheet/cloth/ten{
	pixel_y = -5
	},
/obj/structure/rack/shelf/wooden,
/turf/open/floor/stone/icemoon,
/area/ruin/unpowered/primitive_catgirl_den)
"gD" = (
/obj/effect/turf_decal/weather/snow/corner,
/obj/effect/turf_decal/siding/wood{
	dir = 1
	},
/turf/open/misc/dirt/icemoon,
/area/ruin/unpowered/primitive_catgirl_den)
"gM" = (
/obj/effect/turf_decal/weather/snow/corner{
	dir = 9
	},
/obj/effect/turf_decal/weather/snow/corner{
	dir = 5
	},
/turf/open/misc/dirt/icemoon,
/area/ruin/unpowered/primitive_catgirl_den)
"gV" = (
/obj/structure/deployable_barricade/wooden{
	dir = 1;
	pixel_y = 23
	},
/obj/structure/deployable_barricade/wooden{
	dir = 8
	},
/turf/open/misc/asteroid/snow/icemoon,
/area/ruin/unpowered/primitive_catgirl_den)
"hJ" = (
/obj/structure/rack/shelf/wooden,
/obj/item/forging/billow/primitive{
	pixel_y = 4
	},
/turf/open/floor/stone/icemoon,
/area/ruin/unpowered/primitive_catgirl_den)
"hY" = (
/obj/structure/deployable_barricade/wooden{
	dir = 8;
	pixel_y = 12
	},
/obj/structure/deployable_barricade/wooden,
/turf/open/misc/asteroid/snow/icemoon,
/area/ruin/unpowered/primitive_catgirl_den)
"iJ" = (
/obj/structure/closet/crate/wooden,
/obj/item/stack/sheet/mineral/wood{
	amount = 15
	},
/obj/item/stack/sheet/mineral/coal/ten,
/turf/open/floor/stone/icemoon,
/area/ruin/unpowered/primitive_catgirl_den)
"iS" = (
/obj/effect/turf_decal/weather/snow/corner{
	dir = 5
	},
/turf/open/misc/dirt/icemoon,
/area/ruin/unpowered/primitive_catgirl_den)
"jh" = (
/obj/structure/rack/shelf/wooden,
/obj/item/reagent_containers/cup/glass/bottle/moonshine{
	pixel_x = 5;
	pixel_y = -1
	},
/obj/item/reagent_containers/cup/glass/bottle/lizardwine{
	pixel_y = 8;
	pixel_x = -5
	},
/turf/open/misc/dirt/icemoon,
/area/ruin/unpowered/primitive_catgirl_den)
"jP" = (
/obj/effect/turf_decal/weather/snow/corner{
	dir = 9
	},
/obj/effect/turf_decal/siding/wood/corner,
/turf/open/misc/dirt/icemoon,
/area/ruin/unpowered/primitive_catgirl_den)
"kf" = (
/obj/structure/reagent_forge{
	pixel_y = 12
	},
/turf/open/floor/stone/icemoon,
/area/ruin/unpowered/primitive_catgirl_den)
"kQ" = (
/obj/structure/bed/maint,
/obj/item/bedsheet/black{
	dir = 1
	},
/turf/open/misc/dirt/icemoon,
/area/ruin/unpowered/primitive_catgirl_den)
"lx" = (
/obj/effect/turf_decal/weather/snow/corner,
/obj/structure/mineral_door/wood,
/turf/open/misc/dirt/icemoon,
/area/ruin/unpowered/primitive_catgirl_den)
"lz" = (
/obj/item/flashlight/flare/torch{
	on = 1
	},
/turf/closed/indestructible/stone,
/area/ruin/unpowered/primitive_catgirl_den)
"lE" = (
/turf/closed/wall/mineral/wood/nonmetal,
/area/ruin/unpowered/primitive_catgirl_den)
"lG" = (
/obj/effect/turf_decal/siding/wood/corner{
	dir = 1
	},
/turf/open/misc/dirt/icemoon,
/area/ruin/unpowered/primitive_catgirl_den)
"lP" = (
/obj/effect/turf_decal/weather/dirt,
/obj/structure/closet/crate/wooden/storage_barrel,
/obj/item/food/cheese/firm_cheese{
	pixel_y = -2
	},
/obj/item/food/cheese/firm_cheese{
	pixel_y = 1
	},
/obj/item/food/cheese/firm_cheese{
	pixel_y = 3
	},
/obj/item/food/cheese/firm_cheese{
	pixel_y = 5
	},
/turf/open/floor/stone/icemoon,
/area/ruin/unpowered/primitive_catgirl_den)
"mr" = (
/obj/effect/turf_decal/weather/snow/corner{
	dir = 8
	},
/obj/structure/rack/shelf/wooden,
/obj/item/reagent_containers/cup/mortar{
	pixel_y = 9;
	pixel_x = -3
	},
/obj/item/pestle{
	pixel_y = -9;
	pixel_x = -7
	},
/obj/item/ore_sensor{
	pixel_y = -1;
	pixel_x = 7
	},
/obj/effect/turf_decal/siding/wood{
	dir = 4
	},
/turf/open/misc/dirt/icemoon,
/area/ruin/unpowered/primitive_catgirl_den)
"mz" = (
/obj/structure/table/wood,
/obj/structure/large_mortar,
/obj/item/pestle{
	pixel_y = -1;
	pixel_x = -8
	},
/turf/open/floor/stone/icemoon,
/area/ruin/unpowered/primitive_catgirl_den)
"ng" = (
/obj/structure/deployable_barricade/wooden{
	dir = 1;
	pixel_y = 23
	},
/obj/structure/deployable_barricade/wooden{
	dir = 8;
	pixel_y = 6
	},
/turf/open/misc/asteroid/snow/icemoon,
/area/ruin/unpowered/primitive_catgirl_den)
"nh" = (
/obj/effect/turf_decal/siding/wood{
	dir = 10
	},
/turf/open/misc/dirt/icemoon,
/area/ruin/unpowered/primitive_catgirl_den)
"nq" = (
/obj/structure/deployable_barricade/wooden{
	dir = 1;
	pixel_y = 23
	},
/turf/open/misc/asteroid/snow/icemoon,
/area/ruin/unpowered/primitive_catgirl_den)
"nA" = (
/obj/machinery/vending/primitive_catgirl_clothing_vendor,
/turf/open/misc/dirt/icemoon,
/area/ruin/unpowered/primitive_catgirl_den)
"nE" = (
/obj/effect/turf_decal/siding/wood/corner,
/turf/open/misc/asteroid/basalt{
	initial_gas_mix = "ICEMOON_ATMOS"
	},
/area/ruin/unpowered/primitive_catgirl_den)
"nP" = (
/obj/effect/turf_decal/weather/snow/corner{
	dir = 4
	},
/obj/structure/fermenting_barrel,
/obj/effect/turf_decal/siding/wood/corner{
	dir = 1
	},
/turf/open/misc/dirt/icemoon,
/area/ruin/unpowered/primitive_catgirl_den)
"oa" = (
/turf/open/misc/asteroid/snow/icemoon,
/area/ruin/unpowered/primitive_catgirl_den)
"oi" = (
/obj/effect/turf_decal/siding/wood{
	dir = 10
	},
/obj/structure/closet/crate/wooden/storage_barrel,
/obj/item/stack/medical/aloe{
	pixel_y = -2
	},
/obj/item/stack/medical/aloe{
	pixel_y = 2;
	pixel_x = 2
	},
/obj/item/stack/medical/gauze/improvised{
	pixel_y = 6
	},
/turf/open/misc/dirt/icemoon,
/area/ruin/unpowered/primitive_catgirl_den)
"or" = (
/obj/structure/water_source/puddle,
/turf/open/misc/asteroid/basalt{
	initial_gas_mix = "ICEMOON_ATMOS"
	},
/area/ruin/unpowered/primitive_catgirl_den)
"pd" = (
/obj/structure/closet/crate/wooden/storage_barrel,
/obj/item/seeds/plump{
	pixel_y = -9
	},
/obj/item/seeds/plump{
	pixel_y = -9
	},
/obj/item/seeds/chanter{
	pixel_y = 1
	},
/obj/item/seeds/chanter{
	pixel_y = 1
	},
/obj/item/seeds/chanter{
	pixel_y = 1
	},
/obj/item/seeds/tower{
	pixel_y = -3
	},
/obj/item/seeds/tower{
	pixel_y = -3
	},
/obj/effect/turf_decal/siding/wood{
	dir = 4
	},
/turf/open/misc/dirt/icemoon,
/area/ruin/unpowered/primitive_catgirl_den)
"pf" = (
/obj/structure/bed/maint{
	pixel_y = 13
	},
/obj/item/bedsheet/black{
	pixel_y = 12
	},
/turf/open/misc/dirt/icemoon,
/area/ruin/unpowered/primitive_catgirl_den)
"qx" = (
/obj/structure/deployable_barricade/wooden{
	dir = 1;
	pixel_y = 23
	},
/obj/structure/deployable_barricade/wooden{
	dir = 4
	},
/turf/open/misc/asteroid/snow/icemoon,
/area/ruin/unpowered/primitive_catgirl_den)
"qO" = (
/obj/structure/chair/sofa/bamboo/left{
	dir = 1
	},
/turf/open/misc/dirt/icemoon,
/area/ruin/unpowered/primitive_catgirl_den)
"qU" = (
/obj/effect/turf_decal/siding/wood{
	dir = 1
	},
/turf/open/misc/dirt/icemoon,
/area/ruin/unpowered/primitive_catgirl_den)
"rl" = (
/obj/structure/chair/wood{
	dir = 1
	},
/turf/open/misc/dirt/icemoon,
/area/ruin/unpowered/primitive_catgirl_den)
"rB" = (
/obj/item/pickaxe/mini,
/turf/open/misc/asteroid/snow/icemoon,
/area/ruin/unpowered/primitive_catgirl_den)
"rJ" = (
/obj/effect/turf_decal/siding/wood{
	dir = 10
	},
/turf/open/misc/asteroid/basalt{
	initial_gas_mix = "ICEMOON_ATMOS"
	},
/area/ruin/unpowered/primitive_catgirl_den)
"sV" = (
/obj/structure/bed/maint{
	pixel_y = 13
	},
/obj/structure/bed/maint,
/obj/item/bedsheet/black/double,
/turf/open/misc/dirt/icemoon,
/area/ruin/unpowered/primitive_catgirl_den)
"tf" = (
/obj/structure/deployable_barricade/wooden{
	dir = 1;
	pixel_y = 23
	},
/obj/structure/deployable_barricade/wooden{
	dir = 4;
	pixel_y = 6
	},
/turf/open/misc/asteroid/snow/icemoon,
/area/ruin/unpowered/primitive_catgirl_den)
"th" = (
/obj/effect/turf_decal/siding/wood{
	dir = 1
	},
/obj/effect/turf_decal/siding/wood/corner{
	dir = 8
	},
/turf/open/misc/dirt/icemoon,
/area/ruin/unpowered/primitive_catgirl_den)
"tw" = (
/obj/structure/rack/shelf/wooden,
/obj/item/forging/reagent_weapon/axe/fake_copper{
	pixel_x = -8;
	pixel_y = -4
	},
/obj/item/forging/reagent_weapon/axe/fake_copper{
	pixel_x = -2;
	pixel_y = -4
	},
/obj/item/forging/reagent_weapon/axe/fake_copper{
	pixel_x = 4;
	pixel_y = -4
	},
/turf/open/misc/dirt/icemoon,
/area/ruin/unpowered/primitive_catgirl_den)
"ty" = (
/obj/effect/turf_decal/weather/snow/corner{
	dir = 9
	},
/turf/open/misc/dirt/icemoon,
/area/ruin/unpowered/primitive_catgirl_den)
"tB" = (
/obj/structure/deployable_barricade/wooden{
	dir = 4
	},
/turf/open/misc/asteroid/snow/icemoon,
/area/ruin/unpowered/primitive_catgirl_den)
"tU" = (
/obj/effect/turf_decal/weather/snow/corner{
	dir = 10
	},
/turf/open/misc/dirt/icemoon,
/area/ruin/unpowered/primitive_catgirl_den)
"uw" = (
/obj/item/cultivator/rake,
/turf/open/misc/asteroid/basalt{
	initial_gas_mix = "ICEMOON_ATMOS"
	},
/area/ruin/unpowered/primitive_catgirl_den)
"uS" = (
/obj/structure/table/wood,
/obj/structure/chem_separator,
/turf/open/floor/wood/icemoon,
/area/ruin/unpowered/primitive_catgirl_den)
"vW" = (
/obj/structure/bed/dogbed,
/turf/open/misc/dirt/icemoon,
/area/ruin/unpowered/primitive_catgirl_den)
"wd" = (
/obj/effect/turf_decal/siding/wood{
	dir = 1
	},
/obj/structure/millstone,
/turf/open/misc/asteroid/basalt{
	initial_gas_mix = "ICEMOON_ATMOS"
	},
/area/ruin/unpowered/primitive_catgirl_den)
"wA" = (
/obj/structure/closet/crate/wooden/storage_barrel,
/obj/item/food/plumphelmetbiscuit{
	pixel_y = -5
	},
/obj/item/food/plumphelmetbiscuit{
	pixel_y = -2
	},
/obj/item/food/plumphelmetbiscuit{
	pixel_y = 1
	},
/obj/item/food/plumphelmetbiscuit{
	pixel_y = 4
	},
/turf/open/floor/stone/icemoon,
/area/ruin/unpowered/primitive_catgirl_den)
"wN" = (
/obj/effect/turf_decal/weather/dirt,
/turf/open/floor/stone/icemoon,
/area/ruin/unpowered/primitive_catgirl_den)
"wZ" = (
/obj/structure/rack/shelf/wooden,
/obj/item/gun/ballistic/bow/longbow{
	pixel_x = -7
	},
/obj/item/gun/ballistic/bow/longbow{
	pixel_x = 3
	},
/obj/effect/turf_decal/weather/snow/corner{
	dir = 8
	},
/turf/open/misc/dirt/icemoon,
/area/ruin/unpowered/primitive_catgirl_den)
"xj" = (
/obj/effect/turf_decal/siding/wood,
/obj/effect/turf_decal/siding/wood{
	dir = 1
	},
/obj/structure/mineral_door/paperframe,
/turf/open/floor/stone/icemoon,
/area/ruin/unpowered/primitive_catgirl_den)
"xk" = (
/obj/effect/turf_decal/weather/snow/corner{
	dir = 8
	},
/turf/open/misc/dirt/icemoon,
/area/ruin/unpowered/primitive_catgirl_den)
"xG" = (
/obj/item/flashlight/flare/torch{
	on = 1
	},
/turf/closed/wall/mineral/wood/nonmetal,
/area/ruin/unpowered/primitive_catgirl_den)
"xS" = (
/obj/structure/closet/crate/wooden,
/obj/item/reagent_containers/cup/glass/bottle/moonshine{
	pixel_y = 7
	},
/obj/item/reagent_containers/cup/glass/bottle/moonshine{
	pixel_x = 8
	},
/obj/item/reagent_containers/cup/glass/bottle/hooch{
	pixel_y = 3;
	pixel_x = -7
	},
/turf/open/misc/dirt/icemoon,
/area/ruin/unpowered/primitive_catgirl_den)
"yw" = (
/obj/effect/turf_decal/siding/wood/corner{
	dir = 4
	},
/obj/effect/turf_decal/siding/wood/corner{
	dir = 8
	},
/obj/structure/closet/crate/wooden,
/obj/item/reagent_containers/cup/glass/bottle/hooch{
	pixel_y = 8
	},
/obj/item/reagent_containers/cup/glass/bottle/moonshine{
	pixel_x = 8
	},
/obj/item/reagent_containers/cup/glass/bottle/moonshine{
	pixel_x = -6
	},
/turf/open/misc/dirt/icemoon,
/area/ruin/unpowered/primitive_catgirl_den)
"zz" = (
/obj/effect/turf_decal/siding/wood,
/turf/open/misc/asteroid/basalt{
	initial_gas_mix = "ICEMOON_ATMOS"
	},
/area/ruin/unpowered/primitive_catgirl_den)
"zE" = (
/obj/effect/turf_decal/siding/wood{
	dir = 4
	},
/obj/structure/chair/wood{
	dir = 8
	},
/turf/open/misc/dirt/icemoon,
/area/ruin/unpowered/primitive_catgirl_den)
"Bm" = (
/obj/structure/rack/shelf/wooden,
/obj/item/reagent_containers/cup/mortar{
	pixel_y = -5;
	pixel_x = 2
	},
/obj/item/pestle{
	pixel_y = -7;
	pixel_x = -5
	},
/obj/item/reagent_containers/cup/bowl/mushroom_bowl{
	pixel_y = 8;
	pixel_x = 3
	},
/obj/item/reagent_containers/cup/bowl/mushroom_bowl{
	pixel_y = 12;
	pixel_x = 3
	},
/turf/open/misc/dirt/icemoon,
/area/ruin/unpowered/primitive_catgirl_den)
"Cl" = (
/obj/effect/turf_decal/siding/wood{
	dir = 6
	},
/turf/open/misc/asteroid/basalt{
	initial_gas_mix = "ICEMOON_ATMOS"
	},
/area/ruin/unpowered/primitive_catgirl_den)
"Co" = (
/obj/effect/turf_decal/siding/wood{
	dir = 4
	},
/turf/open/misc/dirt/icemoon,
/area/ruin/unpowered/primitive_catgirl_den)
"Cp" = (
/obj/effect/turf_decal/siding/wood/corner{
	dir = 4
	},
/obj/effect/turf_decal/siding/wood,
/turf/open/misc/dirt/icemoon,
/area/ruin/unpowered/primitive_catgirl_den)
"CE" = (
/obj/effect/turf_decal/siding/wood/corner,
/obj/effect/turf_decal/siding/wood{
	dir = 8
	},
/turf/open/misc/dirt/icemoon,
/area/ruin/unpowered/primitive_catgirl_den)
"CL" = (
/obj/effect/turf_decal/siding/wood{
	dir = 4
	},
/obj/effect/turf_decal/siding/wood/corner{
	dir = 1
	},
/turf/open/misc/dirt/icemoon,
/area/ruin/unpowered/primitive_catgirl_den)
"CX" = (
/obj/machinery/smartfridge/drying_rack,
/obj/effect/turf_decal/siding/wood,
/turf/open/floor/stone/icemoon,
/area/ruin/unpowered/primitive_catgirl_den)
"Dc" = (
/obj/effect/turf_decal/weather/snow/corner{
	dir = 6
	},
/turf/open/misc/dirt/icemoon,
/area/ruin/unpowered/primitive_catgirl_den)
"DQ" = (
/obj/structure/table/wood,
/obj/structure/large_mortar,
/obj/item/pestle{
	pixel_y = -1;
	pixel_x = -8
	},
/turf/open/floor/wood/icemoon,
/area/ruin/unpowered/primitive_catgirl_den)
"DV" = (
/obj/effect/turf_decal/siding/wood{
	dir = 9
	},
/turf/open/misc/dirt/icemoon,
/area/ruin/unpowered/primitive_catgirl_den)
"Ec" = (
/obj/effect/turf_decal/siding/wood,
/obj/structure/rack/shelf/wooden,
/obj/item/hatchet/wooden{
	pixel_y = 5;
	pixel_x = 4
	},
/obj/item/hatchet/wooden{
	pixel_y = 5;
	pixel_x = -3
	},
/turf/open/misc/asteroid/basalt{
	initial_gas_mix = "ICEMOON_ATMOS"
	},
/area/ruin/unpowered/primitive_catgirl_den)
"Ej" = (
/obj/effect/turf_decal/siding/wood/corner{
	dir = 4
	},
/turf/open/misc/dirt/icemoon,
/area/ruin/unpowered/primitive_catgirl_den)
"Eu" = (
/obj/effect/turf_decal/weather/snow/corner{
	dir = 4
	},
/obj/effect/turf_decal/siding/wood{
	dir = 8
	},
/turf/open/misc/dirt/icemoon,
/area/ruin/unpowered/primitive_catgirl_den)
"Ey" = (
/obj/structure/rack/shelf/wooden,
/obj/item/reagent_containers/cup/glass/bottle/moonshine{
	pixel_y = 12;
	pixel_x = 5;
	name = "high quality wound number"
	},
/obj/item/stack/medical/splint/improvised{
	pixel_y = -2;
	pixel_x = -3;
	amount = 6
	},
/turf/open/floor/stone/icemoon,
/area/ruin/unpowered/primitive_catgirl_den)
"EC" = (
/obj/structure/table/wood,
/turf/open/misc/dirt/icemoon,
/area/ruin/unpowered/primitive_catgirl_den)
"ED" = (
/obj/item/shovel,
/turf/open/misc/asteroid/basalt{
	initial_gas_mix = "ICEMOON_ATMOS"
	},
/area/ruin/unpowered/primitive_catgirl_den)
"EX" = (
/turf/open/floor/wood/icemoon,
/area/ruin/unpowered/primitive_catgirl_den)
"EZ" = (
/obj/structure/table/wood,
/obj/item/knife/hunting{
	pixel_y = 5
	},
/obj/item/kitchen/rollingpin,
/turf/open/misc/dirt/icemoon,
/area/ruin/unpowered/primitive_catgirl_den)
"Fu" = (
/obj/structure/closet/crate/wooden,
/obj/item/stack/sheet/mineral/wood{
	amount = 15
	},
/turf/open/misc/dirt/icemoon,
/area/ruin/unpowered/primitive_catgirl_den)
"Fv" = (
/obj/effect/mob_spawn/ghost_role/human/primitive_catgirl,
/obj/effect/turf_decal/weather/snow/corner{
	dir = 4
	},
/turf/open/misc/dirt/icemoon,
/area/ruin/unpowered/primitive_catgirl_den)
"FR" = (
/obj/structure/chair/sofa/bamboo/right{
	dir = 1
	},
/turf/open/misc/dirt/icemoon,
/area/ruin/unpowered/primitive_catgirl_den)
"FS" = (
/obj/structure/table/wood,
/obj/item/plate/oven_tray/material/fake_brass,
/obj/item/reagent_containers/cup/soup_pot/material/fake_copper{
	pixel_y = 6;
	pixel_x = 3
	},
/turf/open/misc/dirt/icemoon,
/area/ruin/unpowered/primitive_catgirl_den)
"Gy" = (
/turf/closed/indestructible/stone,
/area/ruin/unpowered/primitive_catgirl_den)
"GC" = (
/obj/structure/closet/crate/wooden/storage_barrel,
/obj/item/seeds/cotton,
/obj/item/seeds/cotton,
/obj/item/seeds/aloe{
	pixel_y = -5
	},
/obj/item/seeds/herbs{
	pixel_y = 3
	},
/obj/item/seeds/toechtauese{
	pixel_y = 5
	},
/obj/item/seeds/tea{
	pixel_y = 1
	},
/obj/item/seeds/tea/catnip{
	pixel_y = -3
	},
/obj/item/seeds/coffee{
	pixel_y = -5
	},
/obj/item/seeds/bamboo,
/obj/effect/turf_decal/siding/wood{
	dir = 8
	},
/turf/open/misc/dirt/icemoon,
/area/ruin/unpowered/primitive_catgirl_den)
"GW" = (
/obj/effect/turf_decal/weather/snow/corner{
	dir = 8
	},
/obj/structure/fermenting_barrel,
/turf/open/misc/dirt/icemoon,
/area/ruin/unpowered/primitive_catgirl_den)
"Hd" = (
/obj/machinery/smartfridge/drying_rack,
/turf/open/floor/stone/icemoon,
/area/ruin/unpowered/primitive_catgirl_den)
"HI" = (
/obj/structure/rack/shelf/wooden,
/obj/item/cautery/ashwalker{
	pixel_y = 10
	},
/obj/item/scalpel/ashwalker{
	pixel_y = 6
	},
/obj/item/circular_saw/ashwalker{
	pixel_y = -9
	},
/obj/item/surgicaldrill/ashwalker{
	pixel_y = -7;
	pixel_x = 7
	},
/turf/open/floor/stone/icemoon,
/area/ruin/unpowered/primitive_catgirl_den)
"Kl" = (
/obj/structure/loom,
/turf/open/floor/wood/icemoon,
/area/ruin/unpowered/primitive_catgirl_den)
"Kw" = (
/turf/open/misc/dirt/icemoon,
/area/ruin/unpowered/primitive_catgirl_den)
"KG" = (
/obj/structure/rack/shelf/wooden,
/obj/item/storage/box/matches{
	pixel_y = -8;
	pixel_x = -3
	},
/obj/item/soap/homemade{
	pixel_y = 7
	},
/turf/open/misc/dirt/icemoon,
/area/ruin/unpowered/primitive_catgirl_den)
"KH" = (
/obj/structure/chair/sofa/bamboo/left,
/turf/open/misc/dirt/icemoon,
/area/ruin/unpowered/primitive_catgirl_den)
"KZ" = (
/obj/structure/deployable_barricade/wooden{
	dir = 8;
	pixel_y = 6
	},
/turf/open/misc/asteroid/snow/icemoon,
/area/ruin/unpowered/primitive_catgirl_den)
"Lf" = (
/obj/structure/chair/sofa/bamboo/right,
/turf/open/misc/dirt/icemoon,
/area/ruin/unpowered/primitive_catgirl_den)
"Lv" = (
/obj/structure/deployable_barricade/wooden,
/turf/open/misc/asteroid/snow/icemoon,
/area/ruin/unpowered/primitive_catgirl_den)
"Mz" = (
/obj/machinery/smartfridge/drying_rack,
/turf/open/floor/wood/icemoon,
/area/ruin/unpowered/primitive_catgirl_den)
"Nb" = (
/obj/structure/bed/maint{
	pixel_y = 13
	},
/obj/item/bedsheet/black{
	dir = 1;
	pixel_y = 12
	},
/turf/open/misc/dirt/icemoon,
/area/ruin/unpowered/primitive_catgirl_den)
"Nc" = (
/obj/structure/bed/maint{
	pixel_y = 13
	},
/obj/structure/bed/maint,
/obj/item/bedsheet/black/double{
	dir = 1
	},
/turf/open/misc/dirt/icemoon,
/area/ruin/unpowered/primitive_catgirl_den)
"Nj" = (
/obj/structure/chair/sofa/bamboo,
/turf/open/misc/dirt/icemoon,
/area/ruin/unpowered/primitive_catgirl_den)
"Ny" = (
/obj/structure/rack/shelf/wooden,
/obj/item/storage/bag/quiver{
	pixel_x = -5
	},
/obj/item/storage/bag/quiver{
	pixel_x = 6
	},
/turf/open/misc/dirt/icemoon,
/area/ruin/unpowered/primitive_catgirl_den)
"Nz" = (
/obj/structure/chair/stool/bamboo{
	dir = 1
	},
/turf/open/misc/dirt/icemoon,
/area/ruin/unpowered/primitive_catgirl_den)
"NG" = (
/obj/effect/turf_decal/siding/wood/corner{
	dir = 8
	},
/turf/open/misc/asteroid/basalt{
	initial_gas_mix = "ICEMOON_ATMOS"
	},
/area/ruin/unpowered/primitive_catgirl_den)
"NX" = (
/obj/structure/rack/shelf/wooden,
/obj/item/shield/buckler{
	pixel_y = 7;
	pixel_x = -3
	},
/obj/item/shield/buckler{
	pixel_y = -5;
	pixel_x = 5
	},
/obj/effect/turf_decal/siding/wood/corner{
	dir = 8
	},
/turf/open/misc/dirt/icemoon,
/area/ruin/unpowered/primitive_catgirl_den)
"Oi" = (
/obj/structure/rack/shelf/wooden,
/obj/item/smelling_salts{
	pixel_y = -9;
	pixel_x = -5
	},
/obj/item/smelling_salts{
	pixel_y = -9;
	pixel_x = 6
	},
/obj/item/reagent_containers/cup/mortar{
	pixel_y = 9;
	pixel_x = 5
	},
/turf/open/floor/wood/icemoon,
/area/ruin/unpowered/primitive_catgirl_den)
"Oo" = (
/obj/structure/bed/maint,
/obj/structure/curtain/bounty,
/obj/item/restraints/handcuffs/cable/sinew,
/turf/open/floor/stone/icemoon,
/area/ruin/unpowered/primitive_catgirl_den)
"Pb" = (
/obj/effect/turf_decal/weather/snow/corner{
	dir = 4
	},
/obj/effect/turf_decal/siding/wood/corner{
	dir = 8
	},
/turf/open/misc/dirt/icemoon,
/area/ruin/unpowered/primitive_catgirl_den)
"Pg" = (
/obj/effect/turf_decal/siding/wood{
	dir = 6
	},
/turf/open/misc/dirt/icemoon,
/area/ruin/unpowered/primitive_catgirl_den)
"Pl" = (
/obj/structure/rack/shelf/wooden,
/obj/item/shield/goliath{
	pixel_x = -6
	},
/obj/item/shield/goliath{
	pixel_x = 8
	},
/obj/effect/turf_decal/siding/wood{
	dir = 1
	},
/turf/open/misc/dirt/icemoon,
/area/ruin/unpowered/primitive_catgirl_den)
"PL" = (
/turf/open/floor/stone/icemoon,
/area/ruin/unpowered/primitive_catgirl_den)
"QT" = (
/obj/effect/turf_decal/siding/wood/corner{
	dir = 8
	},
/turf/open/misc/dirt/icemoon,
/area/ruin/unpowered/primitive_catgirl_den)
"QY" = (
/obj/effect/turf_decal/weather/snow/corner,
/obj/structure/fermenting_barrel,
/turf/open/misc/dirt/icemoon,
/area/ruin/unpowered/primitive_catgirl_den)
"Si" = (
/obj/structure/reagent_water_basin,
/turf/open/misc/dirt/icemoon,
/area/ruin/unpowered/primitive_catgirl_den)
"So" = (
/obj/effect/turf_decal/siding/wood{
	dir = 8
	},
/obj/structure/closet/crate/wooden/storage_barrel,
/obj/item/food/raw_headcheese{
	pixel_y = -2
	},
/obj/item/food/raw_headcheese,
/turf/open/misc/dirt/icemoon,
/area/ruin/unpowered/primitive_catgirl_den)
"SZ" = (
/turf/open/misc/asteroid/basalt{
	initial_gas_mix = "ICEMOON_ATMOS"
	},
/area/ruin/unpowered/primitive_catgirl_den)
"Tf" = (
/obj/effect/turf_decal/siding/wood{
	dir = 4
	},
/obj/structure/rack/shelf/wooden,
/obj/item/bedsheet/black{
	pixel_x = 5;
	pixel_y = -2
	},
/obj/item/bedsheet/black{
	pixel_x = 5;
	pixel_y = 12
	},
/turf/open/misc/dirt/icemoon,
/area/ruin/unpowered/primitive_catgirl_den)
"Tw" = (
/obj/structure/table/wood,
/obj/item/plate/oven_tray/material/fake_copper,
/obj/item/food/rootdoughslice{
	pixel_y = 1;
	pixel_x = -4
	},
/obj/item/food/rootdoughslice{
	pixel_y = 6;
	pixel_x = 2
	},
/turf/open/misc/dirt/icemoon,
/area/ruin/unpowered/primitive_catgirl_den)
"Un" = (
/obj/machinery/primitive_stove,
/turf/open/floor/stone/icemoon,
/area/ruin/unpowered/primitive_catgirl_den)
"Uz" = (
/obj/effect/turf_decal/weather/snow/corner{
	dir = 1
	},
/obj/structure/mineral_door/wood,
/turf/open/misc/dirt/icemoon,
/area/ruin/unpowered/primitive_catgirl_den)
"UM" = (
/obj/structure/closet/crate/wooden/storage_barrel,
/obj/item/seeds/greenbean,
/obj/item/seeds/greenbean,
/obj/item/seeds/peanut,
/obj/item/seeds/olive,
/obj/item/seeds/onion,
/obj/item/seeds/onion,
/obj/item/seeds/potato{
	pixel_y = 1
	},
/obj/item/seeds/potato{
	pixel_y = 1
	},
/obj/item/seeds/carrot,
/obj/item/seeds/carrot,
/obj/item/seeds/cabbage,
/obj/effect/turf_decal/siding/wood{
	dir = 6
	},
/turf/open/misc/dirt/icemoon,
/area/ruin/unpowered/primitive_catgirl_den)
"Vz" = (
/obj/structure/deployable_barricade/wooden{
	dir = 4;
	pixel_y = 12
	},
/obj/structure/deployable_barricade/wooden,
/turf/open/misc/asteroid/snow/icemoon,
/area/ruin/unpowered/primitive_catgirl_den)
"WR" = (
/obj/structure/reagent_anvil,
/obj/item/forging/hammer/primitive,
/turf/open/floor/wood/icemoon,
/area/ruin/unpowered/primitive_catgirl_den)
"Xh" = (
/obj/structure/closet/crate/wooden/storage_barrel,
/obj/item/food/raw_sausage{
	pixel_y = -5
	},
/obj/item/food/raw_sausage{
	pixel_y = -2
	},
/obj/item/food/raw_sausage{
	pixel_y = 1
	},
/obj/item/food/raw_sausage{
	pixel_y = 4
	},
/turf/open/misc/dirt/icemoon,
/area/ruin/unpowered/primitive_catgirl_den)
"Xt" = (
/obj/effect/turf_decal/weather/snow/corner{
	dir = 8
	},
/obj/effect/turf_decal/siding/wood{
	dir = 4
	},
/turf/open/misc/dirt/icemoon,
/area/ruin/unpowered/primitive_catgirl_den)
"Xx" = (
/obj/effect/turf_decal/siding/wood,
/obj/effect/turf_decal/siding/wood{
	dir = 1
	},
/obj/structure/window/paperframe,
/turf/open/floor/stone/icemoon,
/area/ruin/unpowered/primitive_catgirl_den)
"XW" = (
/obj/structure/closet/crate/wooden/storage_barrel,
/obj/item/seeds/poppy/lily/trumpet,
/obj/item/seeds/poppy,
/obj/item/seeds/pumpkin,
/obj/item/seeds/tomato,
/obj/item/seeds/whitebeet,
/obj/item/seeds/redbeet,
/obj/item/seeds/wheat,
/obj/item/seeds/wheat,
/obj/item/seeds/garlic,
/obj/item/seeds/garlic,
/obj/item/seeds/peas,
/obj/item/seeds/corn,
/turf/open/misc/asteroid/basalt{
	initial_gas_mix = "ICEMOON_ATMOS"
	},
/area/ruin/unpowered/primitive_catgirl_den)
"Yf" = (
/turf/template_noop,
/area/template_noop)
"Yj" = (
/obj/effect/turf_decal/siding/wood{
	dir = 1
	},
/turf/open/misc/asteroid/basalt{
	initial_gas_mix = "ICEMOON_ATMOS"
	},
/area/ruin/unpowered/primitive_catgirl_den)
"Ym" = (
/obj/structure/chair/wood,
/turf/open/misc/dirt/icemoon,
/area/ruin/unpowered/primitive_catgirl_den)
"YH" = (
/obj/machinery/oven/stone,
/turf/open/floor/stone/icemoon,
/area/ruin/unpowered/primitive_catgirl_den)

(1,1,1) = {"
Yf
Yf
Yf
Yf
gV
hY
Yf
Yf
Yf
Yf
Yf
Yf
Yf
Yf
Yf
Yf
Yf
Yf
Yf
Yf
Yf
"}
(2,1,1) = {"
Yf
Yf
Yf
gV
oa
oa
hY
Yf
Yf
Yf
Yf
Yf
Yf
Yf
Yf
Yf
Yf
Yf
Yf
Yf
Yf
"}
(3,1,1) = {"
Yf
Yf
gV
oa
oa
rB
Lv
Gy
lE
lE
lE
Gy
Yf
Yf
Yf
ng
hY
Yf
Yf
Yf
Yf
"}
(4,1,1) = {"
Yf
Yf
lE
xk
wZ
lz
Gy
lz
Tf
Cp
Oo
lz
Gy
lz
KZ
rB
oa
hY
Yf
Yf
Yf
"}
(5,1,1) = {"
Yf
lE
lE
Kw
Kw
Ny
Xx
uS
DQ
dq
Ey
HI
lE
oa
oa
oa
oa
Lv
Yf
Yf
Yf
"}
(6,1,1) = {"
Gy
lz
Si
Kw
Kw
dR
Xx
cE
EX
dq
PL
Oo
lE
oa
ty
GW
xG
oa
hY
Yf
Yf
"}
(7,1,1) = {"
Gy
iJ
ed
Co
Co
ci
Xx
Oi
EX
th
oi
ba
lE
mr
Co
Ej
QY
oa
Lv
Yf
Yf
"}
(8,1,1) = {"
Gy
kf
dy
EX
EX
Gy
Gy
lz
CE
CL
yw
lz
Gy
Kl
EX
qU
Dc
oa
Lv
Yf
Yf
"}
(9,1,1) = {"
Gy
hJ
dy
WR
EX
Pl
Xx
pf
dy
gq
qU
Nc
lE
Mz
EX
gD
oa
rB
Vz
Yf
Yf
"}
(10,1,1) = {"
Gy
lz
dy
EX
DV
lG
xj
Kw
dy
aQ
qU
vW
lE
Eu
Eu
nP
xG
Lv
Yf
Yf
Yf
"}
(11,1,1) = {"
Yf
lE
NX
Eu
lG
tw
Xx
sV
dy
CX
qU
pf
lE
oa
oa
oa
oa
Lv
Yf
Yf
Yf
"}
(12,1,1) = {"
Yf
lE
lE
oa
iS
lz
Gy
lz
QT
bn
lG
lz
Gy
lz
oa
ty
tU
oa
hY
Yf
Yf
"}
(13,1,1) = {"
Yf
Yf
nq
oa
oa
oa
lE
nA
Lf
EC
Nz
Kw
lE
oa
gM
Fv
Dc
oa
Lv
Yf
Yf
"}
(14,1,1) = {"
Yf
Yf
nq
oa
oa
oa
Uz
Kw
Nj
EC
rl
Kw
lx
oa
oa
oa
oa
oa
Lv
Yf
Yf
"}
(15,1,1) = {"
Yf
Yf
qx
rB
oa
oa
lE
Kw
KH
EC
qO
xS
lE
oa
oa
jP
Xt
lE
lE
hY
Yf
"}
(16,1,1) = {"
Yf
Yf
Yf
nq
oa
lz
Gy
lz
Ym
EC
FR
lz
Gy
lz
fN
Pg
SZ
XW
xG
Lv
Yf
"}
(17,1,1) = {"
Yf
Yf
Yf
qx
oa
oa
lE
KG
ed
zE
Ej
Nb
lE
pd
UM
SZ
SZ
ED
zz
oa
hY
"}
(18,1,1) = {"
Yf
Yf
Yf
Yf
qx
tB
lE
Nc
dy
mz
qU
kQ
lE
Yj
SZ
SZ
SZ
SZ
NG
rJ
Lv
"}
(19,1,1) = {"
Yf
Yf
Yf
Yf
Yf
Yf
lE
vW
dy
Un
qU
sV
lE
Yj
SZ
SZ
or
SZ
SZ
zz
Lv
"}
(20,1,1) = {"
Yf
Yf
Yf
Yf
Yf
Gy
Gy
lz
dy
Hd
qU
lz
Gy
wd
SZ
uw
SZ
SZ
nE
Cl
Lv
"}
(21,1,1) = {"
Yf
Yf
Yf
Yf
Yf
Gy
dE
lP
QT
So
lG
Xh
lE
Yj
SZ
SZ
SZ
SZ
zz
oa
Vz
"}
(22,1,1) = {"
Yf
Yf
Yf
Yf
Yf
Gy
YH
wN
Kw
Kw
Kw
jh
lE
Yj
SZ
SZ
ED
SZ
Ec
Vz
Yf
"}
(23,1,1) = {"
Yf
Yf
Yf
Yf
Yf
Gy
wA
wN
Fu
Kw
Tw
Bm
lE
GC
nh
SZ
SZ
xG
lE
Yf
Yf
"}
(24,1,1) = {"
Yf
Yf
Yf
Yf
Yf
Gy
Gy
lz
FS
db
EZ
lz
Gy
lz
Pb
Eu
Eu
lE
Yf
Yf
Yf
"}
(25,1,1) = {"
Yf
Yf
Yf
Yf
Yf
Yf
Yf
Gy
lE
lE
lE
Gy
Yf
tf
oa
oa
oa
Vz
Yf
Yf
Yf
"}
(26,1,1) = {"
Yf
Yf
Yf
Yf
Yf
Yf
Yf
Yf
Yf
Yf
Yf
Yf
Yf
Yf
qx
ew
Vz
Yf
Yf
Yf
Yf
"}
