//MAP CONVERTED BY dmm2tgm.py THIS HEADER COMMENT PREVENTS RECONVERSION, DO NOT REMOVE
"au" = (
/obj/effect/turf_decal/siding/wood,
/obj/effect/turf_decal/siding/wood{
	dir = 1
	},
/turf/open/misc/dirt/icemoon,
/area/ruin/unpowered/primitive_catgirl_den)
"aM" = (
/obj/machinery/smartfridge/drying_rack{
	idle_power_usage = 0;
	use_power = 0
	},
/turf/open/floor/wood/icemoon,
/area/ruin/unpowered/primitive_catgirl_den)
"bJ" = (
/obj/effect/turf_decal/siding/wood{
	dir = 8
	},
/obj/structure/chair/wood{
	dir = 4
	},
/turf/open/misc/dirt/icemoon,
/area/ruin/unpowered/primitive_catgirl_den)
"ce" = (
/obj/structure/closet/crate/wooden/storage_barrel,
/obj/item/food/raw_sausage{
	pixel_y = -5
	},
/obj/item/food/raw_sausage{
	pixel_y = -2
	},
/obj/item/food/raw_sausage{
	pixel_y = 1
	},
/obj/item/food/raw_sausage{
	pixel_y = 4
	},
/turf/open/misc/dirt/icemoon,
/area/ruin/unpowered/primitive_catgirl_den)
"cg" = (
/obj/structure/bed/maint,
/obj/structure/curtain/bounty,
/obj/effect/turf_decal/siding/wood{
	dir = 4
	},
/turf/open/misc/dirt/icemoon,
/area/ruin/unpowered/primitive_catgirl_den)
"cj" = (
/obj/effect/turf_decal/siding/wood/corner,
/turf/open/misc/dirt/icemoon,
/area/ruin/unpowered/primitive_catgirl_den)
"cJ" = (
/obj/effect/turf_decal/siding/wood/corner{
	dir = 8
	},
/obj/structure/closet/crate/wooden,
/obj/item/reagent_containers/cup/glass/bottle/hooch{
	pixel_y = 8
	},
/obj/item/reagent_containers/cup/glass/bottle/moonshine{
	pixel_x = -6
	},
/obj/item/reagent_containers/cup/glass/bottle/moonshine{
	pixel_x = 8
	},
/turf/open/misc/dirt/icemoon,
/area/ruin/unpowered/primitive_catgirl_den)
"dv" = (
/obj/item/flashlight/flare/torch{
	on = 1
	},
/turf/closed/indestructible/stone,
/area/ruin/unpowered/primitive_catgirl_den)
"dF" = (
/obj/item/ore_sensor{
	pixel_y = -1;
	pixel_x = 7
	},
/obj/item/reagent_containers/cup/mortar{
	pixel_y = 9;
	pixel_x = -3
	},
/obj/item/pestle{
	pixel_y = -9;
	pixel_x = -7
	},
/obj/structure/rack/shelf/wooden,
/turf/open/floor/wood/icemoon,
/area/ruin/unpowered/primitive_catgirl_den)
"dL" = (
/obj/structure/closet/crate/wooden/storage_barrel,
/obj/item/seeds/greenbean,
/obj/item/seeds/greenbean,
/obj/item/seeds/peanut,
/obj/item/seeds/olive,
/obj/item/seeds/onion,
/obj/item/seeds/onion,
/obj/item/seeds/potato{
	pixel_y = 1
	},
/obj/item/seeds/potato{
	pixel_y = 1
	},
/obj/item/seeds/carrot,
/obj/item/seeds/carrot,
/obj/item/seeds/cabbage,
/obj/item/seeds/corn,
/obj/item/seeds/peas,
/obj/item/seeds/garlic,
/obj/item/seeds/garlic,
/obj/item/seeds/wheat,
/obj/item/seeds/wheat,
/obj/item/seeds/redbeet,
/obj/item/seeds/whitebeet,
/obj/item/seeds/tomato,
/obj/item/seeds/pumpkin,
/turf/open/floor/wood/icemoon,
/area/ruin/unpowered/primitive_catgirl_den)
"ef" = (
/obj/structure/flora/grass/both/style_random,
/turf/open/misc/asteroid/snow/icemoon,
/area/ruin/unpowered/primitive_catgirl_den)
"fe" = (
/obj/effect/turf_decal/weather/snow/corner{
	dir = 4
	},
/turf/open/misc/dirt/icemoon,
/area/ruin/unpowered/primitive_catgirl_den)
"fl" = (
/obj/effect/turf_decal/siding/wood/corner{
	dir = 4
	},
/turf/open/misc/dirt/icemoon,
/area/ruin/unpowered/primitive_catgirl_den)
"fY" = (
/obj/structure/loom,
/turf/open/floor/wood/icemoon,
/area/ruin/unpowered/primitive_catgirl_den)
"gs" = (
/obj/item/cultivator/rake,
/turf/open/misc/asteroid/basalt{
	initial_gas_mix = "ICEMOON_ATMOS"
	},
/area/ruin/unpowered/primitive_catgirl_den)
"hj" = (
/obj/effect/turf_decal/siding/wood/corner,
/obj/effect/turf_decal/siding/wood/corner{
	dir = 4
	},
/turf/open/misc/dirt/icemoon,
/area/ruin/unpowered/primitive_catgirl_den)
"hl" = (
/obj/structure/reagent_forge,
/obj/effect/turf_decal/weather/dirt{
	dir = 4
	},
/turf/open/floor/stone/icemoon,
/area/ruin/unpowered/primitive_catgirl_den)
"hS" = (
/obj/structure/closet/crate/wooden,
/obj/item/stack/sheet/mineral/wood{
	amount = 15
	},
/obj/item/stack/sheet/mineral/coal/ten,
/obj/effect/turf_decal/siding/wood/corner{
	dir = 4
	},
/turf/open/misc/dirt/icemoon,
/area/ruin/unpowered/primitive_catgirl_den)
"ig" = (
/obj/item/shovel,
/turf/open/misc/asteroid/snow/icemoon,
/area/ruin/unpowered/primitive_catgirl_den)
"ij" = (
/obj/structure/bed/dogbed,
/turf/open/misc/dirt/icemoon,
/area/ruin/unpowered/primitive_catgirl_den)
"kr" = (
/obj/structure/closet/crate/wooden/storage_barrel,
/obj/item/food/raw_headcheese{
	pixel_y = -2
	},
/obj/item/food/raw_headcheese,
/turf/open/misc/dirt/icemoon,
/area/ruin/unpowered/primitive_catgirl_den)
"ku" = (
/obj/structure/closet/crate/wooden/storage_barrel,
/obj/item/seeds/plump{
	pixel_y = -9
	},
/obj/item/seeds/plump{
	pixel_y = -9
	},
/obj/item/seeds/chanter{
	pixel_y = 1
	},
/obj/item/seeds/chanter{
	pixel_y = 1
	},
/obj/item/seeds/chanter{
	pixel_y = 1
	},
/obj/item/seeds/tower{
	pixel_y = -3
	},
/obj/item/seeds/tower{
	pixel_y = -3
	},
/turf/open/floor/wood/icemoon,
/area/ruin/unpowered/primitive_catgirl_den)
"kU" = (
/obj/effect/turf_decal/siding/wood/corner,
/obj/effect/turf_decal/siding/wood{
	dir = 9
	},
/turf/open/misc/dirt/icemoon,
/area/ruin/unpowered/primitive_catgirl_den)
"kZ" = (
/obj/effect/turf_decal/weather/snow/corner{
	dir = 8
	},
/obj/effect/turf_decal/siding/wood{
	dir = 4
	},
/turf/open/misc/dirt/icemoon,
/area/ruin/unpowered/primitive_catgirl_den)
"lB" = (
/obj/item/pickaxe/mini,
/turf/open/misc/asteroid/snow/icemoon,
/area/ruin/unpowered/primitive_catgirl_den)
"ms" = (
/obj/structure/closet/crate/wooden,
/obj/item/reagent_containers/cup/glass/bottle/hooch{
	pixel_y = 8
	},
/obj/item/reagent_containers/cup/glass/bottle/hooch{
	pixel_y = 3;
	pixel_x = 6
	},
/obj/item/reagent_containers/cup/glass/bottle/moonshine{
	pixel_x = -6
	},
/turf/open/misc/dirt/icemoon,
/area/ruin/unpowered/primitive_catgirl_den)
"mZ" = (
/turf/open/misc/asteroid/snow/icemoon,
/area/ruin/unpowered/primitive_catgirl_den)
"ne" = (
/obj/effect/turf_decal/weather/snow/corner{
	dir = 6
	},
/obj/effect/turf_decal/siding/wood/corner{
	dir = 1
	},
/turf/open/misc/dirt/icemoon,
/area/ruin/unpowered/primitive_catgirl_den)
"nu" = (
/turf/closed/mineral/snowmountain/icemoon,
/area/ruin/unpowered/primitive_catgirl_den)
"ok" = (
/obj/structure/table/wood,
/obj/item/plate,
/obj/item/plate{
	pixel_y = 2;
	pixel_x = 2
	},
/obj/item/plate{
	pixel_y = 5;
	pixel_x = 1
	},
/turf/open/misc/dirt/icemoon,
/area/ruin/unpowered/primitive_catgirl_den)
"oo" = (
/obj/machinery/vending/primitive_catgirl_clothing_vendor,
/turf/open/misc/dirt/icemoon,
/area/ruin/unpowered/primitive_catgirl_den)
"oN" = (
/turf/template_noop,
/area/template_noop)
"oO" = (
/obj/effect/turf_decal/siding/wood,
/obj/structure/closet/crate/wooden/storage_barrel,
/obj/item/food/cheese/mozzarella{
	pixel_y = -6
	},
/obj/item/food/cheese/mozzarella{
	pixel_y = -3;
	pixel_x = -3
	},
/obj/item/food/cheese/mozzarella,
/obj/item/food/cheese/mozzarella{
	pixel_y = 3;
	pixel_x = -3
	},
/obj/item/food/cheese/mozzarella{
	pixel_y = 7
	},
/turf/open/misc/dirt/icemoon,
/area/ruin/unpowered/primitive_catgirl_den)
"pd" = (
/obj/structure/reagent_forge{
	pixel_y = 12
	},
/obj/effect/turf_decal/weather/dirt,
/turf/open/floor/stone/icemoon,
/area/ruin/unpowered/primitive_catgirl_den)
"pS" = (
/obj/item/shovel/serrated,
/turf/open/misc/asteroid/basalt{
	initial_gas_mix = "ICEMOON_ATMOS"
	},
/area/ruin/unpowered/primitive_catgirl_den)
"pZ" = (
/obj/structure/table/wood,
/obj/structure/large_mortar,
/obj/item/pestle,
/turf/open/floor/stone/icemoon,
/area/ruin/unpowered/primitive_catgirl_den)
"qc" = (
/obj/structure/deployable_barricade/wooden{
	dir = 8
	},
/turf/open/misc/asteroid/snow/icemoon,
/area/ruin/unpowered/primitive_catgirl_den)
"qs" = (
/obj/effect/turf_decal/weather/dirt,
/obj/structure/closet/crate/wooden/storage_barrel,
/obj/item/food/plumphelmetbiscuit{
	pixel_y = -5
	},
/obj/item/food/plumphelmetbiscuit{
	pixel_y = -2
	},
/obj/item/food/plumphelmetbiscuit{
	pixel_y = 1
	},
/obj/item/food/plumphelmetbiscuit{
	pixel_y = 4
	},
/turf/open/floor/stone/icemoon,
/area/ruin/unpowered/primitive_catgirl_den)
"qw" = (
/turf/closed/indestructible/stone,
/area/ruin/unpowered/primitive_catgirl_den)
"qC" = (
/obj/effect/turf_decal/siding/wood{
	dir = 6
	},
/turf/open/misc/dirt/icemoon,
/area/ruin/unpowered/primitive_catgirl_den)
"qN" = (
/obj/structure/rack/shelf/wooden,
/obj/item/bedsheet/black{
	pixel_x = 5;
	pixel_y = -2
	},
/obj/item/bedsheet/black{
	pixel_x = 5;
	pixel_y = 12
	},
/obj/effect/turf_decal/siding/wood{
	dir = 4
	},
/turf/open/misc/dirt/icemoon,
/area/ruin/unpowered/primitive_catgirl_den)
"rm" = (
/turf/open/misc/dirt/icemoon,
/area/ruin/unpowered/primitive_catgirl_den)
"rz" = (
/obj/effect/turf_decal/siding/wood/corner{
	dir = 1
	},
/obj/effect/turf_decal/siding/wood/corner{
	dir = 8
	},
/turf/open/misc/dirt/icemoon,
/area/ruin/unpowered/primitive_catgirl_den)
"rG" = (
/obj/structure/table/wood,
/obj/item/candle/infinite{
	pixel_x = -12;
	pixel_y = 4
	},
/turf/open/misc/dirt/icemoon,
/area/ruin/unpowered/primitive_catgirl_den)
"rY" = (
/obj/item/reagent_containers/cup/glass/bottle/moonshine{
	pixel_y = 12;
	pixel_x = 5;
	name = "high quality wound number"
	},
/obj/item/stack/medical/splint/improvised{
	pixel_y = -2;
	pixel_x = -3;
	amount = 6
	},
/obj/structure/rack/shelf/wooden,
/turf/open/floor/stone/icemoon,
/area/ruin/unpowered/primitive_catgirl_den)
"sl" = (
/obj/structure/table/wood,
/obj/item/plate/oven_tray,
/obj/item/food/rootdoughslice{
	pixel_y = 6;
	pixel_x = 2
	},
/obj/item/food/rootdoughslice{
	pixel_y = 1;
	pixel_x = -4
	},
/turf/open/misc/dirt/icemoon,
/area/ruin/unpowered/primitive_catgirl_den)
"us" = (
/obj/effect/turf_decal/siding/wood/corner{
	dir = 8
	},
/obj/effect/turf_decal/siding/wood{
	dir = 1
	},
/turf/open/misc/dirt/icemoon,
/area/ruin/unpowered/primitive_catgirl_den)
"uM" = (
/obj/structure/table/wood,
/obj/structure/chem_separator,
/turf/open/floor/wood/icemoon,
/area/ruin/unpowered/primitive_catgirl_den)
"uZ" = (
/obj/item/shovel,
/turf/open/misc/asteroid/basalt{
	initial_gas_mix = "ICEMOON_ATMOS"
	},
/area/ruin/unpowered/primitive_catgirl_den)
"vf" = (
/obj/effect/turf_decal/weather/dirt,
/turf/open/floor/stone/icemoon,
/area/ruin/unpowered/primitive_catgirl_den)
"vl" = (
/obj/structure/reagent_water_basin,
/turf/open/floor/wood/icemoon,
/area/ruin/unpowered/primitive_catgirl_den)
"vE" = (
/obj/structure/deployable_barricade/wooden{
	dir = 4
	},
/turf/open/misc/asteroid/snow/icemoon,
/area/ruin/unpowered/primitive_catgirl_den)
"vP" = (
/turf/open/floor/stone/icemoon,
/area/ruin/unpowered/primitive_catgirl_den)
"wE" = (
/turf/closed/wall/mineral/wood/nonmetal,
/area/ruin/unpowered/primitive_catgirl_den)
"xr" = (
/obj/item/reagent_containers/cup/bowl/mushroom_bowl{
	pixel_y = 8;
	pixel_x = 3
	},
/obj/item/reagent_containers/cup/bowl/mushroom_bowl{
	pixel_y = 12;
	pixel_x = 3
	},
/obj/item/reagent_containers/cup/mortar{
	pixel_y = -5;
	pixel_x = 2
	},
/obj/item/pestle{
	pixel_y = -7;
	pixel_x = -5
	},
/obj/structure/rack/shelf/wooden,
/turf/open/misc/dirt/icemoon,
/area/ruin/unpowered/primitive_catgirl_den)
"xO" = (
/obj/structure/chair/stool/bamboo,
/turf/open/misc/dirt/icemoon,
/area/ruin/unpowered/primitive_catgirl_den)
"zm" = (
/obj/effect/turf_decal/siding/wood,
/obj/effect/turf_decal/siding/wood/corner{
	dir = 4
	},
/turf/open/misc/dirt/icemoon,
/area/ruin/unpowered/primitive_catgirl_den)
"zO" = (
/obj/item/forging/reagent_weapon/axe/fake_copper{
	pixel_x = -8;
	pixel_y = -4
	},
/obj/item/forging/reagent_weapon/axe/fake_copper{
	pixel_x = -2;
	pixel_y = -4
	},
/obj/item/forging/reagent_weapon/axe/fake_copper{
	pixel_x = 4;
	pixel_y = -4
	},
/obj/structure/rack/shelf/wooden,
/turf/open/misc/dirt/icemoon,
/area/ruin/unpowered/primitive_catgirl_den)
"Ag" = (
/obj/structure/bonfire/oh_yeah_its_grilling_time,
/turf/open/floor/stone/icemoon,
/area/ruin/unpowered/primitive_catgirl_den)
"Ar" = (
/obj/structure/table/wood,
/obj/item/paper_bin/bundlenatural,
/obj/item/pen/charcoal,
/turf/open/floor/wood/icemoon,
/area/ruin/unpowered/primitive_catgirl_den)
"AP" = (
/obj/effect/turf_decal/siding/wood{
	dir = 10
	},
/turf/open/misc/dirt/icemoon,
/area/ruin/unpowered/primitive_catgirl_den)
"Bs" = (
/obj/structure/mineral_door/wood,
/obj/effect/turf_decal/weather/snow/corner,
/turf/open/misc/dirt/icemoon,
/area/ruin/unpowered/primitive_catgirl_den)
"BN" = (
/obj/effect/turf_decal/siding/wood{
	dir = 8
	},
/turf/open/misc/dirt/icemoon,
/area/ruin/unpowered/primitive_catgirl_den)
"CG" = (
/obj/machinery/smartfridge/drying_rack{
	idle_power_usage = 0;
	use_power = 0
	},
/turf/open/floor/stone/icemoon,
/area/ruin/unpowered/primitive_catgirl_den)
"CN" = (
/obj/effect/turf_decal/weather/snow/corner{
	dir = 9
	},
/obj/effect/turf_decal/siding/wood/corner,
/turf/open/misc/dirt/icemoon,
/area/ruin/unpowered/primitive_catgirl_den)
"DO" = (
/obj/effect/turf_decal/weather/snow/corner,
/obj/effect/turf_decal/siding/wood/corner{
	dir = 4
	},
/turf/open/misc/dirt/icemoon,
/area/ruin/unpowered/primitive_catgirl_den)
"Em" = (
/obj/effect/turf_decal/siding/wood{
	dir = 4
	},
/obj/structure/chair/stool/bamboo{
	dir = 4
	},
/turf/open/misc/dirt/icemoon,
/area/ruin/unpowered/primitive_catgirl_den)
"EH" = (
/obj/effect/turf_decal/siding/wood,
/turf/open/misc/dirt/icemoon,
/area/ruin/unpowered/primitive_catgirl_den)
"EQ" = (
/obj/structure/deployable_barricade/wooden{
	dir = 8
	},
/obj/structure/deployable_barricade/wooden,
/turf/open/misc/asteroid/snow/icemoon,
/area/ruin/unpowered/primitive_catgirl_den)
"Fp" = (
/obj/effect/turf_decal/weather/snow/corner{
	dir = 8
	},
/obj/effect/turf_decal/siding/wood/corner,
/turf/open/misc/dirt/icemoon,
/area/ruin/unpowered/primitive_catgirl_den)
"FL" = (
/obj/item/circular_saw/ashwalker{
	pixel_y = -9
	},
/obj/item/surgicaldrill/ashwalker{
	pixel_y = -7;
	pixel_x = 7
	},
/obj/item/cautery/ashwalker{
	pixel_y = 10
	},
/obj/item/scalpel/ashwalker{
	pixel_y = 6
	},
/obj/structure/rack/shelf/wooden,
/turf/open/floor/stone/icemoon,
/area/ruin/unpowered/primitive_catgirl_den)
"FS" = (
/obj/structure/mineral_door/wood,
/obj/effect/turf_decal/weather/snow/corner{
	dir = 1
	},
/turf/open/misc/dirt/icemoon,
/area/ruin/unpowered/primitive_catgirl_den)
"FZ" = (
/obj/structure/rack/shelf/wooden,
/obj/item/storage/bag/plants/portaseeder{
	pixel_y = -8
	},
/obj/item/hatchet/wooden{
	pixel_y = 5;
	pixel_x = 4
	},
/obj/item/hatchet/wooden{
	pixel_y = 5;
	pixel_x = -3
	},
/turf/open/misc/dirt/icemoon,
/area/ruin/unpowered/primitive_catgirl_den)
"Gh" = (
/obj/effect/turf_decal/siding/wood/corner{
	dir = 8
	},
/turf/open/misc/dirt/icemoon,
/area/ruin/unpowered/primitive_catgirl_den)
"Gj" = (
/obj/effect/turf_decal/weather/snow/corner,
/turf/open/misc/dirt/icemoon,
/area/ruin/unpowered/primitive_catgirl_den)
"Gq" = (
/obj/effect/turf_decal/siding/wood/corner{
	dir = 1
	},
/turf/open/misc/dirt/icemoon,
/area/ruin/unpowered/primitive_catgirl_den)
"Gr" = (
/obj/structure/reagent_crafting_bench,
/obj/item/forging/tongs/primitive,
/turf/open/floor/wood/icemoon,
/area/ruin/unpowered/primitive_catgirl_den)
"GR" = (
/obj/structure/table/wood,
/obj/item/candle/infinite{
	pixel_x = 13;
	pixel_y = 7
	},
/turf/open/misc/dirt/icemoon,
/area/ruin/unpowered/primitive_catgirl_den)
"HJ" = (
/turf/open/misc/asteroid/basalt{
	initial_gas_mix = "ICEMOON_ATMOS"
	},
/area/ruin/unpowered/primitive_catgirl_den)
"HK" = (
/obj/structure/table/wood,
/obj/item/sharpener,
/obj/item/sharpener{
	pixel_y = 6
	},
/turf/open/floor/wood/icemoon,
/area/ruin/unpowered/primitive_catgirl_den)
"IP" = (
/obj/item/flashlight/flare/torch{
	on = 1
	},
/turf/closed/wall/mineral/wood/nonmetal,
/area/ruin/unpowered/primitive_catgirl_den)
"Jh" = (
/obj/item/shield/buckler{
	pixel_y = 7;
	pixel_x = -3
	},
/obj/item/shield/buckler{
	pixel_y = -5;
	pixel_x = 5
	},
/obj/structure/rack/shelf/wooden,
/turf/open/misc/dirt/icemoon,
/area/ruin/unpowered/primitive_catgirl_den)
"Jt" = (
/obj/structure/deployable_barricade/wooden{
	dir = 1;
	pixel_y = 23
	},
/obj/structure/deployable_barricade/wooden{
	dir = 4
	},
/turf/open/misc/asteroid/snow/icemoon,
/area/ruin/unpowered/primitive_catgirl_den)
"Jv" = (
/obj/effect/turf_decal/weather/dirt{
	dir = 4
	},
/turf/open/floor/stone/icemoon,
/area/ruin/unpowered/primitive_catgirl_den)
"JF" = (
/obj/effect/turf_decal/siding/wood{
	dir = 10
	},
/obj/structure/closet/crate/wooden/storage_barrel,
/obj/item/stack/medical/aloe{
	pixel_y = -2
	},
/obj/item/stack/medical/aloe{
	pixel_y = 2;
	pixel_x = 2
	},
/obj/item/stack/medical/gauze/improvised{
	pixel_y = 6
	},
/turf/open/misc/dirt/icemoon,
/area/ruin/unpowered/primitive_catgirl_den)
"JH" = (
/obj/structure/table/wood,
/obj/item/cutting_board,
/turf/open/misc/dirt/icemoon,
/area/ruin/unpowered/primitive_catgirl_den)
"Kh" = (
/obj/structure/table/wood,
/obj/structure/large_mortar,
/obj/item/pestle,
/turf/open/floor/wood/icemoon,
/area/ruin/unpowered/primitive_catgirl_den)
"Kl" = (
/obj/item/storage/box/matches{
	pixel_y = -8;
	pixel_x = -3
	},
/obj/item/soap/homemade{
	pixel_y = 7
	},
/obj/structure/rack/shelf/wooden,
/turf/open/floor/stone/icemoon,
/area/ruin/unpowered/primitive_catgirl_den)
"Ko" = (
/obj/effect/turf_decal/weather/snow/corner,
/obj/effect/turf_decal/siding/wood/corner{
	dir = 1
	},
/turf/open/misc/dirt/icemoon,
/area/ruin/unpowered/primitive_catgirl_den)
"Kp" = (
/obj/structure/closet/crate/wooden,
/obj/item/reagent_containers/cup/glass/bottle/moonshine{
	pixel_y = 7
	},
/obj/item/reagent_containers/cup/glass/bottle/moonshine{
	pixel_x = 8
	},
/obj/item/reagent_containers/cup/glass/bottle/hooch{
	pixel_y = 3;
	pixel_x = -7
	},
/turf/open/misc/dirt/icemoon,
/area/ruin/unpowered/primitive_catgirl_den)
"Ky" = (
/obj/structure/deployable_barricade/wooden{
	dir = 1;
	pixel_y = 23
	},
/turf/open/misc/asteroid/snow/icemoon,
/area/ruin/unpowered/primitive_catgirl_den)
"Le" = (
/obj/structure/table/wood,
/obj/item/restraints/handcuffs/cable/sinew,
/turf/open/floor/stone/icemoon,
/area/ruin/unpowered/primitive_catgirl_den)
"LV" = (
/obj/structure/table/wood,
/turf/open/misc/dirt/icemoon,
/area/ruin/unpowered/primitive_catgirl_den)
"MO" = (
/obj/structure/closet/crate/wooden/storage_barrel,
/obj/item/seeds/cotton,
/obj/item/seeds/cotton,
/obj/item/seeds/aloe{
	pixel_y = -5
	},
/obj/item/seeds/herbs{
	pixel_y = 3
	},
/obj/item/seeds/toechtauese{
	pixel_y = 5
	},
/obj/item/seeds/tea{
	pixel_y = 1
	},
/obj/item/seeds/tea/catnip{
	pixel_y = -3
	},
/obj/item/seeds/coffee{
	pixel_y = -5
	},
/obj/item/seeds/bamboo,
/turf/open/floor/wood/icemoon,
/area/ruin/unpowered/primitive_catgirl_den)
"Oe" = (
/obj/item/reagent_containers/cup/glass/bottle/lizardwine{
	pixel_y = 8;
	pixel_x = -5
	},
/obj/item/reagent_containers/cup/glass/bottle/moonshine{
	pixel_x = 5;
	pixel_y = -1
	},
/obj/structure/rack/shelf/wooden,
/turf/open/misc/dirt/icemoon,
/area/ruin/unpowered/primitive_catgirl_den)
"Oj" = (
/obj/item/storage/box/matches{
	pixel_y = 7;
	pixel_x = 3
	},
/obj/item/stack/sheet/cloth/ten{
	pixel_y = -5
	},
/obj/structure/rack/shelf/wooden,
/turf/open/floor/stone/icemoon,
/area/ruin/unpowered/primitive_catgirl_den)
"Ox" = (
/obj/structure/closet/crate/wooden,
/obj/item/stack/sheet/copporcitite{
	amount = 37;
	pixel_x = -4
	},
/obj/item/stack/sheet/cobolterium{
	amount = 32;
	pixel_x = 5
	},
/obj/item/stack/sheet/tinumium{
	amount = 28;
	pixel_y = 4
	},
/turf/open/floor/wood/icemoon,
/area/ruin/unpowered/primitive_catgirl_den)
"OS" = (
/obj/structure/closet/crate/wooden/storage_barrel,
/obj/item/food/meat/slab/human/mutant/lizard{
	pixel_y = -9
	},
/obj/item/food/meat/slab/bear{
	pixel_y = -4
	},
/obj/item/food/meat/slab/bear{
	pixel_y = -1
	},
/obj/item/food/meat/slab/penguin{
	pixel_y = 1
	},
/obj/item/food/meat/slab/penguin{
	pixel_y = 5
	},
/turf/open/misc/dirt/icemoon,
/area/ruin/unpowered/primitive_catgirl_den)
"Qi" = (
/obj/effect/turf_decal/siding/wood{
	dir = 9
	},
/turf/open/misc/dirt/icemoon,
/area/ruin/unpowered/primitive_catgirl_den)
"Rp" = (
/obj/item/forging/billow/primitive{
	pixel_y = 4
	},
/obj/effect/turf_decal/siding/wood{
	dir = 4
	},
/obj/structure/rack/shelf/wooden,
/turf/open/misc/dirt/icemoon,
/area/ruin/unpowered/primitive_catgirl_den)
"Rq" = (
/turf/open/floor/wood/icemoon,
/area/ruin/unpowered/primitive_catgirl_den)
"RI" = (
/obj/structure/closet/crate/wooden/storage_barrel,
/obj/item/food/cheese/firm_cheese{
	pixel_y = -2
	},
/obj/item/food/cheese/firm_cheese{
	pixel_y = 1
	},
/obj/item/food/cheese/firm_cheese{
	pixel_y = 3
	},
/turf/open/misc/dirt/icemoon,
/area/ruin/unpowered/primitive_catgirl_den)
"RP" = (
/obj/structure/bed/maint,
/obj/item/bedsheet/black{
	dir = 1
	},
/turf/open/misc/dirt/icemoon,
/area/ruin/unpowered/primitive_catgirl_den)
"Sb" = (
/obj/item/gun/ballistic/tribalbow{
	pixel_x = -7
	},
/obj/item/gun/ballistic/tribalbow{
	pixel_x = 3
	},
/obj/effect/turf_decal/siding/wood/corner{
	dir = 1
	},
/obj/structure/rack/shelf/wooden,
/turf/open/misc/dirt/icemoon,
/area/ruin/unpowered/primitive_catgirl_den)
"Sk" = (
/obj/effect/turf_decal/siding/wood{
	dir = 4
	},
/obj/effect/turf_decal/siding/wood/corner{
	dir = 1
	},
/turf/open/misc/dirt/icemoon,
/area/ruin/unpowered/primitive_catgirl_den)
"Sw" = (
/obj/effect/turf_decal/siding/wood/corner{
	dir = 4
	},
/obj/effect/turf_decal/siding/wood/corner,
/turf/open/misc/dirt/icemoon,
/area/ruin/unpowered/primitive_catgirl_den)
"Tw" = (
/obj/item/shield/goliath{
	pixel_x = -6
	},
/obj/item/shield/goliath{
	pixel_x = 8
	},
/obj/effect/turf_decal/siding/wood{
	dir = 8
	},
/obj/structure/rack/shelf/wooden,
/turf/open/misc/dirt/icemoon,
/area/ruin/unpowered/primitive_catgirl_den)
"Uj" = (
/obj/structure/deployable_barricade/wooden,
/turf/open/misc/asteroid/snow/icemoon,
/area/ruin/unpowered/primitive_catgirl_den)
"UA" = (
/obj/structure/table/wood,
/obj/item/knife/hunting{
	pixel_y = 5
	},
/obj/item/kitchen/rollingpin,
/turf/open/misc/dirt/icemoon,
/area/ruin/unpowered/primitive_catgirl_den)
"Vi" = (
/obj/structure/rack/shelf/wooden,
/obj/item/reagent_containers/cup/glass/bottle/small{
	pixel_y = 12;
	pixel_x = -6
	},
/obj/item/reagent_containers/cup/glass/bottle/small{
	pixel_y = 12;
	pixel_x = 3
	},
/obj/item/reagent_containers/cup/mortar{
	pixel_y = -5;
	pixel_x = 4
	},
/turf/open/floor/wood/icemoon,
/area/ruin/unpowered/primitive_catgirl_den)
"Vy" = (
/obj/item/retractor/ashwalker{
	pixel_y = -9
	},
/obj/item/hemostat/ashwalker{
	pixel_y = 6
	},
/obj/structure/rack/shelf/wooden,
/turf/open/floor/stone/icemoon,
/area/ruin/unpowered/primitive_catgirl_den)
"VM" = (
/obj/effect/turf_decal/weather/snow/corner{
	dir = 6
	},
/turf/open/misc/dirt/icemoon,
/area/ruin/unpowered/primitive_catgirl_den)
"VZ" = (
/obj/structure/chair/stool/bamboo{
	dir = 1
	},
/turf/open/misc/dirt/icemoon,
/area/ruin/unpowered/primitive_catgirl_den)
"Wd" = (
/obj/structure/reagent_anvil,
/obj/item/forging/hammer/primitive,
/turf/open/floor/wood/icemoon,
/area/ruin/unpowered/primitive_catgirl_den)
"Wf" = (
/obj/structure/chair/wood,
/turf/open/misc/dirt/icemoon,
/area/ruin/unpowered/primitive_catgirl_den)
"Wh" = (
/obj/effect/turf_decal/siding/wood{
	dir = 5
	},
/turf/open/misc/dirt/icemoon,
/area/ruin/unpowered/primitive_catgirl_den)
"Wl" = (
/obj/structure/water_source/puddle,
/turf/open/misc/dirt/icemoon,
/area/ruin/unpowered/primitive_catgirl_den)
"Ws" = (
/obj/effect/turf_decal/siding/wood{
	dir = 4
	},
/turf/open/misc/dirt/icemoon,
/area/ruin/unpowered/primitive_catgirl_den)
"Xs" = (
/obj/effect/mob_spawn/ghost_role/human/primitive_catgirl,
/turf/open/misc/asteroid/snow/icemoon,
/area/ruin/unpowered/primitive_catgirl_den)
"XQ" = (
/obj/structure/deployable_barricade/wooden{
	dir = 4
	},
/obj/structure/deployable_barricade/wooden,
/turf/open/misc/asteroid/snow/icemoon,
/area/ruin/unpowered/primitive_catgirl_den)
"XS" = (
/obj/effect/turf_decal/weather/snow/corner,
/obj/effect/turf_decal/siding/wood{
	dir = 1
	},
/turf/open/misc/dirt/icemoon,
/area/ruin/unpowered/primitive_catgirl_den)
"Yd" = (
/obj/structure/chair/wood{
	dir = 1
	},
/turf/open/misc/dirt/icemoon,
/area/ruin/unpowered/primitive_catgirl_den)
"YF" = (
/obj/item/storage/bag/quiver{
	pixel_x = -5
	},
/obj/item/storage/bag/quiver{
	pixel_x = 6
	},
/obj/structure/rack/shelf/wooden,
/turf/open/misc/dirt/icemoon,
/area/ruin/unpowered/primitive_catgirl_den)
"Za" = (
/obj/effect/turf_decal/siding/wood{
	dir = 1
	},
/obj/effect/turf_decal/siding/wood,
/turf/open/misc/dirt/icemoon,
/area/ruin/unpowered/primitive_catgirl_den)
"Zn" = (
/obj/structure/bed/maint,
/obj/item/bedsheet/black,
/turf/open/misc/dirt/icemoon,
/area/ruin/unpowered/primitive_catgirl_den)
"Zt" = (
/obj/effect/turf_decal/siding/wood{
	dir = 1
	},
/turf/open/misc/dirt/icemoon,
/area/ruin/unpowered/primitive_catgirl_den)

(1,1,1) = {"
oN
oN
oN
oN
nu
nu
nu
oN
oN
oN
oN
oN
oN
oN
oN
oN
oN
oN
oN
oN
oN
oN
oN
"}
(2,1,1) = {"
oN
oN
nu
nu
nu
nu
nu
nu
nu
oN
oN
oN
oN
oN
oN
oN
oN
oN
oN
oN
oN
oN
oN
"}
(3,1,1) = {"
oN
nu
nu
qw
qw
qw
qw
qw
nu
nu
oN
oN
oN
oN
qw
wE
wE
wE
qw
oN
oN
oN
oN
"}
(4,1,1) = {"
oN
nu
nu
dv
Jv
hl
Jv
dv
nu
nu
qc
qc
dv
qw
dv
qN
hj
cg
dv
qw
dv
oN
oN
"}
(5,1,1) = {"
nu
nu
nu
Rp
Sw
Ws
Ws
hS
nu
IP
ef
mZ
mZ
wE
uM
Kh
au
rY
FL
wE
oN
oN
oN
"}
(6,1,1) = {"
nu
IP
Ox
Rq
Za
Rq
Rq
Wh
DO
mZ
mZ
mZ
mZ
wE
Ar
Rq
au
vP
Le
wE
oN
oN
oN
"}
(7,1,1) = {"
nu
nu
Gr
Rq
Za
Wd
vl
Rq
XS
mZ
mZ
ef
mZ
wE
Vi
Rq
us
JF
Vy
wE
oN
oN
oN
"}
(8,1,1) = {"
nu
nu
HK
Qi
rz
AP
Rq
Qi
Ko
ef
mZ
mZ
ef
qw
dv
BN
Gq
cJ
dv
qw
oN
oN
oN
"}
(9,1,1) = {"
nu
IP
Tw
Gq
zO
Gh
BN
Sb
nu
IP
mZ
mZ
mZ
wE
Zn
cj
Ws
fl
RP
wE
oN
oN
oN
"}
(10,1,1) = {"
nu
nu
Jh
rm
rm
fe
YF
nu
nu
nu
mZ
mZ
mZ
wE
RP
EH
Oj
Zt
ij
wE
oN
oN
oN
"}
(11,1,1) = {"
nu
nu
nu
fe
VM
mZ
nu
nu
nu
nu
ef
mZ
mZ
wE
oo
EH
Ag
Zt
Zn
wE
oN
oN
oN
"}
(12,1,1) = {"
oN
nu
IP
mZ
mZ
ef
IP
nu
nu
mZ
mZ
mZ
dv
qw
dv
EH
CG
Zt
dv
qw
dv
EQ
oN
"}
(13,1,1) = {"
oN
Ky
ef
mZ
mZ
mZ
mZ
mZ
mZ
ef
mZ
mZ
lB
wE
ms
Gh
bJ
Gq
rm
wE
Ky
mZ
EQ
"}
(14,1,1) = {"
oN
Jt
mZ
mZ
mZ
mZ
mZ
ef
mZ
mZ
Xs
mZ
mZ
FS
rm
Wf
LV
Yd
rm
Bs
mZ
mZ
Uj
"}
(15,1,1) = {"
oN
oN
Ky
ef
mZ
mZ
mZ
nu
nu
lB
mZ
mZ
ef
wE
rm
xO
rG
Yd
Kp
wE
Ky
mZ
Uj
"}
(16,1,1) = {"
oN
oN
nu
nu
mZ
mZ
CN
IP
nu
nu
mZ
ef
dv
qw
dv
Wf
GR
VZ
dv
qw
dv
vE
XQ
"}
(17,1,1) = {"
oN
nu
nu
nu
Fp
kZ
qC
HJ
nu
nu
ig
mZ
mZ
wE
kr
xO
LV
Yd
RP
wE
oN
oN
oN
"}
(18,1,1) = {"
oN
nu
nu
IP
EH
HJ
HJ
HJ
HJ
nu
nu
mZ
mZ
wE
RI
cj
Em
fl
Zn
wE
oN
oN
oN
"}
(19,1,1) = {"
nu
nu
nu
FZ
EH
gs
HJ
HJ
HJ
IP
nu
mZ
ef
wE
OS
EH
pZ
Zt
Zn
wE
oN
oN
oN
"}
(20,1,1) = {"
nu
nu
Ws
Ws
zm
HJ
HJ
uZ
HJ
nu
nu
mZ
mZ
qw
dv
oO
Ag
Zt
dv
qw
oN
oN
oN
"}
(21,1,1) = {"
nu
nu
HJ
HJ
us
AP
HJ
HJ
HJ
IP
ef
mZ
mZ
qw
vf
EH
Kl
Zt
ce
wE
oN
oN
oN
"}
(22,1,1) = {"
nu
IP
HJ
HJ
Wh
zm
HJ
HJ
Qi
ne
mZ
mZ
mZ
qw
pd
Gh
BN
Gq
Oe
wE
oN
oN
oN
"}
(23,1,1) = {"
nu
HJ
HJ
HJ
HJ
us
BN
BN
Ko
mZ
mZ
mZ
ef
qw
qs
rm
rm
sl
xr
wE
oN
oN
oN
"}
(24,1,1) = {"
nu
HJ
pS
HJ
HJ
Zt
Wl
rm
Gj
ef
mZ
mZ
dv
qw
dv
ok
JH
UA
dv
qw
dv
oN
oN
"}
(25,1,1) = {"
nu
IP
HJ
HJ
kU
Sk
Ws
Ws
fl
IP
vE
XQ
oN
oN
qw
wE
wE
wE
qw
oN
oN
oN
oN
"}
(26,1,1) = {"
nu
nu
nu
nu
IP
aM
Rq
ku
nu
nu
oN
oN
oN
oN
oN
oN
oN
oN
oN
oN
oN
oN
oN
"}
(27,1,1) = {"
oN
nu
nu
nu
nu
fY
Rq
dL
IP
nu
oN
oN
oN
oN
oN
oN
oN
oN
oN
oN
oN
oN
oN
"}
(28,1,1) = {"
oN
nu
nu
nu
nu
nu
dF
MO
nu
nu
oN
oN
oN
oN
oN
oN
oN
oN
oN
oN
oN
oN
oN
"}
(29,1,1) = {"
oN
oN
nu
nu
nu
nu
IP
nu
nu
nu
oN
oN
oN
oN
oN
oN
oN
oN
oN
oN
oN
oN
oN
"}
(30,1,1) = {"
oN
oN
oN
oN
nu
nu
nu
nu
oN
oN
oN
oN
oN
oN
oN
oN
oN
oN
oN
oN
oN
oN
oN
"}
