//MAP CONVERTED BY dmm2tgm.py THIS HEADER COMMENT PREVENTS RECONVERSION, DO NOT REMOVE
"ah" = (
/obj/structure/window/reinforced/spawner/east,
/obj/structure/window/reinforced/spawner/west,
/turf/open/floor/grass/fairy,
/area/shuttle/arrival)
"ay" = (
/obj/effect/turf_decal/trimline/white/line,
/obj/effect/turf_decal/trimline/blue/filled/arrow_cw,
/obj/effect/turf_decal/trimline/blue/filled/arrow_ccw{
	dir = 1
	},
/obj/effect/turf_decal/trimline/white/line{
	dir = 1
	},
/obj/effect/turf_decal/trimline/blue/filled/mid_joiner,
/obj/effect/turf_decal/trimline/blue/filled/mid_joiner{
	dir = 1
	},
/turf/open/floor/iron/shuttle/evac,
/area/shuttle/arrival)
"dp" = (
/obj/effect/turf_decal/trimline/white/line,
/obj/effect/turf_decal/trimline/blue/filled/arrow_cw,
/obj/effect/turf_decal/trimline/blue/filled/arrow_ccw{
	dir = 1
	},
/obj/effect/turf_decal/trimline/white/line{
	dir = 1
	},
/obj/effect/turf_decal/trimline/blue/filled/mid_joiner,
/turf/open/floor/iron/shuttle/evac,
/area/shuttle/arrival)
"en" = (
/obj/effect/turf_decal/trimline/blue/filled/corner{
	dir = 4
	},
/obj/effect/turf_decal/trimline/blue/filled/corner,
/obj/effect/turf_decal/trimline/white/corner{
	dir = 4
	},
/obj/effect/turf_decal/trimline/white/corner,
/turf/open/floor/iron/shuttle/evac,
/area/shuttle/arrival)
"fN" = (
/obj/effect/turf_decal/caution{
	dir = 1
	},
/obj/effect/turf_decal/trimline/white/warning,
/obj/effect/turf_decal/trimline/blue/filled/line{
	dir = 10
	},
/obj/effect/turf_decal/trimline/blue/filled/mid_joiner,
/obj/effect/turf_decal/trimline/blue/filled/mid_joiner{
	dir = 8
	},
/obj/effect/turf_decal/trimline/white/line{
	dir = 10
	},
/turf/open/floor/iron/shuttle/evac,
/area/shuttle/arrival)
"iJ" = (
/turf/closed/wall/mineral/titanium/shuttle_wall/window/evac{
	dir = 4;
	icon_state = "1,13"
	},
/area/shuttle/arrival)
"iK" = (
/turf/closed/wall/mineral/titanium/shuttle_wall/ferry{
	icon_state = "2,3"
	},
/area/shuttle/arrival)
"jQ" = (
/turf/closed/wall/mineral/titanium/shuttle_wall/ferry{
	dir = 1;
	icon_state = "14,5"
	},
/area/shuttle/arrival)
"kp" = (
/obj/structure/window/reinforced/spawner/west,
/obj/structure/window/reinforced/spawner/east,
/turf/open/floor/grass/fairy,
/area/shuttle/arrival)
"lw" = (
/obj/effect/turf_decal/trimline/blue/filled/arrow_cw{
	dir = 4
	},
/obj/effect/turf_decal/trimline/white/arrow_cw{
	dir = 4
	},
/obj/effect/turf_decal/trimline/blue/filled/mid_joiner{
	dir = 4
	},
/turf/open/floor/iron/shuttle/evac,
/area/shuttle/arrival)
"lW" = (
/obj/effect/turf_decal/trimline/blue/filled/arrow_ccw{
	dir = 4
	},
/obj/effect/turf_decal/trimline/white/arrow_ccw{
	dir = 4
	},
/obj/effect/turf_decal/trimline/blue/filled/mid_joiner{
	dir = 4
	},
/turf/open/floor/iron/shuttle/evac,
/area/shuttle/arrival)
"nd" = (
/turf/closed/wall/mineral/titanium/shuttle_wall/ferry{
	dir = 1;
	icon_state = "2,2"
	},
/area/shuttle/arrival)
"nt" = (
/turf/closed/wall/mineral/titanium/shuttle_wall/window/ferry{
	dir = 1;
	icon_state = "2,6"
	},
/area/shuttle/arrival)
"nT" = (
/obj/effect/turf_decal/trimline/blue/filled/line{
	dir = 1
	},
/obj/structure/chair/comfy/shuttle{
	dir = 1
	},
/turf/open/floor/iron/shuttle/evac,
/area/shuttle/arrival)
"oD" = (
/obj/machinery/door/airlock/external,
/obj/effect/turf_decal/tile/blue/full,
/turf/open/floor/iron/shuttle/arrivals,
/area/shuttle/arrival)
"pn" = (
/obj/effect/turf_decal/trimline/blue/filled/corner{
	dir = 1
	},
/obj/effect/turf_decal/trimline/white/corner{
	dir = 1
	},
/obj/effect/turf_decal/delivery/blue,
/obj/effect/spawner/random/trash/box,
/turf/open/floor/iron/shuttle/evac,
/area/shuttle/arrival)
"pv" = (
/turf/closed/wall/mineral/titanium/shuttle_wall/window/ferry{
	dir = 1;
	icon_state = "2,4"
	},
/area/shuttle/arrival)
"pD" = (
/turf/closed/wall/mineral/titanium/shuttle_wall/ferry{
	dir = 1;
	icon_state = "2,8"
	},
/area/shuttle/arrival)
"qj" = (
/obj/effect/turf_decal/trimline/blue/filled/corner{
	dir = 4
	},
/obj/effect/turf_decal/trimline/white/corner{
	dir = 4
	},
/obj/structure/chair/comfy/shuttle{
	dir = 4
	},
/turf/open/floor/iron/shuttle/evac,
/area/shuttle/arrival)
"qp" = (
/obj/effect/turf_decal/trimline/blue/filled/corner,
/obj/effect/turf_decal/trimline/white/corner,
/obj/structure/chair/comfy/shuttle{
	dir = 4
	},
/turf/open/floor/iron/shuttle/evac,
/area/shuttle/arrival)
"qy" = (
/obj/machinery/light/directional/south,
/obj/effect/turf_decal/trimline/blue/filled/line{
	dir = 1
	},
/obj/structure/chair/comfy/shuttle{
	dir = 1
	},
/turf/open/floor/iron/shuttle/evac,
/area/shuttle/arrival)
"qC" = (
/obj/effect/turf_decal/trimline/blue/filled/line{
	dir = 1
	},
/obj/effect/turf_decal/trimline/blue/filled/line,
/obj/effect/turf_decal/trimline/blue/filled/mid_joiner{
	dir = 1
	},
/obj/effect/turf_decal/trimline/blue/filled/mid_joiner,
/obj/effect/turf_decal/trimline/white/arrow_cw,
/obj/effect/turf_decal/trimline/white/arrow_ccw{
	dir = 1
	},
/obj/machinery/door/airlock/command/glass{
	name = "Cockpit";
	req_access = list("cent_general")
	},
/turf/open/floor/iron/shuttle/evac,
/area/shuttle/arrival)
"qV" = (
/turf/closed/wall/mineral/titanium/shuttle_wall/ferry{
	icon_state = "2,7"
	},
/area/shuttle/arrival)
"sv" = (
/obj/structure/chair/comfy/shuttle{
	dir = 4
	},
/turf/open/floor/iron/shuttle/evac,
/area/shuttle/arrival)
"ul" = (
/turf/closed/wall/mineral/titanium/shuttle_wall/ferry{
	icon_state = "3,8"
	},
/area/shuttle/arrival)
"uI" = (
/obj/docking_port/mobile/arrivals_skyrat,
/turf/closed/wall/mineral/titanium/shuttle_wall/ferry{
	dir = 1;
	icon_state = "2,7"
	},
/area/shuttle/arrival)
"wd" = (
/obj/effect/turf_decal/tile/blue/full,
/turf/open/floor/iron/shuttle/arrivals{
	icon_state = "sign_3"
	},
/area/shuttle/arrival)
"xM" = (
/turf/closed/wall/mineral/titanium/shuttle_wall/ferry{
	icon_state = "2,2"
	},
/area/shuttle/arrival)
"yx" = (
/turf/closed/wall/mineral/titanium/shuttle_wall/ferry{
	dir = 1;
	icon_state = "3,8"
	},
/area/shuttle/arrival)
"zu" = (
/turf/open/floor/glass,
/area/shuttle/arrival)
"Ao" = (
/obj/effect/turf_decal/caution,
/obj/effect/turf_decal/trimline/white/warning{
	dir = 1
	},
/obj/effect/turf_decal/trimline/blue/filled/line{
	dir = 9
	},
/obj/effect/turf_decal/trimline/blue/filled/mid_joiner{
	dir = 1
	},
/obj/effect/turf_decal/trimline/blue/filled/mid_joiner{
	dir = 8
	},
/obj/effect/turf_decal/trimline/white/line{
	dir = 9
	},
/turf/open/floor/iron/shuttle/evac,
/area/shuttle/arrival)
"EH" = (
/obj/effect/turf_decal/trimline/white/arrow_cw,
/obj/effect/turf_decal/trimline/blue/filled/line,
/obj/effect/turf_decal/trimline/white/arrow_ccw{
	dir = 1
	},
/obj/effect/turf_decal/trimline/blue/filled/line{
	dir = 1
	},
/obj/effect/turf_decal/trimline/blue/filled/mid_joiner,
/obj/effect/turf_decal/trimline/blue/filled/mid_joiner{
	dir = 1
	},
/turf/open/floor/iron/shuttle/evac,
/area/shuttle/arrival)
"GT" = (
/obj/machinery/light/directional/north,
/obj/effect/turf_decal/trimline/blue/filled/line,
/obj/structure/chair/comfy/shuttle,
/turf/open/floor/iron/shuttle/evac,
/area/shuttle/arrival)
"Hd" = (
/obj/machinery/light/directional/east,
/obj/machinery/status_display/shuttle{
	pixel_x = 32;
	shuttle_id = "arrivals_shuttle"
	},
/obj/effect/turf_decal/delivery/blue,
/obj/structure/closet/crate/bin,
/turf/open/floor/iron/shuttle/evac,
/area/shuttle/arrival)
"HW" = (
/turf/closed/wall/mineral/titanium/shuttle_wall/ferry{
	dir = 1;
	icon_state = "2,3"
	},
/area/shuttle/arrival)
"KE" = (
/obj/effect/turf_decal/trimline/blue/filled/line,
/obj/structure/chair/comfy/shuttle,
/turf/open/floor/iron/shuttle/evac,
/area/shuttle/arrival)
"Nw" = (
/obj/effect/turf_decal/trimline/blue/filled/arrow_ccw{
	dir = 8
	},
/obj/effect/turf_decal/trimline/white/arrow_ccw{
	dir = 8
	},
/obj/effect/turf_decal/trimline/blue/filled/mid_joiner{
	dir = 8
	},
/turf/open/floor/iron/shuttle/evac,
/area/shuttle/arrival)
"Qc" = (
/obj/effect/turf_decal/trimline/blue/filled/corner{
	dir = 8
	},
/obj/effect/turf_decal/trimline/white/corner{
	dir = 8
	},
/obj/effect/turf_decal/delivery/blue,
/turf/open/floor/iron/shuttle/evac,
/area/shuttle/arrival)
"Qx" = (
/obj/structure/closet/shuttle/emergency/white,
/turf/open/floor/grass/fairy,
/area/shuttle/arrival)
"QC" = (
/obj/effect/turf_decal/trimline/blue/filled/arrow_cw{
	dir = 8
	},
/obj/effect/turf_decal/trimline/white/arrow_cw{
	dir = 8
	},
/obj/effect/turf_decal/trimline/blue/filled/mid_joiner{
	dir = 8
	},
/turf/open/floor/iron/shuttle/evac,
/area/shuttle/arrival)
"QE" = (
/turf/closed/wall/mineral/titanium/shuttle_wall/window/evac{
	dir = 8;
	icon_state = "1,13"
	},
/area/shuttle/arrival)
"Rj" = (
/turf/closed/wall/mineral/titanium/shuttle_wall/ferry{
	icon_state = "3,2"
	},
/area/shuttle/arrival)
"Ry" = (
/obj/effect/turf_decal/caution,
/obj/effect/turf_decal/trimline/white/warning{
	dir = 1
	},
/obj/effect/turf_decal/trimline/blue/filled/line{
	dir = 5
	},
/obj/effect/turf_decal/trimline/blue/filled/mid_joiner{
	dir = 4
	},
/obj/effect/turf_decal/trimline/white/line{
	dir = 5
	},
/turf/open/floor/iron/shuttle/evac,
/area/shuttle/arrival)
"RD" = (
/obj/machinery/door/airlock/external,
/turf/open/floor/iron/shuttle/arrivals,
/area/shuttle/arrival)
"RX" = (
/obj/effect/turf_decal/caution{
	dir = 1
	},
/obj/effect/turf_decal/trimline/white/warning,
/obj/effect/turf_decal/trimline/blue/filled/line{
	dir = 6
	},
/obj/effect/turf_decal/trimline/blue/filled/mid_joiner{
	dir = 4
	},
/obj/effect/turf_decal/trimline/blue/filled/mid_joiner,
/obj/effect/turf_decal/trimline/white/line{
	dir = 6
	},
/turf/open/floor/iron/shuttle/evac,
/area/shuttle/arrival)
"SA" = (
/turf/closed/wall/mineral/titanium/shuttle_wall/window/evac{
	dir = 4;
	icon_state = "1,12"
	},
/area/shuttle/arrival)
"Tp" = (
/turf/closed/wall/mineral/titanium/shuttle_wall/ferry{
	icon_state = "2,8"
	},
/area/shuttle/arrival)
"UQ" = (
/obj/effect/turf_decal/trimline/blue/filled/corner{
	dir = 8
	},
/obj/effect/turf_decal/trimline/white/corner{
	dir = 1
	},
/obj/effect/turf_decal/trimline/white/corner{
	dir = 8
	},
/obj/effect/turf_decal/trimline/blue/filled/corner{
	dir = 1
	},
/turf/open/floor/iron/shuttle/evac,
/area/shuttle/arrival)
"US" = (
/turf/closed/wall/mineral/titanium/shuttle_wall/window/ferry{
	icon_state = "2,6"
	},
/area/shuttle/arrival)
"Vx" = (
/obj/effect/turf_decal/trimline/blue/filled/line{
	dir = 1
	},
/obj/effect/turf_decal/trimline/blue/filled/line,
/obj/effect/turf_decal/trimline/blue/filled/mid_joiner,
/obj/effect/turf_decal/trimline/blue/filled/mid_joiner{
	dir = 1
	},
/obj/effect/turf_decal/trimline/white/arrow_ccw{
	dir = 1
	},
/obj/effect/turf_decal/trimline/white/arrow_cw,
/obj/machinery/door/airlock/command/glass{
	name = "Cockpit";
	req_access = list("cent_general")
	},
/turf/open/floor/iron/shuttle/evac,
/area/shuttle/arrival)
"Xt" = (
/obj/machinery/light/directional/west,
/obj/machinery/computer/shuttle/arrivals{
	dir = 4
	},
/obj/machinery/status_display/shuttle{
	pixel_x = -32;
	shuttle_id = "arrivals_shuttle"
	},
/turf/open/floor/iron/shuttle/evac,
/area/shuttle/arrival)
"Xz" = (
/turf/closed/wall/mineral/titanium/shuttle_wall/window/ferry{
	icon_state = "2,4"
	},
/area/shuttle/arrival)
"YH" = (
/turf/closed/wall/mineral/titanium/shuttle_wall/ferry{
	dir = 1;
	icon_state = "3,2"
	},
/area/shuttle/arrival)
"YT" = (
/obj/effect/turf_decal/bot_blue,
/obj/effect/turf_decal/delivery/blue,
/turf/open/floor/iron/shuttle/evac,
/area/shuttle/arrival)
"ZP" = (
/turf/closed/wall/mineral/titanium/shuttle_wall/window/evac{
	dir = 8;
	icon_state = "1,12"
	},
/area/shuttle/arrival)

(1,1,1) = {"
Tp
qV
US
jQ
Xz
iK
xM
"}
(2,1,1) = {"
ul
qj
sv
Xt
sv
qp
Rj
"}
(3,1,1) = {"
oD
Ry
lW
en
lw
RX
RD
"}
(4,1,1) = {"
SA
kp
Qx
qC
Qx
kp
ZP
"}
(5,1,1) = {"
iJ
GT
wd
ay
wd
qy
QE
"}
(6,1,1) = {"
SA
KE
zu
EH
zu
nT
ZP
"}
(7,1,1) = {"
SA
KE
zu
dp
zu
nT
ZP
"}
(8,1,1) = {"
SA
KE
zu
EH
zu
nT
ZP
"}
(9,1,1) = {"
iJ
GT
wd
ay
wd
qy
QE
"}
(10,1,1) = {"
SA
ah
Qx
Vx
Qx
ah
ZP
"}
(11,1,1) = {"
oD
Ao
Nw
UQ
QC
fN
oD
"}
(12,1,1) = {"
YH
pn
YT
Hd
YT
Qc
yx
"}
(13,1,1) = {"
nd
HW
pv
jQ
nt
uI
pD
"}
