//MAP CONVERTED BY dmm2tgm.py THIS HEADER COMMENT PREVENTS RECONVERSION, DO NOT REMOVE
"a" = (
/obj/effect/light_emitter{
	set_cap = 1;
	set_luminosity = 4
	},
/turf/open/misc/ironsand,
/area/centcom/interlink)
"b" = (
/obj/structure/railing/corner{
	dir = 4
	},
/obj/effect/turf_decal/trimline/blue/filled/arrow_cw,
/obj/effect/turf_decal/trimline/white/line,
/turf/open/floor/iron,
/area/centcom/interlink)
"c" = (
/obj/effect/turf_decal/trimline/blue/filled/arrow_ccw{
	dir = 1
	},
/obj/effect/turf_decal/trimline/white/line{
	dir = 1
	},
/turf/open/floor/iron,
/area/centcom/interlink)
"e" = (
/obj/effect/turf_decal/stripes/line{
	dir = 4
	},
/obj/effect/light_emitter{
	set_cap = 1;
	set_luminosity = 4
	},
/turf/open/floor/plating/cobblestone/dungeon,
/area/centcom/interlink)
"f" = (
/obj/effect/turf_decal/trimline/blue/filled/line,
/obj/effect/turf_decal/trimline/white/arrow_cw,
/turf/open/floor/iron,
/area/centcom/interlink)
"g" = (
/obj/effect/turf_decal/stripes/line,
/obj/structure/window/reinforced/spawner/north,
/obj/structure/window/reinforced/spawner/west,
/obj/machinery/vending/clothing,
/turf/open/floor/iron,
/area/centcom/interlink)
"h" = (
/obj/machinery/computer/shuttle/arrivals/recall{
	dir = 4
	},
/obj/structure/window/reinforced/spawner/west,
/turf/open/floor/iron,
/area/centcom/interlink)
"i" = (
/obj/structure/table,
/obj/structure/window/reinforced/spawner/west,
/turf/open/floor/iron,
/area/centcom/interlink)
"j" = (
/obj/effect/turf_decal/stripes/line,
/obj/structure/window/reinforced/spawner/west,
/obj/structure/window/reinforced/spawner/north,
/obj/item/kirbyplants/random,
/turf/open/floor/iron,
/area/centcom/interlink)
"k" = (
/obj/effect/turf_decal/trimline/blue/filled/line{
	dir = 1
	},
/obj/effect/turf_decal/trimline/white/arrow_ccw{
	dir = 1
	},
/turf/open/floor/iron,
/area/centcom/interlink)
"l" = (
/obj/machinery/door/airlock/engineering,
/obj/effect/turf_decal/trimline/blue/filled/arrow_cw,
/turf/open/floor/iron,
/area/centcom/interlink)
"m" = (
/turf/closed/indestructible/riveted,
/area/centcom/interlink)
"n" = (
/obj/machinery/door/airlock/engineering,
/obj/effect/turf_decal/trimline/blue/filled/arrow_ccw{
	dir = 1
	},
/turf/open/floor/iron,
/area/centcom/interlink)
"o" = (
/obj/structure/railing/corner{
	dir = 4
	},
/obj/effect/turf_decal/trimline/blue/filled/corner,
/obj/effect/turf_decal/trimline/white/corner,
/turf/open/floor/iron,
/area/centcom/interlink)
"p" = (
/obj/effect/light_emitter{
	set_cap = 1;
	set_luminosity = 4
	},
/turf/open/floor/iron/dark/small,
/area/centcom/interlink)
"q" = (
/obj/effect/spawner/random/vending/colavend,
/obj/structure/window/reinforced/spawner/west,
/turf/open/floor/iron,
/area/centcom/interlink)
"r" = (
/obj/effect/turf_decal/stripes/line,
/obj/structure/window/reinforced/spawner/north,
/obj/structure/window/reinforced/spawner/east,
/obj/machinery/vending/coffee,
/turf/open/floor/iron,
/area/centcom/interlink)
"s" = (
/obj/effect/turf_decal/trimline/blue/filled/corner{
	dir = 4
	},
/obj/effect/turf_decal/trimline/white/corner{
	dir = 4
	},
/turf/open/floor/iron,
/area/centcom/interlink)
"t" = (
/obj/effect/turf_decal/trimline/white/arrow_cw,
/obj/effect/turf_decal/trimline/blue/filled/shrink_ccw,
/turf/open/floor/iron,
/area/centcom/interlink)
"v" = (
/obj/effect/turf_decal/trimline/blue/filled/arrow_cw,
/obj/effect/turf_decal/trimline/white/line,
/turf/open/floor/iron,
/area/centcom/interlink)
"w" = (
/obj/effect/turf_decal/stripes/line,
/obj/structure/window/reinforced/spawner/north,
/obj/structure/window/reinforced/spawner/east,
/obj/machinery/vending/cigarette,
/turf/open/floor/iron,
/area/centcom/interlink)
"x" = (
/obj/structure/table,
/obj/item/lighter,
/obj/structure/window/reinforced/spawner/west,
/turf/open/floor/iron,
/area/centcom/interlink)
"z" = (
/obj/effect/turf_decal/stripes/line{
	dir = 8
	},
/obj/effect/light_emitter{
	set_cap = 1;
	set_luminosity = 4
	},
/turf/open/floor/plating/cobblestone/dungeon,
/area/centcom/interlink)
"A" = (
/obj/machinery/light/directional/south,
/obj/effect/turf_decal/trimline/blue/filled/arrow_ccw{
	dir = 1
	},
/obj/effect/turf_decal/trimline/white/line{
	dir = 1
	},
/turf/open/floor/iron,
/area/centcom/interlink)
"C" = (
/obj/effect/light_emitter{
	set_cap = 1;
	set_luminosity = 4
	},
/turf/open/floor/iron/smooth_half,
/area/centcom/interlink)
"E" = (
/obj/structure/railing/corner{
	dir = 1
	},
/obj/effect/turf_decal/trimline/blue/filled/arrow_cw,
/obj/effect/turf_decal/trimline/white/line,
/turf/open/floor/iron,
/area/centcom/interlink)
"F" = (
/obj/effect/turf_decal/stripes/line{
	dir = 10
	},
/obj/effect/light_emitter{
	set_cap = 1;
	set_luminosity = 4
	},
/turf/open/floor/plating/cobblestone/dungeon,
/area/centcom/interlink)
"H" = (
/obj/effect/turf_decal/trimline/blue/filled/line{
	dir = 10
	},
/obj/effect/turf_decal/trimline/white/arrow_cw{
	dir = 10
	},
/obj/effect/turf_decal/trimline/white/line,
/turf/open/floor/iron,
/area/centcom/interlink)
"I" = (
/obj/effect/turf_decal/stripes/line,
/obj/structure/window/reinforced/spawner/north,
/obj/structure/statue/bluespace_crystal/zesty,
/turf/open/floor/iron,
/area/centcom/interlink)
"J" = (
/obj/effect/turf_decal/stripes/line,
/obj/structure/window/reinforced/spawner/north,
/obj/structure/window/reinforced/spawner/west,
/obj/machinery/vending/snack/blue,
/turf/open/floor/iron,
/area/centcom/interlink)
"K" = (
/obj/structure/window/reinforced/spawner/west,
/turf/open/floor/iron,
/area/centcom/interlink)
"L" = (
/obj/structure/sign/poster/contraband/random/directional/south,
/obj/effect/turf_decal/trimline/white/arrow_ccw{
	dir = 1
	},
/obj/effect/turf_decal/trimline/blue/filled/shrink_cw{
	dir = 1
	},
/turf/open/floor/iron,
/area/centcom/interlink)
"M" = (
/obj/effect/spawner/structure/window/reinforced,
/turf/open/floor/plating,
/area/centcom/interlink)
"N" = (
/obj/item/kirbyplants/random,
/obj/structure/window/reinforced/spawner/west,
/turf/open/floor/iron,
/area/centcom/interlink)
"O" = (
/obj/docking_port/stationary{
	dir = 8;
	dwidth = 1;
	height = 13;
	shuttle_id = "arrivals_shuttle";
	name = "tram dock";
	roundstart_template = /datum/map_template/shuttle/arrivals_tannhauser;
	width = 7
	},
/obj/effect/light_emitter{
	set_cap = 1;
	set_luminosity = 4
	},
/turf/open/floor/iron/smooth_half,
/area/centcom/interlink)
"Q" = (
/obj/effect/light_emitter{
	set_cap = 1;
	set_luminosity = 4
	},
/turf/open/floor/plating/cobblestone/dungeon,
/area/centcom/interlink)
"R" = (
/obj/effect/turf_decal/stripes/line,
/obj/structure/window/reinforced/spawner/north,
/turf/open/floor/iron,
/area/centcom/interlink)
"V" = (
/obj/machinery/status_display/shuttle{
	pixel_y = -32;
	shuttle_id = "arrivals_shuttle"
	},
/obj/effect/turf_decal/trimline/blue/filled/arrow_ccw{
	dir = 1
	},
/obj/effect/turf_decal/trimline/white/line{
	dir = 1
	},
/turf/open/floor/iron,
/area/centcom/interlink)
"W" = (
/obj/effect/turf_decal/stripes/line,
/obj/structure/window/reinforced/spawner/north,
/obj/item/kirbyplants/random,
/turf/open/floor/iron,
/area/centcom/interlink)
"X" = (
/obj/effect/turf_decal/tile/blue/fourcorners,
/obj/effect/turf_decal/trimline/white/arrow_cw{
	dir = 8
	},
/obj/machinery/door/airlock/external/glass,
/turf/open/floor/iron,
/area/centcom/interlink)
"Z" = (
/obj/machinery/light/directional/south,
/obj/effect/turf_decal/trimline/blue/filled/line{
	dir = 1
	},
/obj/effect/turf_decal/trimline/white/arrow_ccw{
	dir = 1
	},
/turf/open/floor/iron,
/area/centcom/interlink)

(1,1,1) = {"
m
z
z
z
z
z
z
z
F
a
a
m
"}
(2,1,1) = {"
m
Q
C
Q
C
Q
C
Q
j
K
K
m
"}
(3,1,1) = {"
m
Q
p
Q
p
Q
p
Q
w
o
s
m
"}
(4,1,1) = {"
m
Q
C
Q
C
Q
C
Q
X
H
k
M
"}
(5,1,1) = {"
m
Q
C
Q
C
Q
C
Q
g
E
c
M
"}
(6,1,1) = {"
m
Q
C
Q
C
Q
C
Q
R
f
Z
M
"}
(7,1,1) = {"
m
Q
C
Q
C
Q
C
Q
R
v
c
M
"}
(8,1,1) = {"
m
Q
p
Q
p
Q
p
Q
I
f
k
m
"}
(9,1,1) = {"
m
Q
C
Q
C
Q
C
Q
R
v
V
m
"}
(10,1,1) = {"
m
Q
C
Q
C
Q
C
Q
R
f
k
m
"}
(11,1,1) = {"
m
Q
C
Q
C
Q
C
Q
r
b
A
m
"}
(12,1,1) = {"
m
Q
C
Q
C
Q
C
Q
X
H
k
m
"}
(13,1,1) = {"
m
Q
p
Q
p
Q
p
Q
J
E
c
m
"}
(14,1,1) = {"
m
Q
C
Q
C
Q
O
Q
W
f
k
m
"}
(15,1,1) = {"
m
e
e
e
e
e
e
e
m
l
n
m
"}
(16,1,1) = {"
m
q
N
x
h
i
N
q
m
t
L
m
"}
