//MAP CONVERTED BY dmm2tgm.py THIS HEADER COMMENT PREVENTS RECONVERSION, DO NOT REMOVE
"a" = (
/turf/closed/wall/mineral/titanium,
/area/shuttle/expedition_shuttle)
"b" = (
/obj/structure/shuttle/engine/propulsion/right,
/turf/open/floor/plating,
/area/shuttle/expedition_shuttle)
"c" = (
/obj/structure/shuttle/engine/propulsion/burst,
/turf/open/floor/plating,
/area/shuttle/expedition_shuttle)
"d" = (
/obj/structure/shuttle/engine/propulsion/burst{
	dir = 4
	},
/turf/open/floor/plating,
/area/shuttle/expedition_shuttle)
"e" = (
/obj/effect/spawner/structure/window/reinforced/shuttle,
/obj/machinery/door/poddoor{
	name = "Expedition shuttle door";
	id = "Expedition shuttle door"
	},
/turf/open/floor/plating,
/area/shuttle/expedition_shuttle)
"g" = (
/obj/structure/shuttle/engine/propulsion/left,
/turf/open/floor/plating,
/area/shuttle/expedition_shuttle)
"h" = (
/obj/effect/turf_decal/stripes/line{
	dir = 4
	},
/obj/structure/closet/crate,
/turf/open/floor/mineral/titanium/yellow,
/area/shuttle/expedition_shuttle)
"j" = (
/obj/structure/fans/tiny,
/obj/machinery/door/poddoor{
	name = "Expedition shuttle left door";
	id = "Expedition shuttle left door"
	},
/turf/open/floor/mineral/plastitanium,
/area/shuttle/expedition_shuttle)
"l" = (
/obj/effect/turf_decal/stripes/line{
	dir = 8
	},
/turf/open/floor/mineral/titanium/yellow,
/area/shuttle/expedition_shuttle)
"m" = (
/obj/machinery/computer/shuttle/expedition_shuttle{
	dir = 8
	},
/turf/open/floor/glass/reinforced,
/area/shuttle/expedition_shuttle)
"n" = (
/obj/machinery/door/airlock/grunge,
/turf/open/floor/mineral/titanium/yellow,
/area/shuttle/expedition_shuttle)
"o" = (
/obj/machinery/computer/camera_advanced/shuttle_docker/expedition_shuttle{
	dir = 4
	},
/turf/open/floor/glass/reinforced,
/area/shuttle/expedition_shuttle)
"r" = (
/obj/effect/turf_decal/stripes/line{
	dir = 4
	},
/turf/open/floor/mineral/titanium/yellow,
/area/shuttle/expedition_shuttle)
"s" = (
/obj/structure/closet/crate/internals,
/obj/item/tank/internals/oxygen{
	pixel_x = -3;
	pixel_y = 3
	},
/obj/item/tank/internals/oxygen,
/obj/item/clothing/mask/breath{
	pixel_x = -3;
	pixel_y = 3
	},
/obj/item/clothing/mask/breath,
/obj/item/storage/medkit/regular,
/obj/machinery/button/door{
	id = "Expedition shuttle door";
	name = "Expedition shuttle door";
	pixel_x = -25;
	pixel_y = -5
	},
/obj/machinery/light_switch/directional{
	pixel_x = -25;
	pixel_y = 5
	},
/turf/open/floor/mineral/titanium/yellow,
/area/shuttle/expedition_shuttle)
"u" = (
/turf/open/floor/glass/reinforced,
/area/shuttle/expedition_shuttle)
"v" = (
/obj/structure/rack,
/obj/item/storage/toolbox/emergency,
/obj/item/wrench,
/obj/item/crowbar,
/obj/item/radio,
/obj/item/radio/intercom/directional{
	pixel_x = 30
	},
/turf/open/floor/mineral/titanium/yellow,
/area/shuttle/expedition_shuttle)
"w" = (
/obj/structure/fans/tiny,
/obj/machinery/door/airlock/shuttle{
	name = "Expedition shuttle airlock"
	},
/obj/docking_port/mobile{
	height = 5;
	id = "expedition_shuttle";
	name = "Expedition Shuttle";
	width = 13;
	dir = 4;
	port_direction = 8
	},
/turf/open/floor/mineral/plastitanium,
/area/shuttle/expedition_shuttle)
"x" = (
/turf/open/floor/mineral/titanium/yellow,
/area/shuttle/expedition_shuttle)
"y" = (
/obj/structure/chair/comfy/shuttle{
	dir = 4
	},
/obj/effect/turf_decal/trimline/purple/filled,
/obj/machinery/light/small/directional/west,
/obj/structure/closet/secure_closet/wall{
	pixel_x = -30
	},
/turf/open/floor/mineral/titanium,
/area/shuttle/expedition_shuttle)
"B" = (
/obj/effect/turf_decal/stripes/corner{
	dir = 8
	},
/obj/machinery/power/port_gen/pacman/super,
/obj/machinery/button/door{
	id = "Expedition shuttle left door";
	name = "Expedition shuttle left door";
	pixel_x = -25
	},
/obj/machinery/light/small/directional/north,
/turf/open/floor/mineral/titanium/yellow,
/area/shuttle/expedition_shuttle)
"D" = (
/obj/structure/chair/comfy/shuttle{
	dir = 1
	},
/turf/open/floor/glass/reinforced,
/area/shuttle/expedition_shuttle)
"E" = (
/obj/effect/turf_decal/stripes/line{
	dir = 8
	},
/obj/structure/closet/crate/engineering,
/turf/open/floor/mineral/titanium/yellow,
/area/shuttle/expedition_shuttle)
"F" = (
/turf/open/floor/mineral/titanium,
/area/shuttle/expedition_shuttle)
"G" = (
/obj/effect/turf_decal/stripes/corner,
/obj/structure/closet/crate/radiation,
/obj/item/stack/sheet/mineral/uranium/five,
/obj/machinery/button/door{
	id = "Expedition shuttle right door";
	name = "Expedition shuttle right door";
	pixel_x = 25
	},
/obj/machinery/light/small/directional/north,
/turf/open/floor/mineral/titanium/yellow,
/area/shuttle/expedition_shuttle)
"H" = (
/obj/structure/shuttle/engine/propulsion/burst{
	dir = 8
	},
/turf/open/floor/plating,
/area/shuttle/expedition_shuttle)
"I" = (
/obj/structure/chair/comfy/shuttle{
	dir = 8
	},
/obj/effect/turf_decal/trimline/yellow/filled,
/obj/structure/closet/secure_closet/wall{
	pixel_x = 30
	},
/turf/open/floor/mineral/titanium,
/area/shuttle/expedition_shuttle)
"N" = (
/obj/structure/fans/tiny,
/obj/machinery/door/airlock/shuttle{
	name = "Expedition shuttle airlock"
	},
/turf/open/floor/mineral/plastitanium,
/area/shuttle/expedition_shuttle)
"Q" = (
/obj/effect/turf_decal/stripes/line{
	dir = 8
	},
/obj/structure/closet/crate/science,
/turf/open/floor/mineral/titanium/yellow,
/area/shuttle/expedition_shuttle)
"R" = (
/turf/closed/wall/mineral/titanium/nodiagonal,
/area/shuttle/expedition_shuttle)
"S" = (
/obj/structure/fans/tiny,
/obj/machinery/door/poddoor{
	name = "Expedition shuttle right door";
	id = "Expedition shuttle right door"
	},
/turf/open/floor/mineral/plastitanium,
/area/shuttle/expedition_shuttle)
"W" = (
/obj/machinery/light/small/directional/south,
/turf/open/floor/mineral/titanium/yellow,
/area/shuttle/expedition_shuttle)
"X" = (
/obj/structure/chair/comfy/shuttle{
	dir = 8
	},
/obj/effect/turf_decal/trimline/blue/filled,
/obj/machinery/light/small/directional/east,
/obj/structure/closet/secure_closet/wall{
	pixel_x = 30
	},
/turf/open/floor/mineral/titanium,
/area/shuttle/expedition_shuttle)
"Y" = (
/obj/structure/chair/comfy/shuttle{
	dir = 4
	},
/obj/effect/turf_decal/trimline/darkblue/filled,
/obj/structure/closet/secure_closet/wall{
	pixel_x = -30
	},
/turf/open/floor/mineral/titanium,
/area/shuttle/expedition_shuttle)

(1,1,1) = {"
a
e
a
a
w
a
H
a
j
j
j
R
a
"}
(2,1,1) = {"
e
o
Y
y
F
s
a
B
Q
l
E
a
g
"}
(3,1,1) = {"
e
D
u
u
F
x
n
x
x
x
W
a
c
"}
(4,1,1) = {"
e
m
I
X
F
v
a
G
h
r
h
a
b
"}
(5,1,1) = {"
a
e
a
a
N
a
d
a
S
S
S
R
a
"}
