//MAP CONVERTED BY dmm2tgm.py THIS HEADER COMMENT PREVENTS RECONVERSION, DO NOT REMOVE
"a" = (
/turf/closed/mineral/random,
/area/ruin/space/has_grav)
"r" = (
/turf/closed/mineral/random/high_chance,
/area/ruin/space/has_grav)
"F" = (
/turf/template_noop,
/area/template_noop)
"G" = (
/obj/effect/turf_decal/sand/plating,
/turf/open/floor/plating/airless,
/area/ruin/space/has_grav)
"J" = (
/turf/open/misc/asteroid/airless,
/area/ruin/space/has_grav)
"P" = (
/obj/modular_map_connector,
/turf/template_noop,
/area/template_noop)

(1,1,1) = {"
r
r
a
F
F
F
F
F
a
r
r
r
r
r
a
a
a
"}
(2,1,1) = {"
r
a
a
F
F
F
F
F
a
r
r
r
r
r
r
r
r
"}
(3,1,1) = {"
a
a
r
F
F
P
F
F
r
r
r
r
r
r
r
r
r
"}
(4,1,1) = {"
a
r
a
J
G
G
G
J
r
r
r
r
r
r
r
r
a
"}
(5,1,1) = {"
r
r
a
J
J
J
J
J
r
r
r
r
r
r
r
r
r
"}
(6,1,1) = {"
a
a
r
r
J
J
J
a
r
r
r
r
r
r
r
r
r
"}
(7,1,1) = {"
r
a
r
a
r
a
a
r
r
r
r
r
r
r
r
r
r
"}
(8,1,1) = {"
r
a
r
a
r
r
a
r
r
r
r
r
r
r
r
r
r
"}
(9,1,1) = {"
r
a
a
a
a
r
a
r
r
r
r
r
r
r
r
r
a
"}
(10,1,1) = {"
r
r
a
r
a
r
r
r
r
r
r
r
r
r
r
r
r
"}
(11,1,1) = {"
a
a
a
r
a
r
a
r
r
r
r
r
r
r
r
r
r
"}
(12,1,1) = {"
a
a
r
r
a
a
a
a
r
r
r
a
a
a
r
r
r
"}
(13,1,1) = {"
r
r
r
a
a
a
a
r
r
r
a
r
r
a
a
a
r
"}
