//MAP CONVERTED BY dmm2tgm.py THIS HEADER COMMENT PREVENTS RECONVERSION, DO NOT REMOVE
"a" = (
/obj/structure/bed/double,
/obj/effect/spawner/random/bedsheet/double,
/turf/open/floor/carpet/royalblack,
/area/template_noop)
"b" = (
/obj/structure/closet/cabinet,
/obj/effect/spawner/random/food_or_drink/booze,
/obj/effect/spawner/random/food_or_drink/booze,
/obj/effect/spawner/random/food_or_drink/booze,
/obj/effect/spawner/random/food_or_drink/booze,
/obj/effect/spawner/random/food_or_drink/booze,
/obj/effect/spawner/random/food_or_drink/booze,
/obj/effect/spawner/random/food_or_drink/booze,
/obj/effect/spawner/random/food_or_drink/booze,
/obj/effect/spawner/random/food_or_drink/booze,
/obj/effect/spawner/random/food_or_drink/booze,
/obj/machinery/light/directional/west,
/turf/open/floor/wood/parquet,
/area/template_noop)
"c" = (
/obj/structure/cable,
/obj/structure/closet/secure_closet/freezer/fridge/all_access,
/obj/effect/spawner/random/food_or_drink/three_course_meal,
/obj/effect/spawner/random/food_or_drink/three_course_meal,
/obj/machinery/power/apc/auto_name/directional/west,
/obj/effect/mapping_helpers/apc/full_charge,
/obj/effect/mapping_helpers/apc/unlocked,
/obj/effect/spawner/random/food_or_drink/three_course_meal,
/turf/open/floor/wood/parquet,
/area/template_noop)
"d" = (
/obj/structure/curtain/bounty,
/turf/open/floor/carpet/royalblack,
/area/template_noop)
"e" = (
/obj/machinery/airalarm/directional/east,
/obj/effect/mapping_helpers/airalarm/all_access,
/turf/open/floor/carpet/royalblue,
/area/template_noop)
"g" = (
/obj/machinery/atmospherics/components/unary/vent_pump/on/layer4{
	dir = 1
	},
/turf/open/floor/wood/parquet,
/area/template_noop)
"o" = (
/obj/machinery/light_switch/directional/east,
/turf/open/floor/wood/parquet,
/area/template_noop)
"q" = (
/obj/machinery/atmospherics/components/unary/vent_scrubber/on/layer2{
	dir = 8
	},
/turf/open/floor/carpet/royalblue,
/area/template_noop)
"r" = (
/obj/effect/spawner/random/structure/chair_comfy{
	dir = 1
	},
/obj/machinery/firealarm/directional/east,
/turf/open/floor/carpet/royalblue,
/area/template_noop)
"s" = (
/obj/machinery/atmospherics/pipe/smart/manifold4w/supply/hidden/layer4,
/obj/machinery/atmospherics/pipe/smart/manifold4w/scrubbers/hidden/layer2,
/turf/open/floor/wood/parquet,
/area/template_noop)
"t" = (
/obj/structure/fireplace,
/turf/open/floor/stone,
/area/template_noop)
"x" = (
/obj/modular_map_connector,
/obj/structure/cable,
/obj/machinery/atmospherics/pipe/smart/manifold4w/supply/hidden/layer4,
/obj/machinery/atmospherics/pipe/smart/manifold4w/scrubbers/hidden/layer2,
/turf/open/floor/wood/parquet,
/area/template_noop)
"z" = (
/turf/open/floor/wood/parquet,
/area/template_noop)
"A" = (
/obj/structure/extinguisher_cabinet/directional/north,
/obj/item/grown/log/tree,
/obj/item/grown/log/tree,
/obj/item/grown/log/tree,
/obj/item/grown/log/tree,
/obj/item/grown/log/tree,
/turf/open/floor/stone,
/area/template_noop)
"B" = (
/obj/structure/curtain/bounty/start_closed,
/turf/open/floor/carpet/royalblack,
/area/template_noop)
"D" = (
/obj/effect/spawner/random/structure/table_fancy,
/obj/effect/spawner/random/food_or_drink/booze,
/obj/effect/spawner/random/food_or_drink/booze,
/turf/open/floor/carpet/royalblue,
/area/template_noop)
"E" = (
/obj/machinery/atmospherics/components/unary/vent_pump/on/layer4{
	dir = 4
	},
/turf/open/floor/wood/parquet,
/area/template_noop)
"F" = (
/obj/machinery/light/directional/east,
/turf/open/floor/wood/parquet,
/area/template_noop)
"G" = (
/obj/item/hatchet/wooden,
/obj/machinery/airalarm/directional/north,
/obj/effect/mapping_helpers/airalarm/all_access,
/turf/open/floor/stone,
/area/template_noop)
"I" = (
/obj/machinery/atmospherics/pipe/smart/manifold4w/supply/hidden/layer4,
/obj/machinery/atmospherics/pipe/smart/manifold4w/scrubbers/hidden/layer2,
/obj/effect/spawner/random/structure/chair_comfy{
	dir = 1
	},
/turf/open/floor/carpet/royalblue,
/area/template_noop)
"K" = (
/obj/machinery/firealarm/directional/north,
/turf/open/floor/wood/parquet,
/area/template_noop)
"N" = (
/obj/structure/cable,
/obj/machinery/firealarm/directional/west,
/obj/machinery/vending/clothing,
/turf/open/floor/wood/parquet,
/area/template_noop)
"O" = (
/obj/machinery/atmospherics/components/unary/vent_scrubber/on/layer2{
	dir = 1
	},
/obj/machinery/airalarm/directional/west,
/obj/effect/mapping_helpers/airalarm/all_access,
/turf/open/floor/wood/parquet,
/area/template_noop)
"Y" = (
/obj/machinery/atmospherics/pipe/smart/manifold4w/supply/hidden/layer4,
/obj/machinery/atmospherics/pipe/smart/manifold4w/scrubbers/hidden/layer2,
/turf/open/floor/carpet/royalblue,
/area/template_noop)

(1,1,1) = {"
b
c
N
x
O
d
a
"}
(2,1,1) = {"
K
E
z
s
z
B
B
"}
(3,1,1) = {"
G
Y
I
s
g
d
a
"}
(4,1,1) = {"
t
q
D
z
z
B
B
"}
(5,1,1) = {"
A
e
r
o
F
d
a
"}
