//MAP CONVERTED BY dmm2tgm.py THIS HEADER COMMENT PREVENTS RECONVERSION, DO NOT REMOVE
"a" = (
/obj/machinery/firealarm/directional/south{
	pixel_y = -31
	},
/obj/structure/chair/plastic{
	dir = 4
	},
/turf/open/floor/wood/large,
/area/template_noop)
"c" = (
/obj/machinery/airalarm/directional/west,
/obj/effect/mapping_helpers/airalarm/all_access,
/obj/machinery/atmospherics/components/unary/vent_pump/on/layer4,
/turf/open/floor/carpet/royalblue,
/area/template_noop)
"d" = (
/obj/machinery/door/airlock/wood{
	id_tag = "ptdorm1";
	name = "Private Dorm 1"
	},
/obj/machinery/atmospherics/pipe/smart/manifold4w/supply/hidden/layer4,
/obj/machinery/atmospherics/pipe/smart/manifold4w/scrubbers/hidden/layer2,
/turf/open/floor/carpet/royalblack,
/area/template_noop)
"e" = (
/obj/machinery/airalarm/directional/east,
/obj/effect/mapping_helpers/airalarm/all_access,
/turf/open/floor/wood/large,
/area/template_noop)
"k" = (
/obj/machinery/atmospherics/pipe/smart/manifold4w/supply/hidden/layer4,
/obj/machinery/atmospherics/pipe/smart/manifold4w/scrubbers/hidden/layer2,
/turf/open/floor/wood/large,
/area/template_noop)
"m" = (
/obj/machinery/airalarm/directional/east,
/obj/effect/mapping_helpers/airalarm/all_access,
/obj/machinery/atmospherics/pipe/smart/manifold4w/supply/hidden/layer4,
/obj/machinery/atmospherics/pipe/smart/manifold4w/scrubbers/hidden/layer2,
/turf/open/floor/carpet/royalblack,
/area/template_noop)
"o" = (
/obj/machinery/airalarm/directional/south,
/obj/effect/mapping_helpers/airalarm/all_access,
/obj/machinery/atmospherics/pipe/smart/manifold4w/supply/hidden/layer4,
/obj/machinery/atmospherics/pipe/smart/manifold4w/scrubbers/hidden/layer2,
/turf/open/floor/wood/large,
/area/template_noop)
"q" = (
/obj/machinery/atmospherics/components/unary/vent_scrubber/on/layer2{
	dir = 4
	},
/turf/open/floor/wood/large,
/area/template_noop)
"s" = (
/obj/machinery/button/door/directional/south{
	id = "ptdorm1";
	name = "Door Lock Control";
	normaldoorcontrol = 1;
	specialfunctions = 4
	},
/obj/structure/table/wood/fancy/black,
/obj/machinery/atmospherics/components/unary/vent_scrubber/on/layer2{
	dir = 4
	},
/obj/effect/spawner/random/entertainment/lighter,
/obj/item/bong,
/obj/item/reagent_containers/hash,
/turf/open/floor/carpet/royalblack,
/area/template_noop)
"t" = (
/obj/machinery/atmospherics/pipe/smart/manifold4w/supply/hidden/layer4,
/obj/machinery/atmospherics/pipe/smart/manifold4w/scrubbers/hidden/layer2,
/turf/open/floor/carpet/royalblue,
/area/template_noop)
"w" = (
/obj/structure/cable,
/obj/machinery/atmospherics/pipe/smart/manifold4w/supply/hidden/layer4,
/obj/machinery/atmospherics/pipe/smart/manifold4w/scrubbers/hidden/layer2,
/turf/open/floor/wood/large,
/area/template_noop)
"x" = (
/obj/machinery/button/door/directional/south{
	id = "ptdorm4";
	name = "Door Lock Control";
	normaldoorcontrol = 1;
	specialfunctions = 4
	},
/obj/structure/table/wood/fancy/blue,
/obj/machinery/atmospherics/components/unary/vent_scrubber/on/layer2{
	dir = 8
	},
/obj/item/clothing/cigarette/candy,
/obj/item/clothing/cigarette,
/obj/effect/spawner/random/entertainment/lighter,
/turf/open/floor/carpet/royalblue,
/area/template_noop)
"z" = (
/obj/structure/table/wood/poker,
/obj/item/toy/tennis/yellow,
/obj/machinery/atmospherics/pipe/smart/manifold4w/supply/hidden/layer4,
/obj/machinery/atmospherics/pipe/smart/manifold4w/scrubbers/hidden/layer2,
/turf/open/floor/wood/large,
/area/template_noop)
"B" = (
/obj/structure/bed/double,
/obj/effect/spawner/random/bedsheet/double,
/turf/open/floor/carpet/royalblue,
/area/template_noop)
"D" = (
/turf/closed/wall,
/area/template_noop)
"G" = (
/turf/open/floor/wood/large,
/area/template_noop)
"I" = (
/obj/machinery/atmospherics/components/unary/vent_pump/on/layer4{
	dir = 4
	},
/turf/open/floor/wood/large,
/area/template_noop)
"J" = (
/obj/structure/chair/plastic,
/obj/machinery/firealarm/directional/east,
/turf/open/floor/wood/large,
/area/template_noop)
"L" = (
/obj/machinery/power/apc/auto_name/directional/north,
/obj/effect/mapping_helpers/apc/full_charge,
/obj/effect/mapping_helpers/apc/unlocked,
/obj/structure/cable,
/obj/machinery/atmospherics/pipe/smart/manifold4w/supply/hidden/layer4,
/obj/machinery/atmospherics/pipe/smart/manifold4w/scrubbers/hidden/layer2,
/turf/open/floor/wood/large,
/area/template_noop)
"M" = (
/obj/machinery/vending/clothing,
/turf/open/floor/wood/large,
/area/template_noop)
"N" = (
/obj/structure/table/wood/poker,
/turf/open/floor/wood/large,
/area/template_noop)
"O" = (
/obj/machinery/light_switch/directional/north,
/obj/structure/cable,
/obj/machinery/atmospherics/pipe/smart/manifold4w/supply/hidden/layer4,
/obj/machinery/atmospherics/pipe/smart/manifold4w/scrubbers/hidden/layer2,
/obj/modular_map_connector,
/turf/open/floor/wood/large,
/area/template_noop)
"P" = (
/obj/structure/chair/plastic{
	dir = 4
	},
/turf/open/floor/wood/large,
/area/template_noop)
"R" = (
/obj/machinery/atmospherics/components/unary/vent_pump/on/layer4,
/turf/open/floor/carpet/royalblack,
/area/template_noop)
"S" = (
/obj/structure/table/wood/poker,
/obj/item/reagent_containers/cup/glass/bottle/ale{
	pixel_x = -5;
	pixel_y = 4
	},
/obj/item/reagent_containers/cup/glass/bottle/ale{
	pixel_y = 7
	},
/obj/item/reagent_containers/cup/glass/bottle/ale{
	pixel_x = 6;
	pixel_y = 11
	},
/obj/item/reagent_containers/cup/glass/bottle/ale{
	pixel_x = 6;
	pixel_y = 4
	},
/obj/item/reagent_containers/cup/glass/bottle/ale{
	pixel_x = 6;
	pixel_y = -4
	},
/obj/item/reagent_containers/cup/glass/bottle/ale,
/turf/open/floor/wood/large,
/area/template_noop)
"T" = (
/obj/machinery/door/airlock/wood{
	id_tag = "ptdorm4";
	name = "Couples Suite"
	},
/obj/machinery/atmospherics/pipe/smart/manifold4w/supply/hidden/layer4,
/obj/machinery/atmospherics/pipe/smart/manifold4w/scrubbers/hidden/layer2,
/turf/open/floor/carpet/royalblue,
/area/template_noop)
"V" = (
/obj/structure/chair/plastic{
	dir = 8
	},
/turf/open/floor/wood/large,
/area/template_noop)
"W" = (
/obj/machinery/atmospherics/components/unary/vent_scrubber/on/layer2{
	dir = 8
	},
/turf/open/floor/wood/large,
/area/template_noop)
"Y" = (
/obj/structure/bed/double{
	dir = 1
	},
/obj/effect/spawner/random/bedsheet/double{
	dir = 1
	},
/turf/open/floor/carpet/royalblack,
/area/template_noop)
"Z" = (
/obj/machinery/atmospherics/components/unary/vent_pump/on/layer4{
	dir = 8
	},
/turf/open/floor/wood/large,
/area/template_noop)

(1,1,1) = {"
Y
s
D
O
P
G
a
"}
(2,1,1) = {"
R
m
d
w
I
N
q
"}
(3,1,1) = {"
D
D
D
L
k
z
o
"}
(4,1,1) = {"
c
t
T
k
W
S
Z
"}
(5,1,1) = {"
B
x
D
M
J
e
V
"}
