//MAP CONVERTED BY dmm2tgm.py THIS HEADER COMMENT PREVENTS RECONVERSION, DO NOT REMOVE
"a" = (
/obj/structure/table/wood,
/obj/item/flashlight/lamp,
/obj/effect/spawner/random/clothing/beret_or_rabbitears,
/turf/open/floor/carpet/cyan,
/area/template_noop)
"c" = (
/obj/structure/bed/double/pod,
/obj/item/bedsheet/random/double,
/obj/machinery/button/door/directional/north{
	id = "ptdorm4";
	name = "Door Lock Control";
	normaldoorcontrol = 1;
	specialfunctions = 4
	},
/obj/machinery/atmospherics/components/unary/vent_scrubber/on/layer2{
	dir = 8
	},
/turf/open/floor/carpet/red,
/area/template_noop)
"f" = (
/obj/machinery/atmospherics/components/unary/vent_pump/on/layer4{
	dir = 1
	},
/turf/open/floor/carpet/cyan,
/area/template_noop)
"k" = (
/obj/machinery/airalarm/directional/east,
/obj/effect/mapping_helpers/airalarm/all_access,
/obj/machinery/atmospherics/pipe/smart/manifold4w/scrubbers/hidden/layer2,
/obj/machinery/atmospherics/pipe/smart/manifold4w/supply/hidden/layer4,
/turf/open/floor/carpet/purple,
/area/template_noop)
"l" = (
/obj/machinery/door/airlock/wood{
	id_tag = "ptdorm4";
	name = "Couples Suite"
	},
/obj/machinery/door/firedoor/solid,
/obj/machinery/atmospherics/pipe/smart/manifold4w/scrubbers/hidden/layer2,
/obj/machinery/atmospherics/pipe/smart/manifold4w/supply/hidden/layer4,
/turf/open/floor/wood/large,
/area/template_noop)
"m" = (
/obj/structure/bed/pod{
	dir = 1
	},
/obj/item/bedsheet/random{
	dir = 1
	},
/obj/machinery/button/door/directional/south{
	id = "ptdorm1";
	name = "Door Lock Control";
	normaldoorcontrol = 1;
	specialfunctions = 4
	},
/obj/machinery/atmospherics/components/unary/vent_scrubber/on/layer2{
	dir = 4
	},
/turf/open/floor/carpet/purple,
/area/template_noop)
"o" = (
/obj/structure/table/wood,
/obj/item/flashlight/lamp/bananalamp,
/obj/effect/spawner/random/clothing/funny_hats,
/turf/open/floor/carpet/purple,
/area/template_noop)
"q" = (
/obj/machinery/light_switch/directional/north,
/obj/machinery/firealarm/directional/south{
	pixel_y = -31
	},
/obj/modular_map_connector,
/obj/structure/cable,
/obj/machinery/atmospherics/pipe/smart/manifold4w/scrubbers/hidden/layer2,
/obj/machinery/atmospherics/pipe/smart/manifold4w/supply/hidden/layer4,
/turf/open/floor/wood/large,
/area/template_noop)
"r" = (
/obj/machinery/atmospherics/components/unary/vent_pump/on/layer4,
/turf/open/floor/carpet/purple,
/area/template_noop)
"t" = (
/obj/machinery/atmospherics/pipe/smart/manifold4w/scrubbers/hidden/layer2,
/obj/machinery/atmospherics/pipe/smart/manifold4w/supply/hidden/layer4,
/turf/open/floor/wood/large,
/area/template_noop)
"y" = (
/obj/machinery/vending/clothing,
/obj/machinery/light/directional/east,
/turf/open/floor/wood/large,
/area/template_noop)
"B" = (
/obj/structure/table/wood,
/obj/item/flashlight/lamp/green,
/obj/effect/spawner/random/clothing/kittyears_or_rabbitears,
/turf/open/floor/carpet/red,
/area/template_noop)
"C" = (
/obj/machinery/airalarm/directional/west,
/obj/effect/mapping_helpers/airalarm/all_access,
/obj/machinery/atmospherics/components/unary/vent_pump/on/layer4,
/turf/open/floor/carpet/black,
/area/template_noop)
"D" = (
/obj/machinery/airalarm/directional/east,
/obj/effect/mapping_helpers/airalarm/all_access,
/obj/machinery/atmospherics/pipe/smart/manifold4w/scrubbers/hidden/layer2,
/obj/machinery/atmospherics/pipe/smart/manifold4w/supply/hidden/layer4,
/turf/open/floor/carpet/cyan,
/area/template_noop)
"E" = (
/obj/structure/bed/pod{
	dir = 1
	},
/obj/item/bedsheet/random{
	dir = 1
	},
/obj/machinery/button/door/directional/north{
	id = "ptdorm2";
	name = "Door Lock Control";
	normaldoorcontrol = 1;
	specialfunctions = 4
	},
/obj/machinery/atmospherics/components/unary/vent_scrubber/on/layer2{
	dir = 4
	},
/turf/open/floor/carpet/cyan,
/area/template_noop)
"G" = (
/turf/closed/wall,
/area/template_noop)
"H" = (
/obj/machinery/power/apc/auto_name/directional/north,
/obj/effect/mapping_helpers/apc/full_charge,
/obj/effect/mapping_helpers/apc/unlocked,
/obj/machinery/airalarm/directional/south,
/obj/effect/mapping_helpers/airalarm/all_access,
/obj/structure/cable,
/obj/machinery/atmospherics/pipe/smart/manifold4w/scrubbers/hidden/layer2,
/obj/machinery/atmospherics/pipe/smart/manifold4w/supply/hidden/layer4,
/turf/open/floor/wood/large,
/area/template_noop)
"K" = (
/obj/machinery/door/airlock/wood{
	id_tag = "ptdorm1";
	name = "Private Dorm 1"
	},
/obj/machinery/door/firedoor/solid,
/obj/machinery/atmospherics/pipe/smart/manifold4w/scrubbers/hidden/layer2,
/obj/machinery/atmospherics/pipe/smart/manifold4w/supply/hidden/layer4,
/turf/open/floor/wood/large,
/area/template_noop)
"N" = (
/obj/structure/cable,
/obj/machinery/atmospherics/pipe/smart/manifold4w/scrubbers/hidden/layer2,
/obj/machinery/atmospherics/pipe/smart/manifold4w/supply/hidden/layer4,
/turf/open/floor/wood/large,
/area/template_noop)
"R" = (
/obj/machinery/atmospherics/pipe/smart/manifold4w/scrubbers/hidden/layer2,
/obj/machinery/atmospherics/pipe/smart/manifold4w/supply/hidden/layer4,
/turf/open/floor/carpet/black,
/area/template_noop)
"T" = (
/obj/machinery/door/airlock/wood{
	id_tag = "ptdorm2";
	name = "Private Dorm 2"
	},
/obj/machinery/door/firedoor/solid,
/obj/machinery/atmospherics/pipe/smart/manifold4w/scrubbers/hidden/layer2,
/obj/machinery/atmospherics/pipe/smart/manifold4w/supply/hidden/layer4,
/turf/open/floor/wood/large,
/area/template_noop)
"U" = (
/obj/machinery/atmospherics/pipe/smart/manifold4w/scrubbers/hidden/layer2,
/obj/machinery/atmospherics/pipe/smart/manifold4w/supply/hidden/layer4,
/turf/open/floor/carpet/red,
/area/template_noop)
"W" = (
/obj/structure/bed/pod,
/obj/item/bedsheet/random,
/obj/machinery/button/door/directional/south{
	id = "ptdorm3";
	name = "Door Lock Control";
	normaldoorcontrol = 1;
	specialfunctions = 4
	},
/obj/machinery/atmospherics/components/unary/vent_scrubber/on/layer2{
	dir = 8
	},
/turf/open/floor/carpet/black,
/area/template_noop)
"X" = (
/obj/structure/table/wood,
/obj/item/flashlight/lamp/green,
/obj/effect/spawner/random/clothing/costume,
/turf/open/floor/carpet/black,
/area/template_noop)
"Y" = (
/obj/machinery/airalarm/directional/west,
/obj/effect/mapping_helpers/airalarm/all_access,
/obj/machinery/atmospherics/components/unary/vent_pump/on/layer4{
	dir = 1
	},
/turf/open/floor/carpet/red,
/area/template_noop)
"Z" = (
/obj/machinery/door/airlock/wood{
	id_tag = "ptdorm3";
	name = "Private Dorm 3"
	},
/obj/machinery/door/firedoor/solid,
/obj/machinery/atmospherics/pipe/smart/manifold4w/scrubbers/hidden/layer2,
/obj/machinery/atmospherics/pipe/smart/manifold4w/supply/hidden/layer4,
/turf/open/floor/wood/large,
/area/template_noop)

(1,1,1) = {"
o
m
G
q
G
E
a
"}
(2,1,1) = {"
r
k
K
N
T
D
f
"}
(3,1,1) = {"
G
G
G
H
G
G
G
"}
(4,1,1) = {"
C
R
Z
t
l
U
Y
"}
(5,1,1) = {"
X
W
G
y
G
c
B
"}
