//MAP CONVERTED BY dmm2tgm.py THIS HEADER COMMENT PREVENTS RECONVERSION, DO NOT REMOVE
"a" = (
/obj/structure/bed/double,
/obj/item/bedsheet/dorms_double,
/turf/open/floor/wood/parquet,
/area/template_noop)
"c" = (
/obj/machinery/airalarm/directional/east,
/obj/effect/mapping_helpers/airalarm/all_access,
/turf/open/floor/carpet/royalblue,
/area/template_noop)
"i" = (
/obj/machinery/atmospherics/pipe/smart/manifold4w/supply/hidden/layer4,
/obj/machinery/atmospherics/pipe/smart/manifold4w/scrubbers/hidden/layer2,
/obj/effect/spawner/random/structure/chair_comfy{
	dir = 1
	},
/turf/open/floor/carpet/royalblue,
/area/template_noop)
"l" = (
/obj/structure/cable,
/obj/structure/closet/secure_closet/freezer/fridge/all_access,
/obj/effect/spawner/random/food_or_drink/three_course_meal,
/obj/effect/spawner/random/food_or_drink/three_course_meal,
/obj/effect/spawner/random/food_or_drink/three_course_meal,
/obj/effect/spawner/random/food_or_drink/three_course_meal,
/obj/effect/spawner/random/food_or_drink/three_course_meal,
/obj/machinery/power/apc/auto_name/directional/west,
/obj/effect/mapping_helpers/apc/full_charge,
/obj/effect/mapping_helpers/apc/unlocked,
/turf/open/floor/wood/parquet,
/area/template_noop)
"n" = (
/obj/machinery/atmospherics/pipe/smart/manifold4w/supply/hidden/layer4,
/obj/machinery/atmospherics/pipe/smart/manifold4w/scrubbers/hidden/layer2,
/obj/machinery/atmospherics/pipe/smart/manifold4w/scrubbers/hidden/layer2,
/turf/open/floor/wood/parquet,
/area/template_noop)
"p" = (
/obj/structure/fireplace,
/turf/open/floor/stone,
/area/template_noop)
"s" = (
/obj/machinery/atmospherics/components/unary/vent_scrubber/on/layer2{
	dir = 8
	},
/turf/open/floor/carpet/royalblue,
/area/template_noop)
"t" = (
/turf/closed/wall,
/area/template_noop)
"w" = (
/obj/machinery/atmospherics/components/unary/vent_scrubber/on/layer2{
	dir = 1
	},
/obj/machinery/airalarm/directional/west,
/obj/effect/mapping_helpers/airalarm/all_access,
/turf/open/floor/wood/parquet,
/area/template_noop)
"y" = (
/obj/item/hatchet/wooden,
/obj/machinery/airalarm/directional/north,
/obj/effect/mapping_helpers/airalarm/all_access,
/turf/open/floor/stone,
/area/template_noop)
"z" = (
/obj/structure/cable,
/obj/machinery/firealarm/directional/west,
/turf/open/floor/wood/parquet,
/area/template_noop)
"A" = (
/obj/modular_map_connector,
/obj/structure/cable,
/obj/machinery/atmospherics/pipe/smart/manifold4w/supply/hidden/layer4,
/obj/machinery/atmospherics/pipe/smart/manifold4w/scrubbers/hidden/layer2,
/turf/open/floor/wood/parquet,
/area/template_noop)
"D" = (
/obj/effect/spawner/random/structure/chair_comfy{
	dir = 1
	},
/obj/machinery/firealarm/directional/east,
/turf/open/floor/carpet/royalblue,
/area/template_noop)
"F" = (
/obj/structure/curtain/cloth,
/turf/open/floor/wood/parquet,
/area/template_noop)
"G" = (
/obj/machinery/atmospherics/pipe/smart/manifold4w/supply/hidden/layer4,
/obj/machinery/atmospherics/pipe/smart/manifold4w/scrubbers/hidden/layer2,
/turf/open/floor/wood/parquet,
/area/template_noop)
"J" = (
/obj/machinery/firealarm/directional/north,
/turf/open/floor/wood/parquet,
/area/template_noop)
"K" = (
/obj/machinery/atmospherics/components/unary/vent_pump/on/layer4{
	dir = 4
	},
/turf/open/floor/wood/parquet,
/area/template_noop)
"P" = (
/obj/structure/closet/cabinet,
/obj/effect/spawner/random/food_or_drink/booze,
/obj/effect/spawner/random/food_or_drink/booze,
/obj/effect/spawner/random/food_or_drink/booze,
/obj/effect/spawner/random/food_or_drink/booze,
/obj/effect/spawner/random/food_or_drink/booze,
/obj/effect/spawner/random/food_or_drink/booze,
/obj/effect/spawner/random/food_or_drink/booze,
/obj/effect/spawner/random/food_or_drink/booze,
/obj/effect/spawner/random/food_or_drink/booze,
/obj/effect/spawner/random/food_or_drink/booze,
/turf/open/floor/wood/parquet,
/area/template_noop)
"Q" = (
/obj/structure/extinguisher_cabinet/directional/north,
/obj/item/grown/log/tree,
/obj/item/grown/log/tree,
/obj/item/grown/log/tree,
/obj/item/grown/log/tree,
/obj/item/grown/log/tree,
/turf/open/floor/stone,
/area/template_noop)
"R" = (
/obj/machinery/atmospherics/pipe/smart/manifold4w/supply/hidden/layer4,
/obj/machinery/atmospherics/pipe/smart/manifold4w/scrubbers/hidden/layer2,
/turf/open/floor/carpet/royalblue,
/area/template_noop)
"S" = (
/obj/machinery/atmospherics/components/unary/vent_pump/on/layer4{
	dir = 1
	},
/turf/open/floor/wood/parquet,
/area/template_noop)
"V" = (
/turf/open/floor/wood/parquet,
/area/template_noop)
"W" = (
/obj/effect/spawner/random/structure/table_fancy,
/obj/effect/spawner/random/food_or_drink/booze,
/obj/effect/spawner/random/food_or_drink/booze,
/turf/open/floor/carpet/royalblue,
/area/template_noop)

(1,1,1) = {"
P
l
z
A
w
F
a
"}
(2,1,1) = {"
J
K
V
G
V
t
t
"}
(3,1,1) = {"
y
R
i
n
S
F
a
"}
(4,1,1) = {"
p
s
W
V
V
t
t
"}
(5,1,1) = {"
Q
c
D
V
V
F
a
"}
