//MAP CONVERTED BY dmm2tgm.py THIS HEADER COMMENT PREVENTS RECONVERSION, DO NOT REMOVE
"a" = (
/turf/template_noop,
/area/template_noop)
"f" = (
/obj/machinery/door/window/brigdoor/right/directional/south,
/turf/template_noop,
/area/template_noop)
"o" = (
/obj/structure/window/reinforced/spawner/directional/north,
/obj/structure/window/reinforced/spawner/directional/east,
/turf/template_noop,
/area/template_noop)
"v" = (
/obj/structure/window/reinforced/spawner/directional/north,
/turf/template_noop,
/area/template_noop)
"z" = (
/obj/structure/window/reinforced/spawner/directional/south,
/obj/structure/window/reinforced/spawner/directional/east,
/turf/template_noop,
/area/template_noop)
"I" = (
/obj/structure/window/reinforced/spawner/directional/south,
/turf/template_noop,
/area/template_noop)
"K" = (
/obj/machinery/door/window/brigdoor/right/directional/north,
/turf/template_noop,
/area/template_noop)
"Q" = (
/obj/structure/window/reinforced/spawner/directional/east,
/turf/template_noop,
/area/template_noop)
"S" = (
/obj/modular_map_connector,
/turf/template_noop,
/area/template_noop)

(1,1,1) = {"
a
I
S
v
a
"}
(2,1,1) = {"
a
I
a
v
a
"}
(3,1,1) = {"
a
f
a
K
a
"}
(4,1,1) = {"
Q
z
a
o
Q
"}
(5,1,1) = {"
a
I
a
v
a
"}
(6,1,1) = {"
a
f
a
K
a
"}
(7,1,1) = {"
a
I
a
v
a
"}
(8,1,1) = {"
a
I
a
v
a
"}
