//MAP CONVERTED BY dmm2tgm.py THIS HEADER COMMENT PREVENTS RECONVERSION, DO NOT REMOVE
"a" = (
/turf/template_noop,
/area/space)
"c" = (
/obj/structure/window/reinforced{
	dir = 1
	},
/obj/structure/window/reinforced{
	dir = 4
	},
/turf/template_noop,
/area/space)
"k" = (
/obj/structure/window/reinforced{
	dir = 4
	},
/turf/template_noop,
/area/space)
"l" = (
/obj/machinery/door/window/brigdoor/right/directional/north,
/turf/template_noop,
/area/space)
"u" = (
/obj/structure/window/reinforced,
/obj/structure/window/reinforced{
	dir = 4
	},
/turf/template_noop,
/area/space)
"x" = (
/obj/structure/window/reinforced{
	dir = 1
	},
/turf/template_noop,
/area/space)
"H" = (
/obj/machinery/door/window/brigdoor/right/directional/south,
/turf/template_noop,
/area/space)
"J" = (
/obj/structure/window/reinforced,
/turf/template_noop,
/area/space)
"X" = (
/obj/effect/mob_spawn/corpse/facehugger,
/obj/structure/alien/egg/burst,
/turf/template_noop,
/area/space)

(1,1,1) = {"
a
J
a
x
a
"}
(2,1,1) = {"
a
J
a
x
a
"}
(3,1,1) = {"
a
H
a
l
a
"}
(4,1,1) = {"
k
u
a
c
k
"}
(5,1,1) = {"
a
J
a
x
a
"}
(6,1,1) = {"
X
H
a
l
a
"}
(7,1,1) = {"
a
J
a
x
a
"}
(8,1,1) = {"
a
J
a
x
a
"}
