//MAP CONVERTED BY dmm2tgm.py THIS HEADER COMMENT PREVENTS RECONVERSION, DO NOT REMOVE
"a" = (
/turf/template_noop,
/area/template_noop)
"c" = (
/obj/structure/alien/resin/wall,
/turf/template_noop,
/area/template_noop)
"k" = (
/obj/structure/spawner/tarkon_xenos/minor,
/turf/template_noop,
/area/template_noop)
"l" = (
/obj/structure/window/reinforced/spawner/directional/north,
/obj/structure/alien/resin/wall,
/turf/template_noop,
/area/template_noop)
"m" = (
/obj/machinery/door/window/brigdoor/right/directional/north,
/turf/template_noop,
/area/template_noop)
"p" = (
/obj/structure/alien/weeds/node,
/obj/structure/alien/resin/wall,
/turf/template_noop,
/area/template_noop)
"u" = (
/obj/structure/window/reinforced/spawner/directional/south,
/turf/template_noop,
/area/template_noop)
"w" = (
/obj/structure/alien/weeds,
/turf/template_noop,
/area/template_noop)
"x" = (
/obj/structure/window/reinforced/spawner/directional/north,
/turf/template_noop,
/area/template_noop)
"B" = (
/obj/structure/window/reinforced/spawner/directional/south,
/obj/structure/window/reinforced/spawner/directional/east,
/turf/template_noop,
/area/template_noop)
"C" = (
/obj/effect/mob_spawn/corpse/facehugger,
/obj/structure/alien/egg/burst,
/turf/template_noop,
/area/template_noop)
"D" = (
/obj/structure/window/reinforced/spawner/directional/north,
/obj/structure/window/reinforced/spawner/directional/east,
/turf/template_noop,
/area/template_noop)
"H" = (
/obj/structure/window/reinforced/spawner/directional/south,
/obj/structure/alien/resin/wall,
/turf/template_noop,
/area/template_noop)
"J" = (
/obj/machinery/door/window/brigdoor/right/directional/south,
/turf/template_noop,
/area/template_noop)
"L" = (
/obj/modular_map_connector,
/obj/structure/alien/resin/wall,
/obj/structure/alien/weeds,
/turf/template_noop,
/area/template_noop)
"O" = (
/obj/structure/alien/weeds/node,
/turf/template_noop,
/area/template_noop)
"Q" = (
/obj/structure/window/reinforced/spawner/directional/south,
/obj/structure/alien/weeds/node,
/turf/template_noop,
/area/template_noop)
"X" = (
/obj/structure/window/reinforced/spawner/directional/east,
/turf/template_noop,
/area/template_noop)
"Z" = (
/obj/machinery/door/window/brigdoor/right/directional/north,
/obj/structure/alien/weeds/node,
/turf/template_noop,
/area/template_noop)

(1,1,1) = {"
a
a
w
a
a
"}
(2,1,1) = {"
a
a
O
a
a
"}
(3,1,1) = {"
c
H
L
l
p
"}
(4,1,1) = {"
a
u
a
x
k
"}
(5,1,1) = {"
a
J
a
Z
a
"}
(6,1,1) = {"
X
B
a
D
X
"}
(7,1,1) = {"
a
Q
a
x
a
"}
(8,1,1) = {"
C
J
a
m
a
"}
(9,1,1) = {"
k
u
a
x
a
"}
(10,1,1) = {"
O
u
a
x
a
"}
