//MAP CONVERTED BY dmm2tgm.py THIS HEADER COMMENT PREVENTS RECONVERSION, DO NOT REMOVE
"ab" = (
/obj/structure/bed,
/obj/structure/curtain,
/obj/item/instrument/guitar,
/turf/open/floor/iron/icemoon,
/area/ruin/unpowered)
"al" = (
/obj/structure/spider/stickyweb,
/turf/open/floor/plating/icemoon,
/area/ruin/unpowered)
"aA" = (
/obj/structure/fluff/empty_sleeper/syndicate{
	dir = 4
	},
/turf/open/floor/plating/icemoon,
/area/ruin/unpowered)
"aQ" = (
/mob/living/simple_animal/hostile/vatbeast,
/turf/open/floor/iron/dark,
/area/ruin/unpowered)
"bb" = (
/obj/structure/table,
/obj/structure/spider/stickyweb,
/turf/open/floor/plating/icemoon,
/area/ruin/unpowered)
"ct" = (
/obj/structure/table,
/obj/item/clothing/under/chameleon/broken,
/turf/open/floor/iron/dark,
/area/ruin/unpowered)
"dA" = (
/obj/structure/spider/stickyweb,
/mob/living/simple_animal/hostile/giant_spider/hunter/ice,
/turf/open/floor/plating/icemoon,
/area/ruin/unpowered)
"dO" = (
/obj/structure/filingcabinet/chestdrawer,
/obj/structure/spider/stickyweb,
/turf/open/floor/iron/icemoon,
/area/ruin/unpowered)
"ex" = (
/obj/structure/fence/corner{
	dir = 1
	},
/turf/open/floor/plating/asteroid/snow/icemoon,
/area/icemoon/underground/explored)
"fw" = (
/obj/structure/spider/cocoon,
/turf/open/floor/plating/icemoon,
/area/ruin/unpowered)
"fN" = (
/obj/structure/table,
/obj/item/implanter/tracking/gps,
/obj/item/radio,
/turf/open/floor/iron/icemoon,
/area/ruin/unpowered)
"fO" = (
/obj/item/flashlight/seclite,
/turf/open/floor/plating,
/area/ruin/unpowered)
"gc" = (
/obj/structure/decorative/shelf/alcohol_assortment,
/turf/open/floor/iron/icemoon,
/area/ruin/unpowered)
"gi" = (
/obj/structure/fence/corner,
/turf/open/floor/plating/asteroid/snow/icemoon,
/area/icemoon/underground/explored)
"gk" = (
/obj/structure/spider/stickyweb,
/turf/open/floor/iron/icemoon,
/area/ruin/unpowered)
"hg" = (
/obj/structure/mob_spawner/spiders,
/turf/open/floor/iron/icemoon,
/area/ruin/unpowered)
"hI" = (
/obj/structure/bed,
/obj/structure/curtain,
/obj/item/lipstick/random,
/turf/open/floor/iron/icemoon,
/area/ruin/unpowered)
"hK" = (
/obj/structure/showcase/machinery/implanter{
	desc = "What is this stuff? What is the purpose?";
	name = "strange experiment pod"
	},
/turf/open/floor/plating/icemoon,
/area/ruin/unpowered)
"ih" = (
/obj/structure/spider/stickyweb,
/mob/living/simple_animal/hostile/giant_spider,
/turf/open/floor/iron,
/area/ruin/unpowered)
"im" = (
/obj/structure/decorative/shelf/soda_multipacks,
/turf/open/floor/iron/icemoon,
/area/ruin/unpowered)
"iq" = (
/obj/structure/table,
/obj/item/folder/blue,
/obj/item/hand_labeler,
/turf/open/floor/plating/icemoon,
/area/ruin/unpowered)
"iL" = (
/obj/structure/chair/sofa/left,
/turf/open/floor/iron/icemoon,
/area/ruin/unpowered)
"iR" = (
/obj/structure/table,
/obj/item/defibrillator/compact,
/turf/open/floor/plating/icemoon,
/area/ruin/unpowered)
"jr" = (
/obj/structure/showcase/horrific_experiment,
/turf/open/floor/plating/icemoon,
/area/ruin/unpowered)
"js" = (
/obj/structure/showcase/fakesec{
	desc = "Data and information are visible on the screen, but most of it is encrypted or corrupted.";
	dir = 4;
	name = "Research Terminal"
	},
/turf/open/floor/iron/icemoon,
/area/ruin/unpowered)
"jG" = (
/obj/item/shovel,
/turf/open/floor/iron/dark,
/area/ruin/unpowered)
"jO" = (
/obj/item/kirbyplants/random,
/turf/open/floor/iron,
/area/ruin/unpowered)
"ka" = (
/obj/item/kitchen/fork,
/turf/open/floor/iron/icemoon,
/area/ruin/unpowered)
"kj" = (
/obj/structure/fence,
/turf/open/floor/plating/asteroid/snow/icemoon,
/area/icemoon/underground/explored)
"kJ" = (
/obj/structure/table,
/obj/item/clothing/glasses/chameleon/broken,
/turf/open/floor/iron/dark,
/area/ruin/unpowered)
"kX" = (
/obj/item/bear_armor,
/turf/open/floor/plating/asteroid/snow/icemoon,
/area/icemoon/underground/explored)
"lF" = (
/obj/structure/fluff/oldturret,
/turf/open/floor/plating/asteroid/snow/icemoon,
/area/icemoon/underground/explored)
"lL" = (
/obj/structure/geyser/random,
/turf/open/floor/plating/asteroid/snow/icemoon,
/area/icemoon/underground/explored)
"lX" = (
/turf/closed/wall/r_wall/syndicate,
/area/ruin/unpowered)
"mm" = (
/obj/structure/spider/stickyweb,
/turf/open/floor/iron,
/area/ruin/unpowered)
"mr" = (
/obj/structure/mob_spawner/spiders,
/turf/open/floor/iron,
/area/ruin/unpowered)
"mF" = (
/obj/structure/table,
/obj/item/flashlight/slime,
/turf/open/floor/iron/dark,
/area/ruin/unpowered)
"mH" = (
/obj/structure/tank_holder/extinguisher,
/turf/open/floor/plating/icemoon,
/area/ruin/unpowered)
"mY" = (
/obj/structure/table,
/obj/item/crowbar/advanced,
/turf/open/floor/plating/icemoon,
/area/ruin/unpowered)
"nt" = (
/obj/structure/table,
/obj/item/kinetic_crusher,
/turf/open/floor/iron/dark,
/area/ruin/unpowered)
"nv" = (
/obj/item/plate,
/turf/open/floor/iron/icemoon,
/area/ruin/unpowered)
"oh" = (
/obj/structure/table,
/obj/structure/fluff/paper/stack,
/obj/item/laser_pointer,
/obj/item/capturedevice,
/turf/open/floor/plating/icemoon,
/area/ruin/unpowered)
"pf" = (
/obj/structure/frame/computer{
	dir = 4
	},
/turf/open/floor/plating/icemoon,
/area/ruin/unpowered)
"pp" = (
/obj/machinery/door/airlock/highsecurity,
/obj/effect/mapping_helpers/airlock/locked,
/turf/open/floor/iron/dark,
/area/ruin/unpowered)
"qX" = (
/obj/structure/table,
/obj/item/flashlight/lantern,
/turf/open/floor/iron/dark,
/area/ruin/unpowered)
"rb" = (
/obj/machinery/door/airlock/external{
	req_access_txt = "150"
	},
/turf/open/floor/plating,
/area/ruin/unpowered)
"rm" = (
/turf/open/floor/plating,
/area/ruin/unpowered)
"ro" = (
/obj/structure/table,
/obj/structure/fluff/paper/stack{
	dir = 4
	},
/turf/open/floor/plating/icemoon,
/area/ruin/unpowered)
"rs" = (
/mob/living/simple_animal/hostile/russian,
/turf/open/floor/iron/dark,
/area/ruin/unpowered)
"rH" = (
/obj/item/radio,
/turf/open/floor/iron/icemoon,
/area/ruin/unpowered)
"sp" = (
/obj/structure/fence{
	dir = 4
	},
/turf/open/floor/plating/asteroid/snow/icemoon,
/area/icemoon/underground/explored)
"sW" = (
/obj/structure/holosign/barrier,
/turf/open/floor/plating,
/area/ruin/unpowered)
"uj" = (
/obj/structure/spider/stickyweb,
/turf/open/floor/plating,
/area/ruin/unpowered)
"ul" = (
/obj/structure/table,
/obj/item/glassblowing/blowing_rod,
/obj/item/glassblowing/jacks,
/obj/item/glassblowing/paddle,
/obj/item/glassblowing/shears,
/turf/open/floor/plating/icemoon,
/area/ruin/unpowered)
"ux" = (
/obj/structure/spider/cocoon,
/turf/open/floor/iron,
/area/ruin/unpowered)
"uD" = (
/obj/machinery/door/airlock/highsecurity,
/turf/open/floor/iron/dark,
/area/ruin/unpowered)
"uS" = (
/turf/open/genturf,
/area/icemoon/underground/unexplored/rivers)
"vg" = (
/obj/effect/spawner/random/structure/crate_loot,
/turf/open/floor/iron/dark,
/area/ruin/unpowered)
"vZ" = (
/obj/item/poster/random_contraband,
/turf/open/floor/plating/icemoon,
/area/ruin/unpowered)
"xz" = (
/obj/structure/frame/machine,
/turf/open/floor/iron/icemoon,
/area/ruin/unpowered)
"yy" = (
/obj/structure/table,
/obj/item/bodybag/bluespace,
/obj/item/raw_anomaly_core/random,
/turf/open/floor/iron/dark,
/area/ruin/unpowered)
"zo" = (
/obj/structure/bodycontainer{
	dir = 4
	},
/turf/open/floor/plating/icemoon,
/area/ruin/unpowered)
"zu" = (
/obj/structure/spider/stickyweb,
/mob/living/simple_animal/hostile/giant_spider/nurse/ice,
/turf/open/floor/iron/icemoon,
/area/ruin/unpowered)
"zz" = (
/obj/item/fireaxe/boneaxe,
/turf/open/floor/iron,
/area/ruin/unpowered)
"Ac" = (
/turf/open/floor/plating/icemoon,
/area/ruin/unpowered)
"AB" = (
/obj/structure/table,
/obj/item/healthanalyzer/advanced,
/turf/open/floor/iron/icemoon,
/area/ruin/unpowered)
"AS" = (
/obj/machinery/power/floodlight,
/turf/open/floor/plating,
/area/ruin/unpowered)
"Bs" = (
/obj/structure/tank_holder/anesthetic,
/turf/open/floor/plating/icemoon,
/area/ruin/unpowered)
"Ca" = (
/obj/structure/bed,
/obj/structure/curtain,
/obj/item/hairbrush,
/turf/open/floor/iron/icemoon,
/area/ruin/unpowered)
"Cx" = (
/obj/structure/table,
/obj/item/folder,
/obj/item/pen,
/turf/open/floor/plating/icemoon,
/area/ruin/unpowered)
"CY" = (
/obj/structure/table,
/obj/item/aicard/aitater,
/turf/open/floor/iron/dark,
/area/ruin/unpowered)
"Dj" = (
/obj/structure/chair/sofa/right,
/turf/open/floor/iron/icemoon,
/area/ruin/unpowered)
"Ep" = (
/obj/structure/fluff/iced_abductor,
/turf/open/floor/plating/asteroid/snow/icemoon,
/area/icemoon/underground/explored)
"Et" = (
/obj/machinery/door/airlock/hatch,
/obj/effect/mapping_helpers/airlock/abandoned,
/turf/open/floor/iron/dark,
/area/ruin/unpowered)
"Fl" = (
/obj/structure/spider/stickyweb,
/mob/living/simple_animal/hostile/giant_spider/tarantula,
/turf/open/floor/plating,
/area/ruin/unpowered)
"FI" = (
/obj/effect/spawner/random/engineering/canister,
/turf/open/floor/plating,
/area/ruin/unpowered)
"FK" = (
/obj/structure/spider/cocoon,
/turf/open/floor/plating,
/area/ruin/unpowered)
"Gc" = (
/obj/structure/mob_spawner/spiders,
/turf/open/floor/plating/icemoon,
/area/ruin/unpowered)
"Gl" = (
/obj/structure/tank_holder/oxygen/yellow,
/turf/open/floor/iron/dark,
/area/ruin/unpowered)
"Gx" = (
/obj/structure/spider/stickyweb,
/mob/living/simple_animal/hostile/giant_spider/hunter,
/turf/open/floor/iron,
/area/ruin/unpowered)
"GA" = (
/obj/structure/table,
/obj/item/pickaxe/mini,
/turf/open/floor/iron/dark,
/area/ruin/unpowered)
"Ha" = (
/obj/structure/bed,
/obj/structure/curtain,
/obj/item/pillow,
/turf/open/floor/iron/icemoon,
/area/ruin/unpowered)
"Ht" = (
/obj/structure/spider/cocoon,
/turf/open/floor/iron/icemoon,
/area/ruin/unpowered)
"Im" = (
/obj/machinery/door/airlock/highsecurity,
/turf/open/floor/iron/icemoon,
/area/ruin/unpowered)
"Iw" = (
/turf/open/floor/iron/icemoon,
/area/ruin/unpowered)
"JG" = (
/obj/structure/frame/machine,
/turf/open/floor/plating/icemoon,
/area/ruin/unpowered)
"Kq" = (
/obj/structure/table,
/obj/item/coin/diamond,
/turf/open/floor/iron/dark,
/area/ruin/unpowered)
"Kv" = (
/obj/structure/fireplace,
/obj/item/mop,
/turf/open/floor/iron/icemoon,
/area/ruin/unpowered)
"KS" = (
/obj/structure/filingcabinet/chestdrawer,
/turf/open/floor/iron/icemoon,
/area/ruin/unpowered)
"Lz" = (
/obj/structure/decorative/shelf/crates,
/turf/open/floor/plating/icemoon,
/area/ruin/unpowered)
"Mk" = (
/obj/machinery/door/airlock/highsecurity,
/turf/open/floor/plating/icemoon,
/area/ruin/unpowered)
"Mv" = (
/obj/structure/safe,
/obj/item/autosurgeon/organ/cmo,
/turf/open/floor/iron/dark,
/area/ruin/unpowered)
"Nb" = (
/turf/open/floor/plating/asteroid/snow/icemoon,
/area/icemoon/underground/explored)
"Nc" = (
/obj/item/gps/spaceruin,
/turf/open/floor/iron,
/area/ruin/unpowered)
"Nq" = (
/obj/structure/table,
/obj/item/pickaxe,
/turf/open/floor/iron/dark,
/area/ruin/unpowered)
"NO" = (
/obj/item/poster/random_contraband,
/turf/open/floor/iron,
/area/ruin/unpowered)
"Of" = (
/obj/item/inducer,
/turf/open/floor/plating,
/area/ruin/unpowered)
"Ph" = (
/obj/structure/table,
/obj/item/clothing/mask/chameleon/broken,
/turf/open/floor/iron/dark,
/area/ruin/unpowered)
"PP" = (
/obj/item/autosurgeon/organ,
/turf/open/floor/iron/icemoon,
/area/ruin/unpowered)
"Qi" = (
/obj/machinery/door/airlock/vault{
	req_access_txt = "150"
	},
/obj/effect/mapping_helpers/airlock/locked,
/obj/effect/mapping_helpers/airlock/cutaiwire,
/obj/effect/mapping_helpers/airlock/abandoned,
/turf/open/floor/iron/dark,
/area/ruin/unpowered)
"Qn" = (
/obj/structure/table,
/obj/item/binoculars,
/turf/open/floor/iron/dark,
/area/ruin/unpowered)
"QR" = (
/mob/living/simple_animal/hostile/giant_spider/hunter/ice,
/turf/open/floor/iron/icemoon,
/area/ruin/unpowered)
"Rm" = (
/obj/structure/showcase/fakesec{
	desc = "Data and information are visible on the screen, but most of it is encrypted or corrupted.";
	dir = 4;
	name = "Research Terminal"
	},
/turf/open/floor/plating/icemoon,
/area/ruin/unpowered)
"RR" = (
/obj/item/radio,
/turf/open/floor/plating,
/area/ruin/unpowered)
"SV" = (
/mob/living/simple_animal/hostile/giant_spider/hunter/ice,
/turf/open/floor/plating/icemoon,
/area/ruin/unpowered)
"Tb" = (
/obj/machinery/door/airlock/maintenance_hatch,
/turf/open/floor/plating,
/area/ruin/unpowered)
"Te" = (
/obj/item/kirbyplants/random,
/turf/open/floor/iron/dark,
/area/ruin/unpowered)
"Tg" = (
/obj/structure/table,
/obj/item/camera_bug,
/turf/open/floor/iron/dark,
/area/ruin/unpowered)
"TC" = (
/obj/machinery/power/smes,
/turf/open/floor/plating,
/area/ruin/unpowered)
"TL" = (
/obj/structure/table,
/obj/item/shovel,
/turf/open/floor/iron/dark,
/area/ruin/unpowered)
"TQ" = (
/turf/open/floor/iron/dark,
/area/ruin/unpowered)
"Ug" = (
/obj/structure/table,
/obj/item/folder/red,
/obj/item/pen,
/turf/open/floor/iron/dark,
/area/ruin/unpowered)
"Ui" = (
/obj/structure/showcase/machinery/cloning_pod,
/turf/open/floor/plating/icemoon,
/area/ruin/unpowered)
"UZ" = (
/obj/structure/decorative/shelf/crates1,
/turf/open/floor/plating/icemoon,
/area/ruin/unpowered)
"Vk" = (
/obj/structure/table,
/obj/item/radio,
/obj/item/clothing/ears/earmuffs,
/turf/open/floor/iron/dark,
/area/ruin/unpowered)
"Vl" = (
/mob/living/simple_animal/hostile/russian/ranged/officer,
/turf/open/floor/iron/dark,
/area/ruin/unpowered)
"Vt" = (
/obj/structure/showcase/fakesec{
	desc = "Data and information are visible on the screen, but most of it is encrypted or corrupted.";
	dir = 4;
	name = "Research Terminal"
	},
/turf/open/floor/iron/dark,
/area/ruin/unpowered)
"VB" = (
/obj/machinery/door/airlock/highsecurity,
/obj/effect/mapping_helpers/airlock/abandoned,
/obj/effect/mapping_helpers/airlock/locked,
/obj/structure/fans/tiny/invisible,
/turf/open/floor/iron/dark,
/area/ruin/unpowered)
"VO" = (
/obj/structure/decorative/shelf/alcohol,
/turf/open/floor/iron/icemoon,
/area/ruin/unpowered)
"VZ" = (
/obj/structure/filingcabinet,
/turf/open/floor/plating/icemoon,
/area/ruin/unpowered)
"Wq" = (
/obj/structure/tank_holder/extinguisher,
/turf/open/floor/iron,
/area/ruin/unpowered)
"WB" = (
/obj/effect/spawner/random/structure/crate_abandoned,
/turf/open/floor/iron/dark,
/area/ruin/unpowered)
"XK" = (
/turf/open/floor/iron,
/area/ruin/unpowered)
"Yj" = (
/obj/item/extinguisher/advanced,
/turf/open/floor/iron,
/area/ruin/unpowered)
"ZK" = (
/obj/item/pickaxe/emergency,
/turf/open/floor/iron,
/area/ruin/unpowered)

(1,1,1) = {"
uS
uS
uS
uS
uS
uS
kX
uS
uS
uS
uS
uS
uS
uS
uS
uS
uS
uS
uS
uS
uS
uS
uS
uS
uS
uS
uS
uS
uS
uS
uS
uS
uS
"}
(2,1,1) = {"
uS
uS
Nb
uS
Nb
Nb
Nb
Nb
Nb
Nb
Nb
Nb
Nb
uS
uS
uS
Nb
Nb
Nb
Nb
Nb
uS
uS
uS
uS
uS
uS
uS
uS
uS
Nb
uS
uS
"}
(3,1,1) = {"
uS
Nb
Nb
Nb
lX
lX
lX
lX
lX
lX
lX
lX
kj
kj
kj
kj
lX
lX
lX
lX
lX
lX
lX
lX
lX
lX
lX
lX
lX
lX
lX
lX
uS
"}
(4,1,1) = {"
uS
uS
Nb
Nb
rb
sW
rb
TQ
TQ
TQ
Te
lX
Nb
Nb
lL
Nb
lX
Ui
Ui
Ui
jr
jr
Ui
Ui
Ui
jr
jr
jr
aA
aA
aA
lX
uS
"}
(5,1,1) = {"
uS
uS
uS
Nb
lX
lX
lX
Gl
TQ
TQ
TQ
lX
lX
lX
lX
Nb
lX
Rm
bb
oh
ro
Rm
bb
fN
js
js
AB
bb
fw
gk
SV
lX
uS
"}
(6,1,1) = {"
uS
uS
uS
uS
sp
Nb
lX
Gl
TQ
rs
TQ
uD
TQ
TQ
lX
Nb
lX
al
Ac
QR
gk
Iw
Iw
gk
gk
gk
al
Ac
SV
Ac
gk
lX
uS
"}
(7,1,1) = {"
uS
uS
uS
uS
sp
lF
lX
GA
TQ
TQ
TQ
uD
TQ
TQ
lX
Nb
lX
gk
gk
gk
al
Ac
QR
gk
PP
vZ
Ac
gk
gk
al
fw
lX
uS
"}
(8,1,1) = {"
uS
uS
uS
uS
sp
Nb
lX
Qn
TL
TQ
TQ
lX
TQ
TQ
lX
Nb
lX
VZ
VZ
fw
fw
al
al
Bs
hg
Iw
KS
dO
zo
zo
zo
lX
uS
"}
(9,1,1) = {"
uS
ex
kj
kj
gi
Nb
lX
lX
lX
lX
lX
lX
Nq
TQ
lX
Nb
lX
lX
lX
lX
lX
pp
lX
lX
lX
pp
lX
lX
lX
lX
lX
lX
uS
"}
(10,1,1) = {"
uS
sp
kX
Nb
Nb
Nb
sp
Nb
Nb
Nb
Nb
lX
qX
TQ
lX
Nb
lX
jO
rm
mr
mm
mm
ih
XK
Yj
mm
mm
mm
mm
Of
rm
lX
uS
"}
(11,1,1) = {"
uS
sp
Nb
Nb
Nb
Nb
sp
Nb
lL
Nb
Nb
lX
TQ
TQ
lX
lX
lX
mm
XK
uj
fO
uj
XK
mm
ux
mm
ZK
XK
uj
XK
mm
lX
uS
"}
(12,1,1) = {"
uS
sp
Nb
lL
lX
lX
lX
lX
lX
lX
Nb
lX
rs
TQ
Et
TQ
Et
XK
ih
NO
mm
Nc
uj
rm
mm
XK
rm
FK
XK
Gx
mm
lX
uS
"}
(13,1,1) = {"
uS
sp
lF
lX
lX
AS
FI
TC
TC
lX
Nb
lX
TQ
Te
lX
lX
lX
jO
mm
XK
ux
mm
XK
ih
XK
mm
rm
mm
XK
mm
mr
lX
uS
"}
(14,1,1) = {"
uS
sp
Nb
Tb
rm
rm
rm
rm
rm
Tb
Nb
lX
lX
lX
lX
Ep
lX
lX
lX
lX
lX
lX
lX
lX
lX
XK
Gx
lX
lX
lX
lX
lX
uS
"}
(15,1,1) = {"
uS
sp
Nb
lX
lX
lX
lX
lX
lX
lX
Nb
Nb
Nb
Nb
Nb
Nb
lX
Lz
UZ
im
lX
xz
JG
pf
lX
zz
ux
lX
Kv
Iw
ab
lX
uS
"}
(16,1,1) = {"
uS
sp
Nb
lX
lX
lX
lX
lX
lX
lX
lX
lX
lX
lX
lX
lX
lX
Ac
Iw
rH
Mk
al
Ac
Iw
pp
mm
XK
Im
Iw
Iw
lX
lX
uS
"}
(17,1,1) = {"
uS
sp
Nb
lX
lX
nt
Tg
WB
lX
ct
Ph
Ug
TQ
rs
Vt
Vt
lX
lX
lX
lX
lX
mH
Iw
al
lX
rm
mm
lX
nv
ka
Ca
lX
uS
"}
(18,1,1) = {"
uS
sp
lF
lX
lX
TQ
TQ
TQ
lX
kJ
TQ
TQ
TQ
TQ
TQ
TQ
VB
gk
Ht
Iw
Gc
zu
gk
fw
lX
uj
uj
lX
Dj
Iw
lX
lX
uS
"}
(19,1,1) = {"
uS
sp
Nb
lX
lX
Mv
aQ
TQ
Qi
TQ
TQ
rs
mF
Vl
TQ
Te
lX
Ac
al
gk
Ac
Iw
al
iR
lX
ux
Fl
lX
iL
Iw
Ha
lX
uS
"}
(20,1,1) = {"
uS
sp
Nb
lX
lX
TQ
TQ
TQ
lX
TQ
TQ
TQ
jG
TQ
TQ
TQ
VB
al
Ac
dA
Ht
Iw
al
iq
lX
ZK
RR
lX
gc
Iw
lX
lX
uS
"}
(21,1,1) = {"
uS
sp
Nb
lX
lX
CY
yy
WB
lX
vg
TQ
rs
TQ
TQ
Kq
Vk
lX
Gc
al
hK
hK
ul
mY
Cx
lX
Wq
mr
lX
VO
Iw
hI
lX
uS
"}
(22,1,1) = {"
uS
gi
kj
lX
lX
lX
lX
lX
lX
lX
lX
lX
lX
lX
lX
lX
lX
lX
lX
lX
lX
lX
lX
lX
lX
lX
lX
lX
lX
lX
lX
lX
uS
"}
(23,1,1) = {"
uS
uS
uS
lX
lX
lX
lX
lX
lX
lX
uS
uS
uS
uS
uS
uS
uS
uS
uS
uS
uS
uS
uS
uS
uS
uS
uS
uS
uS
uS
uS
uS
uS
"}
