//MAP CONVERTED BY dmm2tgm.py THIS HEADER COMMENT PREVENTS RECONVERSION, DO NOT REMOVE
"ad" = (
/mob/living/simple_animal/hostile/bear/snow{
	faction = list("hostile")
	},
/turf/open/floor/plating/asteroid/snow/icemoon,
/area/icemoon/underground/explored)
"av" = (
/mob/living/simple_animal/hostile/bear/snow{
	faction = list("hostile")
	},
/turf/open/floor/iron/icemoon,
/area/ruin/unpowered)
"aN" = (
/mob/living/simple_animal/hostile/asteroid/wolf,
/turf/open/floor/plating/asteroid/snow/icemoon,
/area/icemoon/underground/explored)
"bm" = (
/obj/machinery/door/airlock/external{
	req_access_txt = "150"
	},
/obj/structure/barricade/wooden/crude/snow,
/turf/open/floor/iron/icemoon,
/area/ruin/unpowered)
"bx" = (
/obj/structure/reagent_dispensers/beerkeg{
	desc = "An Irishman's dream!";
	name = "whiskey keg";
	reagent_id = /datum/reagent/consumable/ethanol/whiskey
	},
/turf/open/floor/iron/icemoon,
/area/ruin/unpowered)
"cc" = (
/obj/structure/bed{
	name = "bottom bunk"
	},
/obj/structure/bed{
	name = "top bunk";
	pixel_y = 12
	},
/obj/effect/spawner/random/entertainment/musical_instrument,
/turf/open/floor/iron/icemoon,
/area/ruin/unpowered)
"dC" = (
/obj/machinery/light/dim/directional/east,
/turf/open/floor/iron/icemoon,
/area/ruin/unpowered)
"dK" = (
/obj/effect/spawner/structure/window/reinforced,
/turf/open/floor/plating/icemoon,
/area/ruin/unpowered)
"dY" = (
/obj/effect/mob_spawn/human/corpse/damaged,
/turf/open/floor/iron/icemoon,
/area/ruin/unpowered)
"eZ" = (
/obj/structure/closet/body_bag,
/turf/open/floor/iron/icemoon,
/area/ruin/unpowered)
"fx" = (
/obj/effect/spawner/random/medical/patient_stretcher,
/obj/effect/spawner/random/medical/surgery_tool_advanced,
/turf/open/floor/plating/snowed/icemoon,
/area/ruin/unpowered)
"fD" = (
/obj/effect/mob_spawn/human/miner/rig,
/obj/structure/bed{
	name = "bottom bunk"
	},
/obj/structure/bed{
	name = "top bunk";
	pixel_y = 12
	},
/obj/item/key/atv,
/turf/open/floor/iron/icemoon,
/area/ruin/unpowered)
"fM" = (
/obj/structure/table_frame,
/turf/open/floor/iron/icemoon,
/area/ruin/unpowered)
"hx" = (
/obj/effect/mob_spawn/human/corpse/damaged,
/obj/item/lead_pipe,
/obj/effect/decal/cleanable/blood,
/turf/open/floor/iron/icemoon,
/area/ruin/unpowered)
"hI" = (
/turf/open/floor/plating/icemoon,
/area/icemoon/underground/explored)
"hJ" = (
/mob/living/simple_animal/hostile/asteroid/wolf{
	faction = list("hostile")
	},
/turf/open/floor/iron/icemoon,
/area/ruin/unpowered)
"hR" = (
/obj/effect/decal/cleanable/blood/splatter,
/turf/open/floor/plating/snowed/icemoon,
/area/ruin/unpowered)
"iH" = (
/obj/effect/mob_spawn/human/engineer,
/obj/item/holosign_creator/atmos{
	pixel_x = -6;
	pixel_y = 3
	},
/turf/open/floor/plating/icemoon,
/area/ruin/unpowered)
"iL" = (
/obj/structure/bed{
	name = "bottom bunk"
	},
/obj/structure/bed{
	name = "top bunk";
	pixel_y = 12
	},
/obj/effect/spawner/random/entertainment/money_small,
/turf/open/floor/iron/icemoon,
/area/ruin/unpowered)
"iM" = (
/obj/structure/rack/shelf,
/obj/effect/spawner/random/medical/firstaid,
/turf/open/floor/plating/snowed/icemoon,
/area/ruin/unpowered)
"jj" = (
/turf/open/floor/plating/icemoon,
/area/ruin/unpowered)
"jq" = (
/obj/effect/decal/cleanable/glass{
	dir = 4
	},
/obj/effect/decal/cleanable/glass{
	dir = 1
	},
/turf/open/floor/plating/snowed/smoothed/icemoon,
/area/ruin/unpowered)
"ju" = (
/obj/structure/table/wood/poker,
/obj/effect/spawner/random/food_or_drink/refreshing_beverage,
/turf/open/floor/plating/icemoon,
/area/ruin/unpowered)
"jv" = (
/obj/structure/table,
/obj/effect/spawner/random/engineering/material,
/obj/effect/spawner/random/engineering/material,
/obj/effect/spawner/random/engineering/material,
/turf/open/floor/iron/icemoon,
/area/ruin/unpowered)
"jR" = (
/obj/effect/spawner/random/trash/mess,
/turf/open/floor/iron/icemoon,
/area/ruin/unpowered)
"kf" = (
/obj/structure/table/wood/poker,
/obj/effect/spawner/random/food_or_drink/booze,
/turf/open/floor/iron/icemoon,
/area/ruin/unpowered)
"kk" = (
/obj/structure/bed,
/turf/open/floor/plating/snowed/icemoon,
/area/ruin/unpowered)
"ko" = (
/obj/structure/table,
/obj/item/storage/backpack/duffelbag/mining_conscript,
/turf/open/floor/iron/icemoon,
/area/ruin/unpowered)
"kH" = (
/obj/structure/table,
/obj/effect/spawner/random/engineering/tool_advanced,
/turf/open/floor/iron/icemoon,
/area/ruin/unpowered)
"lb" = (
/obj/machinery/light/broken/directional/east,
/turf/open/floor/plating/snowed/icemoon,
/area/ruin/unpowered)
"lA" = (
/obj/effect/spawner/random/engineering/tank,
/turf/open/floor/iron/icemoon,
/area/ruin/unpowered)
"lJ" = (
/obj/structure/rack/shelf,
/turf/open/floor/iron/icemoon,
/area/ruin/unpowered)
"lM" = (
/obj/structure/frame/machine,
/turf/open/floor/iron/icemoon,
/area/ruin/unpowered)
"lZ" = (
/turf/open/floor/plating/snowed/smoothed/icemoon,
/area/ruin/unpowered)
"me" = (
/obj/effect/spawner/random/structure/chair_flipped,
/turf/open/floor/iron/icemoon,
/area/ruin/unpowered)
"mF" = (
/obj/structure/firelock_frame,
/turf/open/floor/iron/icemoon,
/area/ruin/unpowered)
"mG" = (
/obj/effect/mob_spawn/human/doctor,
/turf/open/floor/plating/icemoon,
/area/ruin/unpowered)
"mW" = (
/obj/effect/spawner/random/trash/grime,
/obj/effect/decal/cleanable/blood/tracks,
/turf/open/floor/iron/icemoon,
/area/ruin/unpowered)
"nA" = (
/obj/effect/spawner/random/exotic/antag_gear,
/obj/structure/closet/crate/secure/gear{
	req_access_txt = "150"
	},
/obj/item/key/atv,
/obj/item/storage/backpack/duffelbag/syndie,
/turf/open/floor/plating/icemoon,
/area/ruin/unpowered)
"nQ" = (
/obj/structure/table,
/turf/open/floor/iron/icemoon,
/area/ruin/unpowered)
"nV" = (
/obj/effect/decal/cleanable/blood/splatter,
/turf/open/floor/plating/icemoon,
/area/ruin/unpowered)
"oM" = (
/obj/effect/decal/cleanable/glass{
	dir = 1
	},
/obj/structure/barricade/wooden/snowed,
/turf/open/floor/plating/snowed/smoothed/icemoon,
/area/ruin/unpowered)
"pe" = (
/obj/effect/spawner/random/engineering/tank,
/obj/machinery/light/red/directional/north,
/turf/open/floor/plating/icemoon,
/area/ruin/unpowered)
"pi" = (
/obj/structure/table,
/obj/item/flashlight/seclite,
/obj/item/flashlight/seclite,
/obj/item/implanter/tracking/gps,
/turf/open/floor/iron/icemoon,
/area/ruin/unpowered)
"ps" = (
/obj/structure/table/wood/poker,
/turf/open/floor/plating/icemoon,
/area/ruin/unpowered)
"pT" = (
/obj/effect/decal/cleanable/blood/tracks{
	dir = 4
	},
/turf/open/floor/iron/icemoon,
/area/ruin/unpowered)
"qn" = (
/obj/machinery/light/red/directional/south,
/turf/open/floor/iron/icemoon,
/area/ruin/unpowered)
"rl" = (
/obj/effect/mob_spawn/human/miner,
/obj/structure/closet/body_bag/stasis,
/turf/open/floor/iron/icemoon,
/area/ruin/unpowered)
"rt" = (
/obj/effect/spawner/random/vending/colavend,
/turf/open/floor/iron/icemoon,
/area/ruin/unpowered)
"rF" = (
/obj/structure/rack/shelf,
/obj/effect/spawner/random/medical/firstaid_rare,
/obj/item/implanter/mortis,
/turf/open/floor/iron/icemoon,
/area/ruin/unpowered)
"rZ" = (
/mob/living/simple_animal/hostile/true_changeling,
/turf/open/floor/iron/icemoon,
/area/ruin/unpowered)
"st" = (
/obj/effect/decal/cleanable/blood/tracks{
	dir = 5
	},
/turf/open/floor/iron/icemoon,
/area/ruin/unpowered)
"sP" = (
/obj/effect/decal/cleanable/blood/tracks,
/turf/open/floor/plating/icemoon,
/area/ruin/unpowered)
"td" = (
/obj/item/kirbyplants/dead,
/turf/open/floor/iron/icemoon,
/area/ruin/unpowered)
"tm" = (
/obj/structure/frame/computer{
	dir = 4
	},
/turf/open/floor/plating/snowed/icemoon,
/area/ruin/unpowered)
"tP" = (
/obj/effect/mob_spawn/human/engineer,
/obj/item/rcd_upgrade/frames,
/turf/open/floor/iron/icemoon,
/area/ruin/unpowered)
"un" = (
/turf/closed/wall/ice,
/area/ruin/unpowered)
"up" = (
/obj/effect/spawner/random/trash/grime,
/turf/open/floor/iron/icemoon,
/area/ruin/unpowered)
"uS" = (
/obj/structure/table,
/obj/effect/spawner/random/exotic/technology,
/turf/open/floor/iron/icemoon,
/area/ruin/unpowered)
"uT" = (
/obj/machinery/door/airlock/mining,
/turf/open/floor/iron/icemoon,
/area/ruin/unpowered)
"ve" = (
/obj/effect/spawner/random/structure/chair_flipped,
/turf/open/floor/plating/icemoon,
/area/ruin/unpowered)
"vn" = (
/obj/structure/rack,
/turf/open/floor/iron/icemoon,
/area/ruin/unpowered)
"vu" = (
/mob/living/simple_animal/hostile/asteroid/wolf{
	faction = list("hostile")
	},
/turf/open/floor/plating/snowed/icemoon,
/area/ruin/unpowered)
"vF" = (
/turf/open/floor/plating/asteroid/snow/icemoon,
/area/icemoon/underground/explored)
"vV" = (
/turf/open/floor/plating/snowed/icemoon,
/area/ruin/unpowered)
"wj" = (
/obj/structure/table,
/obj/effect/spawner/random/engineering/toolbox,
/obj/effect/spawner/random/engineering/toolbox,
/turf/open/floor/plating/icemoon,
/area/ruin/unpowered)
"wl" = (
/obj/effect/spawner/random/maintenance,
/turf/open/floor/plating/icemoon,
/area/ruin/unpowered)
"wR" = (
/obj/item/roller,
/turf/open/floor/iron/icemoon,
/area/ruin/unpowered)
"wT" = (
/obj/structure/bed{
	name = "bottom bunk"
	},
/obj/structure/bed{
	name = "top bunk";
	pixel_y = 12
	},
/turf/open/floor/plating/snowed/icemoon,
/area/ruin/unpowered)
"xa" = (
/obj/structure/table,
/obj/item/laser_pointer,
/turf/open/floor/iron/icemoon,
/area/ruin/unpowered)
"xY" = (
/obj/structure/tank_dispenser,
/obj/machinery/light/red/directional/north,
/turf/open/floor/iron/icemoon,
/area/ruin/unpowered)
"yd" = (
/obj/structure/rack,
/obj/item/storage/bag/ore{
	pixel_y = 8
	},
/obj/item/storage/bag/ore/holding{
	pixel_y = 4
	},
/obj/item/storage/bag/plants,
/obj/machinery/light/red/directional/south,
/turf/open/floor/iron/icemoon,
/area/ruin/unpowered)
"yj" = (
/obj/structure/table,
/obj/item/clothing/suit/hooded/wintercoat/miner,
/obj/item/clothing/suit/hooded/wintercoat/miner,
/obj/item/clothing/suit/hooded/wintercoat/miner,
/obj/item/clothing/suit/hooded/wintercoat/miner,
/turf/open/floor/plating/icemoon,
/area/ruin/unpowered)
"yl" = (
/obj/effect/decal/cleanable/glass{
	dir = 4
	},
/obj/structure/barricade/wooden/snowed,
/turf/open/floor/plating/icemoon,
/area/ruin/unpowered)
"yG" = (
/obj/effect/spawner/random/trash/grime,
/obj/machinery/light/broken/directional/north,
/turf/open/floor/iron/icemoon,
/area/ruin/unpowered)
"yW" = (
/obj/structure/table,
/obj/item/storage/bag/trash,
/turf/open/floor/iron/icemoon,
/area/ruin/unpowered)
"zn" = (
/obj/effect/spawner/random/engineering/atmospherics_portable,
/turf/open/floor/iron/icemoon,
/area/ruin/unpowered)
"zD" = (
/obj/item/screwdriver/nuke,
/turf/open/floor/iron/icemoon,
/area/ruin/unpowered)
"AG" = (
/obj/item/kirbyplants/dead,
/turf/open/floor/plating/icemoon,
/area/ruin/unpowered)
"Bd" = (
/obj/structure/trash_pile,
/turf/open/floor/plating/icemoon,
/area/ruin/unpowered)
"Bo" = (
/obj/machinery/light/broken/directional/south,
/turf/open/floor/plating/icemoon,
/area/ruin/unpowered)
"BU" = (
/obj/effect/mob_spawn/human/geneticist,
/obj/structure/closet/body_bag,
/turf/open/floor/iron/icemoon,
/area/ruin/unpowered)
"BV" = (
/obj/structure/bed,
/turf/open/floor/iron/icemoon,
/area/ruin/unpowered)
"Cb" = (
/obj/machinery/door/airlock/external{
	req_access_txt = "150"
	},
/turf/open/floor/iron/icemoon,
/area/ruin/unpowered)
"Cs" = (
/obj/structure/trash_pile,
/turf/open/floor/plating/snowed/icemoon,
/area/ruin/unpowered)
"CB" = (
/obj/machinery/door/airlock/medical,
/turf/open/floor/iron/icemoon,
/area/ruin/unpowered)
"CF" = (
/obj/machinery/door/airlock/mining,
/turf/open/floor/plating/icemoon,
/area/ruin/unpowered)
"Dc" = (
/mob/living/simple_animal/hostile/mining_drone{
	faction = list("hostile")
	},
/turf/open/floor/iron/icemoon,
/area/ruin/unpowered)
"DF" = (
/obj/effect/spawner/random/engineering/canister,
/turf/open/floor/iron/icemoon,
/area/ruin/unpowered)
"Eq" = (
/obj/structure/bed{
	name = "bottom bunk"
	},
/obj/structure/bed{
	name = "top bunk";
	pixel_y = 12
	},
/obj/effect/spawner/random/entertainment/toy,
/turf/open/floor/plating/snowed/icemoon,
/area/ruin/unpowered)
"Er" = (
/obj/structure/rack/shelf,
/obj/effect/spawner/random/maintenance,
/obj/effect/spawner/random/maintenance,
/obj/effect/spawner/random/maintenance,
/turf/open/floor/iron/icemoon,
/area/ruin/unpowered)
"Ez" = (
/obj/effect/spawner/random/structure/crate_abandoned,
/turf/open/floor/iron/icemoon,
/area/ruin/unpowered)
"EA" = (
/obj/machinery/light/dim/directional/east,
/turf/open/floor/plating/icemoon,
/area/ruin/unpowered)
"FF" = (
/obj/structure/rack,
/obj/item/pickaxe/mini{
	pixel_x = 9;
	pixel_y = 9
	},
/obj/item/pickaxe/mini{
	pixel_x = 6;
	pixel_y = 6
	},
/obj/item/pickaxe/mini{
	pixel_x = 3;
	pixel_y = 3
	},
/obj/item/pickaxe/mini,
/turf/open/floor/iron/icemoon,
/area/ruin/unpowered)
"FK" = (
/obj/machinery/light/broken/directional/north,
/turf/open/floor/iron/icemoon,
/area/ruin/unpowered)
"GL" = (
/obj/structure/tank_dispenser/oxygen,
/turf/open/floor/iron/icemoon,
/area/ruin/unpowered)
"GX" = (
/obj/effect/decal/cleanable/blood/tracks,
/turf/open/floor/iron/icemoon,
/area/ruin/unpowered)
"Ic" = (
/mob/living/simple_animal/hostile/asteroid/wolf{
	faction = list("hostile")
	},
/turf/open/floor/plating/asteroid/snow/icemoon,
/area/icemoon/underground/explored)
"IU" = (
/obj/structure/table,
/obj/effect/spawner/random/food_or_drink/seed_rare,
/obj/effect/spawner/random/food_or_drink/seed_rare,
/obj/effect/spawner/random/food_or_drink/seed_rare,
/obj/effect/spawner/random/food_or_drink/seed_rare,
/obj/effect/spawner/random/food_or_drink/seed_rare,
/turf/open/floor/iron/icemoon,
/area/ruin/unpowered)
"Kl" = (
/obj/machinery/light/red/directional/west,
/obj/item/kirbyplants/dead,
/turf/open/floor/iron/icemoon,
/area/ruin/unpowered)
"Kt" = (
/obj/item/shard,
/obj/effect/decal/cleanable/glass{
	dir = 8
	},
/obj/effect/decal/cleanable/glass,
/turf/open/floor/plating/snowed/smoothed/icemoon,
/area/ruin/unpowered)
"KS" = (
/turf/open/floor/plating/catwalk_floor/plated,
/area/icemoon/underground/explored)
"LO" = (
/obj/vehicle/sealed/mecha/working/ripley,
/turf/open/floor/iron/icemoon,
/area/ruin/unpowered)
"Mh" = (
/obj/structure/rack/shelf,
/obj/effect/spawner/random/engineering/vending_restock,
/obj/effect/spawner/random/engineering/vending_restock,
/turf/open/floor/plating/icemoon,
/area/ruin/unpowered)
"Mi" = (
/obj/effect/mob_spawn/human/miner/explorer,
/obj/structure/closet/body_bag/environmental,
/turf/open/floor/iron/icemoon,
/area/ruin/unpowered)
"Ml" = (
/turf/open/lava/plasma/ice_moon,
/area/icemoon/underground/explored)
"Mn" = (
/obj/effect/decal/cleanable/blood,
/turf/open/floor/iron/icemoon,
/area/ruin/unpowered)
"Nm" = (
/turf/closed/wall,
/area/ruin/unpowered)
"Nw" = (
/obj/machinery/door/airlock/engineering,
/turf/open/floor/plating/icemoon,
/area/ruin/unpowered)
"NU" = (
/turf/open/floor/iron/icemoon,
/area/ruin/unpowered)
"Od" = (
/turf/open/genturf,
/area/icemoon/underground/unexplored/rivers)
"Oj" = (
/obj/structure/table,
/obj/effect/spawner/random/entertainment/cigarette_pack,
/obj/effect/spawner/random/entertainment/cigarette_pack,
/turf/open/floor/plating/icemoon,
/area/ruin/unpowered)
"Pj" = (
/obj/structure/table,
/obj/effect/spawner/random/food_or_drink/three_course_meal,
/obj/machinery/light/red/directional/west,
/turf/open/floor/plating/icemoon,
/area/ruin/unpowered)
"Pl" = (
/obj/structure/rack,
/turf/open/floor/plating/icemoon,
/area/ruin/unpowered)
"Pt" = (
/obj/structure/table,
/obj/effect/spawner/random/engineering/material_rare,
/obj/effect/spawner/random/engineering/material_rare,
/turf/open/floor/iron/icemoon,
/area/ruin/unpowered)
"PG" = (
/obj/structure/trash_pile,
/obj/machinery/light/broken/directional/east,
/turf/open/floor/iron/icemoon,
/area/ruin/unpowered)
"PJ" = (
/obj/effect/spawner/random/trash/bin,
/turf/open/floor/iron/icemoon,
/area/ruin/unpowered)
"Qf" = (
/obj/machinery/light/red/directional/west,
/turf/open/floor/plating/icemoon,
/area/ruin/unpowered)
"Qm" = (
/obj/structure/frame/machine,
/turf/open/floor/plating/snowed/icemoon,
/area/ruin/unpowered)
"Qw" = (
/obj/structure/table,
/obj/item/paper/crumpled/bloody{
	info = "We locked it up, but most of us are dead. It's just me and Frank left. We're going to try finding help. If you see this note, do NOT open the door.";
	name = "bloody paper"
	},
/obj/machinery/light/broken/directional/north,
/turf/open/floor/iron/icemoon,
/area/ruin/unpowered)
"RN" = (
/obj/machinery/power/smes,
/turf/open/floor/plating/icemoon,
/area/ruin/unpowered)
"RO" = (
/obj/machinery/computer/station_alert{
	dir = 8;
	pixel_x = 4
	},
/turf/open/floor/iron/icemoon,
/area/ruin/unpowered)
"RS" = (
/obj/vehicle/ridden/atv,
/turf/open/floor/iron/icemoon,
/area/ruin/unpowered)
"Sn" = (
/obj/structure/rack/shelf,
/obj/effect/spawner/random/medical/supplies,
/turf/open/floor/plating/icemoon,
/area/ruin/unpowered)
"SA" = (
/mob/living/simple_animal/hostile/bear/snow,
/turf/open/floor/plating/snowed/icemoon,
/area/ruin/unpowered)
"Tk" = (
/obj/structure/barricade/wooden/snowed,
/turf/open/floor/plating/snowed/smoothed/icemoon,
/area/ruin/unpowered)
"To" = (
/obj/machinery/computer/atmos_alert{
	dir = 4;
	pixel_x = -4
	},
/turf/open/floor/iron/icemoon,
/area/ruin/unpowered)
"Tw" = (
/obj/structure/table,
/obj/machinery/light/dim/directional/east,
/obj/item/inducer,
/turf/open/floor/iron/icemoon,
/area/ruin/unpowered)
"Tx" = (
/obj/effect/spawner/random/trash/mess,
/turf/open/floor/plating/snowed/icemoon,
/area/ruin/unpowered)
"TH" = (
/obj/structure/barricade/wooden/snowed,
/turf/open/floor/plating/snowed/icemoon,
/area/ruin/unpowered)
"TO" = (
/obj/effect/decal/cleanable/glass{
	dir = 1
	},
/obj/structure/barricade/wooden/snowed,
/turf/open/floor/plating/icemoon,
/area/ruin/unpowered)
"TU" = (
/turf/closed/wall/r_wall,
/area/ruin/unpowered)
"TY" = (
/obj/structure/trash_pile,
/turf/open/floor/iron/icemoon,
/area/ruin/unpowered)
"Uy" = (
/obj/effect/decal/cleanable/blood/tracks{
	dir = 4
	},
/turf/open/floor/plating/icemoon,
/area/ruin/unpowered)
"UF" = (
/obj/structure/table,
/obj/item/reagent_containers/food/drinks/bottle/wine/unlabeled,
/obj/effect/spawner/random/entertainment/money_small,
/turf/open/floor/iron/icemoon,
/area/ruin/unpowered)
"UH" = (
/obj/effect/spawner/random/trash/box,
/turf/open/floor/iron/icemoon,
/area/ruin/unpowered)
"UL" = (
/obj/structure/frame/machine,
/turf/open/floor/plating/icemoon,
/area/ruin/unpowered)
"Ve" = (
/obj/effect/mob_spawn/human/corpse/nanotrasensoldier,
/obj/effect/decal/cleanable/blood,
/turf/open/floor/iron/icemoon,
/area/ruin/unpowered)
"VP" = (
/obj/structure/rack,
/obj/item/storage/bag/xenoarch,
/turf/open/floor/iron/icemoon,
/area/ruin/unpowered)
"VS" = (
/obj/effect/decal/cleanable/blood/splatter,
/turf/open/floor/iron/icemoon,
/area/ruin/unpowered)
"We" = (
/obj/effect/spawner/random/vending/snackvend,
/turf/open/floor/plating/icemoon,
/area/ruin/unpowered)
"WA" = (
/obj/machinery/door/airlock/grunge,
/obj/effect/mapping_helpers/airlock/locked,
/turf/open/floor/plating/icemoon,
/area/ruin/unpowered)
"WB" = (
/obj/effect/spawner/random/trash/hobo_squat,
/turf/open/floor/iron/icemoon,
/area/ruin/unpowered)
"Xa" = (
/obj/effect/decal/cleanable/glass{
	dir = 4
	},
/turf/open/floor/plating/snowed/smoothed/icemoon,
/area/ruin/unpowered)
"Xb" = (
/obj/structure/rack/shelf,
/turf/open/floor/plating/icemoon,
/area/ruin/unpowered)
"Xi" = (
/obj/effect/mob_spawn/human/corpse/cargo_tech,
/turf/open/floor/iron/icemoon,
/area/ruin/unpowered)
"Xo" = (
/obj/structure/table,
/obj/item/storage/bag/sheetsnatcher,
/obj/machinery/light/red/directional/south,
/turf/open/floor/iron/icemoon,
/area/ruin/unpowered)
"Xr" = (
/obj/structure/bed{
	name = "bottom bunk"
	},
/obj/structure/bed{
	name = "top bunk";
	pixel_y = 12
	},
/turf/open/floor/iron/icemoon,
/area/ruin/unpowered)
"XA" = (
/obj/structure/tank_holder/anesthetic,
/turf/open/floor/iron/icemoon,
/area/ruin/unpowered)
"Yc" = (
/obj/effect/spawner/random/structure/bucket,
/turf/open/floor/iron/icemoon,
/area/ruin/unpowered)
"Yg" = (
/obj/effect/mob_spawn/human/miner/explorer,
/obj/effect/decal/cleanable/blood,
/turf/open/floor/iron/icemoon,
/area/ruin/unpowered)
"Yq" = (
/obj/effect/spawner/random/medical/patient_stretcher,
/obj/item/bodybag/stasis,
/turf/open/floor/plating/icemoon,
/area/ruin/unpowered)
"YB" = (
/obj/effect/spawner/random/maintenance,
/turf/open/floor/iron/icemoon,
/area/ruin/unpowered)
"YW" = (
/obj/structure/table/wood/poker,
/obj/effect/spawner/random/entertainment/deck,
/turf/open/floor/plating/icemoon,
/area/ruin/unpowered)
"Zl" = (
/obj/structure/table,
/obj/item/pickaxe/drill,
/obj/item/pickaxe/drill/jackhammer{
	pixel_y = 5
	},
/turf/open/floor/plating/icemoon,
/area/ruin/unpowered)
"Zo" = (
/obj/machinery/power/emitter,
/turf/open/floor/plating/icemoon,
/area/ruin/unpowered)

(1,1,1) = {"
Od
Od
Od
Od
Od
Od
Od
Od
Od
vF
vF
vF
vF
KS
KS
vF
vF
vF
Od
Od
Od
Od
Od
Od
Od
Od
Od
Od
Od
"}
(2,1,1) = {"
Od
Od
Od
Od
vF
Od
Od
vF
Od
Ml
Ml
Ml
Ml
KS
KS
Ml
Ml
Ml
Ml
Ml
Ml
Ml
Ml
Ml
Ml
Od
Od
Od
Od
"}
(3,1,1) = {"
Od
Od
Od
vF
vF
vF
Od
vF
Ml
Ml
Ml
Ml
Ml
KS
KS
Ml
Ml
Ml
Ml
Ml
Ml
Ml
Ml
Ml
Ml
Ml
Od
Od
Od
"}
(4,1,1) = {"
Od
Od
vF
vF
Ml
Ml
Ml
Ml
Ml
Ml
Ml
vF
vF
KS
KS
vF
vF
vF
vF
vF
vF
vF
vF
vF
Ml
Ml
Ml
Od
Od
"}
(5,1,1) = {"
Od
vF
vF
Ml
Ml
Ml
Ml
Ml
Ml
vF
vF
vF
vF
KS
KS
vF
vF
vF
vF
vF
vF
vF
vF
vF
vF
Ml
Ml
Ml
Od
"}
(6,1,1) = {"
Od
vF
Ml
Ml
vF
vF
vF
vF
vF
vF
vF
vF
vF
hI
hI
vF
vF
vF
vF
vF
vF
vF
vF
vF
vF
vF
Ml
Ml
Od
"}
(7,1,1) = {"
Od
vF
Ml
Ml
vF
Nm
Nm
oM
un
un
un
un
un
TH
bm
un
un
un
un
un
Kt
Xa
un
un
un
un
vF
Ml
Ml
"}
(8,1,1) = {"
Od
Od
Ml
vF
vF
un
cc
NU
PJ
Pj
Oj
Nm
Cs
vV
vV
Kl
me
NU
me
un
vV
vV
tm
fx
XA
Nm
vF
Ml
Ml
"}
(9,1,1) = {"
Od
Od
Ml
vF
vF
un
Xr
vV
Dc
jj
UF
Nm
yG
vV
vV
vV
ju
YW
jj
un
Qm
vV
vV
vV
vV
Nm
vF
Ml
Ml
"}
(10,1,1) = {"
Od
Od
Ml
vF
vF
lZ
Eq
NU
jj
NU
bx
Nm
NU
SA
pT
jj
ps
kf
Bo
un
Qm
NU
vV
NU
vu
Nm
vF
Ml
Ml
"}
(11,1,1) = {"
Od
Od
Ml
Ml
vF
lZ
vV
vV
hR
Dc
qn
un
NU
NU
Uy
NU
ve
NU
NU
Nm
vV
NU
BU
vV
lM
un
vF
Ml
Ml
"}
(12,1,1) = {"
Od
vF
Ml
Ml
vF
Nm
wT
cc
NU
iL
fD
un
FK
UH
Uy
NU
av
NU
NU
CB
vV
NU
BV
NU
BV
un
vF
Ml
Ml
"}
(13,1,1) = {"
vF
vF
Ml
Ml
vF
Nm
Nm
un
CF
un
un
un
AG
jj
NU
NU
jj
VS
up
Nm
Yq
mG
BV
hJ
BV
un
vF
vF
Ml
"}
(14,1,1) = {"
vF
vF
Ml
Ml
vF
un
vn
jj
NU
Qf
lJ
Xb
jj
jj
jj
jR
jj
NU
Bo
Nm
NU
jj
kk
vV
kk
un
vF
vF
vF
"}
(15,1,1) = {"
vF
vF
Ml
Ml
vF
un
VP
NU
jj
YB
jj
jj
NU
jj
Ve
jj
NU
eZ
jj
un
jj
wR
jj
vV
vV
Nm
vF
vF
Ic
"}
(16,1,1) = {"
vF
KS
KS
KS
KS
Cb
NU
jR
jj
GX
sP
Mn
jj
Er
nQ
uS
Bd
jj
NU
yl
NU
vV
vV
vV
vV
Tk
vF
vF
vF
"}
(17,1,1) = {"
vF
KS
KS
KS
KS
Cb
NU
Mn
jj
NU
av
jj
dY
TU
TU
TU
TU
jR
NU
TO
jj
NU
hJ
vV
vV
dK
vF
vF
vF
"}
(18,1,1) = {"
vF
vF
Ml
Ml
vF
un
rt
jj
rl
jj
jj
NU
xa
TU
rZ
nA
TU
Qw
NU
un
TY
EA
rF
iM
Sn
un
vF
vF
vF
"}
(19,1,1) = {"
Od
vF
Ml
Ml
vF
un
We
av
NU
fM
jj
NU
TY
TU
jj
NU
TU
yW
NU
un
un
un
un
un
Nm
un
vF
vF
vF
"}
(20,1,1) = {"
Od
Od
Ml
Ml
vF
Nm
jj
wl
NU
NU
jj
jj
NU
TU
WA
TU
TU
td
hx
mF
Yc
NU
jj
NU
lJ
Nm
vF
vF
vF
"}
(21,1,1) = {"
Od
Od
Ml
vF
vF
un
NU
jj
jj
jR
NU
jj
jj
NU
st
mW
GX
jj
NU
mF
dC
NU
jj
jj
lJ
un
vF
vF
Od
"}
(22,1,1) = {"
Od
vF
Ml
vF
vF
un
Ez
NU
NU
NU
jj
nV
jj
Xi
Mn
NU
Yg
NU
NU
Nm
Nm
un
un
un
Nm
un
vF
vF
Od
"}
(23,1,1) = {"
Od
Ml
Ml
vF
vF
Nm
Ez
jj
NU
NU
jj
YB
jj
NU
Uy
NU
jj
NU
NU
un
xY
Mh
DF
Zo
RN
un
vF
vF
Od
"}
(24,1,1) = {"
Od
Ml
Ml
vF
vF
Nm
dK
dK
Nm
uT
un
un
IU
jj
pT
NU
NU
NU
NU
Nw
jj
NU
NU
jj
jj
un
vF
vF
Od
"}
(25,1,1) = {"
Od
Ml
Ml
vF
vF
Nm
GL
NU
NU
Mn
FF
un
yj
jj
jj
NU
NU
NU
NU
dK
jj
jj
iH
NU
zn
dK
vF
Od
Od
"}
(26,1,1) = {"
vF
Ml
Ml
vF
aN
Nm
RS
NU
jj
Dc
yd
un
nQ
Mi
NU
jj
jj
jj
jj
Nw
NU
NU
RO
NU
zn
dK
vF
Od
Od
"}
(27,1,1) = {"
vF
Ml
Ml
vF
vF
Nm
RS
Mn
Dc
jj
Zl
dK
Ez
vV
NU
Tx
vV
NU
Pl
un
lA
tP
To
NU
jv
un
vF
Od
Od
"}
(28,1,1) = {"
vF
Ml
Ml
vF
vF
un
lM
NU
NU
NU
ko
dK
NU
jj
NU
vV
vV
NU
TY
un
pe
NU
zD
WB
Pt
un
vF
Od
Od
"}
(29,1,1) = {"
vF
Ml
Ml
vF
vF
un
fM
fM
UL
pi
Xo
un
TY
PG
vV
vV
vV
lb
TY
un
LO
dC
kH
wj
Tw
Nm
vF
Od
Od
"}
(30,1,1) = {"
vF
Ml
Ml
Ml
vF
un
un
un
un
un
Nm
Nm
un
un
dK
jq
dK
Nm
un
un
un
un
un
Nm
Nm
Nm
Od
Od
Od
"}
(31,1,1) = {"
Od
vF
Ml
Ml
Ml
vF
vF
vF
vF
vF
vF
vF
vF
vF
vF
vF
vF
vF
vF
vF
vF
vF
vF
ad
vF
vF
Od
Od
Od
"}
(32,1,1) = {"
Od
Od
vF
Ml
Ml
Ml
Ml
Ml
Ml
Ml
Ml
vF
vF
vF
vF
vF
vF
ad
vF
vF
vF
vF
vF
vF
Od
Od
Od
Od
Od
"}
(33,1,1) = {"
Od
Od
Od
vF
Ml
Ml
Ml
Ml
Ml
Ml
Ml
Ml
vF
vF
vF
vF
vF
vF
vF
Od
Od
Od
Od
Od
Od
Od
Od
Od
Od
"}
