//MAP CONVERTED BY dmm2tgm.py THIS HEADER COMMENT PREVENTS RECONVERSION, DO NOT REMOVE
"aP" = (
/obj/structure/table,
/obj/effect/spawner/random/medical/firstaid,
/turf/open/floor/iron/icemoon,
/area/ruin/unpowered)
"bj" = (
/mob/living/simple_animal/hostile/skeleton/plasmaminer,
/obj/effect/decal/cleanable/blood/splatter,
/turf/open/floor/iron/icemoon,
/area/ruin/unpowered)
"br" = (
/turf/closed/wall/r_wall/rust,
/area/ruin/unpowered)
"bY" = (
/obj/structure/showcase/horrific_experiment,
/turf/open/floor/iron/icemoon,
/area/ruin/unpowered)
"cY" = (
/obj/structure/showcase/machinery/oldpod{
	dir = 4
	},
/turf/open/floor/iron/icemoon,
/area/ruin/unpowered)
"dh" = (
/obj/structure/table/wood,
/obj/effect/spawner/random/entertainment/musical_instrument,
/turf/open/floor/wood/cold,
/area/ruin/unpowered)
"dv" = (
/mob/living/simple_animal/hostile/skeleton/ice,
/turf/open/floor/iron/icemoon,
/area/ruin/unpowered)
"eZ" = (
/obj/structure/table,
/turf/open/floor/plating/snowed,
/area/ruin/unpowered)
"hy" = (
/obj/machinery/door/airlock/external{
	req_access_txt = "150"
	},
/obj/structure/barricade/wooden/crude/snow,
/turf/open/floor/plating/icemoon,
/area/ruin/unpowered)
"if" = (
/obj/structure/table/reinforced,
/obj/item/bodybag/environmental,
/turf/open/floor/iron/icemoon,
/area/ruin/unpowered)
"it" = (
/obj/structure/barricade/security,
/turf/open/floor/iron/icemoon,
/area/ruin/unpowered)
"iv" = (
/obj/structure/table,
/turf/open/floor/iron/icemoon,
/area/ruin/unpowered)
"iy" = (
/obj/machinery/door/airlock/grunge,
/turf/open/floor/plating/icemoon,
/area/ruin/unpowered)
"iN" = (
/obj/structure/table/reinforced,
/obj/effect/spawner/random/medical/firstaid_rare,
/turf/open/floor/plating/icemoon,
/area/ruin/unpowered)
"lj" = (
/turf/open/floor/wood/cold,
/area/ruin/unpowered)
"lm" = (
/obj/effect/spawner/random/structure/crate_abandoned,
/turf/open/floor/plating/icemoon,
/area/ruin/unpowered)
"lU" = (
/obj/effect/spawner/random/engineering/tank,
/turf/open/floor/iron/icemoon,
/area/ruin/unpowered)
"mr" = (
/obj/structure/table/reinforced,
/obj/effect/spawner/random/medical/minor_healing,
/turf/open/floor/iron/icemoon,
/area/ruin/unpowered)
"nD" = (
/obj/structure/trash_pile,
/turf/open/floor/plating/icemoon,
/area/ruin/unpowered)
"nP" = (
/obj/structure/table,
/turf/open/floor/plating/icemoon,
/area/ruin/unpowered)
"nR" = (
/mob/living/simple_animal/hostile/zombie{
	faction = list("skeleton")
	},
/turf/open/floor/plating/icemoon,
/area/ruin/unpowered)
"nT" = (
/obj/structure/trash_pile,
/turf/open/floor/iron/icemoon,
/area/ruin/unpowered)
"of" = (
/obj/structure/table/wood,
/obj/effect/spawner/random/entertainment/deck,
/turf/open/floor/wood/cold,
/area/ruin/unpowered)
"ox" = (
/obj/effect/spawner/random/medical/patient_stretcher,
/turf/open/floor/iron/icemoon,
/area/ruin/unpowered)
"oF" = (
/obj/machinery/computer{
	dir = 4
	},
/turf/open/floor/plating/icemoon,
/area/ruin/unpowered)
"oI" = (
/obj/structure/table,
/obj/effect/spawner/random/engineering/material,
/turf/open/floor/iron/icemoon,
/area/ruin/unpowered)
"oT" = (
/obj/machinery/computer,
/turf/open/floor/iron/icemoon,
/area/ruin/unpowered)
"pc" = (
/obj/structure/tank_holder/anesthetic,
/turf/open/floor/iron/icemoon,
/area/ruin/unpowered)
"rb" = (
/obj/structure/server,
/turf/open/floor/iron/icemoon,
/area/ruin/unpowered)
"rB" = (
/obj/structure/tank_holder/extinguisher,
/turf/open/floor/iron/icemoon,
/area/ruin/unpowered)
"sg" = (
/turf/open/floor/plating/icemoon,
/area/ruin/unpowered)
"sE" = (
/turf/open/floor/iron/icemoon,
/area/ruin/unpowered)
"sL" = (
/obj/structure/reagent_dispensers/beerkeg,
/turf/open/floor/plating/icemoon,
/area/ruin/unpowered)
"tf" = (
/obj/structure/safe,
/obj/effect/spawner/random/exotic/antag_gear,
/obj/effect/spawner/random/maintenance/eight,
/turf/open/floor/iron/icemoon,
/area/ruin/unpowered)
"tN" = (
/obj/structure/table/reinforced,
/turf/open/floor/iron/icemoon,
/area/ruin/unpowered)
"uG" = (
/obj/effect/decal/cleanable/blood,
/turf/open/floor/iron/icemoon,
/area/ruin/unpowered)
"uO" = (
/obj/structure/rack/gunrack,
/turf/open/floor/iron/icemoon,
/area/ruin/unpowered)
"uZ" = (
/obj/machinery/door/airlock/grunge,
/turf/open/floor/wood/cold,
/area/ruin/unpowered)
"vM" = (
/obj/effect/spawner/random/entertainment/arcade{
	dir = 8
	},
/turf/open/floor/wood/cold,
/area/ruin/unpowered)
"vX" = (
/obj/structure/table/reinforced,
/obj/effect/spawner/random/medical/memeorgans,
/turf/open/floor/plating/icemoon,
/area/ruin/unpowered)
"xf" = (
/obj/machinery/door/airlock/grunge,
/turf/open/floor/iron/icemoon,
/area/ruin/unpowered)
"xA" = (
/obj/effect/decal/cleanable/blood,
/turf/open/floor/plating/icemoon,
/area/ruin/unpowered)
"xE" = (
/obj/effect/decal/cleanable/blood/splatter,
/turf/open/floor/plating/icemoon,
/area/ruin/unpowered)
"yc" = (
/obj/effect/spawner/random/structure/barricade,
/turf/open/floor/plating/snowed,
/area/ruin/unpowered)
"yT" = (
/obj/structure/rack/shelf,
/obj/effect/spawner/random/engineering/material_rare,
/obj/effect/spawner/random/engineering/material_rare,
/turf/open/floor/iron/icemoon,
/area/ruin/unpowered)
"zB" = (
/obj/structure/bed,
/obj/item/bedsheet,
/turf/open/floor/wood/cold,
/area/ruin/unpowered)
"Ah" = (
/obj/structure/table/reinforced,
/obj/effect/spawner/random/engineering/toolbox,
/turf/open/floor/iron/icemoon,
/area/ruin/unpowered)
"Au" = (
/obj/effect/decal/cleanable/blood/footprints{
	dir = 4
	},
/turf/open/floor/iron/icemoon,
/area/ruin/unpowered)
"Bd" = (
/obj/structure/rack/shelf,
/obj/effect/spawner/random/medical/minor_healing,
/turf/open/floor/wood/cold,
/area/ruin/unpowered)
"Bs" = (
/obj/structure/table/reinforced,
/obj/effect/spawner/random/engineering/material,
/obj/effect/spawner/random/engineering/material,
/turf/open/floor/plating/icemoon,
/area/ruin/unpowered)
"BM" = (
/obj/structure/reagent_dispensers/watertank,
/turf/open/floor/plating/icemoon,
/area/ruin/unpowered)
"CN" = (
/obj/structure/tank_dispenser/oxygen,
/turf/open/floor/plating/icemoon,
/area/ruin/unpowered)
"CY" = (
/obj/structure/table/wood,
/obj/effect/spawner/random/entertainment/cigarette_pack,
/obj/effect/spawner/random/entertainment/lighter,
/turf/open/floor/wood/cold,
/area/ruin/unpowered)
"Dl" = (
/obj/structure/table/reinforced,
/obj/effect/spawner/random/exotic/languagebook,
/turf/open/floor/plating/icemoon,
/area/ruin/unpowered)
"Dr" = (
/obj/structure/table/reinforced,
/obj/effect/spawner/random/medical/memeorgans,
/turf/open/floor/iron/icemoon,
/area/ruin/unpowered)
"Dy" = (
/obj/structure/tank_dispenser/oxygen,
/turf/open/floor/iron/icemoon,
/area/ruin/unpowered)
"DI" = (
/obj/effect/spawner/random/engineering/flashlight,
/turf/open/floor/iron/icemoon,
/area/ruin/unpowered)
"DW" = (
/obj/structure/table/reinforced,
/obj/effect/spawner/random/exotic/antag_gear_weak,
/turf/open/floor/iron/icemoon,
/area/ruin/unpowered)
"Eg" = (
/obj/structure/table,
/obj/item/bodybag/stasis,
/turf/open/floor/iron/icemoon,
/area/ruin/unpowered)
"Fc" = (
/obj/effect/decal/cleanable/blood/footprints,
/turf/open/floor/plating/snowed,
/area/ruin/unpowered)
"FL" = (
/obj/structure/bed/roller,
/obj/effect/spawner/random/medical/minor_healing,
/turf/open/floor/iron/icemoon,
/area/ruin/unpowered)
"GG" = (
/obj/structure/rack/shelf,
/obj/effect/spawner/random/engineering/vending_restock,
/obj/effect/spawner/random/engineering/vending_restock,
/turf/open/floor/iron/icemoon,
/area/ruin/unpowered)
"Hu" = (
/turf/open/floor/plating/snowed,
/area/ruin/unpowered)
"Jt" = (
/obj/effect/spawner/random/exotic/ripley,
/turf/open/floor/iron/icemoon,
/area/ruin/unpowered)
"JB" = (
/obj/structure/table/wood,
/obj/effect/spawner/random/entertainment/money_small,
/turf/open/floor/wood/cold,
/area/ruin/unpowered)
"JC" = (
/turf/closed/wall/r_wall,
/area/ruin/unpowered)
"JN" = (
/obj/machinery/door/airlock/hatch{
	req_access_txt = "3"
	},
/obj/effect/spawner/random/structure/barricade,
/turf/open/floor/iron/icemoon,
/area/ruin/unpowered)
"KE" = (
/obj/structure/rack/shelf,
/obj/effect/spawner/random/engineering/material,
/turf/open/floor/iron/icemoon,
/area/ruin/unpowered)
"KF" = (
/mob/living/simple_animal/hostile/zombie{
	faction = list("skeleton")
	},
/turf/open/floor/iron/icemoon,
/area/ruin/unpowered)
"Li" = (
/obj/structure/bed/roller,
/turf/open/floor/iron/icemoon,
/area/ruin/unpowered)
"Lm" = (
/obj/machinery/computer{
	dir = 4
	},
/turf/open/floor/iron/icemoon,
/area/ruin/unpowered)
"Lr" = (
/mob/living/simple_animal/hostile/skeleton/plasmaminer/jackhammer,
/turf/open/floor/iron/icemoon,
/area/ruin/unpowered)
"Lt" = (
/obj/structure/bed,
/obj/item/bedsheet,
/obj/effect/spawner/random/entertainment/toy,
/turf/open/floor/wood/cold,
/area/ruin/unpowered)
"LU" = (
/obj/effect/decal/cleanable/blood/footprints,
/turf/open/floor/iron/icemoon,
/area/ruin/unpowered)
"LW" = (
/obj/effect/spawner/random/structure/barricade,
/turf/open/floor/iron/icemoon,
/area/ruin/unpowered)
"Mb" = (
/obj/effect/spawner/random/structure/barricade,
/turf/open/floor/plating/icemoon,
/area/ruin/unpowered)
"Mz" = (
/obj/machinery/computer{
	dir = 8
	},
/turf/open/floor/plating/icemoon,
/area/ruin/unpowered)
"MB" = (
/turf/open/floor/plating/asteroid/snow/icemoon,
/area/icemoon/underground/explored)
"MQ" = (
/obj/structure/showcase/machinery/signal_decrypter,
/turf/open/floor/iron/icemoon,
/area/ruin/unpowered)
"NB" = (
/mob/living/simple_animal/hostile/skeleton/ice,
/turf/open/floor/plating/icemoon,
/area/ruin/unpowered)
"NL" = (
/obj/structure/table/reinforced,
/obj/effect/spawner/random/medical/firstaid_rare,
/turf/open/floor/iron/icemoon,
/area/ruin/unpowered)
"Ot" = (
/obj/effect/decal/cleanable/blood/tracks,
/turf/open/floor/iron/icemoon,
/area/ruin/unpowered)
"OM" = (
/obj/effect/spawner/random/structure/crate_abandoned,
/turf/open/floor/iron/icemoon,
/area/ruin/unpowered)
"OZ" = (
/obj/structure/rack/shelf,
/obj/effect/spawner/random/engineering/material_rare,
/turf/open/floor/iron/icemoon,
/area/ruin/unpowered)
"PZ" = (
/obj/machinery/computer{
	dir = 1
	},
/turf/open/floor/iron/icemoon,
/area/ruin/unpowered)
"QI" = (
/obj/effect/spawner/random/exotic/snow_gear,
/turf/open/floor/plating/asteroid/snow/icemoon,
/area/icemoon/underground/explored)
"RT" = (
/obj/machinery/door/airlock/external{
	req_access_txt = "150"
	},
/turf/open/floor/plating/icemoon,
/area/ruin/unpowered)
"Sg" = (
/obj/structure/table/reinforced,
/obj/effect/spawner/random/medical/organs,
/turf/open/floor/iron/icemoon,
/area/ruin/unpowered)
"Si" = (
/mob/living/simple_animal/hostile/skeleton/plasmaminer,
/turf/open/floor/iron/icemoon,
/area/ruin/unpowered)
"SH" = (
/mob/living/simple_animal/hostile/skeleton/plasmaminer/jackhammer,
/turf/open/floor/plating/snowed,
/area/ruin/unpowered)
"SR" = (
/obj/structure/rack/shelf,
/turf/open/floor/wood/cold,
/area/ruin/unpowered)
"SS" = (
/obj/structure/rack,
/turf/open/floor/iron/icemoon,
/area/ruin/unpowered)
"TN" = (
/obj/effect/decal/cleanable/blood/gibs/torso,
/turf/open/floor/iron/icemoon,
/area/ruin/unpowered)
"Up" = (
/obj/structure/tank_holder/extinguisher,
/turf/open/floor/plating/icemoon,
/area/ruin/unpowered)
"Ut" = (
/obj/structure/table/reinforced,
/obj/effect/spawner/random/exotic/technology,
/turf/open/floor/iron/icemoon,
/area/ruin/unpowered)
"Ux" = (
/obj/structure/table/wood,
/obj/effect/spawner/random/entertainment/cigarette_pack,
/obj/effect/spawner/random/entertainment/coin,
/turf/open/floor/plating/icemoon,
/area/ruin/unpowered)
"UL" = (
/obj/structure/rack/shelf,
/turf/open/floor/iron/icemoon,
/area/ruin/unpowered)
"Vp" = (
/obj/structure/showcase/machinery/cloning_pod,
/turf/open/floor/iron/icemoon,
/area/ruin/unpowered)
"VO" = (
/obj/structure/table,
/obj/effect/spawner/random/maintenance/two,
/turf/open/floor/iron/icemoon,
/area/ruin/unpowered)
"WM" = (
/obj/structure/table/reinforced,
/obj/effect/spawner/random/engineering/material_cheap,
/turf/open/floor/iron/icemoon,
/area/ruin/unpowered)
"WU" = (
/obj/machinery/computer{
	dir = 8
	},
/turf/open/floor/iron/icemoon,
/area/ruin/unpowered)
"WZ" = (
/obj/structure/reagent_dispensers/watertank,
/turf/open/floor/iron/icemoon,
/area/ruin/unpowered)
"Yd" = (
/mob/living/simple_animal/hostile/zombie{
	faction = list("skeleton")
	},
/turf/open/floor/plating/snowed,
/area/ruin/unpowered)
"Yl" = (
/mob/living/simple_animal/hostile/skeleton/plasmaminer/jackhammer,
/turf/open/floor/plating/icemoon,
/area/ruin/unpowered)
"YA" = (
/obj/structure/showcase/machinery/implanter{
	desc = "What is this stuff? What is the purpose?";
	name = "strange experiment pod"
	},
/turf/open/floor/iron/icemoon,
/area/ruin/unpowered)
"Zw" = (
/obj/structure/table/reinforced,
/obj/effect/spawner/random/exotic/antag_gear_weak,
/turf/open/floor/plating/icemoon,
/area/ruin/unpowered)
"Zy" = (
/obj/structure/table/reinforced,
/obj/effect/spawner/random/engineering/tool_alien,
/turf/open/floor/iron/icemoon,
/area/ruin/unpowered)

(1,1,1) = {"
MB
MB
MB
MB
MB
MB
MB
MB
MB
MB
MB
MB
MB
MB
MB
MB
MB
MB
MB
MB
MB
MB
MB
MB
MB
MB
MB
MB
MB
MB
"}
(2,1,1) = {"
MB
MB
MB
MB
MB
MB
MB
MB
MB
MB
MB
MB
MB
MB
MB
MB
MB
MB
MB
MB
MB
MB
MB
MB
MB
MB
MB
MB
MB
MB
"}
(3,1,1) = {"
MB
MB
QI
JC
JC
br
br
br
JC
br
br
br
JC
JC
br
br
JC
JC
br
br
br
br
br
br
JC
JC
JC
JC
MB
MB
"}
(4,1,1) = {"
MB
MB
MB
JC
nT
Hu
iv
iv
SS
JC
zB
of
zB
JB
zB
Ux
SR
JC
rB
sg
sE
Mb
KF
Hu
uG
yc
sg
JC
JC
JC
"}
(5,1,1) = {"
MB
JC
br
br
Hu
Lr
sE
xE
Si
br
lj
lj
lj
lj
lj
sg
lm
br
nT
sE
sE
LW
sE
sg
Hu
yc
Hu
RT
sg
hy
"}
(6,1,1) = {"
MB
hy
sg
RT
Fc
Fc
sg
Hu
nT
br
lj
lj
sg
sg
lj
lj
sg
br
Li
sE
sg
LW
uG
sg
sE
Mb
Hu
JC
JC
JC
"}
(7,1,1) = {"
MB
JC
br
JC
Hu
bj
nD
sE
SS
JC
Lt
dh
zB
CY
vM
lj
Bd
br
sE
dv
KF
br
br
br
JC
br
JC
JC
MB
MB
"}
(8,1,1) = {"
MB
MB
QI
br
sE
sg
sE
Hu
CN
JC
br
br
br
JC
JC
uZ
JC
JC
uG
sE
sE
br
tf
sg
sE
tN
NL
br
MB
MB
"}
(9,1,1) = {"
MB
MB
MB
JC
Up
sE
Hu
TN
sE
JN
sE
DI
sE
KF
LW
sg
LW
sE
sE
sE
nT
br
uO
sE
nR
sE
tN
br
MB
MB
"}
(10,1,1) = {"
MB
MB
MB
br
br
JC
JC
br
JC
JC
nT
sE
sg
Ot
Ot
Ot
LU
sE
DI
sg
sE
br
oT
sE
dv
sE
PZ
br
MB
MB
"}
(11,1,1) = {"
MB
MB
MB
br
BM
sE
nT
sg
sE
JN
sE
Lr
sE
sE
LW
sE
sE
KF
sE
sE
Au
JC
WM
sE
KF
sg
PZ
br
MB
MB
"}
(12,1,1) = {"
MB
QI
MB
br
nT
sg
SH
sg
Dy
JC
JC
br
br
br
JC
xf
br
br
LW
LW
Au
JC
Bs
sg
sE
sg
sg
JC
MB
MB
"}
(13,1,1) = {"
MB
MB
MB
JC
uG
Hu
Hu
sg
SS
br
iN
Ah
Lm
Lm
sg
KF
nT
JC
sE
sE
sE
JC
JC
iy
JC
xf
br
JC
MB
MB
"}
(14,1,1) = {"
MB
JC
JC
JC
sE
Yd
sE
Lr
sE
br
Zw
sg
uG
sE
Yl
it
sE
xf
sE
KF
sg
JC
WZ
KF
sE
sE
VO
JC
MB
MB
"}
(15,1,1) = {"
MB
hy
sg
RT
Hu
Hu
sg
Hu
xA
JC
sE
sE
sg
DI
sE
sE
it
JC
nT
sE
sE
JC
sL
sE
Li
uG
aP
JC
MB
MB
"}
(16,1,1) = {"
MB
JC
br
br
sE
Hu
eZ
iv
SS
br
nT
lU
Zy
DW
sE
sg
sg
JC
sE
FL
sE
br
GG
sE
sE
sg
yT
JC
MB
MB
"}
(17,1,1) = {"
MB
MB
MB
br
JC
JC
br
br
br
br
br
br
JC
JC
uG
Yl
PZ
br
sE
uG
KF
br
OZ
xA
nR
sE
KE
JC
MB
MB
"}
(18,1,1) = {"
MB
MB
MB
br
OM
sE
bY
Vp
vX
bY
Vp
cY
pc
JC
sE
sE
PZ
br
dv
LW
LW
br
oT
sE
sE
sE
sE
br
MB
MB
"}
(19,1,1) = {"
MB
MB
MB
JC
UL
uG
sE
Lm
sE
Lm
oF
sE
sE
br
KF
sE
sE
JC
sg
sE
sE
JC
nT
sE
Eg
aP
uG
br
MB
MB
"}
(20,1,1) = {"
MB
MB
MB
br
Dl
sg
nR
sE
sE
sg
KF
sE
if
br
sE
sE
NB
JC
nR
sE
uG
xf
sE
uG
nP
oI
KF
br
MB
MB
"}
(21,1,1) = {"
MB
MB
MB
br
Sg
sE
sE
KF
sE
sg
uG
sE
Jt
JC
sE
sg
uG
JC
sg
sE
sE
JC
oT
sE
sE
nD
sg
JC
MB
MB
"}
(22,1,1) = {"
MB
MB
MB
JC
Sg
sE
uG
WU
Mz
sE
sE
sE
sg
xf
sE
sg
Ah
br
uG
sE
sE
br
sg
sE
sE
sg
sE
JC
MB
MB
"}
(23,1,1) = {"
MB
MB
MB
JC
nT
ox
Dr
bY
Vp
YA
YA
rb
MQ
br
WU
Ut
mr
br
nT
sE
KF
br
rB
sE
KF
sE
nD
JC
MB
MB
"}
(24,1,1) = {"
MB
MB
MB
JC
JC
br
br
br
JC
br
br
br
JC
JC
JC
JC
br
br
br
br
JC
br
br
JC
JC
br
br
JC
MB
MB
"}
(25,1,1) = {"
MB
MB
MB
MB
MB
MB
MB
MB
MB
MB
MB
MB
MB
MB
MB
MB
MB
MB
MB
MB
MB
MB
MB
MB
MB
MB
MB
MB
MB
MB
"}
(26,1,1) = {"
MB
MB
MB
MB
MB
MB
MB
MB
MB
MB
MB
MB
MB
MB
MB
MB
MB
MB
MB
MB
MB
MB
MB
MB
MB
MB
MB
MB
MB
MB
"}
