//MAP CONVERTED BY dmm2tgm.py THIS HEADER COMMENT PREVENTS RECONVERSION, DO NOT REMOVE
"ap" = (
/obj/structure/rack/gunrack,
/obj/item/gun/energy/laser/retro,
/turf/open/floor/iron/dark,
/area/space)
"bg" = (
/obj/structure/chair/comfy/shuttle{
	dir = 8
	},
/turf/open/floor/iron/smooth,
/area/space)
"bE" = (
/obj/structure/chair/comfy/shuttle{
	dir = 8
	},
/turf/open/floor/iron/dark/red,
/area/space)
"cz" = (
/obj/structure/decorative/shelf/crates1,
/turf/open/floor/iron/icemoon,
/area/space)
"dA" = (
/obj/structure/bed,
/obj/effect/spawner/random/clothing/syndie,
/turf/open/floor/iron/dark/brown,
/area/space)
"es" = (
/obj/structure/window/reinforced,
/obj/structure/bed,
/obj/item/laser_pointer/upgraded,
/turf/open/floor/iron/dark/brown,
/area/space)
"eP" = (
/mob/living/simple_animal/hostile/russian,
/obj/structure/chair/comfy/shuttle{
	dir = 8
	},
/turf/open/floor/iron/dark,
/area/space)
"fk" = (
/turf/open/floor/iron/dark,
/area/space)
"fB" = (
/obj/item/modular_computer/laptop/preset/syndicate,
/obj/structure/table/reinforced,
/turf/open/floor/iron/dark,
/area/space)
"fP" = (
/obj/item/paper,
/obj/item/paper{
	pixel_x = 7
	},
/obj/item/paper{
	pixel_x = 3;
	pixel_y = 4
	},
/obj/item/paper_bin{
	pixel_x = 12;
	pixel_y = 9
	},
/obj/item/pen,
/obj/structure/table/reinforced,
/turf/open/floor/iron/dark/red,
/area/space)
"gF" = (
/obj/machinery/iv_drip,
/obj/machinery/stasis,
/turf/open/floor/iron/icemoon,
/area/space)
"hs" = (
/obj/structure/table/reinforced,
/obj/effect/spawner/random/decoration/ornament,
/turf/open/floor/iron/dark/red,
/area/space)
"hx" = (
/obj/machinery/door/airlock/vault{
	id_tag = "syndie_lavaland_vault";
	req_access_txt = "150"
	},
/turf/open/floor/iron/dark,
/area/space)
"hD" = (
/obj/machinery/light/broken,
/turf/open/floor/iron/dark/red,
/area/space)
"hK" = (
/obj/structure/table/reinforced,
/turf/open/floor/iron/dark/red,
/area/space)
"hY" = (
/obj/structure/chair/comfy/shuttle{
	dir = 8
	},
/mob/living/simple_animal/hostile/russian/ranged/officer,
/turf/open/floor/iron/dark,
/area/space)
"il" = (
/obj/item/defibrillator/loaded,
/obj/structure/table,
/obj/item/gun/syringe,
/turf/open/floor/iron/smooth,
/area/space)
"jo" = (
/obj/machinery/light/broken,
/obj/structure/chair/comfy/shuttle{
	dir = 8
	},
/turf/open/floor/iron/dark/red,
/area/space)
"kQ" = (
/mob/living/simple_animal/hostile/russian/ranged/trooper,
/turf/open/floor/iron/dark,
/area/space)
"lc" = (
/turf/open/floor/iron/smooth,
/area/space)
"lI" = (
/mob/living/simple_animal/hostile/russian,
/turf/open/floor/iron/dark/red,
/area/space)
"nt" = (
/mob/living/simple_animal/hostile/russian/ranged,
/turf/open/floor/iron/dark,
/area/space)
"nC" = (
/obj/machinery/light/broken{
	dir = 4
	},
/turf/open/floor/iron/icemoon,
/area/space)
"nR" = (
/obj/item/statuebust/hippocratic,
/turf/open/floor/iron/dark/brown,
/area/space)
"oa" = (
/mob/living/simple_animal/hostile/russian,
/turf/open/floor/iron/smooth,
/area/space)
"oV" = (
/obj/machinery/computer{
	dir = 8
	},
/turf/open/floor/iron/icemoon,
/area/space)
"qK" = (
/obj/effect/spawner/random/engineering/material_rare,
/obj/effect/spawner/random/engineering/material_rare,
/obj/effect/spawner/random/engineering/material_rare,
/obj/effect/spawner/random/engineering/material_rare,
/obj/effect/spawner/random/engineering/material,
/obj/effect/spawner/random/engineering/material,
/obj/effect/spawner/random/engineering/material,
/obj/effect/spawner/random/engineering/material,
/turf/open/floor/plating/icemoon,
/area/space)
"qM" = (
/obj/machinery/light/broken,
/mob/living/simple_animal/hostile/russian/ranged,
/turf/open/floor/iron/smooth,
/area/space)
"qW" = (
/turf/open/floor/iron/dark/red,
/area/space)
"rr" = (
/obj/structure/window/reinforced,
/obj/structure/bed,
/obj/item/instrument/guitar,
/turf/open/floor/iron/dark/brown,
/area/space)
"rE" = (
/obj/structure/chair/comfy/shuttle{
	dir = 4
	},
/turf/open/floor/iron/smooth,
/area/space)
"sc" = (
/obj/machinery/ammo_workbench,
/turf/open/floor/iron/dark,
/area/space)
"sR" = (
/obj/machinery/door/airlock/hos,
/turf/open/floor/iron/icemoon,
/area/space)
"tk" = (
/obj/machinery/door/airlock/external{
	req_access_txt = "150"
	},
/turf/open/floor/plating/icemoon,
/area/space)
"wg" = (
/obj/machinery/light/broken{
	dir = 4
	},
/obj/structure/table/reinforced,
/turf/open/floor/iron/dark/red,
/area/space)
"wA" = (
/obj/machinery/suit_storage_unit/syndicate,
/obj/machinery/light/broken{
	dir = 8
	},
/turf/open/floor/iron/dark,
/area/space)
"xl" = (
/turf/closed/wall/mineral/plastitanium,
/area/space)
"xu" = (
/obj/structure/decorative/shelf/crates,
/turf/open/floor/iron/icemoon,
/area/space)
"xx" = (
/obj/machinery/cell_charger_multi,
/obj/structure/table,
/turf/open/floor/iron/icemoon,
/area/space)
"xL" = (
/obj/machinery/autolathe,
/turf/open/floor/plating/icemoon,
/area/space)
"yC" = (
/obj/item/geiger_counter{
	pixel_x = -6
	},
/obj/item/multitool/advanced{
	pixel_x = 6
	},
/obj/item/crowbar/advanced,
/obj/item/screwdriver/nuke{
	pixel_y = 6
	},
/obj/structure/table,
/turf/open/floor/plating/icemoon,
/area/space)
"yD" = (
/obj/machinery/door/airlock/highsecurity,
/turf/open/floor/iron/dark/brown,
/area/space)
"yV" = (
/obj/machinery/computer{
	dir = 4
	},
/turf/open/floor/iron/dark,
/area/space)
"zb" = (
/obj/structure/chair/comfy/shuttle{
	dir = 8
	},
/turf/open/floor/iron/dark,
/area/space)
"zg" = (
/obj/effect/spawner/random/decoration/glowstick,
/turf/open/floor/iron/smooth,
/area/space)
"zN" = (
/obj/structure/table,
/obj/item/stamp/syndicate,
/turf/open/floor/iron/smooth,
/area/space)
"zU" = (
/obj/machinery/light/broken{
	dir = 8
	},
/turf/open/floor/iron/icemoon,
/area/space)
"Ak" = (
/obj/machinery/space_heater,
/turf/open/floor/plating/icemoon,
/area/space)
"AJ" = (
/turf/open/floor/iron/dark/brown,
/area/space)
"AL" = (
/obj/structure/rack/shelf,
/obj/item/switchblade,
/turf/open/floor/iron/dark/red,
/area/space)
"AP" = (
/turf/open/genturf,
/area/space)
"Bx" = (
/mob/living/simple_animal/hostile/skeleton/ice,
/turf/open/floor/plating/asteroid/snow/icemoon,
/area/space)
"Cf" = (
/obj/structure/extinguisher_cabinet/directional/north,
/turf/open/floor/iron/icemoon,
/area/space)
"Dn" = (
/obj/structure/shuttle/engine/propulsion{
	dir = 4
	},
/turf/open/floor/plating/icemoon,
/area/space)
"Dq" = (
/mob/living/simple_animal/hostile/russian,
/turf/open/floor/iron/dark,
/area/space)
"DB" = (
/obj/structure/table,
/obj/item/slimecross/stabilized/gold{
	pixel_x = 6;
	pixel_y = 8
	},
/obj/item/slimecross/stabilized/metal,
/turf/open/floor/iron/smooth,
/area/space)
"DY" = (
/obj/machinery/door/airlock/highsecurity,
/turf/open/floor/iron/smooth,
/area/space)
"Ej" = (
/obj/machinery/door/airlock/maintenance_hatch,
/turf/open/floor/plating/icemoon,
/area/space)
"Em" = (
/obj/effect/spawner/structure/window/plasma/reinforced/plastitanium,
/turf/open/floor/plating/icemoon,
/area/space)
"Fs" = (
/turf/open/floor/plating/asteroid/snow/icemoon,
/area/space)
"Fw" = (
/obj/item/inducer/syndicate,
/obj/structure/table,
/turf/open/floor/plating/icemoon,
/area/space)
"FE" = (
/obj/structure/table,
/obj/effect/spawner/random/engineering/flashlight,
/turf/open/floor/iron/icemoon,
/area/space)
"Hb" = (
/obj/item/cardboard_cutout/adaptive,
/obj/machinery/light/broken{
	dir = 1
	},
/turf/open/floor/iron/smooth,
/area/space)
"Is" = (
/mob/living/simple_animal/hostile/skeleton/plasmaminer/jackhammer,
/turf/open/floor/plating/asteroid/snow/icemoon,
/area/space)
"Js" = (
/obj/structure/table,
/obj/item/food/boiledegg,
/obj/item/food/burrito{
	pixel_x = 6
	},
/obj/item/food/cherrycupcake{
	pixel_x = -8;
	pixel_y = 5
	},
/obj/item/food/chococornet{
	pixel_x = -6;
	pixel_y = -6
	},
/obj/item/food/cornedbeef{
	pixel_x = 9;
	pixel_y = 10
	},
/turf/open/floor/iron/dark/brown,
/area/space)
"Jx" = (
/turf/open/floor/iron/icemoon,
/area/space)
"KX" = (
/obj/machinery/light/broken,
/turf/open/floor/iron/dark/brown,
/area/space)
"LX" = (
/mob/living/simple_animal/hostile/skeleton/plasmaminer,
/turf/open/floor/plating/asteroid/snow/icemoon,
/area/space)
"Nz" = (
/obj/machinery/suit_storage_unit/mining/eva,
/turf/open/floor/iron/smooth,
/area/space)
"NK" = (
/obj/machinery/door/airlock/highsecurity,
/turf/open/floor/iron/icemoon,
/area/space)
"OG" = (
/obj/machinery/computer/crew{
	dir = 4
	},
/turf/open/floor/iron/icemoon,
/area/space)
"OJ" = (
/turf/closed/wall/r_wall/syndicate/nodiagonal,
/area/space)
"OR" = (
/obj/structure/table/reinforced,
/obj/item/gun_maintenance_supplies,
/turf/open/floor/iron/dark,
/area/space)
"Pq" = (
/turf/closed/mineral/random/snow,
/area/space)
"PB" = (
/obj/structure/table,
/obj/item/soap/syndie,
/turf/open/floor/iron/dark/brown,
/area/space)
"Rb" = (
/obj/machinery/power/emitter/welded{
	dir = 8
	},
/turf/open/floor/iron/dark/red,
/area/space)
"Rl" = (
/mob/living/simple_animal/hostile/russian,
/turf/open/floor/iron/icemoon,
/area/space)
"Ro" = (
/obj/structure/tank_dispenser/oxygen,
/turf/open/floor/iron/smooth,
/area/space)
"RI" = (
/turf/open/floor/plating/icemoon,
/area/space)
"RL" = (
/obj/structure/table,
/obj/machinery/recharger,
/turf/open/floor/iron/icemoon,
/area/space)
"RV" = (
/obj/machinery/light/broken,
/turf/open/floor/iron/smooth,
/area/space)
"SY" = (
/mob/living/simple_animal/hostile/russian,
/turf/open/floor/plating/icemoon,
/area/space)
"Td" = (
/obj/structure/chair/comfy/shuttle,
/turf/open/floor/iron/smooth,
/area/space)
"Tz" = (
/mob/living/simple_animal/hostile/russian,
/turf/open/floor/iron/dark/brown,
/area/space)
"TK" = (
/obj/structure/table/reinforced,
/obj/item/coin/gold,
/obj/item/coin/gold{
	pixel_x = -7;
	pixel_y = 8
	},
/obj/item/coin/diamond{
	pixel_x = 6;
	pixel_y = 4
	},
/obj/item/coin/bananium{
	pixel_x = -4;
	pixel_y = 3
	},
/obj/item/raw_anomaly_core/random{
	pixel_x = 6;
	pixel_y = -4
	},
/obj/item/raw_anomaly_core/random{
	pixel_y = -4
	},
/obj/item/raw_anomaly_core/random{
	pixel_x = -6;
	pixel_y = -4
	},
/turf/open/floor/iron/dark/red,
/area/space)
"Ux" = (
/obj/structure/tank_holder/extinguisher,
/turf/open/floor/iron/smooth,
/area/space)
"UB" = (
/obj/item/choice_beacon/ingredient,
/obj/structure/table,
/obj/machinery/light/broken{
	dir = 1
	},
/turf/open/floor/iron/dark/brown,
/area/space)
"Vs" = (
/obj/machinery/nuclearbomb/beer,
/turf/open/floor/iron/dark/brown,
/area/space)
"Vw" = (
/obj/structure/table/reinforced,
/obj/item/binoculars,
/obj/machinery/light/broken{
	dir = 8
	},
/obj/machinery/recharger,
/turf/open/floor/iron/dark,
/area/space)
"VB" = (
/obj/machinery/light/broken{
	dir = 8
	},
/turf/open/floor/iron/smooth,
/area/space)
"VO" = (
/obj/structure/table/reinforced,
/obj/item/disk/tech_disk/spaceloot,
/obj/item/disk/tech_disk/spaceloot{
	pixel_x = 5;
	pixel_y = 5
	},
/obj/item/megaphone/command,
/turf/open/floor/iron/dark,
/area/space)
"XN" = (
/obj/item/pickaxe/mini,
/obj/item/pickaxe/mini,
/obj/item/pickaxe/mini,
/obj/item/resonator/upgraded,
/obj/structure/table,
/turf/open/floor/plating/icemoon,
/area/space)
"Yy" = (
/obj/structure/bed/roller,
/turf/open/floor/iron/smooth,
/area/space)
"YW" = (
/mob/living/simple_animal/hostile/russian/ranged,
/turf/open/floor/iron/smooth,
/area/space)
"Zd" = (
/obj/structure/table/reinforced,
/obj/item/grenade/barrier,
/obj/item/grenade/barrier,
/obj/item/grenade/barrier,
/turf/open/floor/iron/dark,
/area/space)

(1,1,1) = {"
AP
AP
AP
AP
Pq
Pq
Pq
AP
AP
AP
Pq
AP
Pq
Pq
Pq
AP
"}
(2,1,1) = {"
AP
AP
Pq
Pq
Pq
Pq
Em
Em
xl
Pq
Pq
Pq
Pq
Pq
Pq
Pq
"}
(3,1,1) = {"
AP
Pq
Pq
Pq
Pq
Pq
yV
yV
fB
xl
Pq
Pq
Pq
Pq
Pq
Pq
"}
(4,1,1) = {"
AP
Pq
Pq
Pq
Pq
eP
zb
hY
fk
Vw
xl
Em
Em
Em
xl
AP
"}
(5,1,1) = {"
Pq
Pq
Pq
Pq
Zd
fk
fk
fk
fk
VO
xl
Rb
hK
Rb
xl
AP
"}
(6,1,1) = {"
Pq
Pq
Pq
xl
xl
xl
sR
xl
xl
xl
xl
bE
fk
jo
xl
AP
"}
(7,1,1) = {"
Pq
Pq
xl
Hb
rE
VB
lc
lc
VB
lc
DY
qW
nt
qW
xl
AP
"}
(8,1,1) = {"
Pq
Pq
xl
Td
zN
oa
lc
lc
lc
Ro
xl
qW
fk
qW
xl
AP
"}
(9,1,1) = {"
Pq
Pq
xl
Td
DB
lc
YW
lc
zg
Nz
xl
hs
fk
lI
xl
AP
"}
(10,1,1) = {"
Fs
Pq
xl
Hb
bg
lc
lc
lc
lc
Nz
xl
fP
wg
qW
xl
Fs
"}
(11,1,1) = {"
Fs
xl
xl
xl
xl
xl
Yy
lc
qM
OJ
OJ
OJ
OJ
OJ
OJ
Fs
"}
(12,1,1) = {"
Fs
xl
UB
Js
nR
xl
il
lc
lc
OJ
wA
TK
OR
OJ
OJ
Bx
"}
(13,1,1) = {"
Fs
Em
PB
AJ
AJ
yD
lc
zg
lc
hx
fk
Dq
hD
OJ
OJ
Fs
"}
(14,1,1) = {"
Fs
Em
Vs
Tz
KX
xl
lc
oa
lc
hx
kQ
fk
lI
OJ
OJ
Is
"}
(15,1,1) = {"
Fs
Em
AJ
AJ
AJ
xl
Ux
lc
RV
OJ
ap
AL
sc
OJ
OJ
Fs
"}
(16,1,1) = {"
Fs
xl
rr
es
dA
xl
xl
NK
xl
OJ
OJ
OJ
OJ
OJ
xl
Fs
"}
(17,1,1) = {"
Fs
xl
xl
xl
xl
xl
cz
Jx
OG
gF
zU
Jx
tk
RI
tk
LX
"}
(18,1,1) = {"
Fs
xl
xL
Fw
yC
xl
xu
Jx
Rl
Jx
Jx
Jx
xl
xl
xl
Fs
"}
(19,1,1) = {"
Fs
xl
RI
SY
RI
Ej
Jx
Jx
Jx
Jx
Jx
Rl
RL
xl
Bx
Fs
"}
(20,1,1) = {"
Fs
xl
Ak
qK
XN
xl
Cf
nC
oV
FE
nC
Jx
xx
xl
Fs
Fs
"}
(21,1,1) = {"
Fs
xl
xl
xl
xl
xl
xl
xl
xl
xl
xl
xl
xl
xl
LX
Is
"}
(22,1,1) = {"
Fs
Dn
Dn
Dn
xl
xl
Dn
Dn
Dn
xl
xl
Dn
Dn
Dn
Fs
Fs
"}
