//MAP CONVERTED BY dmm2tgm.py THIS HEADER COMMENT PREVENTS RECONVERSION, DO NOT REMOVE
"dS" = (
/obj/structure/rack,
/obj/item/soap/deluxe,
/obj/item/soap/deluxe,
/obj/item/soap/deluxe,
/turf/open/floor/iron,
/area/space)
"dX" = (
/obj/structure/rack/shelf,
/obj/structure/window/reinforced,
/obj/structure/window/reinforced{
	dir = 1;
	pixel_y = 4
	},
/obj/machinery/door/window/brigdoor{
	dir = 4
	},
/obj/item/slimepotion/speed,
/obj/item/slimepotion/speed,
/obj/item/slimepotion/slime_reviver{
	pixel_x = 5
	},
/obj/item/slimepotion/slime_reviver{
	pixel_x = 5
	},
/obj/item/slimepotion/slime_reviver{
	pixel_x = 5
	},
/obj/item/stack/sheet/mineral/diamond{
	amount = 25
	},
/obj/item/stack/sheet/mineral/gold{
	amount = 10
	},
/obj/item/stack/sheet/mineral/plasma/thirty,
/turf/open/floor/iron,
/area/space)
"hH" = (
/obj/structure/rack/shelf,
/obj/item/food/bread/root{
	pixel_y = 12
	},
/obj/item/food/bread/root{
	pixel_y = 12
	},
/obj/item/food/bread/root{
	pixel_y = 12
	},
/obj/item/food/bread/root{
	pixel_y = 12
	},
/obj/item/food/bread/root{
	pixel_y = 12
	},
/obj/item/food/bread/root{
	pixel_y = 12
	},
/obj/item/food/bread/root{
	pixel_y = 12
	},
/obj/item/food/bread/root{
	pixel_y = 12
	},
/obj/item/food/baguette,
/obj/item/food/baguette,
/obj/item/food/baguette,
/obj/item/food/baguette,
/obj/item/food/baguette,
/obj/item/food/baguette,
/obj/item/food/baguette,
/obj/item/food/baguette,
/obj/item/food/baguette,
/turf/open/floor/iron,
/area/space)
"ix" = (
/obj/structure/rack/shelf,
/obj/item/reagent_containers/food/condiment/vinegar,
/obj/item/reagent_containers/food/condiment/vinegar,
/obj/item/reagent_containers/food/condiment/vinegar,
/obj/item/reagent_containers/food/condiment/vinegar,
/obj/item/reagent_containers/food/condiment/vinegar,
/obj/item/reagent_containers/food/condiment/vinegar,
/obj/item/reagent_containers/food/condiment/vinegar,
/turf/open/floor/iron,
/area/space)
"jl" = (
/obj/structure/rack/shelf,
/obj/item/inducer,
/obj/item/inducer,
/obj/item/inducer,
/obj/item/inducer,
/obj/item/inducer,
/obj/item/inducer,
/turf/open/floor/iron,
/area/space)
"jq" = (
/obj/structure/rack/shelf,
/obj/item/tank/internals/plasmaman/belt/full,
/obj/item/tank/internals/plasmaman/belt/full,
/obj/item/tank/internals/plasmaman/belt/full,
/obj/item/tank/internals/plasmaman/belt/full,
/obj/item/tank/internals/plasmaman/belt/full,
/obj/item/tank/internals/plasmaman/belt/full,
/obj/item/tank/internals/plasmaman/belt/full,
/obj/item/tank/internals/nitrogen/belt/full,
/obj/item/tank/internals/nitrogen/belt/full,
/obj/item/tank/internals/nitrogen/belt/full,
/obj/item/tank/internals/nitrogen/belt/full,
/obj/item/tank/internals/nitrogen/belt/full,
/obj/item/tank/internals/nitrogen/belt/full,
/obj/item/tank/internals/emergency_oxygen/double,
/obj/item/tank/internals/emergency_oxygen/double,
/obj/item/tank/internals/emergency_oxygen/double,
/obj/item/tank/internals/emergency_oxygen/double,
/obj/item/tank/internals/emergency_oxygen/double,
/obj/item/tank/internals/emergency_oxygen/double,
/obj/item/tank/internals/emergency_oxygen/double,
/obj/item/tank/internals/emergency_oxygen/double,
/obj/item/tank/internals/emergency_oxygen/double,
/turf/open/floor/iron,
/area/space)
"jw" = (
/obj/structure/rack/shelf,
/obj/item/switchblade,
/obj/item/switchblade,
/obj/item/switchblade,
/turf/open/floor/iron,
/area/space)
"jD" = (
/turf/closed/wall/r_wall,
/area/space)
"ke" = (
/obj/structure/rack/shelf,
/turf/open/floor/iron,
/area/space)
"ki" = (
/obj/structure/rack/shelf,
/obj/item/stack/sheet/mineral/wood/fifty,
/obj/item/stack/sheet/mineral/wood/fifty,
/obj/item/stack/sheet/mineral/wood/fifty,
/turf/open/floor/iron,
/area/space)
"lQ" = (
/obj/structure/rack/shelf,
/obj/item/implanter/mortis,
/obj/item/implanter/mortis,
/obj/item/implanter/mortis,
/obj/item/implanter/mortis,
/obj/item/implanter/mortis,
/obj/item/implanter/mortis,
/obj/item/laser_pointer{
	pixel_y = 6
	},
/obj/item/laser_pointer{
	pixel_y = 6
	},
/obj/item/laser_pointer{
	pixel_y = 6
	},
/obj/item/laser_pointer{
	pixel_y = 6
	},
/obj/item/laser_pointer{
	pixel_y = 6
	},
/obj/item/laser_pointer{
	pixel_y = 6
	},
/turf/open/floor/iron,
/area/space)
"mG" = (
/obj/structure/rack,
/turf/open/floor/iron,
/area/space)
"nC" = (
/obj/structure/rack,
/obj/item/raw_anomaly_core/random,
/obj/item/raw_anomaly_core/random,
/obj/item/raw_anomaly_core/random,
/obj/item/raw_anomaly_core/random,
/turf/open/floor/iron,
/area/space)
"oB" = (
/obj/structure/closet/crate/freezer{
	anchored = 1
	},
/obj/item/food/bbqribs,
/obj/item/food/bbqribs,
/obj/item/food/bbqribs,
/obj/item/food/bbqribs,
/obj/item/food/bbqribs,
/obj/item/food/bbqribs,
/obj/item/food/bbqribs,
/obj/item/food/beef_wellington,
/obj/item/food/beef_wellington,
/obj/item/food/beef_wellington,
/obj/item/food/beef_wellington,
/obj/item/food/beef_wellington,
/obj/item/food/beef_wellington,
/turf/open/floor/iron,
/area/space)
"pi" = (
/obj/structure/rack/shelf,
/obj/item/stack/sheet/plasteel/fifty,
/obj/item/stack/sheet/plasteel/fifty,
/obj/item/stack/sheet/plasteel/fifty,
/obj/item/stack/sheet/runed_metal/ten,
/turf/open/floor/iron,
/area/space)
"pX" = (
/obj/structure/rack,
/obj/item/glassblowing/blowing_rod,
/obj/item/glassblowing/blowing_rod,
/obj/item/glassblowing/blowing_rod,
/obj/item/glassblowing/jacks,
/obj/item/glassblowing/jacks,
/obj/item/glassblowing/jacks,
/obj/item/glassblowing/paddle,
/obj/item/glassblowing/paddle,
/obj/item/glassblowing/paddle,
/obj/item/glassblowing/shears,
/obj/item/glassblowing/shears,
/obj/item/glassblowing/shears,
/turf/open/floor/iron,
/area/space)
"qL" = (
/obj/structure/closet/crate/freezer,
/obj/item/food/meat/slab,
/obj/item/food/meat/slab,
/obj/item/food/meat/slab,
/obj/item/food/meat/slab,
/obj/item/food/meat/slab,
/obj/item/food/meat/slab,
/obj/item/food/meat/slab,
/obj/item/food/meat/slab,
/obj/item/food/meat/slab,
/obj/item/food/meat/slab,
/obj/item/food/meat/slab,
/obj/item/food/meat/slab,
/obj/item/food/meat/slab,
/obj/item/food/raw_sausage,
/obj/item/food/raw_sausage,
/obj/item/food/raw_sausage,
/obj/item/food/raw_sausage,
/obj/item/food/raw_sausage,
/obj/item/food/raw_sausage,
/obj/item/food/raw_sausage,
/turf/open/floor/iron,
/area/space)
"si" = (
/obj/machinery/porta_turret/syndicate/energy/heavy{
	dir = 1
	},
/turf/open/floor/plating/asteroid/snow/icemoon,
/area/space)
"tF" = (
/obj/structure/rack/shelf,
/obj/item/pickaxe/diamond,
/obj/item/pickaxe/diamond,
/obj/item/pickaxe/drill/diamonddrill,
/obj/item/pickaxe/drill/diamonddrill,
/turf/open/floor/iron,
/area/space)
"tN" = (
/obj/structure/rack/shelf,
/obj/item/seeds/wheat/meat,
/turf/open/floor/iron,
/area/space)
"ue" = (
/turf/open/floor/plating,
/area/space)
"uf" = (
/obj/item/kirbyplants/random,
/turf/open/floor/iron,
/area/space)
"uW" = (
/obj/structure/rack/shelf,
/obj/item/kinetic_crusher,
/obj/item/kinetic_crusher,
/obj/item/kinetic_crusher,
/obj/item/mining_voucher,
/obj/item/mining_voucher,
/obj/item/mining_voucher,
/obj/item/mining_voucher,
/turf/open/floor/iron,
/area/space)
"wW" = (
/obj/structure/rack/shelf,
/obj/item/stack/sheet/plastic/fifty,
/obj/item/stack/sheet/plastic/fifty,
/turf/open/floor/iron,
/area/space)
"xq" = (
/obj/structure/rack/shelf,
/obj/item/food/canned/envirochow{
	pixel_x = 9;
	pixel_y = 12
	},
/obj/item/food/canned/envirochow{
	pixel_x = 9;
	pixel_y = 12
	},
/obj/item/food/canned/envirochow{
	pixel_x = 9;
	pixel_y = 12
	},
/obj/item/food/canned/envirochow{
	pixel_x = 9;
	pixel_y = 12
	},
/obj/item/food/canned/envirochow{
	pixel_x = 9;
	pixel_y = 12
	},
/obj/item/food/canned/envirochow{
	pixel_x = 9;
	pixel_y = 12
	},
/obj/item/food/canned/envirochow{
	pixel_x = 9;
	pixel_y = 12
	},
/obj/item/food/canned/envirochow{
	pixel_x = 9;
	pixel_y = 12
	},
/obj/item/food/canned/envirochow{
	pixel_x = 9;
	pixel_y = 12
	},
/obj/item/food/canned/envirochow{
	pixel_x = 9;
	pixel_y = 12
	},
/obj/item/food/syndicake{
	pixel_x = -8;
	pixel_y = 9
	},
/obj/item/food/syndicake{
	pixel_x = -8;
	pixel_y = 9
	},
/obj/item/food/syndicake{
	pixel_x = -8;
	pixel_y = 9
	},
/obj/item/food/syndicake{
	pixel_x = -8;
	pixel_y = 9
	},
/obj/item/food/syndicake{
	pixel_x = -8;
	pixel_y = 9
	},
/obj/item/food/syndicake{
	pixel_x = -8;
	pixel_y = 9
	},
/obj/item/food/syndicake{
	pixel_x = -8;
	pixel_y = 9
	},
/obj/item/food/syndicake{
	pixel_x = -8;
	pixel_y = 9
	},
/obj/item/food/syndicake{
	pixel_x = -8;
	pixel_y = 9
	},
/obj/item/food/syndicake{
	pixel_x = -8;
	pixel_y = 9
	},
/turf/open/floor/iron,
/area/space)
"xs" = (
/obj/structure/closet/crate/freezer{
	anchored = 1
	},
/obj/item/food/burrito{
	pixel_x = -6
	},
/obj/item/food/burrito{
	pixel_x = -6
	},
/obj/item/food/burrito{
	pixel_x = -6
	},
/obj/item/food/burrito{
	pixel_x = -6
	},
/obj/item/food/burrito{
	pixel_x = -6
	},
/obj/item/food/burrito{
	pixel_x = -6
	},
/obj/item/food/burrito{
	pixel_x = -6
	},
/obj/item/food/burrito{
	pixel_x = -6
	},
/obj/item/food/burrito{
	pixel_x = -6
	},
/obj/item/food/burrito{
	pixel_x = -6
	},
/obj/item/food/burrito{
	pixel_x = -6
	},
/obj/item/food/carneburrito,
/obj/item/food/carneburrito,
/obj/item/food/carneburrito,
/obj/item/food/carneburrito,
/obj/item/food/carneburrito,
/obj/item/food/carneburrito,
/obj/item/food/carneburrito,
/obj/item/food/carneburrito,
/obj/item/food/carneburrito,
/obj/item/food/cheesyburrito{
	pixel_x = 9
	},
/obj/item/food/cheesyburrito{
	pixel_x = 9
	},
/obj/item/food/cheesyburrito{
	pixel_x = 9
	},
/obj/item/food/cheesyburrito{
	pixel_x = 9
	},
/obj/item/food/cheesyburrito{
	pixel_x = 9
	},
/obj/item/food/cheesyburrito{
	pixel_x = 9
	},
/obj/item/food/cheesyburrito{
	pixel_x = 9
	},
/obj/item/food/cheesyburrito{
	pixel_x = 9
	},
/obj/item/food/cheesyburrito{
	pixel_x = 9
	},
/obj/item/food/cheesyburrito{
	pixel_x = 9
	},
/turf/open/floor/iron,
/area/space)
"xt" = (
/turf/open/genturf,
/area/space)
"yg" = (
/obj/structure/closet/crate/freezer,
/obj/item/food/meat/slab/rawcrab,
/obj/item/food/meat/slab/rawcrab,
/obj/item/food/meat/slab/rawcrab,
/obj/item/food/meat/slab/rawcrab,
/obj/item/food/meat/slab/rawcrab,
/obj/item/food/meat/slab/rawcrab,
/obj/item/food/meat/slab/rawcrab,
/obj/item/food/meat/slab/rawcrab,
/obj/item/food/meat/slab/rawcrab,
/obj/item/food/meat/slab/rawcrab,
/obj/item/food/meat/slab/rawcrab,
/turf/open/floor/iron,
/area/space)
"yq" = (
/obj/structure/rack/shelf,
/obj/item/t_scanner/adv_mining_scanner,
/obj/item/t_scanner/adv_mining_scanner,
/obj/item/t_scanner/adv_mining_scanner,
/turf/open/floor/iron,
/area/space)
"zl" = (
/obj/structure/rack,
/obj/item/lipstick/random,
/obj/item/lipstick/random,
/obj/item/lipstick/random,
/obj/item/lipstick/random,
/obj/item/lipstick/random,
/obj/item/lipstick/random,
/obj/item/lipstick/random,
/obj/item/lipstick/random,
/obj/item/lipstick/random,
/obj/item/lipstick/random,
/turf/open/floor/iron,
/area/space)
"zv" = (
/obj/structure/rack/shelf,
/obj/item/language_manual/roundstart_species/five,
/turf/open/floor/iron,
/area/space)
"EZ" = (
/obj/structure/closet/crate/freezer{
	anchored = 1
	},
/obj/item/food/cheese/wheel,
/obj/item/food/cheese/wheel,
/obj/item/food/cheese/wheel,
/obj/item/food/cheese/wheel,
/obj/item/food/cheese/wheel,
/turf/open/floor/iron,
/area/space)
"Hb" = (
/obj/structure/rack,
/obj/item/paint/anycolor,
/turf/open/floor/iron,
/area/space)
"Hh" = (
/obj/structure/rack/shelf,
/obj/item/food/candy{
	pixel_x = 8;
	pixel_y = 8
	},
/obj/item/food/candy{
	pixel_x = 8;
	pixel_y = 8
	},
/obj/item/food/candy{
	pixel_x = 8;
	pixel_y = 8
	},
/obj/item/food/candy{
	pixel_x = 8;
	pixel_y = 8
	},
/obj/item/storage/fancy/cigarettes/cigpack_candy{
	pixel_x = 9;
	pixel_y = -9
	},
/obj/item/storage/fancy/cigarettes/cigpack_candy{
	pixel_x = 9;
	pixel_y = -9
	},
/obj/item/storage/fancy/cigarettes/cigpack_candy{
	pixel_x = 9;
	pixel_y = -9
	},
/obj/item/storage/fancy/cigarettes/cigpack_candy{
	pixel_x = 9;
	pixel_y = -9
	},
/obj/item/storage/fancy/cigarettes/cigpack_candy{
	pixel_x = 9;
	pixel_y = -9
	},
/obj/item/food/chocolatebar{
	pixel_x = -6;
	pixel_y = 9
	},
/obj/item/food/chocolatebar{
	pixel_x = -6;
	pixel_y = 9
	},
/obj/item/food/chocolatebar{
	pixel_x = -6;
	pixel_y = 9
	},
/obj/item/food/chocolatebar{
	pixel_x = -6;
	pixel_y = 9
	},
/obj/item/food/chocolatebar{
	pixel_x = -6;
	pixel_y = 9
	},
/obj/item/food/chocolatebar{
	pixel_x = -6;
	pixel_y = 9
	},
/obj/item/food/chocolatebar{
	pixel_x = -6;
	pixel_y = 9
	},
/obj/item/food/chocolatebar{
	pixel_x = -6;
	pixel_y = 9
	},
/obj/item/food/chocolatebar{
	pixel_x = -6;
	pixel_y = 9
	},
/obj/item/food/ant_candy{
	pixel_x = -9;
	pixel_y = 2
	},
/obj/item/food/ant_candy{
	pixel_x = -9;
	pixel_y = 2
	},
/obj/item/food/ant_candy{
	pixel_x = -9;
	pixel_y = 2
	},
/obj/item/food/ant_candy{
	pixel_x = -9;
	pixel_y = 2
	},
/obj/item/food/ant_candy{
	pixel_x = -9;
	pixel_y = 2
	},
/obj/item/food/ant_candy{
	pixel_x = -9;
	pixel_y = 2
	},
/obj/item/food/honeybar{
	pixel_x = -9;
	pixel_y = -12
	},
/obj/item/food/honeybar{
	pixel_x = -9;
	pixel_y = -12
	},
/obj/item/food/honeybar{
	pixel_x = -9;
	pixel_y = -12
	},
/obj/item/food/honeybar{
	pixel_x = -9;
	pixel_y = -12
	},
/obj/item/food/honeybar{
	pixel_x = -9;
	pixel_y = -12
	},
/obj/item/food/honeybar{
	pixel_x = -9;
	pixel_y = -12
	},
/obj/item/food/honeybar{
	pixel_x = -9;
	pixel_y = -12
	},
/obj/item/food/honeybar{
	pixel_x = -9;
	pixel_y = -12
	},
/turf/open/floor/iron,
/area/space)
"HS" = (
/obj/structure/closet/crate/freezer,
/obj/item/food/icecreamsandwich,
/obj/item/food/icecreamsandwich,
/obj/item/food/icecreamsandwich,
/obj/item/food/icecreamsandwich,
/obj/item/food/icecreamsandwich,
/obj/item/food/icecream/chocolate,
/obj/item/food/icecream/chocolate,
/obj/item/food/icecream/chocolate,
/obj/item/food/icecream/chocolate,
/obj/item/food/icecream/chocolate,
/obj/item/food/icecream/chocolate,
/obj/item/food/icecream/chocolate,
/obj/item/food/popsicle/creamsicle_orange,
/obj/item/food/popsicle/creamsicle_orange,
/obj/item/food/popsicle/creamsicle_orange,
/obj/item/food/popsicle/creamsicle_orange,
/obj/item/food/popsicle/creamsicle_orange,
/obj/item/food/popsicle/creamsicle_orange,
/obj/item/food/snowcones/honey,
/obj/item/food/snowcones/honey,
/obj/item/food/snowcones/honey,
/turf/open/floor/iron,
/area/space)
"IS" = (
/obj/structure/table,
/obj/item/gps/spaceruin,
/obj/item/megaphone/cargo,
/turf/open/floor/iron,
/area/space)
"IY" = (
/obj/structure/closet/crate/freezer,
/obj/item/food/meat/slab/chicken,
/obj/item/food/meat/slab/chicken,
/obj/item/food/meat/slab/chicken,
/obj/item/food/meat/slab/chicken,
/obj/item/food/meat/slab/chicken,
/obj/item/food/meat/slab/chicken,
/obj/item/food/meat/slab/chicken,
/obj/item/food/meat/slab/chicken,
/obj/item/food/meat/slab/chicken,
/obj/item/food/meat/slab/chicken,
/obj/item/food/meat/slab/chicken,
/obj/item/food/meat/slab/chicken,
/turf/open/floor/iron,
/area/space)
"Jc" = (
/obj/structure/closet/crate/freezer{
	anchored = 1
	},
/turf/open/floor/iron,
/area/space)
"JP" = (
/obj/structure/rack/shelf,
/obj/item/reagent_containers/food/condiment/quality_oil{
	pixel_x = 6
	},
/obj/item/reagent_containers/food/condiment/quality_oil{
	pixel_x = 6
	},
/obj/item/reagent_containers/food/condiment/quality_oil{
	pixel_x = 6
	},
/obj/item/reagent_containers/food/condiment/quality_oil{
	pixel_x = 6
	},
/obj/item/reagent_containers/food/condiment/quality_oil{
	pixel_x = 6
	},
/obj/item/reagent_containers/food/condiment/quality_oil{
	pixel_x = 6
	},
/obj/item/reagent_containers/food/condiment/quality_oil{
	pixel_x = 6
	},
/obj/item/reagent_containers/food/condiment/quality_oil{
	pixel_x = 6
	},
/obj/item/reagent_containers/food/condiment/quality_oil{
	pixel_x = 6
	},
/obj/item/reagent_containers/food/condiment/quality_oil{
	pixel_x = 6
	},
/obj/item/reagent_containers/food/condiment/quality_oil{
	pixel_x = 6
	},
/obj/item/reagent_containers/food/condiment/soysauce{
	pixel_x = -6
	},
/obj/item/reagent_containers/food/condiment/soysauce{
	pixel_x = -6
	},
/obj/item/reagent_containers/food/condiment/soysauce{
	pixel_x = -6
	},
/obj/item/reagent_containers/food/condiment/soysauce{
	pixel_x = -6
	},
/obj/item/reagent_containers/food/condiment/soysauce{
	pixel_x = -6
	},
/obj/item/reagent_containers/food/condiment/soysauce{
	pixel_x = -6
	},
/obj/item/reagent_containers/food/condiment/soysauce{
	pixel_x = -6
	},
/turf/open/floor/iron,
/area/space)
"Kt" = (
/turf/closed/wall,
/area/space)
"Kx" = (
/obj/structure/rack/shelf,
/obj/structure/window/reinforced,
/obj/machinery/door/window/brigdoor{
	dir = 4
	},
/obj/item/implanter/tracking,
/obj/item/implanter/tracking,
/obj/item/implanter/tracking,
/obj/item/implanter/tracking,
/obj/item/implanter/tracking/gps{
	pixel_y = 6
	},
/obj/item/implanter/tracking/gps{
	pixel_y = 6
	},
/obj/item/stack/telecrystal/twenty,
/turf/open/floor/iron,
/area/space)
"LA" = (
/obj/machinery/door/airlock/multi_tile/glass,
/obj/structure/fans/tiny/invisible,
/turf/open/floor/iron,
/area/space)
"Om" = (
/obj/structure/rack/shelf,
/obj/item/rod_of_asclepius,
/turf/open/floor/iron,
/area/space)
"Po" = (
/obj/structure/rack/shelf,
/obj/item/food/sosjerky/healthy,
/obj/item/food/sosjerky/healthy,
/obj/item/food/sosjerky/healthy,
/obj/item/food/sosjerky/healthy,
/obj/item/food/sosjerky/healthy,
/obj/item/food/sosjerky/healthy,
/obj/item/food/sosjerky/healthy,
/obj/item/food/sosjerky/healthy,
/obj/item/food/sosjerky/healthy,
/obj/item/food/sosjerky/healthy,
/turf/open/floor/iron,
/area/space)
"PR" = (
/obj/structure/rack/shelf,
/obj/item/soap/syndie,
/obj/item/soap/syndie,
/obj/item/soap/syndie,
/obj/item/soap/syndie,
/turf/open/floor/iron,
/area/space)
"PS" = (
/obj/machinery/porta_turret/syndicate{
	dir = 8
	},
/turf/open/floor/plating/asteroid/snow/icemoon,
/area/space)
"Qr" = (
/obj/structure/rack/shelf,
/obj/item/food/canned/beans{
	pixel_x = -6;
	pixel_y = 12
	},
/obj/item/food/canned/beans{
	pixel_x = -6;
	pixel_y = 12
	},
/obj/item/food/canned/beans{
	pixel_x = -6;
	pixel_y = 12
	},
/obj/item/food/canned/beans{
	pixel_x = -6;
	pixel_y = 12
	},
/obj/item/food/canned/beans{
	pixel_x = -6;
	pixel_y = 12
	},
/obj/item/food/canned/beans{
	pixel_x = -6;
	pixel_y = 12
	},
/obj/item/food/canned/peaches{
	pixel_x = 9;
	pixel_y = 12
	},
/obj/item/food/canned/peaches{
	pixel_x = 9;
	pixel_y = 12
	},
/obj/item/food/canned/peaches{
	pixel_x = 9;
	pixel_y = 12
	},
/obj/item/food/canned/peaches{
	pixel_x = 9;
	pixel_y = 12
	},
/obj/item/food/canned/peaches{
	pixel_x = 9;
	pixel_y = 12
	},
/obj/item/food/canned/peaches{
	pixel_x = 9;
	pixel_y = 12
	},
/obj/item/food/canned/peaches{
	pixel_x = 9;
	pixel_y = 12
	},
/obj/item/food/canned/peaches{
	pixel_x = 9;
	pixel_y = 12
	},
/obj/item/food/canned/peaches{
	pixel_x = 9;
	pixel_y = 12
	},
/obj/item/food/canned/peaches{
	pixel_x = 9;
	pixel_y = 12
	},
/obj/item/food/canned/peaches{
	pixel_x = 9;
	pixel_y = 12
	},
/obj/item/food/canned_jellyfish{
	pixel_x = 12;
	pixel_y = -6
	},
/obj/item/food/canned_jellyfish{
	pixel_x = 12;
	pixel_y = -6
	},
/obj/item/food/canned_jellyfish{
	pixel_x = 12;
	pixel_y = -6
	},
/obj/item/food/canned_jellyfish{
	pixel_x = 12;
	pixel_y = -6
	},
/obj/item/food/canned_jellyfish{
	pixel_x = 12;
	pixel_y = -6
	},
/obj/item/food/canned_jellyfish{
	pixel_x = 12;
	pixel_y = -6
	},
/obj/item/food/canned_jellyfish{
	pixel_x = 12;
	pixel_y = -6
	},
/obj/item/food/canned_jellyfish{
	pixel_x = 12;
	pixel_y = -6
	},
/obj/item/food/canned_jellyfish{
	pixel_x = 12;
	pixel_y = -6
	},
/obj/item/food/canned_jellyfish{
	pixel_x = 12;
	pixel_y = -6
	},
/obj/item/food/canned_jellyfish{
	pixel_x = 12;
	pixel_y = -6
	},
/obj/item/food/canned_jellyfish{
	pixel_x = 12;
	pixel_y = -6
	},
/obj/item/food/canned_jellyfish{
	pixel_x = 12;
	pixel_y = -6
	},
/obj/item/food/desert_snails{
	pixel_x = -9;
	pixel_y = -9
	},
/obj/item/food/desert_snails{
	pixel_x = -9;
	pixel_y = -9
	},
/obj/item/food/desert_snails{
	pixel_x = -9;
	pixel_y = -9
	},
/obj/item/food/desert_snails{
	pixel_x = -9;
	pixel_y = -9
	},
/obj/item/food/desert_snails{
	pixel_x = -9;
	pixel_y = -9
	},
/obj/item/food/desert_snails{
	pixel_x = -9;
	pixel_y = -9
	},
/obj/item/food/desert_snails{
	pixel_x = -9;
	pixel_y = -9
	},
/obj/item/food/desert_snails{
	pixel_x = -9;
	pixel_y = -9
	},
/obj/item/food/desert_snails{
	pixel_x = -9;
	pixel_y = -9
	},
/obj/item/food/desert_snails{
	pixel_x = -9;
	pixel_y = -9
	},
/obj/item/food/desert_snails{
	pixel_x = -9;
	pixel_y = -9
	},
/turf/open/floor/iron,
/area/space)
"Sw" = (
/obj/structure/rack/shelf,
/obj/item/reagent_containers/food/condiment/bbqsauce{
	pixel_x = 9
	},
/obj/item/reagent_containers/food/condiment/bbqsauce{
	pixel_x = 9
	},
/obj/item/reagent_containers/food/condiment/bbqsauce{
	pixel_x = 9
	},
/obj/item/reagent_containers/food/condiment/bbqsauce{
	pixel_x = 9
	},
/obj/item/reagent_containers/food/condiment/bbqsauce{
	pixel_x = 9
	},
/obj/item/reagent_containers/food/condiment/bbqsauce{
	pixel_x = 9
	},
/obj/item/reagent_containers/food/condiment/bbqsauce{
	pixel_x = 9
	},
/obj/item/reagent_containers/food/condiment/bbqsauce{
	pixel_x = 9
	},
/obj/item/reagent_containers/food/condiment/bbqsauce{
	pixel_x = 9
	},
/obj/item/reagent_containers/food/condiment/bbqsauce{
	pixel_x = 9
	},
/obj/item/reagent_containers/food/condiment/mayonnaise{
	pixel_x = -6
	},
/obj/item/reagent_containers/food/condiment/mayonnaise{
	pixel_x = -6
	},
/obj/item/reagent_containers/food/condiment/mayonnaise{
	pixel_x = -6
	},
/obj/item/reagent_containers/food/condiment/mayonnaise{
	pixel_x = -6
	},
/obj/item/reagent_containers/food/condiment/mayonnaise{
	pixel_x = -6
	},
/obj/item/reagent_containers/food/condiment/mayonnaise{
	pixel_x = -6
	},
/obj/item/reagent_containers/food/condiment/mayonnaise{
	pixel_x = -6
	},
/obj/item/reagent_containers/food/condiment/mayonnaise{
	pixel_x = -6
	},
/obj/item/reagent_containers/food/condiment/mayonnaise{
	pixel_x = -6
	},
/obj/item/reagent_containers/food/condiment/mayonnaise{
	pixel_x = -6
	},
/obj/item/reagent_containers/food/condiment/mayonnaise{
	pixel_x = -6
	},
/obj/item/reagent_containers/food/condiment/mayonnaise{
	pixel_x = -6
	},
/obj/item/reagent_containers/food/condiment/mayonnaise{
	pixel_x = -6
	},
/obj/item/reagent_containers/food/condiment/mayonnaise{
	pixel_x = -6
	},
/turf/open/floor/iron,
/area/space)
"SF" = (
/turf/open/floor/plating/asteroid/snow/icemoon,
/area/space)
"SQ" = (
/obj/structure/rack/shelf,
/obj/item/reagent_containers/syringe/antiviral,
/obj/item/reagent_containers/syringe/antiviral,
/obj/item/reagent_containers/syringe/antiviral,
/obj/item/reagent_containers/syringe/antiviral,
/obj/item/reagent_containers/syringe/antiviral,
/obj/item/reagent_containers/syringe/antiviral,
/obj/item/reagent_containers/syringe/epinephrine{
	pixel_y = 6
	},
/obj/item/reagent_containers/syringe/epinephrine{
	pixel_y = 6
	},
/obj/item/reagent_containers/syringe/epinephrine{
	pixel_y = 6
	},
/obj/item/reagent_containers/syringe/epinephrine{
	pixel_y = 6
	},
/obj/item/reagent_containers/syringe/epinephrine{
	pixel_y = 6
	},
/obj/item/reagent_containers/syringe/epinephrine{
	pixel_y = 6
	},
/obj/item/reagent_containers/syringe/penacid{
	pixel_y = -6
	},
/obj/item/reagent_containers/syringe/penacid{
	pixel_y = -6
	},
/obj/item/reagent_containers/syringe/penacid{
	pixel_y = -6
	},
/obj/item/reagent_containers/syringe/penacid{
	pixel_y = -6
	},
/obj/item/reagent_containers/syringe/penacid{
	pixel_y = -6
	},
/obj/item/reagent_containers/syringe/penacid{
	pixel_y = -6
	},
/obj/item/reagent_containers/syringe/penacid{
	pixel_y = -6
	},
/obj/item/reagent_containers/syringe/penacid{
	pixel_y = -6
	},
/turf/open/floor/iron,
/area/space)
"Tf" = (
/obj/machinery/scanner_gate,
/turf/open/floor/iron,
/area/space)
"UX" = (
/obj/structure/rack/shelf,
/obj/item/food/bread/plain{
	pixel_y = 12
	},
/obj/item/food/bread/plain{
	pixel_y = 12
	},
/obj/item/food/bread/plain{
	pixel_y = 12
	},
/obj/item/food/bread/plain{
	pixel_y = 12
	},
/obj/item/food/bread/plain{
	pixel_y = 12
	},
/obj/item/food/bread/plain{
	pixel_y = 12
	},
/obj/item/food/bread/plain{
	pixel_y = 12
	},
/obj/item/food/bread/plain{
	pixel_y = 12
	},
/obj/item/food/bread/banana,
/obj/item/food/bread/banana,
/obj/item/food/bread/banana,
/obj/item/food/bread/banana,
/obj/item/food/bread/banana,
/obj/item/food/bread/banana,
/obj/item/food/bread/banana,
/obj/item/food/bread/banana,
/turf/open/floor/iron,
/area/space)
"Vh" = (
/turf/open/floor/iron,
/area/space)
"Vq" = (
/obj/structure/rack/shelf,
/obj/item/poster/random_contraband,
/obj/item/poster/random_contraband,
/obj/item/poster/random_contraband,
/obj/item/poster/random_contraband,
/obj/item/poster/random_contraband,
/obj/item/poster/random_contraband,
/obj/item/poster/random_contraband,
/obj/item/poster/random_contraband,
/obj/item/poster/random_contraband,
/obj/item/poster/random_contraband,
/obj/item/poster/random_contraband,
/obj/item/poster/random_contraband,
/turf/open/floor/iron,
/area/space)
"VF" = (
/obj/structure/rack/shelf,
/obj/structure/window/reinforced,
/obj/machinery/door/window/brigdoor{
	dir = 4
	},
/obj/item/sharpener,
/turf/open/floor/iron,
/area/space)
"VL" = (
/obj/structure/fans/tiny/invisible,
/turf/open/floor/iron,
/area/space)
"WB" = (
/obj/structure/closet/crate/freezer,
/obj/item/food/grown/corn,
/obj/item/food/grown/corn,
/obj/item/food/grown/corn,
/obj/item/food/grown/corn,
/obj/item/food/grown/corn,
/obj/item/food/grown/corn,
/obj/item/food/grown/carrot,
/obj/item/food/grown/carrot,
/obj/item/food/grown/carrot,
/obj/item/food/grown/carrot,
/obj/item/food/grown/carrot,
/obj/item/food/grown/carrot,
/obj/item/food/grown/carrot,
/obj/item/food/grown/cabbage,
/obj/item/food/grown/cabbage,
/obj/item/food/grown/cabbage,
/obj/item/food/grown/cabbage,
/obj/item/food/grown/cabbage,
/obj/item/food/grown/cabbage,
/obj/item/food/grown/cabbage,
/obj/item/food/grown/cabbage,
/obj/item/food/grown/cabbage,
/obj/item/food/grown/eggplant,
/obj/item/food/grown/eggplant,
/obj/item/food/grown/eggplant,
/obj/item/food/grown/eggplant,
/obj/item/food/grown/eggplant,
/obj/item/food/grown/eggplant,
/obj/item/food/grown/ghost_chili,
/obj/item/food/grown/onion,
/obj/item/food/grown/onion,
/obj/item/food/grown/onion,
/obj/item/food/grown/onion,
/obj/item/food/grown/whitebeet,
/obj/item/food/grown/whitebeet,
/obj/item/food/grown/whitebeet,
/obj/item/food/grown/whitebeet,
/obj/item/food/grown/whitebeet,
/obj/item/food/grown/whitebeet,
/turf/open/floor/iron,
/area/space)
"Xx" = (
/obj/structure/closet/crate/freezer,
/obj/item/food/grown/cherries,
/obj/item/food/grown/cherries,
/obj/item/food/grown/cherries,
/obj/item/food/grown/cherries,
/obj/item/food/grown/cherries,
/obj/item/food/grown/cherries,
/obj/item/food/grown/berries,
/obj/item/food/grown/berries,
/obj/item/food/grown/berries,
/obj/item/food/grown/berries,
/obj/item/food/grown/berries,
/obj/item/food/grown/berries,
/obj/item/food/grown/berries,
/obj/item/food/grown/banana,
/obj/item/food/grown/banana,
/obj/item/food/grown/banana,
/obj/item/food/grown/banana,
/obj/item/food/grown/banana,
/obj/item/food/grown/banana,
/obj/item/food/grown/banana,
/obj/item/food/grown/banana,
/obj/item/food/grown/banana,
/obj/item/food/grown/apple,
/obj/item/food/grown/apple,
/obj/item/food/grown/apple,
/obj/item/food/grown/apple,
/obj/item/food/grown/apple,
/obj/item/food/grown/apple,
/obj/item/food/grown/apple,
/obj/item/food/grown/apple,
/obj/item/food/grown/apple,
/obj/item/food/grown/pineapple,
/obj/item/food/grown/pineapple,
/obj/item/food/grown/pineapple,
/obj/item/food/grown/pineapple,
/obj/item/food/grown/pineapple,
/turf/open/floor/iron,
/area/space)
"YL" = (
/obj/structure/table,
/turf/open/floor/iron,
/area/space)
"Zj" = (
/obj/machinery/paystand,
/turf/open/floor/iron,
/area/space)
"ZV" = (
/obj/machinery/porta_turret/syndicate{
	dir = 4
	},
/turf/open/floor/plating/asteroid/snow/icemoon,
/area/space)

(1,1,1) = {"
xt
xt
xt
xt
xt
xt
xt
xt
xt
xt
xt
xt
xt
xt
xt
xt
xt
xt
xt
xt
xt
xt
xt
"}
(2,1,1) = {"
xt
xt
xt
xt
SF
SF
xt
xt
xt
xt
SF
SF
xt
xt
SF
SF
SF
xt
xt
xt
SF
xt
xt
"}
(3,1,1) = {"
xt
xt
xt
SF
SF
SF
jD
jD
jD
jD
jD
jD
jD
jD
jD
jD
jD
jD
jD
jD
jD
SF
xt
"}
(4,1,1) = {"
xt
xt
SF
SF
SF
SF
jD
YL
dX
VF
Kx
IS
uf
Vh
uf
Kt
Vh
Vh
Vh
Vh
jD
SF
xt
"}
(5,1,1) = {"
xt
SF
SF
SF
SF
SF
jD
YL
Vh
Vh
Vh
Vh
Vh
Vh
Vh
Vh
Vh
Vh
Vh
Vh
jD
SF
xt
"}
(6,1,1) = {"
SF
SF
SF
SF
SF
ZV
jD
YL
Zj
YL
YL
YL
Hh
Vh
Vh
Kt
Vh
Vh
Vh
Vh
jD
SF
xt
"}
(7,1,1) = {"
SF
SF
SF
SF
SF
SF
LA
Tf
Vh
Vh
Vh
Vh
Vh
Vh
pX
Kt
Vh
Vh
Vh
Vh
jD
SF
xt
"}
(8,1,1) = {"
SF
SF
SF
SF
SF
SF
VL
Tf
Vh
Vh
Vh
Vh
Vh
Vh
mG
Kt
Kt
Kt
Kt
Kt
jD
SF
xt
"}
(9,1,1) = {"
SF
SF
SF
SF
SF
PS
jD
YL
Vh
ke
Vq
jl
lQ
Vh
mG
Kt
tF
uW
zv
Om
jD
xt
xt
"}
(10,1,1) = {"
SF
SF
SF
SF
SF
si
jD
YL
Vh
Vh
Vh
Vh
Vh
Vh
Vh
Kt
Vh
Vh
Vh
Vh
jD
xt
xt
"}
(11,1,1) = {"
SF
SF
SF
SF
SF
ZV
jD
YL
Vh
ix
JP
Sw
xq
Vh
Vh
Vh
Vh
Jc
Vh
PR
jD
xt
xt
"}
(12,1,1) = {"
SF
SF
SF
SF
SF
SF
LA
Tf
Vh
Vh
Vh
Vh
Vh
Vh
dS
Kt
Vh
Jc
Vh
ki
jD
xt
xt
"}
(13,1,1) = {"
SF
SF
SF
SF
SF
SF
VL
Tf
Vh
Vh
Vh
Vh
Vh
Vh
nC
Kt
Vh
Jc
Vh
pi
jD
SF
xt
"}
(14,1,1) = {"
SF
SF
SF
SF
SF
PS
jD
HS
Vh
SQ
jq
ke
tN
Vh
Hb
Kt
Vh
Jc
Vh
wW
jD
SF
xt
"}
(15,1,1) = {"
SF
SF
SF
SF
SF
SF
jD
uf
Vh
Vh
Vh
Vh
Vh
Vh
zl
Kt
Vh
Vh
Vh
Vh
jD
SF
SF
"}
(16,1,1) = {"
SF
SF
SF
SF
SF
SF
jD
WB
Vh
ke
ke
ke
Qr
Vh
Vh
Vh
Vh
Vh
yq
jw
jD
SF
SF
"}
(17,1,1) = {"
SF
SF
SF
SF
SF
SF
jD
Xx
Vh
Vh
Vh
Vh
Vh
Vh
Vh
Kt
Kt
Kt
Kt
Kt
jD
SF
SF
"}
(18,1,1) = {"
SF
SF
SF
SF
SF
SF
jD
ke
Vh
ke
Po
oB
xs
EZ
Vh
Kt
ue
ue
ue
ue
jD
SF
SF
"}
(19,1,1) = {"
xt
SF
SF
SF
SF
SF
jD
UX
Vh
Vh
Vh
Vh
Vh
Vh
Vh
ue
ue
ue
ue
ue
jD
SF
SF
"}
(20,1,1) = {"
xt
xt
SF
SF
SF
SF
jD
jD
hH
ke
Vh
qL
IY
yg
uf
Kt
ue
ue
ue
ue
jD
SF
SF
"}
(21,1,1) = {"
xt
xt
xt
SF
SF
SF
SF
jD
jD
jD
jD
jD
jD
jD
jD
jD
jD
jD
jD
jD
jD
SF
SF
"}
(22,1,1) = {"
xt
xt
xt
xt
xt
SF
SF
SF
SF
SF
SF
SF
SF
SF
SF
SF
SF
SF
SF
SF
SF
SF
SF
"}
(23,1,1) = {"
xt
xt
xt
xt
xt
xt
xt
xt
xt
xt
xt
xt
xt
SF
SF
SF
SF
SF
SF
SF
SF
SF
SF
"}
