//MAP CONVERTED BY dmm2tgm.py THIS HEADER COMMENT PREVENTS RECONVERSION, DO NOT REMOVE
"ap" = (
/obj/structure/rack/gunrack,
/obj/item/gun/energy/laser/retro,
/turf/open/floor/iron/dark,
/area/ruin/powered)
"bg" = (
/obj/structure/chair/comfy/shuttle{
	dir = 8
	},
/turf/open/floor/iron/smooth,
/area/ruin/powered)
"bE" = (
/obj/structure/chair/comfy/shuttle{
	dir = 8
	},
/turf/open/floor/plating,
/area/ruin/powered)
"ck" = (
/obj/effect/decal/cleanable/robot_debris,
/turf/open/floor/plating/asteroid/snow/icemoon,
/area/icemoon/underground/explored)
"cz" = (
/obj/structure/decorative/shelf/crates1,
/turf/open/floor/iron/dark,
/area/ruin/powered)
"dA" = (
/obj/structure/bed,
/obj/effect/spawner/random/clothing/syndie,
/turf/open/floor/iron/dark/brown,
/area/ruin/powered)
"es" = (
/obj/structure/window/reinforced,
/obj/structure/bed,
/obj/item/laser_pointer/upgraded,
/obj/machinery/light{
	dir = 4
	},
/turf/open/floor/iron/dark/brown,
/area/ruin/powered)
"eJ" = (
/obj/item/stack/rods/ten,
/turf/open/floor/plating/asteroid/snow/icemoon,
/area/icemoon/underground/explored)
"eP" = (
/mob/living/simple_animal/hostile/russian,
/obj/structure/chair/comfy/shuttle{
	dir = 8
	},
/turf/open/floor/iron/dark,
/area/ruin/powered)
"fk" = (
/turf/open/floor/iron/dark,
/area/ruin/powered)
"fB" = (
/obj/item/modular_computer/laptop/preset/syndicate,
/obj/structure/table/reinforced,
/turf/open/floor/iron/dark,
/area/ruin/powered)
"fP" = (
/obj/item/paper,
/obj/item/paper{
	pixel_x = 7
	},
/obj/item/paper{
	pixel_x = 3;
	pixel_y = 4
	},
/obj/item/paper_bin{
	pixel_x = 12;
	pixel_y = 9
	},
/obj/item/pen,
/obj/structure/table/reinforced,
/turf/open/floor/iron/dark/red,
/area/ruin/powered)
"gF" = (
/obj/machinery/iv_drip,
/obj/machinery/stasis,
/turf/open/floor/iron/dark,
/area/ruin/powered)
"ha" = (
/obj/structure/girder/reinforced,
/turf/open/floor/plating/icemoon,
/area/ruin/powered)
"hs" = (
/obj/structure/table/reinforced,
/obj/effect/spawner/random/decoration/ornament,
/turf/open/floor/iron/dark/red,
/area/ruin/powered)
"hx" = (
/obj/machinery/door/airlock/vault{
	id_tag = "syndie_lavaland_vault";
	req_access_txt = "150"
	},
/obj/effect/mapping_helpers/airlock/locked,
/turf/open/floor/iron/dark,
/area/ruin/powered)
"hD" = (
/obj/machinery/light/broken,
/turf/open/floor/iron/dark/red,
/area/ruin/powered)
"hK" = (
/obj/structure/table/reinforced,
/turf/open/floor/plating,
/area/ruin/powered)
"hQ" = (
/obj/item/stack/rods,
/turf/open/floor/plating/asteroid/snow/icemoon,
/area/icemoon/underground/explored)
"hY" = (
/obj/structure/chair/comfy/shuttle{
	dir = 8
	},
/mob/living/simple_animal/hostile/russian/ranged/officer,
/turf/open/floor/plating,
/area/ruin/powered)
"il" = (
/obj/item/defibrillator/loaded,
/obj/structure/table,
/obj/item/gun/syringe,
/turf/open/floor/iron/smooth,
/area/ruin/powered)
"jo" = (
/obj/machinery/light/broken,
/obj/structure/chair/comfy/shuttle{
	dir = 8
	},
/turf/open/floor/iron/dark/red,
/area/ruin/powered)
"kQ" = (
/mob/living/simple_animal/hostile/russian/ranged/trooper,
/turf/open/floor/plating,
/area/ruin/powered)
"lc" = (
/turf/open/floor/iron/smooth,
/area/ruin/powered)
"lI" = (
/mob/living/simple_animal/hostile/russian,
/turf/open/floor/plating,
/area/ruin/powered)
"nt" = (
/mob/living/simple_animal/hostile/russian/ranged,
/turf/open/floor/iron/dark,
/area/ruin/powered)
"nC" = (
/obj/machinery/light/broken{
	dir = 4
	},
/turf/open/floor/iron/dark,
/area/ruin/powered)
"nR" = (
/obj/item/statuebust/hippocratic,
/turf/open/floor/iron/dark/brown,
/area/ruin/powered)
"os" = (
/obj/effect/decal/fakelattice,
/turf/open/floor/plating/asteroid/snow,
/area/icemoon/underground/explored)
"oV" = (
/obj/machinery/computer{
	dir = 8
	},
/turf/open/floor/iron/dark,
/area/ruin/powered)
"pd" = (
/obj/structure/fans/tiny,
/turf/open/floor/plating,
/area/ruin/powered)
"qK" = (
/obj/effect/spawner/random/engineering/material_rare,
/obj/effect/spawner/random/engineering/material_rare,
/obj/effect/spawner/random/engineering/material_rare,
/obj/effect/spawner/random/engineering/material_rare,
/obj/effect/spawner/random/engineering/material,
/obj/effect/spawner/random/engineering/material,
/obj/effect/spawner/random/engineering/material,
/obj/effect/spawner/random/engineering/material,
/turf/open/floor/plating/icemoon,
/area/ruin/powered)
"qR" = (
/obj/item/stack/cable_coil,
/turf/open/floor/plating/asteroid/snow/icemoon,
/area/icemoon/underground/explored)
"qW" = (
/turf/open/floor/iron/dark/red,
/area/ruin/powered)
"rr" = (
/obj/structure/window/reinforced,
/obj/structure/bed,
/obj/item/instrument/guitar,
/turf/open/floor/iron/dark/brown,
/area/ruin/powered)
"rE" = (
/obj/structure/chair/comfy/shuttle{
	dir = 4
	},
/turf/open/floor/plating,
/area/ruin/powered)
"sR" = (
/obj/machinery/door/airlock/hos,
/turf/open/floor/iron/icemoon,
/area/ruin/powered)
"tk" = (
/obj/machinery/door/airlock/external{
	req_access_txt = "150"
	},
/obj/effect/mapping_helpers/airlock/locked,
/turf/open/floor/plating,
/area/ruin/powered)
"ts" = (
/turf/open/floor/plating,
/area/ruin/powered)
"wg" = (
/obj/machinery/light/broken{
	dir = 4
	},
/obj/structure/table/reinforced,
/turf/open/floor/iron/dark/red,
/area/ruin/powered)
"wy" = (
/obj/machinery/light{
	dir = 4
	},
/turf/open/floor/iron/dark,
/area/ruin/powered)
"wA" = (
/obj/machinery/light/broken{
	dir = 8
	},
/obj/machinery/suit_storage_unit/security,
/turf/open/floor/iron/dark,
/area/ruin/powered)
"xl" = (
/turf/closed/wall/mineral/plastitanium,
/area/ruin/powered)
"xu" = (
/obj/structure/decorative/shelf/crates,
/turf/open/floor/iron/dark,
/area/ruin/powered)
"xx" = (
/obj/machinery/cell_charger_multi,
/obj/structure/table,
/turf/open/floor/iron/icemoon,
/area/ruin/powered)
"xL" = (
/obj/machinery/autolathe,
/turf/open/floor/plating/icemoon,
/area/ruin/powered)
"ys" = (
/obj/machinery/door/airlock/external{
	req_access_txt = "150"
	},
/turf/open/floor/plating,
/area/ruin/powered)
"yC" = (
/obj/item/geiger_counter{
	pixel_x = -6
	},
/obj/item/crowbar/advanced,
/obj/item/screwdriver/nuke{
	pixel_y = 6
	},
/obj/structure/table,
/turf/open/floor/plating/icemoon,
/area/ruin/powered)
"yD" = (
/obj/machinery/door/airlock/highsecurity,
/turf/open/floor/iron/dark/brown,
/area/ruin/powered)
"yV" = (
/obj/machinery/computer{
	dir = 4
	},
/turf/open/floor/iron/dark,
/area/ruin/powered)
"zb" = (
/obj/structure/chair/comfy/shuttle{
	dir = 8
	},
/turf/open/floor/iron/dark,
/area/ruin/powered)
"zg" = (
/obj/effect/spawner/random/decoration/glowstick,
/turf/open/floor/iron/smooth,
/area/ruin/powered)
"zN" = (
/obj/structure/table,
/obj/item/stamp/syndicate,
/turf/open/floor/plating,
/area/ruin/powered)
"zU" = (
/obj/machinery/light/broken{
	dir = 8
	},
/turf/open/floor/iron/dark,
/area/ruin/powered)
"Ak" = (
/obj/machinery/space_heater,
/obj/machinery/light{
	dir = 4
	},
/turf/open/floor/plating/icemoon,
/area/ruin/powered)
"AJ" = (
/turf/open/floor/iron/dark/brown,
/area/ruin/powered)
"AL" = (
/obj/structure/rack/shelf,
/turf/open/floor/iron/dark/red,
/area/ruin/powered)
"AP" = (
/turf/open/genturf,
/area/icemoon/underground/unexplored)
"Bx" = (
/mob/living/simple_animal/hostile/skeleton/ice,
/turf/open/floor/plating/asteroid/snow/icemoon,
/area/icemoon/underground/explored)
"Cf" = (
/obj/structure/extinguisher_cabinet/directional/north,
/turf/open/floor/iron/dark,
/area/ruin/powered)
"CX" = (
/obj/effect/spawner/random/decoration/glowstick,
/turf/open/floor/plating,
/area/ruin/powered)
"Dn" = (
/obj/structure/shuttle/engine/propulsion{
	dir = 4
	},
/turf/open/floor/plating/icemoon,
/area/ruin/powered)
"Dq" = (
/mob/living/simple_animal/hostile/russian,
/turf/open/floor/iron/dark,
/area/ruin/powered)
"DB" = (
/obj/structure/table,
/obj/item/slimecross/stabilized/metal,
/turf/open/floor/iron/smooth,
/area/ruin/powered)
"DY" = (
/obj/machinery/door/airlock/highsecurity,
/turf/open/floor/iron/smooth,
/area/ruin/powered)
"Ej" = (
/obj/machinery/door/airlock/maintenance_hatch,
/turf/open/floor/plating/icemoon,
/area/ruin/powered)
"Em" = (
/obj/effect/spawner/structure/window/reinforced/plasma/plastitanium,
/turf/open/floor/plating/icemoon,
/area/ruin/powered)
"Fs" = (
/turf/open/floor/plating/asteroid/snow/icemoon,
/area/icemoon/underground/explored)
"Fw" = (
/obj/item/inducer/syndicate,
/obj/structure/table,
/turf/open/floor/plating/icemoon,
/area/ruin/powered)
"FE" = (
/obj/structure/table,
/obj/effect/spawner/random/engineering/flashlight,
/turf/open/floor/plating,
/area/ruin/powered)
"Gm" = (
/obj/item/stack/cable_coil,
/turf/open/floor/plating/icemoon,
/area/ruin/powered)
"Hb" = (
/obj/item/cardboard_cutout/adaptive,
/obj/machinery/light/broken{
	dir = 1
	},
/turf/open/floor/iron/smooth,
/area/ruin/powered)
"HC" = (
/obj/machinery/light/broken,
/turf/open/floor/plating,
/area/ruin/powered)
"HW" = (
/mob/living/simple_animal/hostile/russian,
/obj/machinery/light,
/turf/open/floor/iron/dark/red,
/area/ruin/powered)
"Is" = (
/mob/living/simple_animal/hostile/skeleton/plasmaminer/jackhammer,
/turf/open/floor/plating/asteroid/snow/icemoon,
/area/icemoon/underground/explored)
"IS" = (
/obj/structure/frame/machine,
/turf/open/floor/plating/icemoon,
/area/ruin/powered)
"Js" = (
/obj/structure/table,
/obj/item/food/boiledegg,
/obj/item/food/burrito{
	pixel_x = 6
	},
/obj/item/food/cherrycupcake{
	pixel_x = -8;
	pixel_y = 5
	},
/obj/item/food/chococornet{
	pixel_x = -6;
	pixel_y = -6
	},
/obj/item/food/cornedbeef{
	pixel_x = 9;
	pixel_y = 10
	},
/turf/open/floor/iron/dark/brown,
/area/ruin/powered)
"LK" = (
/obj/structure/girder/reinforced,
/turf/open/floor/plating/asteroid/snow,
/area/icemoon/underground/explored)
"LX" = (
/mob/living/simple_animal/hostile/skeleton/plasmaminer,
/turf/open/floor/plating/asteroid/snow/icemoon,
/area/icemoon/underground/explored)
"Nz" = (
/obj/machinery/suit_storage_unit/mining/eva,
/turf/open/floor/iron/smooth,
/area/ruin/powered)
"NK" = (
/obj/machinery/door/airlock/highsecurity,
/turf/open/floor/iron/icemoon,
/area/ruin/powered)
"OG" = (
/obj/machinery/computer/crew{
	dir = 4
	},
/turf/open/floor/iron/dark,
/area/ruin/powered)
"OJ" = (
/turf/closed/wall/r_wall/syndicate/nodiagonal,
/area/ruin/powered)
"OR" = (
/obj/structure/table/reinforced,
/obj/item/gun_maintenance_supplies,
/turf/open/floor/iron/dark,
/area/ruin/powered)
"Pq" = (
/turf/closed/mineral/random/snow,
/area/icemoon/underground/explored)
"PB" = (
/obj/structure/table,
/obj/item/soap/syndie,
/turf/open/floor/iron/dark/brown,
/area/ruin/powered)
"Rb" = (
/obj/machinery/power/emitter/welded{
	dir = 8
	},
/turf/open/floor/iron/dark/red,
/area/ruin/powered)
"Ro" = (
/obj/structure/tank_dispenser/oxygen,
/obj/machinery/light,
/turf/open/floor/iron/smooth,
/area/ruin/powered)
"RI" = (
/turf/open/floor/plating/icemoon,
/area/ruin/powered)
"RL" = (
/obj/structure/table,
/obj/machinery/recharger,
/turf/open/floor/iron/icemoon,
/area/ruin/powered)
"RV" = (
/obj/machinery/light/broken,
/turf/open/floor/iron/smooth,
/area/ruin/powered)
"SY" = (
/mob/living/simple_animal/hostile/russian,
/turf/open/floor/plating/icemoon,
/area/ruin/powered)
"Td" = (
/obj/structure/chair/comfy/shuttle,
/turf/open/floor/iron/smooth,
/area/ruin/powered)
"TK" = (
/obj/structure/table/reinforced,
/obj/item/coin/gold,
/obj/item/coin/gold{
	pixel_x = -7;
	pixel_y = 8
	},
/obj/item/coin/diamond{
	pixel_x = 6;
	pixel_y = 4
	},
/obj/item/coin/bananium{
	pixel_x = -4;
	pixel_y = 3
	},
/obj/item/raw_anomaly_core/random{
	pixel_x = 6;
	pixel_y = -4
	},
/obj/item/raw_anomaly_core/random{
	pixel_x = -6;
	pixel_y = -4
	},
/turf/open/floor/iron/dark/red,
/area/ruin/powered)
"Ux" = (
/obj/structure/tank_holder/extinguisher,
/turf/open/floor/iron/smooth,
/area/ruin/powered)
"UB" = (
/obj/item/choice_beacon/ingredient,
/obj/structure/table,
/obj/machinery/light/broken{
	dir = 1
	},
/turf/open/floor/iron/dark/brown,
/area/ruin/powered)
"Vg" = (
/obj/machinery/light/broken{
	dir = 8
	},
/turf/open/floor/plating,
/area/ruin/powered)
"Vl" = (
/obj/machinery/light/broken{
	dir = 4
	},
/turf/open/floor/plating,
/area/ruin/powered)
"Vs" = (
/obj/machinery/nuclearbomb/beer,
/turf/open/floor/iron/dark/brown,
/area/ruin/powered)
"Vw" = (
/obj/structure/table/reinforced,
/obj/item/binoculars,
/obj/machinery/light/broken{
	dir = 8
	},
/obj/machinery/recharger,
/turf/open/floor/iron/dark,
/area/ruin/powered)
"VB" = (
/obj/machinery/light/broken{
	dir = 8
	},
/turf/open/floor/iron/smooth,
/area/ruin/powered)
"VO" = (
/obj/structure/table/reinforced,
/obj/item/disk/tech_disk/spaceloot,
/obj/item/disk/tech_disk/spaceloot{
	pixel_x = 5;
	pixel_y = 5
	},
/obj/item/megaphone/command,
/turf/open/floor/iron/dark,
/area/ruin/powered)
"Xc" = (
/obj/machinery/light,
/turf/open/floor/plating,
/area/ruin/powered)
"XN" = (
/obj/item/pickaxe/mini,
/obj/item/pickaxe/mini,
/obj/item/pickaxe/mini,
/obj/item/resonator/upgraded,
/obj/structure/table,
/turf/open/floor/plating/icemoon,
/area/ruin/powered)
"Yy" = (
/obj/structure/bed/roller,
/turf/open/floor/plating,
/area/ruin/powered)
"Yz" = (
/obj/machinery/light{
	dir = 4
	},
/turf/open/floor/iron/smooth,
/area/ruin/powered)
"Zd" = (
/obj/structure/table/reinforced,
/obj/item/grenade/barrier,
/obj/item/grenade/barrier,
/turf/open/floor/iron/dark,
/area/ruin/powered)

(1,1,1) = {"
AP
AP
AP
AP
Pq
Pq
Pq
AP
AP
AP
Pq
AP
Pq
Pq
Pq
AP
"}
(2,1,1) = {"
AP
AP
Pq
Pq
Pq
Pq
xl
xl
xl
Pq
Pq
Pq
Pq
Pq
Pq
Pq
"}
(3,1,1) = {"
AP
Pq
Pq
Pq
Pq
Pq
yV
yV
fB
xl
Pq
Pq
Pq
Pq
Pq
Pq
"}
(4,1,1) = {"
AP
Pq
Pq
Pq
os
eP
zb
hY
fk
Vw
xl
Em
xl
Em
ha
AP
"}
(5,1,1) = {"
Pq
Pq
Pq
LK
Zd
wy
ts
wy
fk
VO
xl
Rb
hK
Rb
xl
AP
"}
(6,1,1) = {"
Pq
Pq
Pq
xl
xl
xl
sR
xl
xl
xl
xl
bE
ts
jo
xl
AP
"}
(7,1,1) = {"
Pq
Pq
xl
Hb
rE
VB
lc
lc
Vg
lc
DY
ts
nt
qW
xl
AP
"}
(8,1,1) = {"
Pq
Pq
xl
Td
zN
lI
lc
lc
ts
Ro
xl
qW
fk
ts
xl
AP
"}
(9,1,1) = {"
Pq
Pq
xl
Td
DB
lc
lc
lI
zg
Nz
xl
hs
ts
lI
xl
AP
"}
(10,1,1) = {"
Fs
Pq
xl
Hb
bg
Yz
ts
lc
lc
Nz
xl
fP
wg
qW
xl
hQ
"}
(11,1,1) = {"
eJ
ha
xl
xl
xl
xl
Yy
lc
HC
OJ
OJ
OJ
OJ
OJ
OJ
Fs
"}
(12,1,1) = {"
Fs
xl
UB
Js
nR
xl
il
lc
lI
OJ
wA
TK
OR
OJ
ha
Bx
"}
(13,1,1) = {"
ck
xl
PB
AJ
ts
yD
lc
CX
ts
hx
ts
lI
hD
OJ
OJ
ck
"}
(14,1,1) = {"
qR
xl
Vs
lI
HC
xl
lc
lI
lc
hx
kQ
fk
HW
OJ
OJ
Is
"}
(15,1,1) = {"
Fs
xl
AJ
AJ
AJ
xl
Ux
lc
RV
OJ
ap
AL
fk
OJ
ha
Fs
"}
(16,1,1) = {"
Fs
xl
rr
es
dA
xl
xl
NK
xl
OJ
OJ
OJ
OJ
OJ
xl
Fs
"}
(17,1,1) = {"
Fs
xl
xl
xl
xl
xl
cz
fk
OG
gF
zU
ts
ys
pd
tk
LX
"}
(18,1,1) = {"
Fs
xl
xL
Fw
yC
xl
xu
ts
lI
fk
ts
Xc
xl
xl
xl
Fs
"}
(19,1,1) = {"
ck
xl
RI
SY
RI
Ej
fk
fk
fk
ts
fk
Dq
RL
xl
Bx
Fs
"}
(20,1,1) = {"
Fs
xl
Ak
qK
XN
xl
Cf
nC
oV
FE
Vl
fk
xx
xl
Fs
Fs
"}
(21,1,1) = {"
Fs
ha
xl
xl
xl
xl
xl
xl
xl
xl
xl
xl
xl
xl
LX
Is
"}
(22,1,1) = {"
Fs
Dn
Dn
IS
xl
xl
Dn
Gm
IS
xl
xl
RI
Dn
Dn
hQ
Fs
"}
