//MAP CONVERTED BY dmm2tgm.py THIS HEADER COMMENT PREVENTS RECONVERSION, DO NOT REMOVE
"aP" = (
/obj/structure/table,
/obj/effect/spawner/random/medical/firstaid,
/turf/open/floor/iron/icemoon,
/area/space)
"br" = (
/turf/closed/wall/r_wall/rust,
/area/space)
"bY" = (
/obj/structure/showcase/horrific_experiment,
/turf/open/floor/iron/icemoon,
/area/space)
"cY" = (
/obj/structure/showcase/machinery/oldpod{
	dir = 4
	},
/turf/open/floor/iron/icemoon,
/area/space)
"dh" = (
/obj/structure/table/wood,
/obj/effect/spawner/random/entertainment/musical_instrument,
/turf/open/floor/wood/cold,
/area/space)
"dv" = (
/mob/living/simple_animal/hostile/skeleton/ice,
/turf/open/floor/iron/icemoon,
/area/space)
"eZ" = (
/obj/structure/table,
/turf/open/floor/plating/snowed,
/area/space)
"hy" = (
/obj/machinery/door/airlock/external{
	req_access_txt = "150"
	},
/obj/structure/barricade/wooden/crude/snow,
/turf/open/floor/plating/icemoon,
/area/space)
"if" = (
/obj/structure/table/reinforced,
/obj/item/bodybag/environmental,
/turf/open/floor/iron/icemoon,
/area/space)
"it" = (
/obj/structure/barricade/security,
/turf/open/floor/iron/icemoon,
/area/space)
"iv" = (
/obj/structure/table,
/turf/open/floor/iron/icemoon,
/area/space)
"iy" = (
/obj/machinery/door/airlock/grunge,
/turf/open/floor/plating/icemoon,
/area/space)
"iN" = (
/obj/structure/table/reinforced,
/obj/effect/spawner/random/medical/firstaid_rare,
/turf/open/floor/plating/icemoon,
/area/space)
"lj" = (
/turf/open/floor/wood/cold,
/area/space)
"lm" = (
/obj/effect/spawner/random/structure/crate_abandoned,
/turf/open/floor/plating/icemoon,
/area/space)
"lU" = (
/obj/effect/spawner/random/engineering/tank,
/turf/open/floor/iron/icemoon,
/area/space)
"mr" = (
/obj/structure/table/reinforced,
/obj/effect/spawner/random/medical/minor_healing,
/turf/open/floor/iron/icemoon,
/area/space)
"nD" = (
/obj/structure/trash_pile,
/turf/open/floor/plating/icemoon,
/area/space)
"nP" = (
/obj/structure/table,
/turf/open/floor/plating/icemoon,
/area/space)
"nR" = (
/mob/living/simple_animal/hostile/zombie{
	faction = list("skeleton")
	},
/turf/open/floor/plating/icemoon,
/area/space)
"nT" = (
/obj/structure/trash_pile,
/turf/open/floor/iron/icemoon,
/area/space)
"of" = (
/obj/structure/table/wood,
/obj/effect/spawner/random/entertainment/deck,
/turf/open/floor/wood/cold,
/area/space)
"ox" = (
/obj/effect/spawner/random/medical/patient_stretcher,
/turf/open/floor/iron/icemoon,
/area/space)
"oF" = (
/obj/machinery/computer{
	dir = 4
	},
/turf/open/floor/plating/icemoon,
/area/space)
"oI" = (
/obj/structure/table,
/obj/effect/spawner/random/engineering/material,
/turf/open/floor/iron/icemoon,
/area/space)
"oT" = (
/obj/machinery/computer,
/turf/open/floor/iron/icemoon,
/area/space)
"pc" = (
/obj/structure/tank_holder/anesthetic,
/turf/open/floor/iron/icemoon,
/area/space)
"rb" = (
/obj/structure/server,
/turf/open/floor/iron/icemoon,
/area/space)
"rB" = (
/obj/structure/tank_holder/extinguisher,
/turf/open/floor/iron/icemoon,
/area/space)
"sg" = (
/turf/open/floor/plating/icemoon,
/area/space)
"sE" = (
/turf/open/floor/iron/icemoon,
/area/space)
"sL" = (
/obj/structure/reagent_dispensers/beerkeg,
/turf/open/floor/plating/icemoon,
/area/space)
"tf" = (
/obj/structure/safe,
/obj/effect/spawner/random/exotic/antag_gear,
/obj/effect/spawner/random/maintenance/eight,
/turf/open/floor/iron/icemoon,
/area/space)
"tN" = (
/obj/structure/table/reinforced,
/turf/open/floor/iron/icemoon,
/area/space)
"uO" = (
/obj/structure/rack/gunrack,
/turf/open/floor/iron/icemoon,
/area/space)
"uZ" = (
/obj/machinery/door/airlock/grunge,
/turf/open/floor/wood/cold,
/area/space)
"vM" = (
/obj/effect/spawner/random/entertainment/arcade{
	dir = 8
	},
/turf/open/floor/wood/cold,
/area/space)
"vX" = (
/obj/structure/table/reinforced,
/obj/effect/spawner/random/medical/memeorgans,
/turf/open/floor/plating/icemoon,
/area/space)
"xf" = (
/obj/machinery/door/airlock/grunge,
/turf/open/floor/iron/icemoon,
/area/space)
"yc" = (
/obj/effect/spawner/random/structure/barricade,
/turf/open/floor/plating/snowed,
/area/space)
"yT" = (
/obj/structure/rack/shelf,
/obj/effect/spawner/random/engineering/material_rare,
/obj/effect/spawner/random/engineering/material_rare,
/turf/open/floor/iron/icemoon,
/area/space)
"zB" = (
/obj/structure/bed,
/obj/item/bedsheet,
/turf/open/floor/wood/cold,
/area/space)
"Ah" = (
/obj/structure/table/reinforced,
/obj/effect/spawner/random/engineering/toolbox,
/turf/open/floor/iron/icemoon,
/area/space)
"Bd" = (
/obj/structure/rack/shelf,
/obj/effect/spawner/random/medical/minor_healing,
/turf/open/floor/wood/cold,
/area/space)
"Bs" = (
/obj/structure/table/reinforced,
/obj/effect/spawner/random/engineering/material,
/obj/effect/spawner/random/engineering/material,
/turf/open/floor/plating/icemoon,
/area/space)
"BM" = (
/obj/structure/reagent_dispensers/watertank,
/turf/open/floor/plating/icemoon,
/area/space)
"CN" = (
/obj/structure/tank_dispenser/oxygen,
/turf/open/floor/plating/icemoon,
/area/space)
"CY" = (
/obj/structure/table/wood,
/obj/effect/spawner/random/entertainment/cigarette_pack,
/obj/effect/spawner/random/entertainment/lighter,
/turf/open/floor/wood/cold,
/area/space)
"Dl" = (
/obj/structure/table/reinforced,
/obj/effect/spawner/random/exotic/languagebook,
/turf/open/floor/plating/icemoon,
/area/space)
"Dr" = (
/obj/structure/table/reinforced,
/obj/effect/spawner/random/medical/memeorgans,
/turf/open/floor/iron/icemoon,
/area/space)
"Dy" = (
/obj/structure/tank_dispenser/oxygen,
/turf/open/floor/iron/icemoon,
/area/space)
"DI" = (
/obj/effect/spawner/random/engineering/flashlight,
/turf/open/floor/iron/icemoon,
/area/space)
"DW" = (
/obj/structure/table/reinforced,
/obj/effect/spawner/random/exotic/antag_gear_weak,
/turf/open/floor/iron/icemoon,
/area/space)
"Eg" = (
/obj/structure/table,
/obj/item/bodybag/stasis,
/turf/open/floor/iron/icemoon,
/area/space)
"FL" = (
/obj/structure/bed/roller,
/obj/effect/spawner/random/medical/minor_healing,
/turf/open/floor/iron/icemoon,
/area/space)
"GG" = (
/obj/structure/rack/shelf,
/obj/effect/spawner/random/engineering/vending_restock,
/obj/effect/spawner/random/engineering/vending_restock,
/turf/open/floor/iron/icemoon,
/area/space)
"Hu" = (
/turf/open/floor/plating/snowed,
/area/space)
"Jt" = (
/obj/effect/spawner/random/exotic/ripley,
/turf/open/floor/iron/icemoon,
/area/space)
"JB" = (
/obj/structure/table/wood,
/obj/effect/spawner/random/entertainment/money_small,
/turf/open/floor/wood/cold,
/area/space)
"JC" = (
/turf/closed/wall/r_wall,
/area/space)
"JN" = (
/obj/machinery/door/airlock/hatch{
	req_access_txt = "3"
	},
/obj/effect/spawner/random/structure/barricade,
/turf/open/floor/iron/icemoon,
/area/space)
"KE" = (
/obj/structure/rack/shelf,
/obj/effect/spawner/random/engineering/material,
/turf/open/floor/iron/icemoon,
/area/space)
"KF" = (
/mob/living/simple_animal/hostile/zombie{
	faction = list("skeleton")
	},
/turf/open/floor/iron/icemoon,
/area/space)
"Li" = (
/obj/structure/bed/roller,
/turf/open/floor/iron/icemoon,
/area/space)
"Lm" = (
/obj/machinery/computer{
	dir = 4
	},
/turf/open/floor/iron/icemoon,
/area/space)
"Lr" = (
/mob/living/simple_animal/hostile/skeleton/plasmaminer/jackhammer,
/turf/open/floor/iron/icemoon,
/area/space)
"Lt" = (
/obj/structure/bed,
/obj/item/bedsheet,
/obj/effect/spawner/random/entertainment/toy,
/turf/open/floor/wood/cold,
/area/space)
"LW" = (
/obj/effect/spawner/random/structure/barricade,
/turf/open/floor/iron/icemoon,
/area/space)
"Mb" = (
/obj/effect/spawner/random/structure/barricade,
/turf/open/floor/plating/icemoon,
/area/space)
"Mz" = (
/obj/machinery/computer{
	dir = 8
	},
/turf/open/floor/plating/icemoon,
/area/space)
"MB" = (
/turf/open/floor/plating/asteroid/snow/icemoon,
/area/space)
"MQ" = (
/obj/structure/showcase/machinery/signal_decrypter,
/turf/open/floor/iron/icemoon,
/area/space)
"NB" = (
/mob/living/simple_animal/hostile/skeleton/ice,
/turf/open/floor/plating/icemoon,
/area/space)
"NL" = (
/obj/structure/table/reinforced,
/obj/effect/spawner/random/medical/firstaid_rare,
/turf/open/floor/iron/icemoon,
/area/space)
"OM" = (
/obj/effect/spawner/random/structure/crate_abandoned,
/turf/open/floor/iron/icemoon,
/area/space)
"OZ" = (
/obj/structure/rack/shelf,
/obj/effect/spawner/random/engineering/material_rare,
/turf/open/floor/iron/icemoon,
/area/space)
"PZ" = (
/obj/machinery/computer{
	dir = 1
	},
/turf/open/floor/iron/icemoon,
/area/space)
"QI" = (
/obj/effect/spawner/random/exotic/snow_gear,
/turf/open/floor/plating/asteroid/snow/icemoon,
/area/space)
"RT" = (
/obj/machinery/door/airlock/external{
	req_access_txt = "150"
	},
/turf/open/floor/plating/icemoon,
/area/space)
"Sg" = (
/obj/structure/table/reinforced,
/obj/effect/spawner/random/medical/organs,
/turf/open/floor/iron/icemoon,
/area/space)
"Si" = (
/mob/living/simple_animal/hostile/skeleton/plasmaminer,
/turf/open/floor/iron/icemoon,
/area/space)
"SH" = (
/mob/living/simple_animal/hostile/skeleton/plasmaminer/jackhammer,
/turf/open/floor/plating/snowed,
/area/space)
"SR" = (
/obj/structure/rack/shelf,
/turf/open/floor/wood/cold,
/area/space)
"SS" = (
/obj/structure/rack,
/turf/open/floor/iron/icemoon,
/area/space)
"Up" = (
/obj/structure/tank_holder/extinguisher,
/turf/open/floor/plating/icemoon,
/area/space)
"Ut" = (
/obj/structure/table/reinforced,
/obj/effect/spawner/random/exotic/technology,
/turf/open/floor/iron/icemoon,
/area/space)
"Ux" = (
/obj/structure/table/wood,
/obj/effect/spawner/random/entertainment/cigarette_pack,
/obj/effect/spawner/random/entertainment/coin,
/turf/open/floor/plating/icemoon,
/area/space)
"UL" = (
/obj/structure/rack/shelf,
/turf/open/floor/iron/icemoon,
/area/space)
"Vp" = (
/obj/structure/showcase/machinery/cloning_pod,
/turf/open/floor/iron/icemoon,
/area/space)
"VO" = (
/obj/structure/table,
/obj/effect/spawner/random/maintenance/two,
/turf/open/floor/iron/icemoon,
/area/space)
"WM" = (
/obj/structure/table/reinforced,
/obj/effect/spawner/random/engineering/material_cheap,
/turf/open/floor/iron/icemoon,
/area/space)
"WU" = (
/obj/machinery/computer{
	dir = 8
	},
/turf/open/floor/iron/icemoon,
/area/space)
"WZ" = (
/obj/structure/reagent_dispensers/watertank,
/turf/open/floor/iron/icemoon,
/area/space)
"Yd" = (
/mob/living/simple_animal/hostile/zombie{
	faction = list("skeleton")
	},
/turf/open/floor/plating/snowed,
/area/space)
"Yl" = (
/mob/living/simple_animal/hostile/skeleton/plasmaminer/jackhammer,
/turf/open/floor/plating/icemoon,
/area/space)
"YA" = (
/obj/structure/showcase/machinery/implanter{
	desc = "What is this stuff? What is the purpose?";
	name = "strange experiment pod"
	},
/turf/open/floor/iron/icemoon,
/area/space)
"Zw" = (
/obj/structure/table/reinforced,
/obj/effect/spawner/random/exotic/antag_gear_weak,
/turf/open/floor/plating/icemoon,
/area/space)
"Zy" = (
/obj/structure/table/reinforced,
/obj/effect/spawner/random/engineering/tool_alien,
/turf/open/floor/iron/icemoon,
/area/space)

(1,1,1) = {"
MB
MB
MB
MB
MB
MB
MB
MB
MB
MB
MB
MB
MB
MB
MB
MB
MB
MB
MB
MB
MB
MB
MB
MB
MB
MB
MB
MB
MB
MB
"}
(2,1,1) = {"
MB
MB
MB
MB
MB
MB
MB
MB
MB
MB
MB
MB
MB
MB
MB
MB
MB
MB
MB
MB
MB
MB
MB
MB
MB
MB
MB
MB
MB
MB
"}
(3,1,1) = {"
MB
MB
QI
JC
JC
br
br
br
JC
br
br
br
JC
JC
br
br
JC
JC
br
br
br
br
br
br
JC
JC
JC
JC
MB
MB
"}
(4,1,1) = {"
MB
MB
MB
JC
nT
Hu
iv
iv
SS
JC
zB
of
zB
JB
zB
Ux
SR
JC
rB
sg
sE
Mb
KF
Hu
sE
yc
sg
JC
JC
JC
"}
(5,1,1) = {"
MB
JC
br
br
Hu
Lr
sE
sg
Si
br
lj
lj
lj
lj
lj
sg
lm
br
nT
sE
sE
LW
sE
sg
Hu
yc
Hu
RT
sg
hy
"}
(6,1,1) = {"
MB
hy
sg
RT
Hu
Hu
sg
Hu
nT
br
lj
lj
sg
sg
lj
lj
sg
br
Li
sE
sg
LW
sE
sg
sE
Mb
Hu
JC
JC
JC
"}
(7,1,1) = {"
MB
JC
br
JC
Hu
Si
nD
sE
SS
JC
Lt
dh
zB
CY
vM
lj
Bd
br
sE
dv
KF
br
br
br
JC
br
JC
JC
MB
MB
"}
(8,1,1) = {"
MB
MB
QI
br
sE
sg
sE
Hu
CN
JC
br
br
br
JC
JC
uZ
JC
JC
sE
sE
sE
br
tf
sg
sE
tN
NL
br
MB
MB
"}
(9,1,1) = {"
MB
MB
MB
JC
Up
sE
Hu
sE
sE
JN
sE
DI
sE
KF
LW
sg
LW
sE
sE
sE
nT
br
uO
sE
nR
sE
tN
br
MB
MB
"}
(10,1,1) = {"
MB
MB
MB
br
br
JC
JC
br
JC
JC
nT
sE
sg
sE
sE
sE
sE
sE
DI
sg
sE
br
oT
sE
dv
sE
PZ
br
MB
MB
"}
(11,1,1) = {"
MB
MB
MB
br
BM
sE
nT
sg
sE
JN
sE
Lr
sE
sE
LW
sE
sE
KF
sE
sE
sE
JC
WM
sE
KF
sg
PZ
br
MB
MB
"}
(12,1,1) = {"
MB
QI
MB
br
nT
sg
SH
sg
Dy
JC
JC
br
br
br
JC
xf
br
br
LW
LW
sE
JC
Bs
sg
sE
sg
sg
JC
MB
MB
"}
(13,1,1) = {"
MB
MB
MB
JC
sE
Hu
Hu
sg
SS
br
iN
Ah
Lm
Lm
sg
KF
nT
JC
sE
sE
sE
JC
JC
iy
JC
xf
br
JC
MB
MB
"}
(14,1,1) = {"
MB
JC
JC
JC
sE
Yd
sE
Lr
sE
br
Zw
sg
sE
sE
Yl
it
sE
xf
sE
KF
sg
JC
WZ
KF
sE
sE
VO
JC
MB
MB
"}
(15,1,1) = {"
MB
hy
sg
RT
Hu
Hu
sg
Hu
sg
JC
sE
sE
sg
DI
sE
sE
it
JC
nT
sE
sE
JC
sL
sE
Li
sE
aP
JC
MB
MB
"}
(16,1,1) = {"
MB
JC
br
br
sE
Hu
eZ
iv
SS
br
nT
lU
Zy
DW
sE
sg
sg
JC
sE
FL
sE
br
GG
sE
sE
sg
yT
JC
MB
MB
"}
(17,1,1) = {"
MB
MB
MB
br
JC
JC
br
br
br
br
br
br
JC
JC
sE
Yl
PZ
br
sE
sE
KF
br
OZ
sg
nR
sE
KE
JC
MB
MB
"}
(18,1,1) = {"
MB
MB
MB
br
OM
sE
bY
Vp
vX
bY
Vp
cY
pc
JC
sE
sE
PZ
br
dv
LW
LW
br
oT
sE
sE
sE
sE
br
MB
MB
"}
(19,1,1) = {"
MB
MB
MB
JC
UL
sE
sE
Lm
sE
Lm
oF
sE
sE
br
KF
sE
sE
JC
sg
sE
sE
JC
nT
sE
Eg
aP
sE
br
MB
MB
"}
(20,1,1) = {"
MB
MB
MB
br
Dl
sg
nR
sE
sE
sg
KF
sE
if
br
sE
sE
NB
JC
nR
sE
sE
xf
sE
sE
nP
oI
KF
br
MB
MB
"}
(21,1,1) = {"
MB
MB
MB
br
Sg
sE
sE
KF
sE
sg
sE
sE
Jt
JC
sE
sg
sE
JC
sg
sE
sE
JC
oT
sE
sE
nD
sg
JC
MB
MB
"}
(22,1,1) = {"
MB
MB
MB
JC
Sg
sE
sE
WU
Mz
sE
sE
sE
sg
xf
sE
sg
Ah
br
sE
sE
sE
br
sg
sE
sE
sg
sE
JC
MB
MB
"}
(23,1,1) = {"
MB
MB
MB
JC
nT
ox
Dr
bY
Vp
YA
YA
rb
MQ
br
WU
Ut
mr
br
nT
sE
KF
br
rB
sE
KF
sE
nD
JC
MB
MB
"}
(24,1,1) = {"
MB
MB
MB
JC
JC
br
br
br
JC
br
br
br
JC
JC
JC
JC
br
br
br
br
JC
br
br
JC
JC
br
br
JC
MB
MB
"}
(25,1,1) = {"
MB
MB
MB
MB
MB
MB
MB
MB
MB
MB
MB
MB
MB
MB
MB
MB
MB
MB
MB
MB
MB
MB
MB
MB
MB
MB
MB
MB
MB
MB
"}
(26,1,1) = {"
MB
MB
MB
MB
MB
MB
MB
MB
MB
MB
MB
MB
MB
MB
MB
MB
MB
MB
MB
MB
MB
MB
MB
MB
MB
MB
MB
MB
MB
MB
"}
