//MAP CONVERTED BY dmm2tgm.py THIS HEADER COMMENT PREVENTS RECONVERSION, DO NOT REMOVE
"aq" = (
/obj/machinery/door/airlock/vault{
	name = "Vault";
	req_access_txt = "53"
	},
/obj/effect/mapping_helpers/airlock/locked,
/obj/effect/mapping_helpers/airlock/cutaiwire,
/turf/open/floor/iron,
/area/space)
"at" = (
/obj/structure/chair/pew/right{
	dir = 4
	},
/turf/open/floor/iron/chapel{
	dir = 9
	},
/area/space)
"au" = (
/obj/structure/table/wood,
/turf/open/floor/wood,
/area/space)
"aD" = (
/obj/machinery/vending/donksofttoyvendor,
/turf/open/floor/wood,
/area/space)
"aQ" = (
/obj/item/reagent_containers/glass/bottle/toxin,
/turf/open/floor/carpet,
/area/space)
"aT" = (
/obj/structure/table/glass,
/obj/effect/spawner/random/medical/organs,
/turf/open/floor/wood/cold,
/area/space)
"aX" = (
/mob/living/simple_animal/hostile/skeleton/ice,
/turf/open/floor/plating/asteroid/snow/icemoon,
/area/space)
"bJ" = (
/obj/structure/fans/tiny/invisible,
/obj/machinery/door/airlock/maintenance_hatch{
	name = "Power Generator"
	},
/turf/open/floor/wood/cold,
/area/space)
"bM" = (
/obj/structure/table,
/turf/open/floor/iron/icemoon,
/area/space)
"bP" = (
/obj/effect/spawner/random/structure/barricade,
/turf/open/floor/plating/asteroid/snow/icemoon,
/area/space)
"bR" = (
/obj/machinery/door/airlock/wood{
	name = "Town House"
	},
/turf/open/floor/wood/cold,
/area/space)
"bS" = (
/obj/machinery/space_heater,
/turf/open/floor/wood/cold,
/area/space)
"cr" = (
/obj/structure/fence/corner{
	dir = 10
	},
/turf/open/floor/plating,
/area/space)
"cH" = (
/obj/item/stack/sheet/mineral/wood,
/turf/open/floor/plating/snowed/icemoon,
/area/space)
"dn" = (
/obj/structure/decorative/shelf/alcohol,
/obj/effect/spawner/random/maintenance,
/turf/open/floor/wood,
/area/space)
"dq" = (
/obj/structure/decorative/shelf/soda_milk,
/turf/open/floor/wood,
/area/space)
"dO" = (
/obj/effect/mob_spawn/human/doctor,
/turf/open/floor/wood/cold,
/area/space)
"eg" = (
/obj/machinery/door/airlock/wood{
	name = "Priest Quarters"
	},
/turf/open/floor/carpet,
/area/space)
"el" = (
/obj/effect/decal/cleanable/glass{
	dir = 1
	},
/obj/effect/decal/cleanable/glass{
	dir = 4
	},
/obj/item/shard{
	icon_state = "medium"
	},
/turf/open/floor/plating/snowed/icemoon,
/area/space)
"er" = (
/obj/structure/barricade/sandbags,
/turf/open/floor/plating/asteroid/snow/icemoon,
/area/space)
"eu" = (
/obj/structure/tank_dispenser/oxygen,
/turf/open/floor/wood/cold,
/area/space)
"eB" = (
/obj/effect/decal/cleanable/glass{
	dir = 8
	},
/obj/effect/decal/cleanable/glass{
	dir = 1
	},
/obj/item/shard,
/turf/open/floor/plating/snowed/icemoon,
/area/space)
"eG" = (
/turf/open/floor/iron/chapel{
	dir = 5
	},
/area/space)
"eP" = (
/obj/machinery/washing_machine,
/turf/open/floor/iron/icemoon,
/area/space)
"fi" = (
/obj/structure/table/wood,
/obj/effect/spawner/random/entertainment/coin,
/turf/open/floor/plating/snowed/icemoon,
/area/space)
"fR" = (
/turf/open/floor/carpet/lone/star,
/area/space)
"gg" = (
/obj/structure/chair/stool/bar/directional/west,
/turf/open/floor/wood,
/area/space)
"gw" = (
/obj/structure/table/wood,
/obj/effect/spawner/random/engineering/toolbox,
/turf/open/floor/wood/cold,
/area/space)
"gC" = (
/obj/structure/rack,
/obj/effect/spawner/random/engineering/tool_advanced,
/obj/effect/spawner/random/engineering/tool_alien,
/turf/open/floor/iron/icemoon,
/area/space)
"gP" = (
/obj/structure/bed/double,
/turf/open/floor/carpet,
/area/space)
"hW" = (
/mob/living/simple_animal/hostile/skeleton/ice,
/turf/open/floor/plating/snowed/icemoon,
/area/space)
"ik" = (
/obj/structure/rack,
/obj/effect/spawner/random/exotic/technology,
/turf/open/floor/iron/icemoon,
/area/space)
"it" = (
/mob/living/simple_animal/hostile/skeleton/eskimo,
/turf/open/floor/iron/icemoon,
/area/space)
"iM" = (
/obj/structure/chair/stool/bar/directional/south,
/turf/open/floor/wood,
/area/space)
"iX" = (
/obj/structure/bed,
/turf/open/floor/wood/cold,
/area/space)
"jl" = (
/turf/open/floor/plating/asteroid/snow/icemoon,
/area/space)
"js" = (
/obj/structure/table/reinforced/rglass,
/obj/effect/spawner/random/food_or_drink/three_course_meal,
/turf/open/floor/iron/icemoon,
/area/space)
"jL" = (
/obj/structure/door_assembly/door_assembly_sec/old,
/obj/item/stack/sheet/mineral/wood,
/turf/open/floor/iron,
/area/space)
"jQ" = (
/obj/machinery/space_heater,
/turf/open/floor/plating/snowed/icemoon,
/area/space)
"kb" = (
/obj/machinery/oven,
/turf/open/floor/wood/cold,
/area/space)
"kl" = (
/obj/effect/mob_spawn/human/cook,
/turf/open/floor/plating/snowed/icemoon,
/area/space)
"kL" = (
/obj/effect/mob_spawn/human/corpse/assistant,
/turf/open/floor/carpet,
/area/space)
"lg" = (
/obj/effect/spawner/random/structure/closet_private,
/turf/open/floor/wood/cold,
/area/space)
"md" = (
/mob/living/simple_animal/hostile/skeleton/plasmaminer/jackhammer,
/turf/open/floor/plating/asteroid/snow/icemoon,
/area/space)
"me" = (
/obj/structure/chair/pew/right{
	dir = 4
	},
/turf/open/floor/iron/chapel{
	dir = 1
	},
/area/space)
"mB" = (
/turf/open/floor/iron/chapel{
	dir = 4
	},
/area/space)
"mF" = (
/obj/structure/table/reinforced/rglass,
/turf/open/floor/iron/icemoon,
/area/space)
"mU" = (
/turf/open/floor/wood/cold,
/area/space)
"ni" = (
/obj/machinery/ore_silo,
/turf/open/floor/wood/cold,
/area/space)
"nl" = (
/turf/open/floor/plating/cobblestone/planet,
/area/space)
"nn" = (
/obj/structure/filingcabinet,
/obj/effect/spawner/random/entertainment/money_large,
/turf/open/floor/carpet,
/area/space)
"nW" = (
/mob/living/simple_animal/hostile/russian/ranged/officer,
/turf/open/floor/iron/icemoon,
/area/space)
"oi" = (
/obj/structure/table/glass,
/obj/effect/spawner/random/medical/firstaid,
/turf/open/floor/wood/cold,
/area/space)
"oo" = (
/obj/structure/frame/machine,
/turf/open/floor/wood/cold,
/area/space)
"op" = (
/obj/effect/spawner/random/engineering/toolbox,
/turf/open/floor/iron/icemoon,
/area/space)
"ot" = (
/obj/structure/bed,
/turf/open/floor/carpet,
/area/space)
"oF" = (
/obj/structure/fence/door,
/turf/open/floor/plating/asteroid/snow/icemoon,
/area/space)
"oI" = (
/obj/structure/rack/gunrack,
/obj/effect/spawner/random/contraband/armory,
/turf/open/floor/iron/icemoon,
/area/space)
"pg" = (
/obj/structure/door_assembly/door_assembly_wood,
/obj/item/stack/sheet/mineral/wood,
/turf/open/floor/plating/snowed/icemoon,
/area/space)
"pm" = (
/obj/structure/barricade/security,
/turf/open/floor/iron/icemoon,
/area/space)
"pw" = (
/obj/structure/rack/shelf,
/obj/effect/spawner/random/exotic/technology,
/turf/open/floor/iron/icemoon,
/area/space)
"pC" = (
/obj/structure/decorative/shelf/crates,
/turf/open/floor/wood,
/area/space)
"pT" = (
/obj/structure/door_assembly/door_assembly_wood,
/turf/open/floor/plating/snowed/icemoon,
/area/space)
"qg" = (
/obj/machinery/door/airlock/wood/glass{
	name = "Town Stockhouse"
	},
/turf/open/floor/wood/cold,
/area/space)
"qr" = (
/turf/open/floor/iron/chapel,
/area/space)
"qM" = (
/obj/machinery/iv_drip,
/turf/open/floor/wood/cold,
/area/space)
"qY" = (
/obj/machinery/vending/medical,
/turf/open/floor/wood,
/area/space)
"rc" = (
/obj/structure/rack/shelf,
/obj/effect/spawner/random/exotic/antag_gear_weak,
/obj/effect/spawner/random/exotic/antag_gear_weak,
/turf/open/floor/iron/icemoon,
/area/space)
"rp" = (
/obj/structure/decorative/shelf/crates1,
/turf/open/floor/wood,
/area/space)
"rO" = (
/obj/effect/spawner/random/engineering/toolbox,
/turf/open/floor/wood/cold,
/area/space)
"sU" = (
/obj/structure/bed{
	name = "bottom bunk"
	},
/obj/structure/bed{
	name = "top bunk";
	pixel_y = 12
	},
/turf/open/floor/wood/cold,
/area/space)
"tb" = (
/obj/structure/table/wood,
/obj/effect/spawner/random/entertainment/cigar,
/obj/effect/spawner/random/food_or_drink/booze,
/turf/open/floor/wood,
/area/space)
"ty" = (
/obj/machinery/power/floodlight,
/turf/open/floor/plating/asteroid/snow/icemoon,
/area/space)
"ui" = (
/obj/structure/bed/double,
/turf/open/floor/wood/cold,
/area/space)
"uJ" = (
/mob/living/simple_animal/hostile/cat_butcherer{
	desc = "Oh shit!";
	name = "Crazy Surgeon"
	},
/turf/open/floor/wood/cold,
/area/space)
"uL" = (
/obj/machinery/space_heater,
/turf/open/floor/carpet,
/area/space)
"uM" = (
/mob/living/simple_animal/hostile/zombie{
	faction = list("skeleton")
	},
/turf/open/floor/wood/cold,
/area/space)
"uS" = (
/obj/structure/flora/tree/pine,
/turf/open/floor/plating/asteroid/snow/icemoon,
/area/space)
"vk" = (
/obj/machinery/door/airlock/wood{
	name = "Mayor's House"
	},
/obj/structure/barricade/wooden/crude/snow,
/turf/open/floor/wood,
/area/space)
"vZ" = (
/obj/structure/filingcabinet,
/turf/open/floor/iron/icemoon,
/area/space)
"wc" = (
/obj/structure/rack/shelf,
/obj/effect/spawner/random/exotic/syndie,
/obj/effect/spawner/random/exotic/syndie,
/obj/effect/spawner/random/exotic/syndie,
/turf/open/floor/iron/icemoon,
/area/space)
"wf" = (
/obj/effect/spawner/random/food_or_drink/donkpockets,
/turf/open/floor/wood/cold,
/area/space)
"wm" = (
/obj/effect/spawner/random/structure/chair_flipped,
/turf/open/floor/wood,
/area/space)
"wo" = (
/obj/machinery/vending/boozeomat/all_access,
/turf/open/floor/wood,
/area/space)
"wy" = (
/obj/structure/fence{
	dir = 4
	},
/turf/open/floor/plating,
/area/space)
"xd" = (
/obj/machinery/washing_machine,
/turf/open/floor/wood/cold,
/area/space)
"xu" = (
/obj/machinery/door/window/brigdoor,
/turf/open/floor/wood,
/area/space)
"xH" = (
/obj/effect/spawner/random/entertainment/arcade,
/turf/open/floor/wood,
/area/space)
"yO" = (
/obj/structure/frame/computer{
	dir = 4
	},
/turf/open/floor/wood/cold,
/area/space)
"zf" = (
/obj/effect/decal/cleanable/glass{
	dir = 1
	},
/obj/effect/spawner/random/structure/barricade,
/turf/open/floor/plating/snowed/icemoon,
/area/space)
"zq" = (
/turf/closed/wall/mineral/wood,
/area/space)
"zE" = (
/obj/effect/mob_spawn/human/corpse/russian,
/turf/open/floor/wood,
/area/space)
"zG" = (
/obj/structure/table/wood,
/turf/open/floor/wood/cold,
/area/space)
"Al" = (
/obj/structure/chair/pew/left{
	dir = 4
	},
/turf/open/floor/plating/snowed/icemoon,
/area/space)
"Au" = (
/obj/effect/spawner/random/exotic/snow_gear,
/turf/open/floor/plating/asteroid/snow/icemoon,
/area/space)
"Ax" = (
/obj/machinery/space_heater,
/turf/open/floor/iron/icemoon,
/area/space)
"AB" = (
/obj/structure/table/wood,
/obj/machinery/chem_dispenser/drinks/beer/fullupgrade{
	dir = 8
	},
/turf/open/floor/wood,
/area/space)
"AM" = (
/obj/structure/tank_holder/extinguisher,
/turf/open/floor/wood/cold,
/area/space)
"BO" = (
/obj/structure/rack/shelf,
/obj/effect/spawner/random/exotic/languagebook,
/obj/effect/spawner/random/maintenance,
/obj/effect/spawner/random/maintenance,
/obj/effect/spawner/random/maintenance,
/turf/open/floor/wood,
/area/space)
"BW" = (
/obj/structure/rack/shelf,
/obj/effect/spawner/random/engineering/vending_restock,
/obj/effect/spawner/random/engineering/vending_restock,
/obj/effect/spawner/random/maintenance,
/obj/effect/spawner/random/maintenance,
/obj/effect/spawner/random/maintenance,
/turf/open/floor/wood,
/area/space)
"Cm" = (
/turf/open/floor/carpet/lone,
/area/space)
"Ct" = (
/obj/structure/altar_of_gods,
/obj/item/reagent_containers/pill/shadowtoxin{
	desc = "Legends tell of a black substance that will alter the form of those who consume it, blessing (or cursing) them with an affinity for darkness.";
	name = "shadow pill"
	},
/turf/open/floor/carpet,
/area/space)
"CD" = (
/obj/structure/table/glass,
/obj/effect/spawner/random/medical/surgery_tool_advanced,
/obj/effect/spawner/random/medical/surgery_tool_advanced,
/turf/open/floor/wood/cold,
/area/space)
"CJ" = (
/obj/effect/spawner/random/structure/crate_abandoned,
/turf/open/floor/wood,
/area/space)
"CN" = (
/obj/effect/mob_spawn/human/corpse/damaged,
/turf/open/floor/carpet,
/area/space)
"CT" = (
/mob/living/simple_animal/hostile/skeleton/plasmaminer/jackhammer,
/turf/open/floor/wood/cold,
/area/space)
"CY" = (
/obj/effect/mob_spawn/human/engineer,
/turf/open/floor/carpet,
/area/space)
"Dj" = (
/turf/open/genturf,
/area/space)
"Dx" = (
/turf/open/floor/carpet,
/area/space)
"Dz" = (
/obj/structure/table/wood,
/obj/structure/window/reinforced,
/obj/effect/spawner/random/entertainment/musical_instrument,
/obj/effect/spawner/random/food_or_drink/cups,
/turf/open/floor/wood,
/area/space)
"DY" = (
/obj/structure/fence/corner,
/turf/open/floor/plating/asteroid/snow/icemoon,
/area/space)
"EE" = (
/obj/item/reagent_containers/glass/bottle/toxin,
/turf/open/floor/carpet/lone,
/area/space)
"Fc" = (
/obj/structure/fence{
	dir = 4
	},
/turf/open/floor/plating/asteroid/snow/icemoon,
/area/space)
"Fj" = (
/turf/open/floor/wood,
/area/space)
"Fs" = (
/obj/machinery/door/airlock/survival_pod/glass{
	name = "Brig"
	},
/turf/open/floor/stone,
/area/space)
"Gk" = (
/obj/effect/decal/cleanable/glass,
/obj/effect/decal/cleanable/glass{
	dir = 4
	},
/turf/open/floor/plating/snowed/icemoon,
/area/space)
"Gv" = (
/turf/open/floor/iron,
/area/space)
"GT" = (
/obj/structure/table/wood,
/obj/effect/spawner/random/entertainment/coin,
/obj/effect/spawner/random/entertainment/coin,
/turf/open/floor/wood,
/area/space)
"GU" = (
/obj/effect/spawner/random/structure/chair_flipped,
/turf/open/floor/wood/cold,
/area/space)
"Hi" = (
/obj/effect/mob_spawn/human/corpse/russian,
/turf/open/floor/iron/icemoon,
/area/space)
"HI" = (
/turf/closed/wall/mineral/stone,
/area/space)
"Id" = (
/obj/machinery/door/airlock/wood{
	name = "Living Quarters"
	},
/turf/open/floor/carpet,
/area/space)
"Ig" = (
/mob/living/simple_animal/hostile/skeleton/plasmaminer,
/turf/open/floor/iron/icemoon,
/area/space)
"Il" = (
/obj/structure/bed{
	name = "bottom bunk"
	},
/obj/item/bedsheet/dorms,
/obj/structure/bed{
	name = "top bunk";
	pixel_y = 12
	},
/obj/item/bedsheet/dorms{
	pixel_y = 12
	},
/turf/open/floor/iron/icemoon,
/area/space)
"Iu" = (
/turf/open/floor/iron/icemoon,
/area/space)
"Ja" = (
/obj/structure/table/wood,
/obj/effect/spawner/random/food_or_drink/booze,
/turf/open/floor/wood,
/area/space)
"Js" = (
/obj/effect/mob_spawn/human/doctor,
/turf/open/floor/carpet,
/area/space)
"JM" = (
/obj/effect/mob_spawn/human/corpse/damaged,
/turf/open/floor/plating/asteroid/snow/icemoon,
/area/space)
"JO" = (
/obj/structure/tank_dispenser/oxygen,
/turf/open/floor/plating/snowed/icemoon,
/area/space)
"Km" = (
/obj/effect/spawner/random/medical/patient_stretcher,
/turf/open/floor/wood/cold,
/area/space)
"KV" = (
/obj/structure/barricade/security,
/turf/open/floor/plating/asteroid/snow/icemoon,
/area/space)
"KW" = (
/obj/structure/closet/body_bag,
/turf/open/floor/wood/cold,
/area/space)
"La" = (
/obj/structure/door_assembly/door_assembly_wood,
/obj/structure/barricade/wooden/crude/snow,
/turf/open/floor/plating/snowed/icemoon,
/area/space)
"Lc" = (
/obj/effect/spawner/structure/window/reinforced,
/turf/open/floor/plating,
/area/space)
"Lf" = (
/obj/machinery/griddle,
/turf/open/floor/wood/cold,
/area/space)
"Lk" = (
/obj/structure/barricade/wooden/snowed,
/turf/open/floor/plating/snowed/icemoon,
/area/space)
"Lw" = (
/obj/machinery/smoke_machine,
/turf/open/floor/wood/cold,
/area/space)
"LC" = (
/obj/structure/chair/pew/left{
	dir = 4
	},
/turf/open/floor/iron/chapel{
	dir = 8
	},
/area/space)
"LY" = (
/obj/structure/fence/door{
	dir = 4;
	name = "Prison Cell"
	},
/turf/open/floor/plating,
/area/space)
"MH" = (
/obj/structure/fence,
/turf/open/floor/plating/asteroid/snow/icemoon,
/area/space)
"MU" = (
/obj/structure/fans/tiny/invisible,
/obj/machinery/door/airlock/security/old/glass{
	name = "Guard Post"
	},
/turf/open/floor/iron,
/area/space)
"Nd" = (
/obj/effect/mob_spawn/human/doctor,
/obj/structure/bed,
/turf/open/floor/wood/cold,
/area/space)
"Nw" = (
/obj/structure/bed,
/obj/structure/closet/body_bag/stasis,
/turf/open/floor/wood/cold,
/area/space)
"NJ" = (
/obj/structure/table/glass,
/obj/item/reagent_containers/glass/beaker/bluespace,
/turf/open/floor/wood/cold,
/area/space)
"NO" = (
/obj/machinery/power/port_gen/pacman/super,
/turf/open/floor/wood/cold,
/area/space)
"Oa" = (
/obj/structure/barricade/security,
/turf/open/floor/plating/cobblestone/planet,
/area/space)
"Oc" = (
/obj/structure/decorative/shelf/crates1,
/obj/effect/spawner/random/medical/firstaid,
/turf/open/floor/wood,
/area/space)
"Og" = (
/obj/machinery/door/airlock/wood{
	name = "Stock Room"
	},
/turf/open/floor/wood,
/area/space)
"Oi" = (
/obj/structure/table/wood,
/obj/machinery/microwave,
/turf/open/floor/wood/cold,
/area/space)
"Oz" = (
/turf/open/floor/stone,
/area/space)
"OE" = (
/obj/structure/table/wood,
/obj/machinery/chem_dispenser/drinks/fullupgrade{
	dir = 8
	},
/turf/open/floor/wood,
/area/space)
"OG" = (
/obj/structure/fence/corner{
	dir = 10
	},
/obj/structure/fence/post,
/turf/open/floor/plating/asteroid/snow/icemoon,
/area/space)
"OZ" = (
/obj/effect/mob_spawn/human/corpse/russian,
/turf/open/floor/plating/snowed/icemoon,
/area/space)
"Pe" = (
/obj/machinery/door/airlock/wood,
/turf/open/floor/wood,
/area/space)
"Pj" = (
/obj/effect/mob_spawn/human/engineer,
/turf/open/floor/wood/cold,
/area/space)
"PB" = (
/turf/open/floor/plating/snowed/icemoon,
/area/space)
"PP" = (
/obj/structure/door_assembly/door_assembly_wood,
/turf/open/floor/wood/cold,
/area/space)
"PX" = (
/turf/open/floor/iron/chapel{
	dir = 6
	},
/area/space)
"Ql" = (
/obj/structure/table/wood,
/obj/structure/window/reinforced{
	dir = 4
	},
/obj/effect/spawner/random/decoration/ornament,
/turf/open/floor/wood,
/area/space)
"QN" = (
/obj/machinery/microwave,
/turf/open/floor/wood/cold,
/area/space)
"Rn" = (
/obj/effect/mob_spawn/human/miner/explorer,
/turf/open/floor/wood/cold,
/area/space)
"Rs" = (
/obj/structure/table/glass,
/obj/structure/bedsheetbin,
/turf/open/floor/wood/cold,
/area/space)
"Sa" = (
/obj/effect/spawner/random/medical/supplies,
/turf/open/floor/wood/cold,
/area/space)
"SE" = (
/obj/machinery/grill,
/turf/open/floor/wood/cold,
/area/space)
"Tc" = (
/obj/effect/mob_spawn/human/corpse/damaged,
/turf/open/floor/plating/snowed/icemoon,
/area/space)
"Tf" = (
/obj/item/reagent_containers/glass/bowl/ceramic,
/turf/open/floor/plating/snowed/icemoon,
/area/space)
"Th" = (
/obj/effect/spawner/random/structure/closet_private,
/turf/open/floor/carpet,
/area/space)
"Tl" = (
/obj/structure/table/wood,
/obj/effect/spawner/random/decoration/ornament,
/turf/open/floor/wood/cold,
/area/space)
"Ts" = (
/obj/effect/decal/cleanable/glass{
	dir = 4
	},
/obj/effect/decal/cleanable/glass,
/obj/item/shard,
/turf/open/floor/plating/snowed/icemoon,
/area/space)
"Tv" = (
/obj/item/stock_parts/cell/bluespace,
/turf/open/floor/wood/cold,
/area/space)
"TM" = (
/obj/structure/table/wood,
/obj/effect/spawner/random/food_or_drink/dinner,
/turf/open/floor/wood/cold,
/area/space)
"TQ" = (
/obj/machinery/paystand,
/turf/open/floor/wood,
/area/space)
"Ua" = (
/turf/closed/wall/r_wall,
/area/space)
"Uz" = (
/obj/structure/fence/corner,
/obj/structure/fence/post,
/turf/open/floor/plating/asteroid/snow/icemoon,
/area/space)
"Vk" = (
/obj/machinery/door/window/brigdoor{
	dir = 4
	},
/turf/open/floor/wood,
/area/space)
"VA" = (
/obj/machinery/space_heater,
/turf/open/floor/wood,
/area/space)
"Wo" = (
/obj/structure/statue/snow/snowman,
/turf/open/floor/plating/asteroid/snow/icemoon,
/area/space)
"Xl" = (
/obj/machinery/door/airlock/wood{
	name = "Town Clinic"
	},
/obj/structure/barricade/wooden/snowed,
/turf/open/floor/wood/cold,
/area/space)
"Xm" = (
/obj/machinery/seed_extractor,
/obj/effect/spawner/random/food_or_drink/seed_rare,
/obj/effect/spawner/random/food_or_drink/seed_rare,
/obj/effect/spawner/random/food_or_drink/seed_rare,
/turf/open/floor/wood/cold,
/area/space)
"Xn" = (
/obj/machinery/door/airlock/wood{
	name = "Town House";
	req_access_txt = "12"
	},
/turf/open/floor/wood/cold,
/area/space)
"Xp" = (
/obj/effect/spawner/random/structure/crate_abandoned,
/turf/open/floor/plating/snowed/icemoon,
/area/space)
"XM" = (
/turf/closed/wall/ice,
/area/space)
"XP" = (
/obj/structure/table/wood,
/turf/open/floor/carpet,
/area/space)
"XT" = (
/obj/structure/table/wood,
/obj/effect/spawner/random/decoration/ornament,
/turf/open/floor/carpet,
/area/space)
"Ya" = (
/mob/living/simple_animal/hostile/skeleton/plasmaminer,
/turf/open/floor/plating/asteroid/snow/icemoon,
/area/space)
"Yz" = (
/obj/structure/fence/corner{
	dir = 10
	},
/turf/open/floor/plating/asteroid/snow/icemoon,
/area/space)
"YE" = (
/obj/effect/decal/cleanable/glass,
/turf/open/floor/plating/snowed/icemoon,
/area/space)
"YG" = (
/obj/structure/chair/pew/left{
	dir = 4
	},
/turf/open/floor/iron/chapel{
	dir = 10
	},
/area/space)
"YU" = (
/turf/open/floor/plating,
/area/space)
"Zj" = (
/obj/structure/table/glass,
/obj/item/storage/backpack/duffelbag/med/surgery,
/obj/effect/spawner/random/medical/firstaid_rare,
/turf/open/floor/wood/cold,
/area/space)
"Zs" = (
/obj/effect/mob_spawn/human/miner/rig,
/turf/open/floor/plating/asteroid/snow/icemoon,
/area/space)
"ZM" = (
/turf/closed/wall,
/area/space)
"ZR" = (
/mob/living/simple_animal/hostile/skeleton/ice,
/turf/open/floor/wood/cold,
/area/space)
"ZT" = (
/obj/effect/mob_spawn/human/cook,
/turf/open/floor/wood/cold,
/area/space)

(1,1,1) = {"
Dj
OG
MH
MH
MH
MH
MH
MH
Yz
Dj
Dj
Dj
Dj
Dj
Dj
Dj
Dj
Dj
Dj
Dj
Dj
Dj
Dj
Dj
Dj
Dj
Dj
Dj
Dj
Dj
Dj
Dj
Dj
Dj
Dj
Dj
Dj
Dj
Dj
Dj
Dj
Dj
"}
(2,1,1) = {"
Dj
Fc
jl
jl
jl
uS
jl
jl
Fc
jl
Dj
Dj
Dj
Dj
Dj
Dj
Dj
Dj
Dj
Dj
jl
OG
MH
MH
MH
MH
MH
MH
MH
MH
MH
MH
MH
MH
MH
MH
MH
MH
zq
zq
zq
zq
"}
(3,1,1) = {"
Dj
Fc
zq
zq
zq
zq
zq
zq
Uz
MH
MH
MH
MH
MH
MH
MH
MH
MH
MH
MH
MH
DY
Wo
jl
jl
jl
uS
jl
jl
jl
jl
jl
jl
uS
jl
jl
Ya
jl
zq
NO
NO
zq
"}
(4,1,1) = {"
Dj
Fc
zq
lg
zG
zG
yO
Lc
jl
jl
jl
jl
jl
jl
jl
jl
jl
jl
jl
jl
jl
jl
jl
jl
jl
jl
jl
jl
jl
jl
jl
jl
jl
jl
jl
jl
jl
jl
zq
Tv
Pj
zq
"}
(5,1,1) = {"
Dj
Fc
zq
mU
CT
mU
mU
zq
zq
zq
zq
jl
jl
jl
jl
jl
jl
jl
jl
jl
jl
jl
jl
jl
jl
jl
zq
zq
zq
zq
zq
zq
zq
Lc
Lc
zq
zq
jl
zq
bJ
zq
zq
"}
(6,1,1) = {"
Dj
Fc
zq
mU
mU
Dx
Dx
zq
kb
wf
zq
jl
zq
zq
zq
zq
zq
zq
zq
zq
zq
jl
zq
zq
zq
zq
zq
sU
lg
sU
lg
zq
iX
aT
iX
oi
zq
jl
jl
jl
Ya
Fc
"}
(7,1,1) = {"
Dj
Fc
zq
mU
mU
XT
gP
zq
Lf
ZT
zq
md
zq
iX
lg
oo
zq
iX
uJ
gw
zq
jl
zq
iX
GU
Tl
zq
Sa
mU
mU
mU
zq
qM
uM
qM
KW
zq
jl
jl
jl
jl
Fc
"}
(8,1,1) = {"
Dj
Fc
zq
zq
Pe
zq
zq
zq
SE
mU
zq
jl
zq
mU
mU
mU
zq
mU
mU
mU
zq
jl
zq
mU
mU
PB
zq
GU
Oi
mU
xd
zq
Nw
CD
Nd
NJ
zq
jl
Ua
Ua
Ua
Ua
"}
(9,1,1) = {"
Dj
Fc
zq
PB
mU
mU
zG
zG
mU
hW
zq
jl
zq
PB
TM
PB
zq
kb
mU
mU
Lc
jl
zq
PB
PB
mU
zq
mU
zG
GU
mU
zq
qM
mU
qM
KW
zq
jl
Ua
jQ
JO
Ua
"}
(10,1,1) = {"
Dj
Fc
zq
PB
ZR
PB
wm
PB
mU
mU
zq
jl
zq
jQ
PB
mU
zq
QN
mU
bS
Lc
Ya
zq
Lc
pT
zq
zq
mU
mU
mU
mU
zq
uM
dO
Km
Km
zq
jl
Ua
PB
PB
Lc
"}
(11,1,1) = {"
jl
Fc
zq
bS
mU
mU
PB
PB
PB
mU
zq
jl
zq
zq
Lk
PP
zq
zq
Xn
zq
zq
jl
jl
jl
nl
jl
zq
ui
mU
mU
ui
zq
Zj
mU
mU
uM
zq
jl
Ua
PB
Gv
Lc
"}
(12,1,1) = {"
jl
Fc
zq
zq
Lc
Lc
YE
zf
vk
zq
zq
jl
jl
uS
jl
nl
er
jl
nl
jl
bP
jl
jl
er
nl
jl
zq
zq
zq
bR
zq
zq
Rs
KW
mU
AM
zq
jl
jl
PB
Xp
Lc
"}
(13,1,1) = {"
uS
Fc
jl
jl
jl
jl
jl
jl
nl
ty
jl
jl
jl
jl
jl
nl
er
jl
nl
bP
jl
jl
jl
er
jl
jl
ty
jl
jl
nl
jl
zq
Lc
zq
Xl
zq
zq
jl
jl
MU
Ua
Ua
"}
(14,1,1) = {"
jl
Fc
jl
JM
jl
jl
aX
jl
jl
jl
jl
jl
jl
er
er
er
jl
jl
jl
jl
jl
jl
jl
er
jl
jl
jl
jl
jl
nl
jl
jl
jl
jl
nl
jl
jl
jl
jl
nl
ty
Fc
"}
(15,1,1) = {"
jl
oF
KV
jl
jl
jl
jl
jl
jl
jl
jl
jl
jl
jl
jl
jl
jl
jl
nl
jl
jl
jl
jl
jl
nl
jl
jl
jl
jl
nl
jl
jl
aX
jl
nl
jl
jl
jl
jl
jl
jl
Fc
"}
(16,1,1) = {"
jl
Fc
jl
jl
nl
nl
jl
jl
nl
nl
jl
jl
nl
nl
nl
nl
jl
jl
jl
jl
jl
jl
jl
nl
nl
nl
jl
jl
nl
nl
nl
nl
nl
nl
nl
nl
jl
jl
nl
jl
KV
oF
"}
(17,1,1) = {"
jl
jl
nl
jl
jl
jl
jl
nl
nl
nl
nl
nl
jl
jl
nl
nl
nl
jl
nl
nl
jl
jl
er
jl
nl
nl
nl
nl
nl
nl
jl
nl
jl
nl
nl
jl
jl
nl
nl
jl
Oa
oF
"}
(18,1,1) = {"
jl
jl
nl
jl
jl
jl
nl
jl
nl
jl
jl
jl
jl
jl
jl
nl
jl
jl
jl
jl
jl
jl
er
jl
jl
jl
jl
jl
er
er
er
jl
er
er
jl
jl
er
jl
jl
jl
Oa
oF
"}
(19,1,1) = {"
jl
jl
jl
jl
jl
uS
nl
nl
nl
jl
jl
uS
jl
jl
jl
nl
jl
jl
jl
jl
jl
jl
er
aX
jl
jl
jl
jl
er
jl
jl
nl
jl
jl
jl
md
er
jl
nl
jl
jl
Fc
"}
(20,1,1) = {"
jl
Fc
jl
jl
jl
jl
nl
jl
nl
jl
jl
jl
jl
md
jl
nl
ty
jl
jl
jl
uS
jl
jl
jl
jl
jl
jl
jl
er
XM
XM
pg
XM
XM
el
eB
XM
XM
qg
zq
zq
Fc
"}
(21,1,1) = {"
jl
Fc
jl
HI
HI
HI
La
HI
La
HI
HI
HI
jl
zq
Lk
pT
zq
Lc
Gk
Ts
zq
jl
jl
jl
jl
ZM
ZM
XM
XM
ZM
PB
cH
OZ
Iu
cH
PB
PB
XM
mU
eu
zq
Fc
"}
(22,1,1) = {"
Dj
Fc
jl
HI
at
Al
PB
Tc
PB
me
Al
HI
jl
zq
cH
PB
PB
Fj
fi
PB
zq
zq
zq
zq
bP
XM
Il
Iu
bM
XM
Iu
PB
Iu
PB
PB
PB
Hi
XM
mU
Lw
zq
Fc
"}
(23,1,1) = {"
Dj
Fc
jl
HI
mB
PX
kl
EE
CY
PB
qr
HI
JM
zq
rp
PB
BO
PB
TQ
PB
zq
dn
dq
zq
Au
XM
Il
Ig
bM
XM
mF
mF
js
mF
PB
Iu
Iu
XM
mU
bS
zq
Fc
"}
(24,1,1) = {"
Dj
Fc
jl
HI
me
YG
kL
Tf
CN
at
LC
HI
jl
zq
BW
Fj
qY
Fj
au
zE
Og
Fj
Fj
zq
jl
XM
Il
Iu
Iu
jL
Iu
Ig
OZ
mF
PB
Iu
PB
ZM
Rn
rO
zq
Fc
"}
(25,1,1) = {"
Dj
Fc
jl
HI
eG
qr
Js
Cm
aQ
PB
PX
HI
jl
zq
aD
zE
rp
Fj
Ql
Vk
zq
pC
Oc
zq
jl
XM
vZ
it
eP
ZM
it
Iu
Iu
op
Iu
Iu
it
ZM
Xm
ni
zq
Fc
"}
(26,1,1) = {"
Dj
Fc
jl
HI
at
LC
Dx
kL
Dx
me
YG
HI
jl
zq
xH
Fj
PB
Fj
PB
Fj
zq
zq
zq
zq
jl
ZM
vZ
Iu
Ax
ZM
ZM
Fs
Lc
Lc
Lc
Fs
XM
Ua
zq
zq
zq
Fc
"}
(27,1,1) = {"
Dj
Fc
jl
HI
mB
PX
Dx
Ct
Dx
eG
qr
HI
jl
zq
gg
gg
gg
gg
Fj
Fj
zq
nn
uL
zq
jl
Ua
Ua
aq
Ua
Ua
CJ
Oz
Fj
Fj
Fj
Oz
Fj
Ua
jl
jl
jl
Fc
"}
(28,1,1) = {"
Dj
Fc
jl
HI
HI
HI
Dx
fR
Dx
HI
HI
HI
jl
zq
Ja
tb
Ja
GT
iM
Fj
zq
Dx
Dx
zq
jl
Ua
pw
pm
oI
Ua
Oz
Oz
Oz
Oz
Oz
Oz
Oz
Ua
jl
Zs
jl
Fc
"}
(29,1,1) = {"
Dj
Fc
jl
jl
jl
HI
VA
Fj
Fj
HI
jl
jl
jl
zq
Fj
zE
Fj
xu
Fj
Fj
Id
Dx
Dx
zq
Ya
Ua
wc
Iu
ik
Ua
LY
cr
LY
cr
LY
cr
LY
Ua
jl
jl
md
Fc
"}
(30,1,1) = {"
Dj
Fc
jl
jl
jl
zq
zq
zq
eg
zq
jl
jl
jl
zq
wo
AB
OE
Dz
Fj
Fj
zq
Th
ot
zq
jl
Ua
rc
nW
gC
Ua
YU
wy
YU
wy
YU
wy
YU
Ua
jl
uS
jl
Fc
"}
(31,1,1) = {"
Dj
Fc
jl
uS
jl
zq
XP
Dx
Dx
zq
jl
jl
jl
zq
zq
zq
zq
zq
zq
zq
zq
zq
zq
zq
jl
Ua
Ua
Ua
Ua
Ua
Ua
Ua
Ua
Ua
Ua
Ua
Ua
Ua
jl
jl
jl
Fc
"}
(32,1,1) = {"
Dj
Fc
jl
jl
jl
zq
XP
Dx
ot
zq
jl
uS
jl
jl
jl
jl
Fc
jl
uS
jl
jl
jl
jl
Uz
MH
MH
MH
MH
MH
MH
MH
MH
MH
MH
MH
MH
MH
MH
MH
MH
MH
DY
"}
(33,1,1) = {"
Dj
Uz
MH
MH
MH
zq
zq
zq
zq
zq
MH
MH
MH
MH
MH
MH
DY
Dj
Dj
Dj
Dj
Dj
Dj
Dj
Dj
Dj
Dj
Dj
Dj
Dj
Dj
Dj
Dj
Dj
Dj
Dj
Dj
Dj
Dj
Dj
Dj
Dj
"}
