//MAP CONVERTED BY dmm2tgm.py THIS HEADER COMMENT PREVENTS RECONVERSION, DO NOT REMOVE
"bA" = (
/obj/effect/spawner/structure/window/reinforced,
/turf/open/floor/plating,
/area/space)
"cc" = (
/obj/structure/trash_pile,
/turf/open/floor/plating/asteroid/snow/icemoon,
/area/space)
"ck" = (
/obj/machinery/computer{
	dir = 8
	},
/turf/open/floor/iron/dark,
/area/space)
"fM" = (
/mob/living/simple_animal/hostile/syndicate/melee/sword,
/turf/open/floor/iron/dark/red/side,
/area/space)
"gG" = (
/obj/structure/table/reinforced,
/obj/effect/spawner/random/food_or_drink/seed_rare,
/turf/open/floor/iron/dark/red,
/area/space)
"gM" = (
/turf/closed/wall/r_wall/syndicate,
/area/space)
"gS" = (
/obj/structure/table/reinforced,
/obj/item/dnainjector/insulated,
/turf/open/floor/iron/dark/red,
/area/space)
"ha" = (
/obj/structure/table/reinforced,
/obj/effect/spawner/random/exotic/syndie,
/turf/open/floor/iron/dark/red,
/area/space)
"hk" = (
/obj/machinery/computer,
/turf/open/floor/iron/dark/red,
/area/space)
"jo" = (
/obj/effect/spawner/random/exotic/antag_gear_weak,
/obj/structure/table/reinforced,
/turf/open/floor/iron/dark/red/side{
	dir = 8
	},
/area/space)
"jq" = (
/turf/open/floor/iron/dark/red/side{
	dir = 8
	},
/area/space)
"jB" = (
/mob/living/simple_animal/hostile/syndicate/melee,
/turf/open/floor/iron/dark/red,
/area/space)
"kU" = (
/obj/machinery/computer{
	dir = 4
	},
/turf/open/floor/iron/dark/red,
/area/space)
"le" = (
/obj/structure/table/reinforced,
/obj/item/disk/tech_disk/spaceloot,
/obj/effect/spawner/random/exotic/technology,
/turf/open/floor/iron/dark/red,
/area/space)
"lJ" = (
/mob/living/simple_animal/hostile/syndicate/ranged,
/turf/open/floor/iron/dark/red,
/area/space)
"lN" = (
/obj/machinery/door/airlock/external{
	req_access_txt = "150"
	},
/turf/open/floor/iron/dark,
/area/space)
"lP" = (
/obj/machinery/computer/atmos_alert,
/turf/open/floor/iron/dark/red,
/area/space)
"mg" = (
/mob/living/simple_animal/hostile/syndicate/civilian,
/turf/open/floor/iron/dark,
/area/space)
"on" = (
/obj/structure/chair/office{
	dir = 8
	},
/turf/open/floor/iron/dark,
/area/space)
"ow" = (
/obj/structure/table/reinforced,
/obj/effect/spawner/random/exotic/antag_gear,
/turf/open/floor/iron/dark/red,
/area/space)
"qq" = (
/mob/living/simple_animal/hostile/syndicate/civilian,
/obj/structure/chair/office{
	dir = 1;
	pixel_y = 12
	},
/turf/open/floor/iron/dark,
/area/space)
"qP" = (
/obj/machinery/computer/monitor,
/turf/open/floor/iron/dark/red,
/area/space)
"ra" = (
/obj/structure/chair/office{
	dir = 4
	},
/turf/open/floor/iron/dark,
/area/space)
"sJ" = (
/obj/structure/chair/office,
/turf/open/floor/iron/dark,
/area/space)
"sL" = (
/obj/machinery/door/airlock/hatch{
	req_access_txt = "150"
	},
/turf/open/floor/iron/dark,
/area/space)
"sN" = (
/turf/open/genturf,
/area/space)
"tl" = (
/turf/open/floor/iron/dark/red/side,
/area/space)
"tn" = (
/mob/living/simple_animal/hostile/syndicate/ranged,
/turf/open/floor/iron/dark,
/area/space)
"tv" = (
/turf/open/floor/iron/dark/red/side{
	dir = 1
	},
/area/space)
"uq" = (
/mob/living/simple_animal/hostile/syndicate/melee/sword,
/turf/open/floor/iron/dark,
/area/space)
"uT" = (
/obj/structure/table/reinforced,
/turf/open/floor/iron/dark/red,
/area/space)
"vb" = (
/obj/machinery/computer{
	dir = 8
	},
/turf/open/floor/iron/dark/red/side{
	dir = 4
	},
/area/space)
"vg" = (
/turf/open/floor/iron/dark/red/side{
	dir = 4
	},
/area/space)
"yj" = (
/obj/structure/chair/office{
	dir = 1;
	pixel_y = 12
	},
/turf/open/floor/iron/dark,
/area/space)
"yu" = (
/obj/machinery/door/airlock/highsecurity{
	req_access_txt = "150"
	},
/turf/open/floor/iron/dark,
/area/space)
"zz" = (
/obj/structure/table/reinforced,
/obj/effect/spawner/random/exotic/antag_gear_weak,
/turf/open/floor/iron/dark/red,
/area/space)
"Az" = (
/obj/structure/table/reinforced,
/obj/effect/spawner/random/food_or_drink/three_course_meal,
/turf/open/floor/iron/dark/red,
/area/space)
"CD" = (
/obj/item/folder/syndicate,
/obj/structure/filingcabinet,
/turf/open/floor/iron/dark/red/side,
/area/space)
"CR" = (
/obj/machinery/computer{
	dir = 4
	},
/turf/open/floor/iron/dark/red/side{
	dir = 8
	},
/area/space)
"EG" = (
/turf/open/floor/iron/dark,
/area/space)
"EM" = (
/obj/structure/table/reinforced,
/obj/effect/spawner/random/exotic/tool,
/turf/open/floor/iron/dark,
/area/space)
"Fc" = (
/obj/structure/table/reinforced,
/obj/effect/spawner/random/food_or_drink/dinner,
/turf/open/floor/iron/dark/red,
/area/space)
"JN" = (
/obj/structure/tank_holder/extinguisher,
/turf/open/floor/iron/dark/red,
/area/space)
"KL" = (
/obj/machinery/porta_turret/syndicate/energy{
	dir = 6
	},
/turf/open/floor/iron/dark,
/area/space)
"KM" = (
/obj/structure/table/reinforced,
/obj/effect/spawner/random/exotic/technology,
/turf/open/floor/iron/dark/red,
/area/space)
"LG" = (
/obj/structure/table/reinforced,
/obj/effect/spawner/random/food_or_drink/seed_rare,
/obj/effect/spawner/random/food_or_drink/seed_rare,
/obj/effect/spawner/random/food_or_drink/seed_rare,
/turf/open/floor/iron/dark/red,
/area/space)
"Pm" = (
/turf/open/floor/plating/asteroid/snow/icemoon,
/area/space)
"Vr" = (
/obj/machinery/porta_turret/syndicate/energy{
	dir = 10
	},
/turf/open/floor/iron/dark,
/area/space)
"Wc" = (
/mob/living/simple_animal/hostile/syndicate/civilian,
/turf/open/floor/iron/dark/red,
/area/space)
"Yr" = (
/mob/living/simple_animal/hostile/syndicate/ranged/smg,
/turf/open/floor/iron/dark,
/area/space)
"YA" = (
/turf/open/floor/iron/dark/red,
/area/space)
"YP" = (
/obj/effect/spawner/random/exotic/snow_gear,
/turf/open/floor/plating/asteroid/snow/icemoon,
/area/space)
"Zk" = (
/obj/structure/table/reinforced,
/turf/open/floor/iron/dark,
/area/space)
"Zx" = (
/mob/living/simple_animal/hostile/syndicate/melee,
/turf/open/floor/iron/dark,
/area/space)

(1,1,1) = {"
sN
Pm
sN
sN
sN
Pm
Pm
Pm
sN
sN
sN
sN
sN
Pm
sN
sN
sN
sN
"}
(2,1,1) = {"
sN
Pm
Pm
Pm
Pm
Pm
Pm
Pm
Pm
sN
sN
Pm
Pm
Pm
cc
sN
sN
sN
"}
(3,1,1) = {"
sN
Pm
gM
gM
gM
gM
gM
gM
gM
gM
gM
gM
gM
gM
gM
gM
cc
sN
"}
(4,1,1) = {"
sN
Pm
gM
YA
EG
jB
gM
YA
YA
YA
gG
uT
LG
YA
YA
gM
Pm
Pm
"}
(5,1,1) = {"
sN
Pm
lN
EG
Zx
EG
sL
EG
EG
EG
EG
Zx
EG
EG
YA
gM
Pm
Pm
"}
(6,1,1) = {"
sN
Pm
gM
YA
EG
YA
gM
EG
EG
EG
EG
EG
EG
mg
zz
gM
Pm
Pm
"}
(7,1,1) = {"
sN
Pm
gM
gM
gM
gM
gM
gM
gM
gM
gM
gM
EG
EG
Az
gM
Pm
sN
"}
(8,1,1) = {"
sN
YP
gM
kU
kU
ow
gS
YA
YA
YA
JN
gM
EG
EG
YA
gM
sN
sN
"}
(9,1,1) = {"
sN
Pm
gM
Wc
on
EG
Zx
EG
EG
EG
YA
yu
EG
EG
YA
gM
sN
sN
"}
(10,1,1) = {"
Pm
Pm
gM
YA
tn
YA
EG
EG
YA
EG
YA
gM
EG
EG
YA
gM
sN
sN
"}
(11,1,1) = {"
Pm
Pm
gM
ha
ra
Yr
sJ
EG
EG
EG
YA
gM
EG
Zx
YA
gM
Pm
sN
"}
(12,1,1) = {"
sN
Pm
gM
le
EG
EG
vb
vg
vg
EG
YA
gM
tn
EG
YA
gM
Pm
Pm
"}
(13,1,1) = {"
sN
Pm
gM
hk
yj
CD
gM
bA
bA
tv
YA
gM
EG
EG
YA
gM
Pm
Pm
"}
(14,1,1) = {"
sN
Pm
gM
hk
EG
fM
gM
Vr
bA
tv
YA
gM
EM
EG
YA
gM
sN
sN
"}
(15,1,1) = {"
sN
Pm
gM
KM
ck
tl
gM
KL
bA
tv
YA
gM
Zk
EG
YA
gM
sN
sN
"}
(16,1,1) = {"
sN
Pm
gM
YA
EG
tl
gM
bA
bA
tv
YA
gM
EG
mg
YA
gM
sN
sN
"}
(17,1,1) = {"
sN
sN
gM
YA
EG
EG
CR
jo
jq
EG
YA
gM
EG
EG
lJ
gM
sN
sN
"}
(18,1,1) = {"
sN
sN
gM
qP
EG
EG
on
EG
uq
EG
YA
gM
EG
EG
YA
gM
Pm
sN
"}
(19,1,1) = {"
sN
sN
gM
lP
qq
YA
EG
EG
YA
EG
YA
gM
EG
EG
YA
gM
sN
sN
"}
(20,1,1) = {"
sN
sN
gM
ha
EG
EG
EG
EG
EG
EG
YA
yu
EG
EG
YA
gM
sN
sN
"}
(21,1,1) = {"
sN
sN
gM
Fc
ha
YA
jB
YA
YA
YA
YA
gM
EG
EG
YA
gM
Pm
sN
"}
(22,1,1) = {"
sN
sN
gM
gM
gM
gM
gM
gM
gM
gM
gM
gM
gM
gM
gM
gM
Pm
Pm
"}
(23,1,1) = {"
sN
Pm
Pm
Pm
Pm
Pm
Pm
cc
Pm
Pm
cc
Pm
sN
sN
sN
sN
Pm
sN
"}
(24,1,1) = {"
sN
Pm
Pm
sN
sN
sN
sN
Pm
Pm
Pm
sN
sN
sN
sN
sN
sN
sN
sN
"}
(25,1,1) = {"
sN
sN
sN
sN
sN
sN
sN
sN
sN
sN
sN
sN
sN
sN
sN
sN
sN
sN
"}
