//MAP CONVERTED BY dmm2tgm.py THIS HEADER COMMENT PREVENTS RECONVERSION, DO NOT REMOVE
"a" = (
/turf/open/floor/plating/asteroid/snow/icemoon,
/area/space)
"g" = (
/turf/open/genturf,
/area/space)
"i" = (
/obj/item/gun/ballistic/revolver/russian/soul,
/turf/open/floor/plating/asteroid/snow/icemoon,
/area/space)
"j" = (
/obj/effect/decal/remains/human,
/obj/item/clothing/head/cowboyhat/sheriff/alt{
	pixel_y = 6
	},
/obj/item/clothing/shoes/cowboyboots,
/obj/item/gun/ballistic/revolver/revolution,
/turf/open/floor/plating/asteroid/snow/icemoon,
/area/space)
"k" = (
/obj/effect/decal/remains/human,
/obj/item/clothing/head/cowboyhat/blackwide,
/obj/item/clothing/shoes/cowboyboots,
/turf/open/floor/plating/asteroid/snow/icemoon,
/area/space)
"l" = (
/obj/effect/decal/remains/human,
/obj/item/storage/belt/holster/cowboy,
/turf/open/floor/plating/asteroid/snow/icemoon,
/area/space)
"m" = (
/obj/effect/decal/remains/human,
/obj/item/clothing/head/cowboyhat/wide,
/turf/open/floor/plating/asteroid/snow/icemoon,
/area/space)
"v" = (
/obj/effect/decal/remains/human,
/obj/item/clothing/suit/cowboyvest,
/turf/open/floor/plating/asteroid/snow/icemoon,
/area/space)
"x" = (
/obj/structure/barricade/sandbags,
/turf/open/floor/plating/asteroid/snow/icemoon,
/area/space)
"y" = (
/obj/effect/decal/remains/human,
/obj/item/clothing/under/rancher/cowboy,
/obj/item/gun/ballistic/revolver/rifle/improvised,
/turf/open/floor/plating/asteroid/snow/icemoon,
/area/space)
"C" = (
/mob/living/simple_animal/hostile/skeleton/ice,
/turf/open/floor/plating/asteroid/snow/icemoon,
/area/space)
"R" = (
/mob/living/simple_animal/hostile/skeleton/plasmaminer,
/turf/open/floor/plating/asteroid/snow/icemoon,
/area/space)
"T" = (
/mob/living/simple_animal/hostile/skeleton/templar,
/turf/open/floor/plating/asteroid/snow/icemoon,
/area/space)
"Z" = (
/obj/item/paper{
	info = "We might go down, not much ammo left and they keep com-";
	name = "ranger note"
	},
/turf/open/floor/plating/asteroid/snow/icemoon,
/area/space)

(1,1,1) = {"
g
g
g
g
g
g
g
g
g
g
g
g
"}
(2,1,1) = {"
g
g
a
g
g
g
a
a
g
g
g
g
"}
(3,1,1) = {"
g
g
m
a
x
x
x
x
x
l
a
g
"}
(4,1,1) = {"
g
g
R
x
j
C
v
T
a
a
R
g
"}
(5,1,1) = {"
g
g
a
x
a
Z
a
a
a
x
g
g
"}
(6,1,1) = {"
g
g
a
a
T
i
a
y
C
x
g
g
"}
(7,1,1) = {"
g
g
a
k
a
x
x
x
x
x
g
g
"}
(8,1,1) = {"
g
g
g
g
g
g
a
a
R
g
g
g
"}
(9,1,1) = {"
g
g
g
g
g
g
g
g
g
g
g
g
"}
