//MAP CONVERTED BY dmm2tgm.py THIS HEADER COMMENT PREVENTS RECONVERSION, DO NOT REMOVE
"at" = (
/obj/structure/window/reinforced,
/obj/structure/window/reinforced{
	dir = 8
	},
/obj/machinery/oven{
	pixel_x = 5;
	pixel_y = 3
	},
/turf/open/floor/iron/kitchen,
/area/space)
"br" = (
/obj/structure/window/reinforced,
/obj/structure/table,
/obj/machinery/chem_dispenser/drinks/beer/fullupgrade{
	dir = 1
	},
/turf/open/floor/iron/kitchen,
/area/space)
"bG" = (
/obj/structure/reagent_dispensers/watertank/high,
/obj/item/reagent_containers/glass/bucket,
/obj/item/reagent_containers/glass/bucket,
/turf/open/floor/iron/green,
/area/space)
"bJ" = (
/obj/machinery/vending/hydronutrients{
	onstation = 0
	},
/turf/open/floor/iron/green,
/area/space)
"cz" = (
/obj/structure/cable,
/turf/open/floor/wood,
/area/space)
"cG" = (
/turf/open/floor/iron/textured,
/area/space)
"cL" = (
/obj/structure/table/wood,
/obj/effect/spawner/random/food_or_drink/refreshing_beverage,
/turf/open/floor/wood,
/area/space)
"ed" = (
/obj/machinery/hydroponics/constructable,
/obj/machinery/light/directional/north,
/turf/open/floor/iron/green,
/area/space)
"eL" = (
/obj/machinery/door/airlock/wood/glass,
/obj/machinery/atmospherics/pipe/smart/manifold4w/supply/hidden/layer4,
/turf/open/floor/iron/textured,
/area/space)
"fl" = (
/obj/structure/chair/sofa/right{
	dir = 4
	},
/turf/open/floor/wood,
/area/space)
"gd" = (
/obj/structure/table/wood,
/obj/effect/spawner/random/food_or_drink/soup,
/turf/open/floor/wood,
/area/space)
"gh" = (
/obj/structure/chair/sofa/left,
/obj/structure/window/reinforced/tinted{
	dir = 1
	},
/turf/open/floor/wood,
/area/space)
"gL" = (
/turf/open/floor/wood,
/area/space)
"gQ" = (
/obj/structure/table,
/obj/machinery/processor{
	pixel_x = 2;
	pixel_y = 8
	},
/turf/open/floor/iron/kitchen,
/area/space)
"im" = (
/obj/structure/chair{
	dir = 1
	},
/turf/open/floor/wood,
/area/space)
"iZ" = (
/obj/machinery/computer/teleporter,
/turf/open/floor/iron/textured,
/area/space)
"jp" = (
/obj/structure/cable,
/obj/structure/window/reinforced/tinted,
/obj/machinery/atmospherics/pipe/smart/manifold4w/supply/hidden/layer4,
/turf/open/floor/plating,
/area/space)
"kc" = (
/obj/structure/cable,
/obj/structure/closet/crate,
/obj/effect/spawner/random/engineering/toolbox,
/obj/effect/spawner/random/engineering/toolbox,
/obj/effect/spawner/random/engineering/toolbox,
/obj/item/storage/toolbox/syndicate,
/obj/item/storage/toolbox/electrical,
/obj/item/construction/rcd/loaded/upgraded,
/obj/item/construction/rcd/loaded/upgraded,
/obj/item/construction/rcd/loaded/upgraded,
/obj/machinery/atmospherics/pipe/smart/manifold4w/supply/hidden/layer4,
/obj/item/storage/box/stockparts/deluxe,
/obj/item/storage/box/stockparts/deluxe,
/obj/item/storage/box/stockparts/deluxe,
/obj/item/storage/box/stockparts/deluxe,
/obj/item/storage/part_replacer/bluespace/tier4,
/turf/open/floor/plating,
/area/space)
"lr" = (
/obj/structure/railing{
	dir = 8
	},
/turf/open/floor/wood,
/area/space)
"lA" = (
/obj/machinery/hydroponics/constructable,
/turf/open/floor/iron/green,
/area/space)
"mY" = (
/obj/structure/chair/sofa/right{
	dir = 1
	},
/turf/open/floor/wood,
/area/space)
"nS" = (
/obj/machinery/atmospherics/components/tank/air,
/obj/machinery/atmospherics/pipe/smart/manifold4w/supply/hidden/layer4,
/turf/open/floor/plating,
/area/space)
"oc" = (
/obj/structure/table,
/obj/machinery/light/directional/east,
/obj/structure/window/reinforced,
/obj/effect/spawner/random/medical/firstaid,
/obj/effect/spawner/random/medical/firstaid_rare,
/turf/open/floor/iron/kitchen,
/area/space)
"oH" = (
/obj/structure/table/wood,
/turf/open/floor/wood,
/area/space)
"oY" = (
/obj/structure/window/reinforced/tinted{
	dir = 1
	},
/turf/open/floor/plating,
/area/space)
"pj" = (
/obj/structure/table,
/turf/open/floor/iron/green,
/area/space)
"pC" = (
/obj/structure/closet/secure_closet/freezer/meat{
	req_access = null
	},
/obj/item/storage/box/ingredients/random,
/obj/item/storage/box/ingredients/random,
/obj/item/storage/box/ingredients/random,
/obj/item/storage/box/ingredients/random,
/obj/item/storage/box/ingredients/seafood,
/obj/item/storage/box/ingredients/seafood,
/turf/open/floor/iron/freezer,
/area/space)
"pJ" = (
/turf/open/floor/iron/kitchen,
/area/space)
"pR" = (
/obj/machinery/atmospherics/pipe/smart/manifold4w/supply/hidden/layer4,
/turf/open/floor/iron/textured,
/area/space)
"pX" = (
/obj/structure/closet/secure_closet/freezer/meat{
	req_access = null
	},
/obj/item/food/meat/slab/monkey,
/obj/item/food/meat/slab/monkey,
/obj/item/food/meat/slab/monkey,
/obj/item/food/meat/slab/monkey,
/obj/item/food/meat/slab/chicken,
/obj/item/food/meat/slab/chicken,
/obj/item/food/meat/slab/chicken,
/obj/item/food/meat/slab/chicken,
/obj/item/food/meat/slab/chicken,
/obj/item/storage/box/ingredients/seafood,
/obj/item/storage/box/ingredients/seafood,
/obj/item/storage/box/ingredients/carnivore,
/obj/item/storage/box/ingredients/carnivore,
/obj/item/storage/box/ingredients/carnivore,
/obj/item/storage/box/ingredients/carnivore,
/turf/open/floor/iron/freezer,
/area/space)
"qe" = (
/obj/effect/spawner/structure/window/reinforced,
/turf/open/floor/plating,
/area/space)
"qs" = (
/turf/closed/wall,
/area/space)
"qH" = (
/obj/structure/window/reinforced/tinted,
/turf/open/floor/iron/freezer,
/area/space)
"rE" = (
/obj/structure/window/reinforced/tinted,
/obj/machinery/atmospherics/pipe/smart/manifold4w/supply/hidden/layer4,
/turf/open/floor/iron/green,
/area/space)
"rG" = (
/obj/structure/table/wood,
/obj/effect/spawner/random/food_or_drink/salad,
/turf/open/floor/wood,
/area/space)
"rV" = (
/obj/effect/spawner/random/exotic/snow_gear,
/turf/open/floor/plating/asteroid/snow/icemoon,
/area/space)
"sp" = (
/obj/effect/spawner/random/vending/colavend,
/turf/open/floor/wood,
/area/space)
"st" = (
/obj/machinery/light/small/directional/west,
/obj/structure/chair/sofa/corner{
	dir = 4
	},
/obj/structure/window/reinforced/tinted{
	dir = 1
	},
/turf/open/floor/wood,
/area/space)
"sw" = (
/obj/machinery/atmospherics/pipe/smart/manifold4w/supply/hidden/layer4,
/turf/open/floor/plating,
/area/space)
"sy" = (
/obj/structure/table,
/obj/structure/cable,
/obj/machinery/atmospherics/pipe/smart/manifold4w/supply/hidden/layer4,
/obj/machinery/reagentgrinder,
/turf/open/floor/iron/kitchen,
/area/space)
"sz" = (
/obj/structure/table,
/obj/machinery/light/directional/north,
/turf/open/floor/iron/kitchen,
/area/space)
"sG" = (
/obj/effect/spawner/random/entertainment/arcade{
	dir = 8
	},
/turf/open/floor/wood,
/area/space)
"tf" = (
/obj/structure/cable,
/obj/machinery/atmospherics/pipe/smart/manifold4w/supply/hidden/layer4,
/turf/open/floor/iron/kitchen,
/area/space)
"tq" = (
/obj/machinery/griddle,
/turf/open/floor/iron/kitchen,
/area/space)
"uX" = (
/obj/structure/window/reinforced,
/obj/structure/table,
/obj/machinery/chem_dispenser/drinks/fullupgrade{
	dir = 1
	},
/turf/open/floor/iron/kitchen,
/area/space)
"vG" = (
/obj/structure/closet/crate,
/obj/item/stack/sheet/mineral/coal{
	amount = 50
	},
/obj/item/stack/sheet/mineral/wood/fifty,
/turf/open/floor/iron/kitchen,
/area/space)
"vM" = (
/obj/structure/window/reinforced,
/obj/machinery/vending/dinnerware,
/turf/open/floor/iron/kitchen,
/area/space)
"wF" = (
/obj/machinery/grill,
/turf/open/floor/iron/kitchen,
/area/space)
"wL" = (
/obj/machinery/light/small/directional/east,
/obj/machinery/teleport/hub,
/turf/open/floor/iron/textured,
/area/space)
"yy" = (
/obj/machinery/power/smes/magical{
	desc = "A high-capacity superconducting magnetic energy storage (SMES) unit. Produces power through an unstable bluespace pocket.";
	name = "bluespace-powered power storage unit"
	},
/obj/structure/cable,
/turf/open/floor/plating,
/area/space)
"yF" = (
/obj/machinery/paystand,
/turf/open/floor/iron/green,
/area/space)
"zM" = (
/obj/structure/rack,
/obj/item/clothing/suit/hooded/wintercoat{
	pixel_y = 16
	},
/obj/item/clothing/suit/hooded/wintercoat{
	pixel_y = 12
	},
/obj/item/clothing/suit/hooded/wintercoat/miner{
	pixel_y = 8
	},
/obj/item/clothing/suit/hooded/wintercoat/miner{
	pixel_y = 4
	},
/obj/item/clothing/suit/hooded/wintercoat/ratvar/fake,
/turf/open/floor/iron/textured,
/area/space)
"zU" = (
/obj/machinery/door/window,
/obj/machinery/atmospherics/pipe/smart/manifold4w/supply/hidden/layer4,
/turf/open/floor/iron/kitchen,
/area/space)
"AF" = (
/obj/structure/chair{
	dir = 4
	},
/turf/open/floor/wood,
/area/space)
"AR" = (
/obj/structure/chair/sofa/left,
/turf/open/floor/wood,
/area/space)
"BH" = (
/obj/machinery/atmospherics/pipe/smart/manifold4w/supply/hidden/layer4,
/turf/open/floor/iron/kitchen,
/area/space)
"CD" = (
/obj/machinery/light/directional/north,
/obj/structure/chair/stool/bar{
	dir = 4
	},
/turf/open/floor/wood,
/area/space)
"Di" = (
/obj/structure/railing{
	dir = 10
	},
/turf/open/floor/wood,
/area/space)
"En" = (
/obj/structure/closet/crate/freezer,
/obj/item/reagent_containers/food/condiment/quality_oil,
/obj/item/reagent_containers/food/condiment/quality_oil,
/obj/item/reagent_containers/food/condiment/quality_oil,
/obj/item/reagent_containers/food/condiment/soysauce,
/obj/item/reagent_containers/food/condiment/soysauce,
/obj/item/reagent_containers/food/condiment/soysauce,
/obj/item/reagent_containers/food/condiment/soysauce,
/obj/item/reagent_containers/food/condiment/soysauce,
/obj/item/reagent_containers/food/condiment/bbqsauce,
/obj/item/reagent_containers/food/condiment/bbqsauce,
/obj/item/reagent_containers/food/condiment/bbqsauce,
/obj/item/reagent_containers/food/condiment/bbqsauce,
/obj/item/reagent_containers/food/condiment/bbqsauce,
/obj/item/reagent_containers/food/condiment/bbqsauce,
/obj/item/reagent_containers/food/condiment/bbqsauce,
/obj/item/reagent_containers/food/condiment/mayonnaise,
/obj/item/reagent_containers/food/condiment/mayonnaise,
/obj/item/reagent_containers/food/condiment/mayonnaise,
/obj/effect/spawner/random/food_or_drink/donkpockets,
/obj/effect/spawner/random/food_or_drink/donkpockets,
/obj/effect/spawner/random/food_or_drink/donkpockets,
/obj/effect/spawner/random/food_or_drink/donkpockets,
/obj/effect/spawner/random/food_or_drink/donkpockets,
/turf/open/floor/iron/kitchen,
/area/space)
"Ex" = (
/obj/structure/cable,
/obj/machinery/power/apc/auto_name/east,
/turf/open/floor/wood,
/area/space)
"EM" = (
/obj/structure/fans/tiny,
/turf/open/floor/iron/kitchen,
/area/space)
"EW" = (
/obj/structure/chair/sofa/bench/left,
/obj/machinery/light/warm/directional/north,
/turf/open/floor/wood,
/area/space)
"Gb" = (
/obj/machinery/light/small/directional/west,
/obj/structure/chair/sofa/corner{
	dir = 4
	},
/turf/open/floor/wood,
/area/space)
"Gf" = (
/obj/structure/chair,
/obj/machinery/atmospherics/pipe/smart/manifold4w/supply/hidden/layer4,
/turf/open/floor/wood,
/area/space)
"Gp" = (
/obj/machinery/door/airlock/wood/glass,
/turf/open/floor/iron/textured,
/area/space)
"GU" = (
/obj/structure/chair{
	dir = 8
	},
/turf/open/floor/wood,
/area/space)
"Hh" = (
/obj/structure/chair/stool/bar{
	dir = 4
	},
/turf/open/floor/wood,
/area/space)
"Hx" = (
/obj/machinery/door/window{
	dir = 1
	},
/turf/open/floor/wood,
/area/space)
"HF" = (
/obj/machinery/jukebox,
/obj/structure/window/reinforced/tinted{
	dir = 1
	},
/turf/open/floor/wood,
/area/space)
"Ja" = (
/obj/structure/railing{
	dir = 8
	},
/obj/machinery/light/warm/directional/north,
/obj/structure/table/wood,
/turf/open/floor/wood,
/area/space)
"JN" = (
/obj/machinery/light/small/directional/west,
/obj/structure/rack,
/obj/item/clothing/suit/brownbattlecoat{
	pixel_y = 16
	},
/obj/item/clothing/suit/brownbattlecoat{
	pixel_y = 12
	},
/obj/item/clothing/suit/furcoat{
	pixel_y = 8
	},
/obj/item/clothing/suit/furcoat{
	pixel_y = 6
	},
/obj/item/clothing/suit/hooded/wintercoat/aformal{
	pixel_y = 4
	},
/obj/item/clothing/suit/hooded/wintercoat/aformal,
/turf/open/floor/iron/textured,
/area/space)
"JQ" = (
/obj/structure/chair/sofa{
	dir = 4
	},
/turf/open/floor/wood,
/area/space)
"Ki" = (
/obj/machinery/teleport/station,
/turf/open/floor/iron/textured,
/area/space)
"Kt" = (
/obj/machinery/door/window,
/turf/open/floor/iron/green,
/area/space)
"KG" = (
/obj/structure/chair/sofa/corner{
	dir = 1
	},
/turf/open/floor/wood,
/area/space)
"KI" = (
/obj/machinery/power/terminal{
	dir = 1
	},
/obj/structure/cable,
/turf/open/floor/plating,
/area/space)
"KL" = (
/obj/machinery/door/window,
/turf/open/floor/iron/freezer,
/area/space)
"LC" = (
/obj/machinery/light/small/directional/south,
/turf/open/floor/wood,
/area/space)
"LM" = (
/turf/open/floor/plating/asteroid/snow/icemoon,
/area/space)
"MB" = (
/obj/structure/table,
/obj/machinery/chem_dispenser/drinks,
/turf/open/floor/iron/green,
/area/space)
"Nh" = (
/obj/structure/fans/tiny,
/obj/machinery/door/airlock/maintenance_hatch,
/turf/open/floor/plating,
/area/space)
"Nu" = (
/obj/machinery/atmospherics/pipe/smart/manifold4w/supply/hidden/layer4,
/turf/open/floor/wood,
/area/space)
"OS" = (
/obj/effect/spawner/structure/window/reinforced,
/obj/structure/cable,
/obj/machinery/atmospherics/pipe/smart/manifold4w/supply/hidden/layer4,
/turf/open/floor/plating,
/area/space)
"Qe" = (
/obj/structure/closet/secure_closet/freezer/fridge{
	req_access = null
	},
/obj/item/storage/box/ingredients/vegetarian,
/obj/item/storage/box/ingredients/italian,
/obj/item/storage/box/ingredients/fruity,
/obj/item/storage/box/ingredients/fiesta,
/obj/item/storage/box/ingredients/american,
/obj/item/reagent_containers/food/condiment/flour{
	list_reagents = list(/datum/reagent/consumable/flour = 5000);
	name = "Premium All-Purpose Flour (50KG)";
	volume = 5000
	},
/obj/item/reagent_containers/food/condiment/milk{
	desc = "It's milk. White and nutritious goodness! This carton uses bluespace to store an impossible amount of milk!";
	list_reagents = list(/datum/reagent/consumable/milk = 8000);
	name = "the big milk jug";
	volume = 8000
	},
/obj/item/reagent_containers/food/condiment/enzyme{
	list_reagents = list(/datum/reagent/consumable/enzyme = 500);
	name = "universe-sized universal enyzyme";
	volume = 500
	},
/obj/item/reagent_containers/food/condiment/rice{
	list_reagents = list(/datum/reagent/consumable/rice = 150);
	name = "Basmati Rice Sack (4KG)";
	volume = 150
	},
/obj/machinery/light/small/directional/north,
/obj/item/storage/box/ingredients/seafood,
/obj/item/storage/box/ingredients/seafood,
/obj/item/reagent_containers/food/condiment/sugar{
	list_reagents = list(/datum/reagent/consumable/sugar = 500);
	name = "big sugar sack";
	volume = 500
	},
/turf/open/floor/iron/kitchen_coldroom/freezerfloor,
/area/space)
"Qv" = (
/obj/structure/chair/sofa/bench,
/turf/open/floor/wood,
/area/space)
"Qw" = (
/obj/machinery/light/directional/north,
/obj/machinery/atmospherics/pipe/smart/manifold4w/supply/hidden/layer4,
/turf/open/floor/iron/kitchen,
/area/space)
"QT" = (
/obj/structure/window/reinforced/tinted,
/obj/machinery/vending/hydroseeds{
	onstation = 0
	},
/turf/open/floor/iron/green,
/area/space)
"Sm" = (
/obj/structure/fans/tiny,
/obj/machinery/door/airlock/wood{
	name = "Diner"
	},
/turf/open/floor/iron/textured,
/area/space)
"Tp" = (
/obj/structure/chair/sofa/bench/right,
/turf/open/floor/wood,
/area/space)
"TC" = (
/obj/structure/railing,
/turf/open/floor/wood,
/area/space)
"TL" = (
/obj/item/beacon,
/turf/open/floor/iron/textured,
/area/space)
"Ud" = (
/obj/structure/window/reinforced/tinted,
/turf/open/floor/iron/green,
/area/space)
"Vb" = (
/obj/machinery/light/directional/north,
/obj/effect/spawner/random/food_or_drink/seed_rare,
/obj/effect/spawner/random/food_or_drink/seed_rare,
/obj/effect/spawner/random/food_or_drink/seed_rare,
/obj/effect/spawner/random/food_or_drink/seed_rare,
/obj/effect/spawner/random/food_or_drink/seed_rare,
/turf/open/floor/iron/green,
/area/space)
"VO" = (
/obj/structure/table,
/obj/machinery/microwave{
	pixel_y = 12
	},
/turf/open/floor/iron/kitchen,
/area/space)
"Xk" = (
/obj/machinery/door/window,
/obj/structure/cable,
/turf/open/floor/iron/kitchen,
/area/space)
"Yx" = (
/obj/machinery/light/small/directional/east,
/obj/effect/spawner/random/vending/snackvend,
/turf/open/floor/wood,
/area/space)

(1,1,1) = {"
LM
LM
LM
LM
LM
LM
LM
LM
LM
LM
LM
LM
LM
LM
LM
LM
"}
(2,1,1) = {"
qs
qs
qs
qs
LM
LM
LM
LM
LM
LM
LM
LM
LM
LM
LM
LM
"}
(3,1,1) = {"
qs
gL
gL
qs
qe
qe
qs
qs
qe
qe
qs
qs
LM
LM
LM
LM
"}
(4,1,1) = {"
qs
gL
gL
st
JQ
fl
gL
Gb
JQ
JQ
KG
qs
LM
LM
LM
LM
"}
(5,1,1) = {"
qs
gL
gL
gh
gd
oH
gL
AR
oH
rG
mY
qe
LM
LM
LM
LM
"}
(6,1,1) = {"
qs
gL
gL
Hx
gL
gL
gL
gL
Nu
gL
gL
qe
LM
LM
LM
LM
"}
(7,1,1) = {"
qs
qs
qs
HF
Nu
Nu
Nu
Nu
Nu
AF
LC
qs
Ja
lr
Di
LM
"}
(8,1,1) = {"
qs
bJ
QT
CD
Hh
Hh
Hh
gL
Gf
oH
im
qs
oH
gL
TC
LM
"}
(9,1,1) = {"
qs
Vb
Ud
pj
pj
pj
pj
gL
Nu
GU
gL
qe
Tp
gL
gL
LM
"}
(10,1,1) = {"
qs
bG
Kt
EM
pJ
pJ
yF
gL
Nu
AF
gL
qe
Qv
gL
gL
LM
"}
(11,1,1) = {"
qs
lA
rE
Qw
BH
BH
MB
gL
Gf
gd
im
qs
Qv
gL
gL
LM
"}
(12,1,1) = {"
qs
lA
Ud
VO
pJ
BH
at
gL
Nu
GU
LC
qs
EW
gL
TC
LM
"}
(13,1,1) = {"
qs
ed
Ud
gQ
pJ
BH
vM
gL
Nu
AF
gL
qs
qs
qs
qs
LM
"}
(14,1,1) = {"
qs
lA
Ud
tq
pJ
BH
uX
gL
Gf
cL
im
qs
JN
zM
qs
LM
"}
(15,1,1) = {"
qs
qs
qs
wF
pJ
BH
br
gL
Nu
GU
Nu
eL
pR
cG
Sm
LM
"}
(16,1,1) = {"
qs
pC
qH
sz
pJ
BH
zU
Nu
Nu
Nu
Nu
qe
TL
cG
qs
LM
"}
(17,1,1) = {"
qs
Qe
KL
pJ
pJ
tf
Xk
cz
gL
gL
gL
Gp
cG
cG
Sm
LM
"}
(18,1,1) = {"
qs
pX
qH
vG
En
sy
oc
Ex
Yx
sp
sG
qs
iZ
cG
qs
LM
"}
(19,1,1) = {"
qs
qs
qs
qs
qe
OS
qs
qs
qs
qs
qs
qs
Ki
cG
qs
LM
"}
(20,1,1) = {"
LM
LM
LM
LM
oY
jp
LM
LM
LM
LM
LM
qs
wL
cG
qs
LM
"}
(21,1,1) = {"
LM
LM
qs
qs
qe
OS
qs
LM
LM
LM
LM
qs
qs
qs
qs
LM
"}
(22,1,1) = {"
LM
LM
qs
yy
KI
kc
qs
LM
LM
LM
LM
LM
LM
LM
LM
LM
"}
(23,1,1) = {"
LM
LM
qs
nS
sw
sw
Nh
LM
LM
LM
LM
LM
LM
LM
LM
LM
"}
(24,1,1) = {"
LM
LM
qs
qs
qs
qs
qs
LM
LM
LM
LM
LM
LM
LM
LM
LM
"}
(25,1,1) = {"
LM
LM
LM
LM
LM
LM
LM
LM
LM
rV
LM
LM
LM
LM
LM
LM
"}
