//MAP CONVERTED BY dmm2tgm.py THIS HEADER COMMENT PREVENTS RECONVERSION, DO NOT REMOVE
"ad" = (
/mob/living/simple_animal/hostile/bear/snow{
	faction = list("hostile")
	},
/turf/open/floor/plating/asteroid/snow/icemoon,
/area/space)
"av" = (
/mob/living/simple_animal/hostile/bear/snow{
	faction = list("hostile")
	},
/turf/open/floor/iron/icemoon,
/area/space)
"aN" = (
/mob/living/simple_animal/hostile/asteroid/wolf,
/turf/open/floor/plating/asteroid/snow/icemoon,
/area/space)
"bm" = (
/obj/machinery/door/airlock/external{
	req_access_txt = "150"
	},
/obj/structure/barricade/wooden/crude/snow,
/turf/open/floor/iron/icemoon,
/area/space)
"bx" = (
/obj/structure/reagent_dispensers/beerkeg{
	desc = "An Irishman's dream!";
	name = "whiskey keg";
	reagent_id = /datum/reagent/consumable/ethanol/whiskey
	},
/turf/open/floor/iron/icemoon,
/area/space)
"cc" = (
/obj/structure/bed{
	name = "bottom bunk"
	},
/obj/structure/bed{
	name = "top bunk";
	pixel_y = 12
	},
/obj/effect/spawner/random/entertainment/musical_instrument,
/turf/open/floor/iron/icemoon,
/area/space)
"dC" = (
/obj/machinery/light/dim/directional/east,
/turf/open/floor/iron/icemoon,
/area/space)
"dK" = (
/obj/effect/spawner/structure/window/reinforced,
/turf/open/floor/plating/icemoon,
/area/space)
"dY" = (
/obj/effect/mob_spawn/human/corpse/damaged,
/turf/open/floor/iron/icemoon,
/area/space)
"eZ" = (
/obj/structure/closet/body_bag,
/turf/open/floor/iron/icemoon,
/area/space)
"fx" = (
/obj/effect/spawner/random/medical/patient_stretcher,
/obj/effect/spawner/random/medical/surgery_tool_advanced,
/turf/open/floor/plating/snowed/icemoon,
/area/space)
"fD" = (
/obj/effect/mob_spawn/human/miner/rig,
/obj/structure/bed{
	name = "bottom bunk"
	},
/obj/structure/bed{
	name = "top bunk";
	pixel_y = 12
	},
/obj/item/key/atv,
/turf/open/floor/iron/icemoon,
/area/space)
"fM" = (
/obj/structure/table_frame,
/turf/open/floor/iron/icemoon,
/area/space)
"hx" = (
/obj/effect/mob_spawn/human/corpse/damaged,
/obj/item/lead_pipe,
/turf/open/floor/iron/icemoon,
/area/space)
"hJ" = (
/mob/living/simple_animal/hostile/asteroid/wolf{
	faction = list("hostile")
	},
/turf/open/floor/iron/icemoon,
/area/space)
"iH" = (
/obj/effect/mob_spawn/human/engineer,
/obj/item/holosign_creator/atmos{
	pixel_x = -6;
	pixel_y = 3
	},
/turf/open/floor/plating/icemoon,
/area/space)
"iL" = (
/obj/structure/bed{
	name = "bottom bunk"
	},
/obj/structure/bed{
	name = "top bunk";
	pixel_y = 12
	},
/obj/effect/spawner/random/entertainment/money_small,
/turf/open/floor/iron/icemoon,
/area/space)
"iM" = (
/obj/structure/rack/shelf,
/obj/effect/spawner/random/medical/firstaid,
/turf/open/floor/plating/snowed/icemoon,
/area/space)
"jj" = (
/turf/open/floor/plating/icemoon,
/area/space)
"jq" = (
/obj/effect/decal/cleanable/glass{
	dir = 4
	},
/obj/effect/decal/cleanable/glass{
	dir = 1
	},
/turf/open/floor/plating/snowed/smoothed/icemoon,
/area/space)
"ju" = (
/obj/structure/table/wood/poker,
/obj/effect/spawner/random/food_or_drink/refreshing_beverage,
/turf/open/floor/plating/icemoon,
/area/space)
"jv" = (
/obj/structure/table,
/obj/effect/spawner/random/engineering/material,
/obj/effect/spawner/random/engineering/material,
/obj/effect/spawner/random/engineering/material,
/turf/open/floor/iron/icemoon,
/area/space)
"jR" = (
/obj/effect/spawner/random/trash/mess,
/turf/open/floor/iron/icemoon,
/area/space)
"kf" = (
/obj/structure/table/wood/poker,
/obj/effect/spawner/random/food_or_drink/booze,
/turf/open/floor/iron/icemoon,
/area/space)
"kk" = (
/obj/structure/bed,
/turf/open/floor/plating/snowed/icemoon,
/area/space)
"ko" = (
/obj/structure/table,
/obj/item/storage/backpack/duffelbag/mining_conscript,
/turf/open/floor/iron/icemoon,
/area/space)
"kH" = (
/obj/structure/table,
/obj/effect/spawner/random/engineering/tool_advanced,
/turf/open/floor/iron/icemoon,
/area/space)
"lb" = (
/obj/machinery/light/broken/directional/east,
/turf/open/floor/plating/snowed/icemoon,
/area/space)
"lA" = (
/obj/effect/spawner/random/engineering/tank,
/turf/open/floor/iron/icemoon,
/area/space)
"lJ" = (
/obj/structure/rack/shelf,
/turf/open/floor/iron/icemoon,
/area/space)
"lM" = (
/obj/structure/frame/machine,
/turf/open/floor/iron/icemoon,
/area/space)
"lZ" = (
/turf/open/floor/plating/snowed/smoothed/icemoon,
/area/space)
"me" = (
/obj/effect/spawner/random/structure/chair_flipped,
/turf/open/floor/iron/icemoon,
/area/space)
"mF" = (
/obj/structure/firelock_frame,
/turf/open/floor/iron/icemoon,
/area/space)
"mG" = (
/obj/effect/mob_spawn/human/doctor,
/turf/open/floor/plating/icemoon,
/area/space)
"nA" = (
/obj/effect/spawner/random/exotic/antag_gear,
/obj/structure/closet/crate/secure/gear{
	req_access_txt = "150"
	},
/obj/item/key/atv,
/obj/item/storage/backpack/duffelbag/syndie,
/turf/open/floor/plating/icemoon,
/area/space)
"nQ" = (
/obj/structure/table,
/turf/open/floor/iron/icemoon,
/area/space)
"oM" = (
/obj/effect/decal/cleanable/glass{
	dir = 1
	},
/obj/structure/barricade/wooden/snowed,
/turf/open/floor/plating/snowed/smoothed/icemoon,
/area/space)
"pe" = (
/obj/effect/spawner/random/engineering/tank,
/obj/machinery/light/red/directional/north,
/turf/open/floor/plating/icemoon,
/area/space)
"pi" = (
/obj/structure/table,
/obj/item/flashlight/seclite,
/obj/item/flashlight/seclite,
/obj/item/implanter/tracking/gps,
/turf/open/floor/iron/icemoon,
/area/space)
"ps" = (
/obj/structure/table/wood/poker,
/turf/open/floor/plating/icemoon,
/area/space)
"qn" = (
/obj/machinery/light/red/directional/south,
/turf/open/floor/iron/icemoon,
/area/space)
"rl" = (
/obj/effect/mob_spawn/human/miner,
/obj/structure/closet/body_bag/stasis,
/turf/open/floor/iron/icemoon,
/area/space)
"rt" = (
/obj/effect/spawner/random/vending/colavend,
/turf/open/floor/iron/icemoon,
/area/space)
"rF" = (
/obj/structure/rack/shelf,
/obj/effect/spawner/random/medical/firstaid_rare,
/obj/item/implanter/mortis,
/turf/open/floor/iron/icemoon,
/area/space)
"rZ" = (
/mob/living/simple_animal/hostile/true_changeling,
/turf/open/floor/iron/icemoon,
/area/space)
"td" = (
/obj/item/kirbyplants/dead,
/turf/open/floor/iron/icemoon,
/area/space)
"tm" = (
/obj/structure/frame/computer{
	dir = 4
	},
/turf/open/floor/plating/snowed/icemoon,
/area/space)
"tP" = (
/obj/effect/mob_spawn/human/engineer,
/obj/item/rcd_upgrade/frames,
/turf/open/floor/iron/icemoon,
/area/space)
"un" = (
/turf/closed/wall/ice,
/area/space)
"up" = (
/obj/effect/spawner/random/trash/grime,
/turf/open/floor/iron/icemoon,
/area/space)
"uS" = (
/obj/structure/table,
/obj/effect/spawner/random/exotic/technology,
/turf/open/floor/iron/icemoon,
/area/space)
"uT" = (
/obj/machinery/door/airlock/mining,
/turf/open/floor/iron/icemoon,
/area/space)
"ve" = (
/obj/effect/spawner/random/structure/chair_flipped,
/turf/open/floor/plating/icemoon,
/area/space)
"vn" = (
/obj/structure/rack,
/turf/open/floor/iron/icemoon,
/area/space)
"vu" = (
/mob/living/simple_animal/hostile/asteroid/wolf{
	faction = list("hostile")
	},
/turf/open/floor/plating/snowed/icemoon,
/area/space)
"vF" = (
/turf/open/floor/plating/asteroid/snow/icemoon,
/area/space)
"vV" = (
/turf/open/floor/plating/snowed/icemoon,
/area/space)
"wj" = (
/obj/structure/table,
/obj/effect/spawner/random/engineering/toolbox,
/obj/effect/spawner/random/engineering/toolbox,
/turf/open/floor/plating/icemoon,
/area/space)
"wl" = (
/obj/effect/spawner/random/maintenance,
/turf/open/floor/plating/icemoon,
/area/space)
"wR" = (
/obj/item/roller,
/turf/open/floor/iron/icemoon,
/area/space)
"wT" = (
/obj/structure/bed{
	name = "bottom bunk"
	},
/obj/structure/bed{
	name = "top bunk";
	pixel_y = 12
	},
/turf/open/floor/plating/snowed/icemoon,
/area/space)
"xa" = (
/obj/structure/table,
/obj/item/laser_pointer,
/turf/open/floor/iron/icemoon,
/area/space)
"xY" = (
/obj/structure/tank_dispenser,
/obj/machinery/light/red/directional/north,
/turf/open/floor/iron/icemoon,
/area/space)
"yd" = (
/obj/structure/rack,
/obj/item/storage/bag/ore{
	pixel_y = 8
	},
/obj/item/storage/bag/ore/holding{
	pixel_y = 4
	},
/obj/item/storage/bag/plants,
/obj/machinery/light/red/directional/south,
/turf/open/floor/iron/icemoon,
/area/space)
"yj" = (
/obj/structure/table,
/turf/open/floor/plating/icemoon,
/area/space)
"yl" = (
/obj/effect/decal/cleanable/glass{
	dir = 4
	},
/obj/structure/barricade/wooden/snowed,
/turf/open/floor/plating/icemoon,
/area/space)
"yG" = (
/obj/effect/spawner/random/trash/grime,
/obj/machinery/light/broken/directional/north,
/turf/open/floor/iron/icemoon,
/area/space)
"yW" = (
/obj/structure/table,
/obj/item/storage/bag/trash,
/turf/open/floor/iron/icemoon,
/area/space)
"zn" = (
/obj/effect/spawner/random/engineering/atmospherics_portable,
/turf/open/floor/iron/icemoon,
/area/space)
"zD" = (
/obj/item/screwdriver/nuke,
/turf/open/floor/iron/icemoon,
/area/space)
"AG" = (
/obj/item/kirbyplants/dead,
/turf/open/floor/plating/icemoon,
/area/space)
"Bd" = (
/obj/structure/trash_pile,
/turf/open/floor/plating/icemoon,
/area/space)
"Bo" = (
/obj/machinery/light/broken/directional/south,
/turf/open/floor/plating/icemoon,
/area/space)
"BU" = (
/obj/effect/mob_spawn/human/geneticist,
/obj/structure/closet/body_bag,
/turf/open/floor/iron/icemoon,
/area/space)
"BV" = (
/obj/structure/bed,
/turf/open/floor/iron/icemoon,
/area/space)
"Cb" = (
/obj/machinery/door/airlock/external{
	req_access_txt = "150"
	},
/turf/open/floor/iron/icemoon,
/area/space)
"Cs" = (
/obj/structure/trash_pile,
/turf/open/floor/plating/snowed/icemoon,
/area/space)
"CB" = (
/obj/machinery/door/airlock/medical,
/turf/open/floor/iron/icemoon,
/area/space)
"CF" = (
/obj/machinery/door/airlock/mining,
/turf/open/floor/plating/icemoon,
/area/space)
"Dc" = (
/mob/living/simple_animal/hostile/mining_drone{
	faction = list("hostile")
	},
/turf/open/floor/iron/icemoon,
/area/space)
"DF" = (
/obj/effect/spawner/random/engineering/canister,
/turf/open/floor/iron/icemoon,
/area/space)
"Eq" = (
/obj/structure/bed{
	name = "bottom bunk"
	},
/obj/structure/bed{
	name = "top bunk";
	pixel_y = 12
	},
/obj/effect/spawner/random/entertainment/toy,
/turf/open/floor/plating/snowed/icemoon,
/area/space)
"Er" = (
/obj/structure/rack/shelf,
/obj/effect/spawner/random/maintenance,
/obj/effect/spawner/random/maintenance,
/obj/effect/spawner/random/maintenance,
/turf/open/floor/iron/icemoon,
/area/space)
"Ez" = (
/obj/effect/spawner/random/structure/crate_abandoned,
/turf/open/floor/iron/icemoon,
/area/space)
"EA" = (
/obj/machinery/light/dim/directional/east,
/turf/open/floor/plating/icemoon,
/area/space)
"FF" = (
/obj/structure/rack,
/obj/item/pickaxe/mini{
	pixel_x = 9;
	pixel_y = 9
	},
/obj/item/pickaxe/mini{
	pixel_x = 6;
	pixel_y = 6
	},
/obj/item/pickaxe/mini{
	pixel_x = 3;
	pixel_y = 3
	},
/obj/item/pickaxe/mini,
/turf/open/floor/iron/icemoon,
/area/space)
"FK" = (
/obj/machinery/light/broken/directional/north,
/turf/open/floor/iron/icemoon,
/area/space)
"GL" = (
/obj/structure/tank_dispenser/oxygen,
/turf/open/floor/iron/icemoon,
/area/space)
"Ic" = (
/mob/living/simple_animal/hostile/asteroid/wolf{
	faction = list("hostile")
	},
/turf/open/floor/plating/asteroid/snow/icemoon,
/area/space)
"IU" = (
/obj/structure/table,
/obj/effect/spawner/random/food_or_drink/seed_rare,
/obj/effect/spawner/random/food_or_drink/seed_rare,
/obj/effect/spawner/random/food_or_drink/seed_rare,
/obj/effect/spawner/random/food_or_drink/seed_rare,
/obj/effect/spawner/random/food_or_drink/seed_rare,
/turf/open/floor/iron/icemoon,
/area/space)
"Kl" = (
/obj/machinery/light/red/directional/west,
/obj/item/kirbyplants/dead,
/turf/open/floor/iron/icemoon,
/area/space)
"Kt" = (
/obj/item/shard,
/obj/effect/decal/cleanable/glass{
	dir = 8
	},
/obj/effect/decal/cleanable/glass,
/turf/open/floor/plating/snowed/smoothed/icemoon,
/area/space)
"KS" = (
/turf/open/floor/plating/catwalk_floor/plated,
/area/space)
"LO" = (
/obj/vehicle/sealed/mecha/working/ripley,
/turf/open/floor/iron/icemoon,
/area/space)
"Mh" = (
/obj/structure/rack/shelf,
/obj/effect/spawner/random/engineering/vending_restock,
/obj/effect/spawner/random/engineering/vending_restock,
/turf/open/floor/plating/icemoon,
/area/space)
"Mi" = (
/obj/effect/mob_spawn/human/miner/explorer,
/obj/structure/closet/body_bag/environmental,
/turf/open/floor/iron/icemoon,
/area/space)
"Ml" = (
/turf/open/lava/plasma/ice_moon,
/area/space)
"Nm" = (
/turf/closed/wall,
/area/space)
"Nw" = (
/obj/machinery/door/airlock/engineering,
/turf/open/floor/plating/icemoon,
/area/space)
"NU" = (
/turf/open/floor/iron/icemoon,
/area/space)
"Od" = (
/turf/open/genturf,
/area/space)
"Oj" = (
/obj/structure/table,
/obj/effect/spawner/random/entertainment/cigarette_pack,
/obj/effect/spawner/random/entertainment/cigarette_pack,
/turf/open/floor/plating/icemoon,
/area/space)
"Pj" = (
/obj/structure/table,
/obj/effect/spawner/random/food_or_drink/three_course_meal,
/obj/machinery/light/red/directional/west,
/turf/open/floor/plating/icemoon,
/area/space)
"Pl" = (
/obj/structure/rack,
/turf/open/floor/plating/icemoon,
/area/space)
"Pt" = (
/obj/structure/table,
/obj/effect/spawner/random/engineering/material_rare,
/obj/effect/spawner/random/engineering/material_rare,
/turf/open/floor/iron/icemoon,
/area/space)
"PG" = (
/obj/structure/trash_pile,
/obj/machinery/light/broken/directional/east,
/turf/open/floor/iron/icemoon,
/area/space)
"PJ" = (
/obj/effect/spawner/random/trash/bin,
/turf/open/floor/iron/icemoon,
/area/space)
"Qf" = (
/obj/machinery/light/red/directional/west,
/turf/open/floor/plating/icemoon,
/area/space)
"Qm" = (
/obj/structure/frame/machine,
/turf/open/floor/plating/snowed/icemoon,
/area/space)
"Qw" = (
/obj/structure/table,
/obj/item/paper/crumpled/bloody{
	info = "We locked it up, but most of us are dead. It's just me and Frank left. We're going to try finding help. If you see this note, do NOT open the door.";
	name = "bloody paper"
	},
/obj/machinery/light/broken/directional/north,
/turf/open/floor/iron/icemoon,
/area/space)
"RN" = (
/obj/machinery/power/smes,
/turf/open/floor/plating/icemoon,
/area/space)
"RO" = (
/obj/machinery/computer/station_alert{
	dir = 8;
	pixel_x = 4
	},
/turf/open/floor/iron/icemoon,
/area/space)
"RS" = (
/obj/vehicle/ridden/atv,
/turf/open/floor/iron/icemoon,
/area/space)
"Sn" = (
/obj/structure/rack/shelf,
/obj/effect/spawner/random/medical/supplies,
/turf/open/floor/plating/icemoon,
/area/space)
"SA" = (
/mob/living/simple_animal/hostile/bear/snow,
/turf/open/floor/plating/snowed/icemoon,
/area/space)
"Tk" = (
/obj/structure/barricade/wooden/snowed,
/turf/open/floor/plating/snowed/smoothed/icemoon,
/area/space)
"To" = (
/obj/machinery/computer/atmos_alert{
	dir = 4;
	pixel_x = -4
	},
/turf/open/floor/iron/icemoon,
/area/space)
"Tw" = (
/obj/structure/table,
/obj/machinery/light/dim/directional/east,
/obj/item/inducer,
/turf/open/floor/iron/icemoon,
/area/space)
"Tx" = (
/obj/effect/spawner/random/trash/mess,
/turf/open/floor/plating/snowed/icemoon,
/area/space)
"TH" = (
/obj/structure/barricade/wooden/snowed,
/turf/open/floor/plating/snowed/icemoon,
/area/space)
"TO" = (
/obj/effect/decal/cleanable/glass{
	dir = 1
	},
/obj/structure/barricade/wooden/snowed,
/turf/open/floor/plating/icemoon,
/area/space)
"TU" = (
/turf/closed/wall/r_wall,
/area/space)
"TY" = (
/obj/structure/trash_pile,
/turf/open/floor/iron/icemoon,
/area/space)
"UF" = (
/obj/structure/table,
/obj/item/reagent_containers/food/drinks/bottle/wine/unlabeled,
/obj/effect/spawner/random/entertainment/money_small,
/turf/open/floor/iron/icemoon,
/area/space)
"UH" = (
/obj/effect/spawner/random/trash/box,
/turf/open/floor/iron/icemoon,
/area/space)
"UL" = (
/obj/structure/frame/machine,
/turf/open/floor/plating/icemoon,
/area/space)
"Ve" = (
/obj/effect/mob_spawn/human/corpse/nanotrasensoldier,
/turf/open/floor/iron/icemoon,
/area/space)
"VP" = (
/obj/structure/rack,
/obj/item/storage/bag/xenoarch,
/turf/open/floor/iron/icemoon,
/area/space)
"We" = (
/obj/effect/spawner/random/vending/snackvend,
/turf/open/floor/plating/icemoon,
/area/space)
"WA" = (
/obj/machinery/door/airlock/grunge,
/obj/effect/mapping_helpers/airlock/locked,
/turf/open/floor/plating/icemoon,
/area/space)
"WB" = (
/obj/effect/spawner/random/trash/hobo_squat,
/turf/open/floor/iron/icemoon,
/area/space)
"Xa" = (
/obj/effect/decal/cleanable/glass{
	dir = 4
	},
/turf/open/floor/plating/snowed/smoothed/icemoon,
/area/space)
"Xb" = (
/obj/structure/rack/shelf,
/turf/open/floor/plating/icemoon,
/area/space)
"Xi" = (
/obj/effect/mob_spawn/human/corpse/cargo_tech,
/turf/open/floor/iron/icemoon,
/area/space)
"Xo" = (
/obj/structure/table,
/obj/item/storage/bag/sheetsnatcher,
/obj/machinery/light/red/directional/south,
/turf/open/floor/iron/icemoon,
/area/space)
"Xr" = (
/obj/structure/bed{
	name = "bottom bunk"
	},
/obj/structure/bed{
	name = "top bunk";
	pixel_y = 12
	},
/turf/open/floor/iron/icemoon,
/area/space)
"XA" = (
/obj/structure/tank_holder/anesthetic,
/turf/open/floor/iron/icemoon,
/area/space)
"Yc" = (
/obj/effect/spawner/random/structure/bucket,
/turf/open/floor/iron/icemoon,
/area/space)
"Yg" = (
/obj/effect/mob_spawn/human/miner/explorer,
/turf/open/floor/iron/icemoon,
/area/space)
"Yq" = (
/obj/effect/spawner/random/medical/patient_stretcher,
/obj/item/bodybag/stasis,
/turf/open/floor/plating/icemoon,
/area/space)
"YB" = (
/obj/effect/spawner/random/maintenance,
/turf/open/floor/iron/icemoon,
/area/space)
"YW" = (
/obj/structure/table/wood/poker,
/obj/effect/spawner/random/entertainment/deck,
/turf/open/floor/plating/icemoon,
/area/space)
"Zl" = (
/obj/structure/table,
/obj/item/pickaxe/drill,
/obj/item/pickaxe/drill/jackhammer{
	pixel_y = 5
	},
/turf/open/floor/plating/icemoon,
/area/space)
"Zo" = (
/obj/machinery/power/emitter,
/turf/open/floor/plating/icemoon,
/area/space)

(1,1,1) = {"
Od
Od
Od
Od
Od
Od
Od
Od
Od
vF
vF
vF
vF
KS
KS
vF
vF
vF
Od
Od
Od
Od
Od
Od
Od
Od
Od
Od
Od
"}
(2,1,1) = {"
Od
Od
Od
Od
vF
Od
Od
vF
Od
Ml
Ml
Ml
Ml
KS
KS
Ml
Ml
Ml
Ml
Ml
Ml
Ml
Ml
Ml
Ml
Od
Od
Od
Od
"}
(3,1,1) = {"
Od
Od
Od
vF
vF
vF
Od
vF
Ml
Ml
Ml
Ml
Ml
KS
KS
Ml
Ml
Ml
Ml
Ml
Ml
Ml
Ml
Ml
Ml
Ml
Od
Od
Od
"}
(4,1,1) = {"
Od
Od
vF
vF
Ml
Ml
Ml
Ml
Ml
Ml
Ml
vF
vF
KS
KS
vF
vF
vF
vF
vF
vF
vF
vF
vF
Ml
Ml
Ml
Od
Od
"}
(5,1,1) = {"
Od
vF
vF
Ml
Ml
Ml
Ml
Ml
Ml
vF
vF
vF
vF
KS
KS
vF
vF
vF
vF
vF
vF
vF
vF
vF
vF
Ml
Ml
Ml
Od
"}
(6,1,1) = {"
Od
vF
Ml
Ml
vF
vF
vF
vF
vF
vF
vF
vF
vF
jj
jj
vF
vF
vF
vF
vF
vF
vF
vF
vF
vF
vF
Ml
Ml
Od
"}
(7,1,1) = {"
Od
vF
Ml
Ml
vF
Nm
Nm
oM
un
un
un
un
un
TH
bm
un
un
un
un
un
Kt
Xa
un
un
un
un
vF
Ml
Ml
"}
(8,1,1) = {"
Od
Od
Ml
vF
vF
un
cc
NU
PJ
Pj
Oj
Nm
Cs
vV
vV
Kl
me
NU
me
un
vV
vV
tm
fx
XA
Nm
vF
Ml
Ml
"}
(9,1,1) = {"
Od
Od
Ml
vF
vF
un
Xr
vV
Dc
jj
UF
Nm
yG
vV
vV
vV
ju
YW
jj
un
Qm
vV
vV
vV
vV
Nm
vF
Ml
Ml
"}
(10,1,1) = {"
Od
Od
Ml
vF
vF
lZ
Eq
NU
jj
NU
bx
Nm
NU
SA
NU
jj
ps
kf
Bo
un
Qm
NU
vV
NU
vu
Nm
vF
Ml
Ml
"}
(11,1,1) = {"
Od
Od
Ml
Ml
vF
lZ
vV
vV
vV
Dc
qn
un
NU
NU
jj
NU
ve
NU
NU
Nm
vV
NU
BU
vV
lM
un
vF
Ml
Ml
"}
(12,1,1) = {"
Od
vF
Ml
Ml
vF
Nm
wT
cc
NU
iL
fD
un
FK
UH
jj
NU
av
NU
NU
CB
vV
NU
BV
NU
BV
un
vF
Ml
Ml
"}
(13,1,1) = {"
vF
vF
Ml
Ml
vF
Nm
Nm
un
CF
un
un
un
AG
jj
NU
NU
jj
NU
up
Nm
Yq
mG
BV
hJ
BV
un
vF
vF
Ml
"}
(14,1,1) = {"
vF
vF
Ml
Ml
vF
un
vn
jj
NU
Qf
lJ
Xb
jj
jj
jj
jR
jj
NU
Bo
Nm
NU
jj
kk
vV
kk
un
vF
vF
vF
"}
(15,1,1) = {"
vF
vF
Ml
Ml
vF
un
VP
NU
jj
YB
jj
jj
NU
jj
Ve
jj
NU
eZ
jj
un
jj
wR
jj
vV
vV
Nm
vF
vF
Ic
"}
(16,1,1) = {"
vF
KS
KS
KS
KS
Cb
NU
jR
jj
NU
jj
NU
jj
Er
nQ
uS
Bd
jj
NU
yl
NU
vV
vV
vV
vV
Tk
vF
vF
vF
"}
(17,1,1) = {"
vF
KS
KS
KS
KS
Cb
NU
NU
jj
NU
av
jj
dY
TU
TU
TU
TU
jR
NU
TO
jj
NU
hJ
vV
vV
dK
vF
vF
vF
"}
(18,1,1) = {"
vF
vF
Ml
Ml
vF
un
rt
jj
rl
jj
jj
NU
xa
TU
rZ
nA
TU
Qw
NU
un
TY
EA
rF
iM
Sn
un
vF
vF
vF
"}
(19,1,1) = {"
Od
vF
Ml
Ml
vF
un
We
av
NU
fM
jj
NU
TY
TU
jj
NU
TU
yW
NU
un
un
un
un
un
Nm
un
vF
vF
vF
"}
(20,1,1) = {"
Od
Od
Ml
Ml
vF
Nm
jj
wl
NU
NU
jj
jj
NU
TU
WA
TU
TU
td
hx
mF
Yc
NU
jj
NU
lJ
Nm
vF
vF
vF
"}
(21,1,1) = {"
Od
Od
Ml
vF
vF
un
NU
jj
jj
jR
NU
jj
jj
NU
NU
up
NU
jj
NU
mF
dC
NU
jj
jj
lJ
un
vF
vF
Od
"}
(22,1,1) = {"
Od
vF
Ml
vF
vF
un
Ez
NU
NU
NU
jj
jj
jj
Xi
NU
NU
Yg
NU
NU
Nm
Nm
un
un
un
Nm
un
vF
vF
Od
"}
(23,1,1) = {"
Od
Ml
Ml
vF
vF
Nm
Ez
jj
NU
NU
jj
YB
jj
NU
jj
NU
jj
NU
NU
un
xY
Mh
DF
Zo
RN
un
vF
vF
Od
"}
(24,1,1) = {"
Od
Ml
Ml
vF
vF
Nm
dK
dK
Nm
uT
un
un
IU
jj
NU
NU
NU
NU
NU
Nw
jj
NU
NU
jj
jj
un
vF
vF
Od
"}
(25,1,1) = {"
Od
Ml
Ml
vF
vF
Nm
GL
NU
NU
NU
FF
un
yj
jj
jj
NU
NU
NU
NU
dK
jj
jj
iH
NU
zn
dK
vF
Od
Od
"}
(26,1,1) = {"
vF
Ml
Ml
vF
aN
Nm
RS
NU
jj
Dc
yd
un
nQ
Mi
NU
jj
jj
jj
jj
Nw
NU
NU
RO
NU
zn
dK
vF
Od
Od
"}
(27,1,1) = {"
vF
Ml
Ml
vF
vF
Nm
RS
NU
Dc
jj
Zl
dK
Ez
vV
NU
Tx
vV
NU
Pl
un
lA
tP
To
NU
jv
un
vF
Od
Od
"}
(28,1,1) = {"
vF
Ml
Ml
vF
vF
un
lM
NU
NU
NU
ko
dK
NU
jj
NU
vV
vV
NU
TY
un
pe
NU
zD
WB
Pt
un
vF
Od
Od
"}
(29,1,1) = {"
vF
Ml
Ml
vF
vF
un
fM
fM
UL
pi
Xo
un
TY
PG
vV
vV
vV
lb
TY
un
LO
dC
kH
wj
Tw
Nm
vF
Od
Od
"}
(30,1,1) = {"
vF
Ml
Ml
Ml
vF
un
un
un
un
un
Nm
Nm
un
un
dK
jq
dK
Nm
un
un
un
un
un
Nm
Nm
Nm
Od
Od
Od
"}
(31,1,1) = {"
Od
vF
Ml
Ml
Ml
vF
vF
vF
vF
vF
vF
vF
vF
vF
vF
vF
vF
vF
vF
vF
vF
vF
vF
ad
vF
vF
Od
Od
Od
"}
(32,1,1) = {"
Od
Od
vF
Ml
Ml
Ml
Ml
Ml
Ml
Ml
Ml
vF
vF
vF
vF
vF
vF
ad
vF
vF
vF
vF
vF
vF
Od
Od
Od
Od
Od
"}
(33,1,1) = {"
Od
Od
Od
vF
Ml
Ml
Ml
Ml
Ml
Ml
Ml
Ml
vF
vF
vF
vF
vF
vF
vF
Od
Od
Od
Od
Od
Od
Od
Od
Od
Od
"}
