//MAP CONVERTED BY dmm2tgm.py THIS HEADER COMMENT PREVENTS RECONVERSION, DO NOT REMOVE
"ao" = (
/obj/docking_port/stationary{
	dir = 8;
	dwidth = 1;
	height = 13;
	shuttle_id = "arrivals_stationary";
	name = "arrivals";
	width = 7
	},
/turf/open/space/basic,
/area/space)
"dm" = (
/obj/effect/turf_decal/stripes/line{
	dir = 8
	},
/obj/effect/turf_decal/stripes/line{
	dir = 4
	},
/obj/effect/mapping_helpers/airlock/cyclelink_helper{
	dir = 8
	},
/obj/machinery/atmospherics/pipe/smart/manifold4w/supply/hidden/layer4,
/obj/effect/landmark/navigate_destination/dockaux,
/obj/machinery/door/airlock/external/glass{
	name = "Arrival Airlock";
	space_dir = 8
	},
/turf/open/floor/catwalk_floor,
/area/station/hallway/secondary/entry)
"du" = (
/obj/effect/turf_decal/siding/wood{
	dir = 1
	},
/turf/open/floor/wood/large,
/area/station/hallway/secondary/entry)
"dL" = (
/obj/effect/turf_decal/siding/wood,
/obj/structure/chair/sofa/bench{
	dir = 1
	},
/obj/effect/landmark/start/hangover,
/turf/open/floor/wood/large,
/area/station/hallway/secondary/entry)
"eb" = (
/turf/closed/wall/r_wall,
/area/station/security/checkpoint/customs)
"fj" = (
/obj/effect/turf_decal/siding/wood{
	dir = 9
	},
/obj/machinery/light/warm/directional/west,
/turf/open/floor/wood/large,
/area/station/hallway/secondary/entry)
"fs" = (
/obj/item/kirbyplants/random,
/obj/machinery/status_display/shuttle{
	pixel_y = 32;
	shuttle_id = "arrivals_shuttle"
	},
/turf/open/floor/iron/smooth_edge,
/area/station/hallway/secondary/entry)
"hD" = (
/obj/item/kirbyplants/random,
/obj/machinery/status_display/shuttle{
	pixel_y = 32;
	shuttle_id = "arrivals_shuttle"
	},
/obj/machinery/light/warm/directional/north,
/turf/open/floor/iron/smooth_edge,
/area/station/hallway/secondary/entry)
"hW" = (
/obj/effect/turf_decal/stripes/line{
	dir = 1
	},
/obj/effect/turf_decal/stripes/line,
/obj/machinery/atmospherics/components/unary/vent_pump/on/layer4{
	dir = 1
	},
/turf/open/floor/iron/smooth_large,
/area/station/hallway/secondary/entry)
"kg" = (
/obj/structure/lattice,
/obj/structure/grille,
/turf/open/space/basic,
/area/space/nearstation)
"kU" = (
/obj/effect/turf_decal/siding/wood,
/obj/structure/chair/sofa/bench/right{
	dir = 1
	},
/obj/effect/landmark/start/assistant,
/turf/open/floor/wood/large,
/area/station/hallway/secondary/entry)
"lD" = (
/obj/machinery/computer/shuttle/arrivals/recall,
/obj/effect/turf_decal/siding/wood{
	dir = 1
	},
/obj/effect/turf_decal/bot,
/turf/open/floor/wood/large,
/area/station/hallway/secondary/entry)
"os" = (
/obj/item/kirbyplants/random,
/obj/structure/sign/nanotrasen{
	pixel_x = -32
	},
/turf/open/floor/iron/smooth,
/area/station/hallway/secondary/entry)
"pv" = (
/obj/effect/mapping_helpers/airlock/cyclelink_helper{
	dir = 1
	},
/obj/machinery/atmospherics/pipe/smart/manifold4w/supply/hidden/layer4,
/obj/machinery/door/airlock/external/glass{
	name = "Arrival Airlock";
	space_dir = 1
	},
/turf/open/floor/catwalk_floor,
/area/station/hallway/secondary/entry)
"pw" = (
/obj/machinery/atmospherics/pipe/smart/manifold4w/supply/hidden/layer4,
/obj/machinery/camera/directional/south{
	c_tag = "Arrivals - Port";
	name = "arrivals camera"
	},
/obj/item/kirbyplants/random,
/obj/machinery/status_display/ai/directional/south,
/turf/open/floor/iron/smooth_edge{
	dir = 1
	},
/area/station/hallway/secondary/entry)
"qL" = (
/obj/structure/lattice/catwalk,
/turf/open/space/basic,
/area/space/nearstation)
"qN" = (
/turf/open/floor/iron/smooth_edge,
/area/station/hallway/secondary/entry)
"rq" = (
/obj/structure/chair/sofa/bench/left,
/obj/effect/turf_decal/siding/wood{
	dir = 1
	},
/obj/effect/landmark/start/hangover,
/turf/open/floor/wood/large,
/area/station/hallway/secondary/entry)
"rz" = (
/obj/structure/lattice,
/turf/open/space/basic,
/area/station/hallway/secondary/entry)
"rX" = (
/obj/effect/turf_decal/siding/wood{
	dir = 6
	},
/turf/open/floor/wood/large,
/area/station/hallway/secondary/entry)
"sz" = (
/obj/effect/landmark/start/hangover,
/turf/open/floor/iron/smooth_large,
/area/station/hallway/secondary/entry)
"sN" = (
/obj/effect/turf_decal/siding/wood,
/turf/open/floor/wood/large,
/area/station/hallway/secondary/entry)
"uM" = (
/obj/structure/chair/sofa/bench/right,
/obj/effect/turf_decal/siding/wood{
	dir = 9
	},
/turf/open/floor/wood/large,
/area/station/hallway/secondary/entry)
"xn" = (
/obj/effect/spawner/structure/window/reinforced,
/turf/open/floor/plating,
/area/station/security/checkpoint/customs)
"xV" = (
/obj/machinery/atmospherics/pipe/smart/manifold4w/supply/hidden/layer4,
/obj/effect/landmark/start/hangover,
/turf/open/floor/iron/smooth_large,
/area/station/hallway/secondary/entry)
"zm" = (
/turf/closed/wall/r_wall,
/area/station/hallway/secondary/entry)
"zp" = (
/obj/structure/closet/firecloset/wall{
	pixel_y = 32
	},
/obj/effect/turf_decal/trimline/white/end,
/obj/effect/turf_decal/trimline/white/mid_joiner,
/turf/open/floor/iron/smooth_edge,
/area/station/hallway/secondary/entry)
"zq" = (
/obj/machinery/atmospherics/pipe/smart/manifold4w/supply/hidden/layer4,
/obj/machinery/atmospherics/pipe/smart/manifold4w/scrubbers/hidden/layer2,
/obj/structure/cable,
/obj/machinery/airalarm/directional/south,
/turf/open/floor/iron/smooth_edge{
	dir = 1
	},
/area/station/hallway/secondary/entry)
"zB" = (
/obj/structure/lattice,
/turf/open/space/basic,
/area/space/nearstation)
"Bw" = (
/obj/machinery/atmospherics/components/unary/vent_scrubber/on/layer2,
/turf/open/floor/iron/smooth_large,
/area/station/hallway/secondary/entry)
"BY" = (
/obj/machinery/atmospherics/pipe/smart/manifold4w/supply/hidden/layer4,
/obj/effect/landmark/start/hangover,
/turf/open/floor/iron/smooth_edge{
	dir = 1
	},
/area/station/hallway/secondary/entry)
"CM" = (
/obj/machinery/atmospherics/pipe/smart/manifold4w/supply/hidden/layer4,
/turf/open/floor/iron/smooth_large,
/area/station/hallway/secondary/entry)
"Eq" = (
/obj/structure/cable,
/turf/open/floor/iron/smooth_large,
/area/station/hallway/secondary/entry)
"Es" = (
/obj/structure/closet/firecloset/wall{
	pixel_y = -32
	},
/obj/effect/turf_decal/trimline/white/end{
	dir = 1
	},
/obj/effect/turf_decal/trimline/white/mid_joiner{
	dir = 1
	},
/turf/open/floor/iron/smooth_edge{
	dir = 1
	},
/area/station/hallway/secondary/entry)
"Fq" = (
/obj/effect/turf_decal/siding/wood{
	dir = 5
	},
/turf/open/floor/wood/large,
/area/station/hallway/secondary/entry)
"Gc" = (
/obj/effect/spawner/structure/window/reinforced,
/turf/open/floor/plating,
/area/station/hallway/secondary/entry)
"HR" = (
/obj/effect/landmark/event_spawn,
/turf/open/floor/iron/smooth_edge,
/area/station/hallway/secondary/entry)
"HT" = (
/obj/effect/turf_decal/siding/wood{
	dir = 6
	},
/obj/structure/table,
/turf/open/floor/wood/large,
/area/station/hallway/secondary/entry)
"IA" = (
/turf/open/floor/iron/smooth_large,
/area/station/hallway/secondary/entry)
"IG" = (
/obj/effect/turf_decal/siding/wood,
/obj/effect/landmark/start/hangover,
/turf/open/floor/wood/large,
/area/station/hallway/secondary/entry)
"Je" = (
/obj/structure/closet/emcloset/wall{
	pixel_y = 32
	},
/obj/effect/turf_decal/trimline/white/end,
/obj/effect/turf_decal/trimline/white/mid_joiner,
/turf/open/floor/iron/smooth_edge,
/area/station/hallway/secondary/entry)
"JQ" = (
/obj/effect/mapping_helpers/airlock/cyclelink_helper{
	dir = 1
	},
/obj/machinery/atmospherics/pipe/smart/manifold4w/supply/hidden/layer4,
/obj/effect/landmark/navigate_destination/dockarrival,
/obj/machinery/door/airlock/external/glass{
	name = "Arrival Airlock";
	space_dir = 1
	},
/turf/open/floor/catwalk_floor,
/area/station/hallway/secondary/entry)
"JZ" = (
/obj/effect/mapping_helpers/airlock/cyclelink_helper,
/obj/machinery/door/airlock/external/glass{
	name = "Arrival Airlock";
	space_dir = 1
	},
/turf/open/floor/catwalk_floor,
/area/station/hallway/secondary/entry)
"Ka" = (
/obj/effect/turf_decal/stripes/line{
	dir = 1
	},
/obj/effect/turf_decal/stripes/line,
/obj/machinery/atmospherics/components/unary/vent_pump/on/layer4,
/turf/open/floor/iron/smooth_large,
/area/station/hallway/secondary/entry)
"Kn" = (
/obj/effect/turf_decal/siding/wood,
/obj/machinery/vending/cigarette,
/obj/effect/turf_decal/bot,
/turf/open/floor/wood/large,
/area/station/hallway/secondary/entry)
"KB" = (
/obj/structure/table,
/obj/effect/turf_decal/siding/wood{
	dir = 5
	},
/turf/open/floor/wood/large,
/area/station/hallway/secondary/entry)
"Mq" = (
/obj/effect/landmark/start/hangover,
/turf/open/floor/iron/smooth_edge,
/area/station/hallway/secondary/entry)
"MB" = (
/obj/machinery/atmospherics/components/unary/vent_pump/on/layer4,
/turf/open/floor/iron/smooth_large,
/area/station/hallway/secondary/entry)
"MS" = (
/obj/effect/turf_decal/siding/wood{
	dir = 10
	},
/obj/machinery/light/warm/directional/west,
/turf/open/floor/wood/large,
/area/station/hallway/secondary/entry)
"NW" = (
/obj/effect/mapping_helpers/airlock/cyclelink_helper{
	dir = 1
	},
/obj/machinery/door/airlock/external/glass{
	name = "Arrival Airlock";
	space_dir = 2
	},
/turf/open/floor/catwalk_floor,
/area/station/hallway/secondary/entry)
"OD" = (
/obj/effect/mapping_helpers/airlock/cyclelink_helper,
/obj/machinery/atmospherics/pipe/smart/manifold4w/supply/hidden/layer4,
/obj/machinery/door/airlock/external/glass{
	name = "Arrival Airlock";
	space_dir = 2
	},
/turf/open/floor/catwalk_floor,
/area/station/hallway/secondary/entry)
"OF" = (
/obj/machinery/power/apc/auto_name/directional/north,
/obj/structure/cable,
/obj/machinery/light/warm/directional/north,
/turf/open/floor/iron/smooth_edge,
/area/station/hallway/secondary/entry)
"OO" = (
/obj/machinery/atmospherics/pipe/smart/manifold4w/supply/hidden/layer4,
/obj/machinery/camera/directional/south{
	c_tag = "Arrivals - Starboard";
	name = "arrivals camera"
	},
/obj/structure/closet/emcloset/wall{
	pixel_y = -32
	},
/obj/machinery/atmospherics/pipe/smart/manifold4w/scrubbers/hidden/layer2,
/obj/effect/turf_decal/trimline/white/end{
	dir = 1
	},
/obj/effect/turf_decal/trimline/white/mid_joiner{
	dir = 1
	},
/turf/open/floor/iron/smooth_edge{
	dir = 1
	},
/area/station/hallway/secondary/entry)
"Pc" = (
/obj/structure/chair/sofa/bench,
/obj/effect/turf_decal/siding/wood{
	dir = 1
	},
/obj/effect/landmark/start/assistant,
/turf/open/floor/wood/large,
/area/station/hallway/secondary/entry)
"Pp" = (
/obj/effect/turf_decal/siding/wood{
	dir = 10
	},
/obj/structure/chair/sofa/bench/left{
	dir = 1
	},
/turf/open/floor/wood/large,
/area/station/hallway/secondary/entry)
"PT" = (
/obj/machinery/atmospherics/pipe/smart/manifold4w/supply/hidden/layer4,
/obj/machinery/atmospherics/pipe/smart/manifold4w/scrubbers/hidden/layer2,
/obj/item/kirbyplants/random,
/obj/machinery/status_display/evac/directional/south,
/obj/machinery/light/warm/directional/south,
/turf/open/floor/iron/smooth_edge{
	dir = 1
	},
/area/station/hallway/secondary/entry)
"Rl" = (
/obj/machinery/atmospherics/pipe/smart/manifold4w/supply/hidden/layer4,
/turf/open/floor/iron/smooth_edge{
	dir = 1
	},
/area/station/hallway/secondary/entry)
"RO" = (
/turf/open/space/basic,
/area/space)
"Ti" = (
/obj/machinery/atmospherics/pipe/smart/manifold4w/supply/hidden/layer4,
/obj/machinery/atmospherics/pipe/smart/manifold4w/scrubbers/hidden/layer2,
/turf/open/floor/iron/smooth_edge{
	dir = 1
	},
/area/station/hallway/secondary/entry)
"UR" = (
/obj/machinery/atmospherics/pipe/smart/manifold4w/supply/hidden/layer4,
/turf/open/floor/iron/smooth_edge{
	dir = 4
	},
/area/station/hallway/secondary/entry)
"VO" = (
/obj/item/kirbyplants/random,
/obj/item/radio/intercom/directional/west,
/turf/open/floor/iron/smooth,
/area/station/hallway/secondary/entry)
"VY" = (
/obj/structure/fluff/arc,
/turf/open/floor/iron/smooth_large,
/area/station/hallway/secondary/entry)
"Xp" = (
/obj/machinery/atmospherics/pipe/smart/manifold4w/supply/hidden/layer4,
/turf/open/floor/iron/smooth_edge,
/area/station/hallway/secondary/entry)
"YJ" = (
/obj/effect/spawner/structure/window/reinforced,
/obj/structure/lattice,
/turf/open/floor/plating,
/area/station/hallway/secondary/entry)

(1,1,1) = {"
zB
qL
qL
qL
qL
qL
qL
qL
zm
Gc
zm
zm
dm
zm
zm
Gc
zm
"}
(2,1,1) = {"
zB
RO
RO
RO
RO
RO
RO
RO
Gc
rz
YJ
os
UR
VO
Gc
rz
Gc
"}
(3,1,1) = {"
kg
RO
RO
RO
RO
RO
RO
RO
zm
Gc
zm
Je
CM
Es
zm
Gc
zm
"}
(4,1,1) = {"
kg
RO
RO
RO
RO
RO
RO
RO
JZ
Ka
pv
Xp
xV
Rl
OD
hW
NW
"}
(5,1,1) = {"
kg
RO
RO
RO
RO
RO
RO
RO
zm
Gc
zm
hD
MB
pw
zm
Gc
zm
"}
(6,1,1) = {"
zB
RO
RO
RO
RO
RO
RO
RO
Gc
uM
MS
qN
IA
Rl
fj
Pp
Gc
"}
(7,1,1) = {"
zB
RO
RO
RO
RO
RO
RO
RO
Gc
Pc
IG
qN
IA
Rl
du
dL
Gc
"}
(8,1,1) = {"
zB
RO
RO
RO
RO
RO
RO
RO
Gc
rq
sN
HR
VY
BY
du
kU
Gc
"}
(9,1,1) = {"
kg
RO
RO
RO
RO
RO
RO
RO
Gc
lD
sN
qN
IA
Rl
du
Kn
Gc
"}
(10,1,1) = {"
kg
RO
RO
RO
RO
RO
RO
RO
Gc
KB
rX
qN
Bw
Ti
Fq
HT
Gc
"}
(11,1,1) = {"
kg
RO
RO
RO
RO
RO
RO
RO
zm
Gc
zm
fs
sz
PT
zm
Gc
zm
"}
(12,1,1) = {"
zB
RO
RO
RO
RO
RO
RO
RO
JZ
Ka
JQ
Xp
CM
Ti
OD
hW
NW
"}
(13,1,1) = {"
zB
RO
RO
RO
RO
RO
RO
RO
zm
Gc
zm
zp
IA
OO
zm
Gc
zm
"}
(14,1,1) = {"
zB
RO
RO
RO
RO
RO
ao
RO
Gc
rz
Gc
Mq
MB
Ti
Gc
rz
Gc
"}
(15,1,1) = {"
kg
qL
qL
eb
xn
xn
xn
eb
eb
xn
eb
OF
Eq
zq
zm
Gc
zm
"}
