//MAP CONVERTED BY dmm2tgm.py THIS HEADER COMMENT PREVENTS RECONVERSION, DO NOT REMOVE
"af" = (
/obj/item/bedsheet/dorms{
	pixel_x = 6;
	pixel_y = 11
	},
/turf/open/floor/carpet/purple,
/area/centcom/basketball)
"ag" = (
/obj/item/toy/plush/carpplushie,
/turf/open/water/beach/biodome,
/area/centcom/basketball)
"ao" = (
/obj/effect/turf_decal/sand,
/turf/open/misc/beach/sand,
/area/centcom/basketball)
"aO" = (
/obj/structure/fence{
	dir = 8
	},
/turf/open/misc/beach/coastline_t/sandwater_inner{
	dir = 1
	},
/area/centcom/basketball)
"by" = (
/turf/open/misc/beach/coastline_t{
	dir = 6
	},
/area/centcom/basketball)
"ck" = (
/obj/structure/fence,
/turf/open/misc/beach/coastline_t{
	dir = 4
	},
/area/centcom/basketball)
"cA" = (
/turf/open/misc/beach/coastline_b{
	dir = 4
	},
/area/centcom/basketball)
"cG" = (
/obj/structure/fence,
/turf/open/misc/beach/coastline_t{
	dir = 10
	},
/area/centcom/basketball)
"cJ" = (
/turf/open/misc/beach/coastline_t{
	dir = 5
	},
/area/centcom/basketball)
"cX" = (
/obj/effect/landmark/basketball/team_spawn/referee,
/turf/open/misc/beach/sand,
/area/centcom/basketball)
"dC" = (
/obj/structure/fluff/beach_umbrella/cap,
/turf/open/misc/beach/sand,
/area/centcom/basketball)
"eU" = (
/obj/structure/chair/plastic{
	dir = 4
	},
/obj/item/fishing_rod{
	pixel_x = 18
	},
/turf/open/misc/beach/coastline_t{
	dir = 5
	},
/area/centcom/basketball)
"fg" = (
/obj/structure/fence/corner,
/turf/open/misc/beach/coastline_t{
	dir = 6
	},
/area/centcom/basketball)
"fm" = (
/obj/structure/flora/rock/pile/jungle/style_random,
/turf/open/indestructible/binary{
	density = 1;
	desc = "I can't move through this.";
	icon = 'icons/misc/beach.dmi';
	icon_state = "water";
	name = "deep ocean water"
	},
/area/centcom/basketball)
"gY" = (
/turf/open/floor/plating,
/area/centcom/basketball)
"hg" = (
/obj/structure/fence,
/turf/open/misc/beach/coastline_t{
	dir = 9
	},
/area/centcom/basketball)
"hV" = (
/turf/open/misc/beach/coastline_b{
	dir = 10
	},
/area/centcom/basketball)
"hX" = (
/obj/structure/fence{
	dir = 8
	},
/turf/open/misc/beach/coastline_t/sandwater_inner,
/area/centcom/basketball)
"iB" = (
/obj/item/reagent_containers/cup/glass/colocup{
	pixel_x = -7;
	pixel_y = -2
	},
/obj/item/reagent_containers/cup/glass/colocup{
	pixel_x = 5;
	pixel_y = 6
	},
/obj/item/reagent_containers/cup/glass/bottle/rum{
	pixel_x = 4;
	pixel_y = -3
	},
/turf/open/floor/carpet/red,
/area/centcom/basketball)
"iH" = (
/turf/open/misc/beach/coastline_t{
	dir = 9
	},
/area/centcom/basketball)
"iJ" = (
/obj/structure/fence,
/turf/open/misc/beach/coastline_t{
	dir = 6
	},
/area/centcom/basketball)
"jb" = (
/obj/item/flashlight/flare/torch,
/turf/open/misc/beach/sand,
/area/centcom/basketball)
"jy" = (
/obj/item/reagent_containers/cup/glass/trophy/bronze_cup,
/obj/structure/flora/rock/style_random{
	desc = "A volcanic rock.";
	name = "coastal rock"
	},
/obj/structure/flora/bush/stalky/style_random{
	desc = "It can't be smoked.";
	name = "sea weed"
	},
/turf/open/misc/beach/coastline_b{
	dir = 1
	},
/area/centcom/basketball)
"jX" = (
/obj/structure/fence,
/turf/open/water/beach/biodome,
/area/centcom/basketball)
"kx" = (
/obj/effect/landmark/basketball/team_spawn/away_hoop,
/obj/structure/hoop/minigame{
	dir = 8
	},
/obj/structure/flora/rock/pile/jungle/style_random,
/turf/open/water/beach/biodome,
/area/centcom/basketball)
"ld" = (
/obj/effect/turf_decal/sand,
/obj/effect/turf_decal/stripes/asteroid/line{
	dir = 4
	},
/turf/open/floor/vault/sandstone,
/area/centcom/basketball)
"lh" = (
/obj/item/flashlight/flare/torch{
	pixel_x = 15;
	pixel_y = -7
	},
/turf/open/misc/beach/coastline_t{
	dir = 1
	},
/area/centcom/basketball)
"lD" = (
/obj/structure/fence{
	dir = 8
	},
/turf/open/misc/beach/sand,
/area/centcom/basketball)
"lQ" = (
/obj/item/toy/seashell,
/obj/structure/flora/bush/sparsegrass/style_random,
/turf/open/misc/beach/sand,
/area/centcom/basketball)
"mW" = (
/obj/item/toy/plush/carpplushie,
/turf/open/misc/beach/coastline_b{
	dir = 4
	},
/area/centcom/basketball)
"nr" = (
/obj/effect/landmark/basketball/team_spawn/home,
/turf/open/misc/beach/coastline_t{
	dir = 8
	},
/area/centcom/basketball)
"nE" = (
/turf/open/floor/light/colour_cycle/dancefloor_a,
/area/centcom/basketball)
"nR" = (
/obj/structure/flora/rock/style_random{
	desc = "A volcanic rock.";
	name = "coastal rock"
	},
/obj/structure/flora/bush/stalky/style_random{
	desc = "It can't be smoked.";
	name = "sea weed"
	},
/turf/open/indestructible/binary{
	density = 1;
	desc = "I can't move through this.";
	icon = 'icons/misc/beach.dmi';
	icon_state = "water";
	name = "deep ocean water"
	},
/area/centcom/basketball)
"nZ" = (
/obj/structure/fence{
	dir = 8
	},
/turf/open/misc/beach/coastline_t/sandwater_inner{
	dir = 4
	},
/area/centcom/basketball)
"oG" = (
/obj/effect/landmark/basketball/team_spawn/home,
/turf/open/misc/beach/coastline_t,
/area/centcom/basketball)
"pf" = (
/obj/item/reagent_containers/cup/glass/trophy/silver_cup,
/obj/structure/flora/rock/style_random{
	desc = "A volcanic rock.";
	name = "coastal rock"
	},
/turf/open/misc/beach/coastline_b{
	dir = 1
	},
/area/centcom/basketball)
"ps" = (
/obj/effect/landmark/basketball/team_spawn/away,
/turf/open/misc/beach/coastline_t,
/area/centcom/basketball)
"pP" = (
/obj/structure/flora/bush/stalky/style_random,
/obj/structure/flora/bush/sparsegrass/style_random,
/turf/open/water/beach/biodome,
/area/centcom/basketball)
"qp" = (
/obj/structure/fence{
	dir = 8
	},
/turf/open/misc/beach/coastline_t{
	dir = 1
	},
/area/centcom/basketball)
"qC" = (
/obj/structure/hoop/minigame{
	dir = 4
	},
/obj/effect/landmark/basketball/team_spawn/home_hoop,
/obj/structure/flora/rock/pile/jungle/style_random,
/turf/open/water/beach/biodome,
/area/centcom/basketball)
"qQ" = (
/obj/effect/landmark/basketball/team_spawn/away,
/turf/open/misc/beach/coastline_t{
	dir = 4
	},
/area/centcom/basketball)
"rd" = (
/turf/open/misc/beach/coastline_b{
	dir = 8
	},
/area/centcom/basketball)
"ru" = (
/obj/structure/flora/bush/stalky/style_random,
/turf/open/water/beach/biodome,
/area/centcom/basketball)
"rI" = (
/obj/item/clothing/head/collectable/paper{
	desc = "What looks like an ordinary paper hat is actually a rare and valuable collector's edition paper hat. Keep away from fire, Curators, and ocean waves."
	},
/turf/open/water/beach/biodome,
/area/centcom/basketball)
"rM" = (
/obj/item/flashlight/flare/torch{
	pixel_x = 10;
	pixel_y = -4
	},
/turf/open/misc/beach/coastline_t{
	dir = 1
	},
/area/centcom/basketball)
"rU" = (
/obj/structure/table,
/obj/item/reagent_containers/cup/glass/bottle/beer,
/obj/item/reagent_containers/cup/glass/bottle/beer,
/obj/item/reagent_containers/cup/glass/bottle/beer,
/obj/item/reagent_containers/cup/glass/bottle/beer,
/obj/item/reagent_containers/cup/glass/bottle/beer,
/obj/item/reagent_containers/cup/glass/bottle/beer,
/turf/open/misc/beach/sand,
/area/centcom/basketball)
"sk" = (
/turf/open/misc/beach/coastline_b{
	dir = 6
	},
/area/centcom/basketball)
"uH" = (
/obj/effect/turf_decal/sand,
/obj/effect/turf_decal/stripes/asteroid/line{
	dir = 6
	},
/turf/open/floor/vault/sandstone,
/area/centcom/basketball)
"wN" = (
/obj/machinery/jukebox,
/turf/open/misc/beach/sand,
/area/centcom/basketball)
"xB" = (
/turf/open/misc/beach/coastline_b{
	dir = 5
	},
/area/centcom/basketball)
"xE" = (
/turf/open/misc/beach/coastline_t/sandwater_inner{
	dir = 4
	},
/area/centcom/basketball)
"xI" = (
/obj/structure/table,
/obj/item/clothing/under/color/rainbow,
/obj/item/clothing/glasses/sunglasses,
/obj/item/clothing/head/collectable/petehat{
	pixel_y = 5
	},
/turf/open/misc/beach/sand,
/area/centcom/basketball)
"yf" = (
/obj/structure/fence,
/turf/open/misc/beach/coastline_t{
	dir = 5
	},
/area/centcom/basketball)
"yY" = (
/mob/living/simple_animal/crab,
/turf/open/misc/beach/sand,
/area/centcom/basketball)
"AW" = (
/obj/structure/flora/bush/stalky/style_random,
/obj/structure/sign/poster/contraband/have_a_puff/directional/west,
/turf/open/water/beach/biodome,
/area/centcom/basketball)
"BM" = (
/turf/closed/indestructible/sandstone,
/area/centcom/basketball)
"BW" = (
/obj/effect/turf_decal/sand,
/obj/effect/turf_decal/stripes/asteroid/line{
	dir = 10
	},
/turf/open/floor/vault/sandstone,
/area/centcom/basketball)
"CF" = (
/obj/structure/sign/picture_frame{
	pixel_y = -32
	},
/turf/open/misc/beach/coastline_t{
	dir = 4
	},
/area/centcom/basketball)
"CV" = (
/obj/structure/fence/corner{
	dir = 8
	},
/turf/open/misc/beach/coastline_t{
	dir = 9
	},
/area/centcom/basketball)
"Di" = (
/obj/item/clothing/neck/necklace/dope,
/turf/open/misc/beach/sand,
/area/centcom/basketball)
"Dt" = (
/obj/item/clothing/mask/gas/tiki_mask,
/turf/open/misc/beach/sand,
/area/centcom/basketball)
"Dw" = (
/turf/open/misc/beach/coastline_t{
	dir = 1
	},
/area/centcom/basketball)
"Ea" = (
/obj/structure/fence,
/turf/open/misc/beach/coastline_t{
	dir = 8
	},
/area/centcom/basketball)
"Fh" = (
/obj/structure/fluff/beach_umbrella/security,
/turf/open/misc/beach/sand,
/area/centcom/basketball)
"Fy" = (
/mob/living/simple_animal/crab/kreb,
/turf/open/misc/beach/sand,
/area/centcom/basketball)
"FS" = (
/obj/item/clothing/neck/beads,
/turf/open/misc/beach/sand,
/area/centcom/basketball)
"Gj" = (
/turf/open/misc/beach/coastline_t/sandwater_inner{
	dir = 8
	},
/area/centcom/basketball)
"Gm" = (
/turf/open/misc/beach/coastline_b,
/area/centcom/basketball)
"GI" = (
/obj/structure/fence/corner{
	dir = 5
	},
/turf/open/misc/beach/coastline_t{
	dir = 5
	},
/area/centcom/basketball)
"Hu" = (
/turf/closed/indestructible/riveted,
/area/centcom/basketball)
"Hx" = (
/obj/effect/turf_decal/sand,
/obj/effect/turf_decal/stripes/asteroid/line{
	dir = 5
	},
/turf/open/floor/vault/sandstone,
/area/centcom/basketball)
"Hz" = (
/obj/structure/flora/bush/stalky/style_random,
/obj/structure/sign/picture_frame{
	pixel_y = 32
	},
/turf/open/water/beach/biodome,
/area/centcom/basketball)
"Ik" = (
/obj/structure/flora/tree/palm,
/turf/open/misc/beach/sand,
/area/centcom/basketball)
"Iy" = (
/obj/structure/fence{
	dir = 8
	},
/turf/open/misc/beach/coastline_t/sandwater_inner{
	dir = 8
	},
/area/centcom/basketball)
"IM" = (
/turf/open/misc/beach/sand,
/area/centcom/basketball)
"Jb" = (
/obj/item/bedsheet/dorms{
	pixel_x = 6;
	pixel_y = 11
	},
/turf/open/floor/carpet/red,
/area/centcom/basketball)
"Jo" = (
/turf/open/misc/beach/coastline_t{
	dir = 4
	},
/area/centcom/basketball)
"JJ" = (
/turf/open/misc/beach/coastline_b{
	dir = 9
	},
/area/centcom/basketball)
"JT" = (
/turf/open/misc/beach/coastline_t/sandwater_inner,
/area/centcom/basketball)
"JU" = (
/obj/item/reagent_containers/cup/glass/trophy/gold_cup{
	pixel_x = 0
	},
/obj/structure/flora/rock/pile/jungle/style_random,
/turf/open/misc/beach/coastline_b{
	dir = 1
	},
/area/centcom/basketball)
"Kf" = (
/obj/effect/turf_decal/sand,
/obj/effect/turf_decal/stripes/asteroid/line,
/turf/open/floor/vault/sandstone,
/area/centcom/basketball)
"Kh" = (
/obj/structure/fluff/beach_umbrella/science,
/turf/open/misc/beach/sand,
/area/centcom/basketball)
"Lu" = (
/obj/item/bedsheet/dorms{
	pixel_x = 6;
	pixel_y = 11
	},
/turf/open/floor/carpet/blue,
/area/centcom/basketball)
"Lx" = (
/turf/open/misc/beach/coastline_t/sandwater_inner{
	dir = 1
	},
/area/centcom/basketball)
"LS" = (
/obj/structure/flora/coconuts,
/turf/open/misc/beach/sand,
/area/centcom/basketball)
"MA" = (
/obj/item/flashlight/flare/torch{
	pixel_x = 12;
	pixel_y = 9
	},
/turf/open/misc/beach/sand,
/area/centcom/basketball)
"MR" = (
/obj/structure/bonfire/dense,
/turf/open/misc/beach/sand,
/area/centcom/basketball)
"Nd" = (
/obj/structure/sign/picture_frame{
	pixel_y = -32
	},
/turf/open/misc/beach/coastline_t{
	dir = 8
	},
/area/centcom/basketball)
"Ni" = (
/obj/structure/sign/picture_frame{
	pixel_y = 32
	},
/turf/open/water/beach/biodome,
/area/centcom/basketball)
"NX" = (
/obj/effect/turf_decal/sand,
/obj/effect/turf_decal/stripes/asteroid/line{
	dir = 1
	},
/turf/open/floor/vault/sandstone,
/area/centcom/basketball)
"Oi" = (
/turf/open/misc/beach/coastline_b{
	dir = 1
	},
/area/centcom/basketball)
"Oj" = (
/obj/structure/table,
/obj/item/reagent_containers/cup/soda_cans/sodawater,
/obj/item/reagent_containers/cup/soda_cans/shamblers,
/obj/item/reagent_containers/cup/soda_cans/pwr_game,
/obj/item/reagent_containers/cup/soda_cans/air,
/obj/item/reagent_containers/cup/soda_cans/canned_laughter,
/obj/item/reagent_containers/cup/soda_cans/tonic,
/turf/open/misc/beach/sand,
/area/centcom/basketball)
"OG" = (
/obj/structure/closet/crate/freezer{
	name = "Cooler"
	},
/obj/item/reagent_containers/cup/glass/ice,
/obj/item/reagent_containers/cup/glass/colocup,
/obj/item/reagent_containers/cup/glass/colocup,
/obj/item/reagent_containers/cup/glass/bottle/beer{
	desc = "Beer advertised to be the best in space.";
	name = "Masterbrand Beer"
	},
/obj/item/reagent_containers/cup/glass/bottle/beer{
	desc = "Beer advertised to be the best in space.";
	name = "Masterbrand Beer"
	},
/obj/item/reagent_containers/cup/glass/bottle/beer{
	desc = "Beer advertised to be the best in space.";
	name = "Masterbrand Beer"
	},
/obj/item/reagent_containers/cup/glass/bottle/beer/light,
/obj/item/reagent_containers/cup/glass/bottle/beer/light,
/obj/item/reagent_containers/cup/glass/bottle/beer/light,
/turf/open/misc/beach/sand,
/area/centcom/basketball)
"OS" = (
/obj/effect/turf_decal/sand,
/obj/effect/turf_decal/stripes/asteroid/line{
	dir = 9
	},
/turf/open/floor/vault/sandstone,
/area/centcom/basketball)
"Pr" = (
/obj/effect/landmark/basketball/team_spawn/home,
/turf/open/misc/beach/coastline_t{
	dir = 1
	},
/area/centcom/basketball)
"Pt" = (
/obj/structure/flora/bush/sparsegrass/style_random,
/turf/open/water/beach/biodome,
/area/centcom/basketball)
"Qd" = (
/obj/structure/fence/corner{
	dir = 1
	},
/turf/open/misc/beach/coastline_t{
	dir = 10
	},
/area/centcom/basketball)
"Qq" = (
/turf/open/misc/beach/coastline_t{
	dir = 10
	},
/area/centcom/basketball)
"QA" = (
/turf/open/misc/beach/coastline_t{
	dir = 8
	},
/area/centcom/basketball)
"QF" = (
/obj/item/bait_can/worm{
	pixel_x = -5;
	pixel_y = 13
	},
/obj/item/fishing_line{
	layer = 4;
	pixel_x = 6;
	pixel_y = 3
	},
/turf/open/misc/beach/sand,
/area/centcom/basketball)
"Rx" = (
/obj/structure/fence{
	dir = 8
	},
/turf/open/misc/beach/coastline_t,
/area/centcom/basketball)
"SV" = (
/turf/open/misc/beach/coastline_t,
/area/centcom/basketball)
"Tc" = (
/obj/item/flashlight/flare/torch{
	pixel_x = -2;
	pixel_y = 8
	},
/turf/open/misc/beach/sand,
/area/centcom/basketball)
"TN" = (
/obj/structure/fluff/beach_umbrella,
/turf/open/misc/beach/coastline_t{
	dir = 1
	},
/area/centcom/basketball)
"Ul" = (
/obj/structure/flora/bush/sparsegrass/style_random,
/turf/open/misc/beach/sand,
/area/centcom/basketball)
"UJ" = (
/obj/structure/flora/bush/sparsegrass/style_random,
/turf/open/misc/beach/coastline_t{
	dir = 8
	},
/area/centcom/basketball)
"UL" = (
/obj/item/clothing/glasses/sunglasses/big,
/turf/open/floor/carpet/purple,
/area/centcom/basketball)
"Vc" = (
/obj/item/clothing/shoes/sandal,
/turf/open/floor/carpet/blue,
/area/centcom/basketball)
"Vq" = (
/obj/structure/chair/plastic{
	dir = 4
	},
/obj/item/fishing_rod{
	pixel_x = 18
	},
/turf/open/misc/beach/coastline_t{
	dir = 4
	},
/area/centcom/basketball)
"VM" = (
/obj/item/flashlight/flare/torch{
	pixel_x = 7;
	pixel_y = -5
	},
/turf/open/misc/beach/sand,
/area/centcom/basketball)
"Wp" = (
/obj/item/storage/cans/sixbeer,
/turf/open/misc/beach/coastline_t{
	dir = 8
	},
/area/centcom/basketball)
"Wx" = (
/obj/structure/flora/tree/palm,
/turf/open/misc/beach/coastline_t{
	dir = 9
	},
/area/centcom/basketball)
"WY" = (
/turf/open/water/beach/biodome,
/area/centcom/basketball)
"Xq" = (
/obj/item/toy/seashell,
/turf/open/misc/beach/sand,
/area/centcom/basketball)
"XT" = (
/obj/item/toy/beach_ball,
/turf/open/misc/beach/sand,
/area/centcom/basketball)
"XV" = (
/obj/effect/landmark/basketball/team_spawn/away,
/turf/open/misc/beach/coastline_t{
	dir = 1
	},
/area/centcom/basketball)
"Yd" = (
/obj/structure/flora/bush/sparsegrass/style_random,
/obj/structure/sign/poster/contraband/have_a_puff/directional/east,
/turf/open/water/beach/biodome,
/area/centcom/basketball)
"Yv" = (
/obj/structure/fluff/beach_umbrella,
/turf/open/misc/beach/sand,
/area/centcom/basketball)
"Yx" = (
/obj/item/toy/basketball,
/turf/open/floor/light/colour_cycle/dancefloor_a,
/area/centcom/basketball)
"YI" = (
/obj/effect/turf_decal/sand,
/obj/effect/turf_decal/stripes/asteroid/line{
	dir = 8
	},
/turf/open/floor/vault/sandstone,
/area/centcom/basketball)
"Zc" = (
/obj/structure/stone_tile/slab,
/turf/closed/indestructible/sandstone,
/area/centcom/basketball)
"Zo" = (
/obj/structure/flora/bush/sparsegrass/style_random,
/obj/structure/sign/poster/contraband/have_a_puff/directional/west,
/turf/open/water/beach/biodome,
/area/centcom/basketball)

(1,1,1) = {"
Hu
Hu
Hu
Hu
Hu
Hu
Hu
Hu
Hu
Hu
Hu
Hu
Hu
Hu
Hu
Hu
Hu
Hu
Hu
Hu
Hu
Hu
Hu
Hu
Hu
"}
(2,1,1) = {"
Hu
gY
gY
gY
gY
BM
BM
BM
BM
BM
BM
BM
BM
BM
BM
BM
BM
BM
BM
BM
gY
gY
gY
gY
Hu
"}
(3,1,1) = {"
Hu
gY
gY
gY
gY
BM
WY
ag
WY
AW
WY
WY
rI
WY
WY
Zo
WY
WY
WY
BM
gY
gY
gY
gY
Hu
"}
(4,1,1) = {"
Hu
gY
gY
gY
gY
BM
WY
xB
rd
rd
rd
sk
WY
xB
rd
rd
rd
sk
WY
BM
gY
gY
gY
gY
Hu
"}
(5,1,1) = {"
Hu
gY
BM
BM
BM
BM
WY
ru
CV
Ea
cG
jX
jX
jX
hg
Ea
Qd
WY
ag
BM
BM
BM
BM
gY
Hu
"}
(6,1,1) = {"
Hu
gY
BM
WY
WY
WY
Pt
WY
qp
IM
SV
Gm
qC
Oi
Dw
Ul
Rx
WY
pP
WY
WY
WY
BM
gY
Hu
"}
(7,1,1) = {"
Hu
gY
BM
WY
hV
xB
rd
sk
qp
LS
oG
xB
rd
sk
Pr
IM
Rx
WY
iH
QA
Qq
ru
BM
gY
Hu
"}
(8,1,1) = {"
Hu
BM
BM
Ni
Oi
Wx
Wp
UJ
nZ
IM
Gj
nr
nr
nr
xE
IM
Iy
QA
xE
IM
Gj
Nd
BM
BM
Hu
"}
(9,1,1) = {"
Hu
BM
nR
WY
Oi
Dw
IM
IM
lD
ao
ao
ao
ao
ao
ao
ao
lD
lQ
IM
Fh
OG
IM
IM
BM
Hu
"}
(10,1,1) = {"
Hu
BM
hV
ag
Oi
Dw
MA
IM
lD
ao
OS
YI
YI
YI
BW
ao
lD
Ik
IM
iB
Jb
Fy
IM
BM
Hu
"}
(11,1,1) = {"
Hu
BM
jy
Pt
Oi
rM
MR
Tc
lD
ao
NX
nE
nE
nE
Kf
ao
lD
XT
IM
Kh
IM
FS
rU
BM
Hu
"}
(12,1,1) = {"
Hu
Zc
JU
WY
Oi
Dw
Dt
IM
lD
ao
NX
nE
Yx
nE
Kf
ao
lD
wN
cX
UL
af
IM
xI
BM
Hu
"}
(13,1,1) = {"
Hu
BM
pf
WY
Oi
lh
MR
jb
lD
ao
NX
nE
nE
nE
Kf
ao
lD
IM
IM
dC
Xq
IM
Oj
BM
Hu
"}
(14,1,1) = {"
Hu
BM
sk
ag
Oi
Dw
VM
IM
lD
ao
Hx
ld
ld
ld
uH
ao
lD
Ik
IM
Vc
Lu
IM
Ul
BM
Hu
"}
(15,1,1) = {"
Hu
BM
fm
WY
Oi
TN
QF
Yv
lD
ao
ao
ao
ao
ao
ao
ao
lD
IM
yY
IM
IM
Xq
Di
BM
Hu
"}
(16,1,1) = {"
Hu
BM
BM
Hz
Oi
eU
Vq
Vq
aO
Ul
JT
qQ
qQ
qQ
Lx
IM
hX
Jo
Lx
Ik
JT
CF
BM
BM
Hu
"}
(17,1,1) = {"
Hu
gY
BM
WY
sk
JJ
cA
hV
qp
Ul
ps
JJ
cA
hV
XV
IM
Rx
Pt
cJ
Jo
by
WY
BM
gY
Hu
"}
(18,1,1) = {"
Hu
gY
BM
WY
Pt
WY
Pt
WY
qp
IM
SV
Gm
kx
Oi
Dw
LS
Rx
WY
WY
WY
ru
WY
BM
gY
Hu
"}
(19,1,1) = {"
Hu
gY
BM
BM
BM
BM
WY
WY
GI
ck
iJ
jX
jX
jX
yf
ck
fg
WY
ru
BM
BM
BM
BM
gY
Hu
"}
(20,1,1) = {"
Hu
gY
gY
gY
gY
BM
ag
JJ
cA
cA
cA
hV
WY
JJ
mW
cA
cA
hV
WY
BM
gY
gY
gY
gY
Hu
"}
(21,1,1) = {"
Hu
gY
gY
gY
gY
BM
ru
WY
WY
Yd
WY
WY
WY
WY
WY
Yd
WY
ag
WY
BM
gY
gY
gY
gY
Hu
"}
(22,1,1) = {"
Hu
gY
gY
gY
gY
BM
BM
BM
BM
BM
BM
BM
BM
BM
BM
BM
BM
BM
BM
BM
gY
gY
gY
gY
Hu
"}
(23,1,1) = {"
Hu
Hu
Hu
Hu
Hu
Hu
Hu
Hu
Hu
Hu
Hu
Hu
Hu
Hu
Hu
Hu
Hu
Hu
Hu
Hu
Hu
Hu
Hu
Hu
Hu
"}
