//MAP CONVERTED BY dmm2tgm.py THIS HEADER COMMENT PREVENTS RECONVERSION, DO NOT REMOVE
"a" = (
/turf/template_noop,
/area/template_noop)
"n" = (
/turf/template_noop,
/area/awaymission/outbound_expedition/ruin/radar_station)
"u" = (
/turf/open/floor/plating/airless,
/area/awaymission/outbound_expedition/ruin/radar_station)
"D" = (
/obj/structure/lattice,
/obj/structure/marker_beacon/olive,
/turf/template_noop,
/area/awaymission/outbound_expedition/ruin/radar_station)
"E" = (
/obj/structure/lattice,
/turf/template_noop,
/area/awaymission/outbound_expedition/ruin/radar_station)
"O" = (
/obj/machinery/exoscanner,
/turf/open/floor/holofloor/plating,
/area/awaymission/outbound_expedition/ruin/radar_station)
"R" = (
/obj/structure/lattice,
/obj/structure/marker_beacon/yellow,
/turf/template_noop,
/area/awaymission/outbound_expedition/ruin/radar_station)
"S" = (
/turf/open/floor/holofloor/plating,
/area/awaymission/outbound_expedition/ruin/radar_station)
"W" = (
/obj/machinery/outbound_expedition/comms_dish,
/obj/structure/marker_beacon/bronze,
/turf/open/floor/holofloor/plating,
/area/awaymission/outbound_expedition/ruin/radar_station)

(1,1,1) = {"
a
a
a
a
a
D
E
D
a
a
a
a
a
"}
(2,1,1) = {"
a
a
a
a
a
E
n
E
a
a
a
a
a
"}
(3,1,1) = {"
a
a
a
a
a
E
n
E
a
a
a
a
a
"}
(4,1,1) = {"
a
a
a
a
a
E
u
E
a
a
a
a
a
"}
(5,1,1) = {"
a
a
a
a
a
E
u
E
a
a
a
a
a
"}
(6,1,1) = {"
R
E
E
E
E
O
S
O
E
E
E
E
R
"}
(7,1,1) = {"
E
n
n
u
u
S
W
S
u
u
n
n
E
"}
(8,1,1) = {"
R
E
E
E
E
O
S
O
E
E
E
E
R
"}
(9,1,1) = {"
a
a
a
a
a
E
u
E
a
a
a
a
a
"}
(10,1,1) = {"
a
a
a
a
a
E
u
E
a
a
a
a
a
"}
(11,1,1) = {"
a
a
a
a
a
E
n
E
a
a
a
a
a
"}
(12,1,1) = {"
a
a
a
a
a
E
n
E
a
a
a
a
a
"}
(13,1,1) = {"
a
a
a
a
a
D
E
D
a
a
a
a
a
"}
