//MAP CONVERTED BY dmm2tgm.py THIS HEADER COMMENT PREVENTS RECONVERSION, DO NOT REMOVE
"a" = (
/turf/template_noop,
/area/template_noop)
"c" = (
/obj/machinery/light/very_dim/directional/east,
/turf/open/floor/bronze/flat,
/area/awaymission/outbound_expedition/ruin/clock)
"e" = (
/obj/structure/destructible/clockwork/gear_base/powered/ocular_warden,
/turf/open/floor/bronze/flat,
/area/awaymission/outbound_expedition/ruin/clock)
"f" = (
/obj/structure/fluff/clockwork/alloy_shards/medium_gearbit,
/turf/open/floor/bronze/flat,
/area/awaymission/outbound_expedition/ruin/clock)
"h" = (
/obj/machinery/door/airlock/bronze,
/obj/structure/fans/tiny,
/turf/open/floor/bronze,
/area/awaymission/outbound_expedition/ruin/clock)
"j" = (
/obj/machinery/light/dim/directional/south,
/turf/open/floor/bronze/flat,
/area/awaymission/outbound_expedition/ruin/clock)
"k" = (
/turf/open/floor/bronze/flat,
/area/awaymission/outbound_expedition/ruin/clock)
"l" = (
/turf/closed/wall/mineral/bronze,
/area/awaymission/outbound_expedition/ruin/clock)
"r" = (
/turf/closed/mineral/random/asteroid,
/area/awaymission/outbound_expedition/ruin/clock)
"s" = (
/obj/structure/fluff/clockwork/alloy_shards/medium_gearbit,
/obj/structure/destructible/clockwork/sigil/transmission,
/turf/open/floor/bronze/flat,
/area/awaymission/outbound_expedition/ruin/clock)
"v" = (
/obj/structure/table/bronze,
/obj/item/flashlight/flare/candle/infinite{
	pixel_x = 7;
	pixel_y = 11
	},
/obj/item/flashlight/flare/candle/infinite{
	pixel_y = 11
	},
/obj/item/flashlight/flare/candle/infinite{
	pixel_x = -7;
	pixel_y = 11
	},
/turf/open/floor/bronze/flat,
/area/awaymission/outbound_expedition/ruin/clock)
"y" = (
/obj/machinery/light/small/directional/north,
/turf/open/floor/bronze,
/area/awaymission/outbound_expedition/ruin/clock)
"A" = (
/turf/open/floor/bronze,
/area/awaymission/outbound_expedition/ruin/clock)
"B" = (
/turf/open/misc/asteroid/airless,
/area/awaymission/outbound_expedition/ruin/clock)
"C" = (
/obj/effect/spawner/structure/window/bronze,
/turf/open/floor/bronze/flat,
/area/awaymission/outbound_expedition/ruin/clock)
"G" = (
/obj/structure/table/bronze,
/obj/item/clothing/head/costume/bronze{
	desc = "An ornate, decorated helmet that looks completely unscathed. A small inscription on it reads , 'Rat'Var's Vision'.";
	name = "ornate bronze helmet";
	pixel_x = -8;
	pixel_y = 7
	},
/obj/item/clockwork/clockwork_slab{
	pixel_x = 5;
	pixel_y = 4
	},
/turf/open/floor/bronze/flat,
/area/awaymission/outbound_expedition/ruin/clock)
"N" = (
/obj/structure/girder/bronze,
/turf/open/floor/bronze/flat,
/area/awaymission/outbound_expedition/ruin/clock)
"P" = (
/obj/structure/table/bronze,
/obj/item/flashlight/flare/candle/infinite,
/obj/item/flashlight/flare/candle/infinite{
	pixel_x = 7
	},
/obj/item/flashlight/flare/candle/infinite{
	pixel_x = -7
	},
/turf/open/floor/bronze/flat,
/area/awaymission/outbound_expedition/ruin/clock)
"V" = (
/obj/structure/destructible/clockwork/gear_base/powered/interdiction_lens/free,
/turf/open/floor/bronze/flat,
/area/awaymission/outbound_expedition/ruin/clock)
"X" = (
/obj/effect/landmark/outbound/ruin_shuttle_interdictor,
/turf/open/floor/bronze/flat,
/area/awaymission/outbound_expedition/ruin/clock)
"Y" = (
/obj/machinery/light/dim/directional/north,
/turf/open/floor/bronze/flat,
/area/awaymission/outbound_expedition/ruin/clock)

(1,1,1) = {"
a
a
a
a
a
a
a
a
a
a
a
a
a
a
a
a
a
a
a
a
a
a
a
a
a
"}
(2,1,1) = {"
a
a
a
a
a
a
a
a
a
a
a
a
a
a
a
a
a
a
a
a
a
a
a
a
a
"}
(3,1,1) = {"
a
a
a
a
a
a
a
a
a
a
a
B
B
B
a
a
a
a
a
a
a
a
a
a
a
"}
(4,1,1) = {"
a
a
a
a
a
a
a
a
B
B
B
B
B
B
B
a
a
a
a
a
a
a
a
a
a
"}
(5,1,1) = {"
a
a
a
a
a
a
a
B
B
B
B
r
r
B
B
B
B
a
a
a
a
a
a
a
a
"}
(6,1,1) = {"
a
a
a
a
a
B
B
B
B
r
r
r
r
r
r
B
B
B
B
a
a
a
a
a
a
"}
(7,1,1) = {"
a
a
a
a
B
B
B
B
r
r
r
r
r
r
r
r
r
B
B
a
a
a
a
a
a
"}
(8,1,1) = {"
a
a
a
a
B
r
r
r
r
r
r
r
r
r
r
r
r
r
B
a
a
a
a
a
a
"}
(9,1,1) = {"
a
a
a
B
B
r
l
l
l
l
l
l
l
l
l
l
l
r
B
B
a
a
a
a
a
"}
(10,1,1) = {"
a
a
a
B
B
r
l
Y
k
k
P
G
v
k
k
j
l
r
B
B
a
a
a
a
a
"}
(11,1,1) = {"
a
a
a
B
B
r
l
k
k
k
k
k
k
e
k
N
l
r
r
B
a
a
a
a
a
"}
(12,1,1) = {"
a
a
a
B
B
r
l
k
k
k
k
k
k
k
k
k
l
r
r
B
B
a
a
a
a
"}
(13,1,1) = {"
a
a
a
B
r
r
l
k
k
f
V
s
k
k
k
k
l
r
r
B
B
a
a
a
a
"}
(14,1,1) = {"
a
a
a
B
r
r
l
k
k
k
k
k
k
e
N
k
l
r
r
r
B
a
a
a
a
"}
(15,1,1) = {"
a
a
a
B
r
r
l
k
k
k
k
f
N
k
k
j
l
r
r
B
B
a
a
a
a
"}
(16,1,1) = {"
a
a
a
B
r
r
l
Y
k
k
k
c
k
X
l
h
l
r
r
B
B
a
a
a
a
"}
(17,1,1) = {"
a
a
a
B
r
r
l
C
C
l
l
l
l
l
l
A
l
r
r
B
B
B
a
a
a
"}
(18,1,1) = {"
a
a
a
B
B
r
r
B
B
r
r
l
y
A
A
A
l
r
B
B
B
a
a
a
a
"}
(19,1,1) = {"
a
a
a
a
B
B
B
B
B
r
r
l
A
l
l
l
l
r
B
B
a
a
a
a
a
"}
(20,1,1) = {"
a
a
a
a
a
B
B
B
B
B
r
l
A
l
r
r
r
B
B
B
a
a
a
a
a
"}
(21,1,1) = {"
a
a
a
a
a
a
a
B
B
B
r
l
h
l
r
B
B
B
B
a
a
a
a
a
a
"}
(22,1,1) = {"
a
a
a
a
a
a
a
a
B
B
B
B
B
B
B
B
B
a
a
a
a
a
a
a
a
"}
(23,1,1) = {"
a
a
a
a
a
a
a
a
a
a
a
B
B
B
B
a
a
a
a
a
a
a
a
a
a
"}
(24,1,1) = {"
a
a
a
a
a
a
a
a
a
a
a
a
a
a
a
a
a
a
a
a
a
a
a
a
a
"}
(25,1,1) = {"
a
a
a
a
a
a
a
a
a
a
a
a
a
a
a
a
a
a
a
a
a
a
a
a
a
"}
