//MAP CONVERTED BY dmm2tgm.py THIS HEADER COMMENT PREVENTS RECONVERSION, DO NOT REMOVE
"aT" = (
/obj/effect/spawner/structure/window/reinforced,
/turf/open/floor/plating,
/area/awaymission/outbound_expedition/ruin/old_shipyard)
"bh" = (
/obj/machinery/door/airlock/external,
/obj/structure/fans/tiny,
/turf/open/floor/iron/shuttle/exploration/textured_flat,
/area/awaymission/outbound_expedition/ruin/old_shipyard)
"bs" = (
/obj/effect/turf_decal/delivery/white,
/obj/machinery/door/poddoor,
/obj/structure/fans/tiny/forcefield{
	dir = 4
	},
/turf/open/floor/plating,
/area/awaymission/outbound_expedition/ruin/old_shipyard)
"bQ" = (
/obj/effect/decal/cleanable/dirt/dust,
/mob/living/simple_animal/hostile/true_changeling{
	name = "The Dormant One";
	real_name = "The Dormant One"
	},
/turf/open/floor/iron,
/area/awaymission/outbound_expedition/ruin/old_shipyard)
"dl" = (
/obj/effect/decal/cleanable/dirt/dust,
/turf/open/floor/catwalk_floor/iron_dark,
/area/awaymission/outbound_expedition/ruin/old_shipyard)
"ds" = (
/obj/effect/decal/cleanable/dirt/dust,
/obj/structure/reagent_dispensers/watertank,
/turf/open/floor/plating,
/area/awaymission/outbound_expedition/ruin/old_shipyard)
"ee" = (
/obj/structure/table,
/obj/effect/decal/cleanable/dirt/dust,
/obj/item/storage/belt/utility,
/turf/open/floor/iron,
/area/awaymission/outbound_expedition/ruin/old_shipyard)
"fu" = (
/obj/effect/decal/cleanable/dirt/dust,
/obj/structure/mopbucket,
/obj/item/reagent_containers/cup/bucket,
/obj/item/mop,
/turf/open/floor/catwalk_floor/iron_dark,
/area/awaymission/outbound_expedition/ruin/old_shipyard)
"fP" = (
/obj/effect/decal/cleanable/dirt/dust,
/obj/machinery/light/warm/no_nightlight/directional/west,
/turf/open/floor/holofloor/dark,
/area/awaymission/outbound_expedition/ruin/old_shipyard)
"gp" = (
/obj/effect/decal/cleanable/dirt/dust,
/obj/machinery/portable_atmospherics/canister/oxygen,
/turf/open/floor/catwalk_floor/iron_dark,
/area/awaymission/outbound_expedition/ruin/old_shipyard)
"hb" = (
/obj/structure/shuttle/engine/propulsion{
	dir = 4
	},
/turf/open/floor/iron/shuttle/exploration/textured_flat,
/area/awaymission/outbound_expedition/ruin/old_shipyard)
"hp" = (
/obj/effect/decal/cleanable/dirt/dust,
/obj/machinery/portable_atmospherics/scrubber,
/turf/open/floor/catwalk_floor/iron_dark,
/area/awaymission/outbound_expedition/ruin/old_shipyard)
"hM" = (
/obj/structure/shuttle/engine/heater{
	dir = 4
	},
/obj/structure/window/reinforced/tinted{
	dir = 8
	},
/turf/open/floor/iron/shuttle/exploration/textured_flat,
/area/awaymission/outbound_expedition/ruin/old_shipyard)
"hY" = (
/obj/machinery/shower{
	pixel_y = 13
	},
/obj/effect/turf_decal/trimline/yellow/end,
/obj/effect/decal/cleanable/dirt/dust,
/turf/open/floor/holofloor/dark,
/area/awaymission/outbound_expedition/ruin/old_shipyard)
"il" = (
/obj/effect/decal/cleanable/dirt/dust,
/obj/structure/bodycontainer/crematorium{
	dir = 4;
	id = "ruinCrematorium"
	},
/turf/open/floor/iron,
/area/awaymission/outbound_expedition/ruin/old_shipyard)
"jc" = (
/obj/machinery/suit_storage_unit/industrial/hauler,
/turf/open/floor/iron/shuttle/arrivals,
/area/awaymission/outbound_expedition/ruin/old_shipyard)
"kr" = (
/obj/structure/railing,
/obj/effect/decal/cleanable/dirt/dust,
/turf/open/floor/catwalk_floor/iron,
/area/awaymission/outbound_expedition/ruin/old_shipyard)
"kL" = (
/obj/item/storage/toolbox/mechanical{
	pixel_y = 5
	},
/obj/structure/table/reinforced,
/turf/open/floor/iron/shuttle/arrivals,
/area/awaymission/outbound_expedition/ruin/old_shipyard)
"lh" = (
/obj/effect/decal/cleanable/dirt/dust,
/obj/machinery/door/airlock/maintenance,
/turf/open/floor/iron,
/area/awaymission/outbound_expedition/ruin/old_shipyard)
"mS" = (
/obj/structure/table,
/obj/effect/decal/cleanable/dirt/dust,
/turf/open/floor/iron,
/area/awaymission/outbound_expedition/ruin/old_shipyard)
"nw" = (
/obj/effect/decal/cleanable/dirt/dust,
/obj/machinery/portable_atmospherics/canister/air,
/turf/open/floor/catwalk_floor/iron_dark,
/area/awaymission/outbound_expedition/ruin/old_shipyard)
"nG" = (
/obj/effect/decal/cleanable/dirt/dust,
/turf/open/floor/plating,
/area/awaymission/outbound_expedition/ruin/old_shipyard)
"oS" = (
/obj/machinery/power/rtg,
/obj/structure/cable,
/obj/effect/decal/cleanable/dirt/dust,
/turf/open/floor/catwalk_floor/iron_dark,
/area/awaymission/outbound_expedition/ruin/old_shipyard)
"pr" = (
/obj/effect/decal/cleanable/dirt/dust,
/obj/structure/noticeboard/directional/west{
	dir = 1
	},
/turf/open/floor/iron,
/area/awaymission/outbound_expedition/ruin/old_shipyard)
"pv" = (
/obj/machinery/airalarm/directional/north,
/obj/structure/table/reinforced,
/obj/item/mod/module/jetpack/advanced,
/turf/open/floor/iron/shuttle/arrivals,
/area/awaymission/outbound_expedition/ruin/old_shipyard)
"qx" = (
/turf/open/floor/iron/shuttle/arrivals,
/area/awaymission/outbound_expedition/ruin/old_shipyard)
"sp" = (
/obj/effect/decal/cleanable/dirt/dust,
/obj/structure/table,
/obj/item/stack/cable_coil,
/obj/item/reagent_containers/cup/rag,
/turf/open/floor/iron,
/area/awaymission/outbound_expedition/ruin/old_shipyard)
"sx" = (
/obj/effect/decal/cleanable/dirt/dust,
/obj/effect/landmark/outbound/ruin_shuttle_interdictor,
/turf/open/floor/iron,
/area/awaymission/outbound_expedition/ruin/old_shipyard)
"sy" = (
/obj/structure/railing{
	dir = 1
	},
/obj/effect/decal/cleanable/dirt/dust,
/turf/open/floor/catwalk_floor/iron,
/area/awaymission/outbound_expedition/ruin/old_shipyard)
"sZ" = (
/obj/structure/marker_beacon/burgundy,
/turf/open/floor/plating,
/area/awaymission/outbound_expedition/ruin/old_shipyard)
"ta" = (
/obj/structure/cable,
/obj/effect/decal/cleanable/dirt/dust,
/turf/open/floor/catwalk_floor/iron_dark,
/area/awaymission/outbound_expedition/ruin/old_shipyard)
"tf" = (
/obj/effect/decal/cleanable/dirt/dust,
/obj/structure/table,
/obj/item/flashlight/lamp,
/turf/open/floor/iron,
/area/awaymission/outbound_expedition/ruin/old_shipyard)
"tH" = (
/obj/effect/decal/cleanable/dirt/dust,
/obj/effect/turf_decal,
/turf/open/floor/plating,
/area/awaymission/outbound_expedition/ruin/old_shipyard)
"uW" = (
/obj/structure/closet,
/obj/effect/decal/cleanable/dirt/dust,
/obj/item/clothing/under/rank/engineering/engineer/skyrat/utility,
/obj/item/storage/toolbox/syndicate,
/obj/item/clothing/shoes/workboots,
/obj/item/radio/headset,
/turf/open/floor/iron,
/area/awaymission/outbound_expedition/ruin/old_shipyard)
"wS" = (
/obj/effect/decal/cleanable/dirt/dust,
/obj/structure/table,
/turf/open/floor/iron,
/area/awaymission/outbound_expedition/ruin/old_shipyard)
"xp" = (
/turf/closed/wall/mineral/titanium/nodiagonal,
/area/awaymission/outbound_expedition/ruin/old_shipyard)
"xV" = (
/obj/effect/decal/cleanable/dirt/dust,
/obj/effect/turf_decal{
	dir = 1
	},
/turf/open/floor/plating,
/area/awaymission/outbound_expedition/ruin/old_shipyard)
"ym" = (
/obj/effect/decal/cleanable/dirt/dust,
/obj/structure/cable,
/turf/open/floor/iron,
/area/awaymission/outbound_expedition/ruin/old_shipyard)
"yU" = (
/obj/machinery/light/very_dim/directional/west,
/turf/open/floor/iron/shuttle/exploration/textured_flat,
/area/awaymission/outbound_expedition/ruin/old_shipyard)
"zc" = (
/obj/machinery/computer/old{
	dir = 4
	},
/turf/open/floor/iron/shuttle/arrivals,
/area/awaymission/outbound_expedition/ruin/old_shipyard)
"zm" = (
/turf/closed/wall/r_wall,
/area/awaymission/outbound_expedition/ruin/old_shipyard)
"Ak" = (
/obj/effect/decal/cleanable/dirt/dust,
/obj/structure/fence{
	dir = 4
	},
/turf/open/floor/iron,
/area/awaymission/outbound_expedition/ruin/old_shipyard)
"Au" = (
/obj/structure/bed/pod{
	pixel_y = 0
	},
/obj/item/bedsheet/black,
/obj/structure/decorative/shelf{
	pixel_y = 18
	},
/turf/open/floor/iron/shuttle/exploration/textured_flat,
/area/awaymission/outbound_expedition/ruin/old_shipyard)
"AC" = (
/obj/effect/decal/cleanable/dirt/dust,
/turf/open/floor/catwalk_floor/iron,
/area/awaymission/outbound_expedition/ruin/old_shipyard)
"Bk" = (
/obj/effect/decal/cleanable/dirt/dust,
/turf/closed/wall/r_wall,
/area/awaymission/outbound_expedition/ruin/old_shipyard)
"BF" = (
/obj/machinery/door/airlock/external,
/obj/effect/decal/cleanable/dirt/dust,
/turf/open/floor/holofloor/dark,
/area/awaymission/outbound_expedition/ruin/old_shipyard)
"CL" = (
/obj/machinery/door/airlock/grunge,
/turf/open/floor/iron/shuttle/cargo{
	dir = 1
	},
/area/awaymission/outbound_expedition/ruin/old_shipyard)
"CS" = (
/obj/effect/decal/cleanable/dirt/dust,
/obj/structure/chair/office{
	dir = 4
	},
/turf/open/floor/iron,
/area/awaymission/outbound_expedition/ruin/old_shipyard)
"Dk" = (
/obj/machinery/light/red/directional/west,
/obj/effect/decal/cleanable/dirt/dust,
/turf/open/floor/holofloor/dark,
/area/awaymission/outbound_expedition/ruin/old_shipyard)
"DP" = (
/obj/structure/disposalpipe/trunk,
/obj/structure/disposaloutlet{
	dir = 1
	},
/turf/open/floor/iron/shuttle/arrivals,
/area/awaymission/outbound_expedition/ruin/old_shipyard)
"DX" = (
/obj/structure/lattice,
/turf/template_noop,
/area/awaymission/outbound_expedition/ruin/old_shipyard)
"EZ" = (
/obj/structure/chair{
	dir = 8
	},
/obj/effect/decal/cleanable/dirt/dust,
/turf/open/floor/holofloor/dark,
/area/awaymission/outbound_expedition/ruin/old_shipyard)
"Fg" = (
/obj/effect/decal/cleanable/dirt/dust,
/obj/machinery/light/warm/no_nightlight/directional/south,
/turf/open/floor/iron,
/area/awaymission/outbound_expedition/ruin/old_shipyard)
"Fu" = (
/obj/machinery/computer/old{
	dir = 8
	},
/turf/open/floor/iron/shuttle/arrivals,
/area/awaymission/outbound_expedition/ruin/old_shipyard)
"FO" = (
/obj/effect/decal/cleanable/dirt/dust,
/obj/machinery/light/warm/no_nightlight/directional/north,
/turf/open/floor/catwalk_floor/iron,
/area/awaymission/outbound_expedition/ruin/old_shipyard)
"Gr" = (
/obj/effect/decal/cleanable/dirt/dust,
/obj/structure/closet,
/turf/open/floor/iron,
/area/awaymission/outbound_expedition/ruin/old_shipyard)
"GD" = (
/turf/open/floor/iron/shuttle/cargo{
	dir = 1
	},
/area/awaymission/outbound_expedition/ruin/old_shipyard)
"Hx" = (
/obj/effect/decal/cleanable/dirt/dust,
/obj/structure/table,
/obj/item/wrench,
/turf/open/floor/iron,
/area/awaymission/outbound_expedition/ruin/old_shipyard)
"HC" = (
/obj/structure/cable,
/obj/effect/decal/cleanable/dirt/dust,
/obj/machinery/light/red/directional/east,
/turf/open/floor/catwalk_floor/iron_dark,
/area/awaymission/outbound_expedition/ruin/old_shipyard)
"Ir" = (
/obj/machinery/door/airlock/maintenance,
/obj/effect/mapping_helpers/airlock/locked,
/obj/effect/decal/cleanable/dirt/dust,
/obj/structure/cable,
/turf/open/floor/iron,
/area/awaymission/outbound_expedition/ruin/old_shipyard)
"Jf" = (
/obj/machinery/power/port_gen/pacman/pre_loaded,
/obj/structure/cable,
/turf/open/floor/iron/shuttle/arrivals,
/area/awaymission/outbound_expedition/ruin/old_shipyard)
"JD" = (
/obj/machinery/light/red/directional/west,
/obj/structure/cable,
/obj/effect/decal/cleanable/dirt/dust,
/turf/open/floor/catwalk_floor/iron_dark,
/area/awaymission/outbound_expedition/ruin/old_shipyard)
"JQ" = (
/obj/structure/marker_beacon/yellow,
/turf/closed/wall/r_wall,
/area/awaymission/outbound_expedition/ruin/old_shipyard)
"Ke" = (
/turf/closed/wall/mineral/titanium,
/area/awaymission/outbound_expedition/ruin/old_shipyard)
"Kw" = (
/obj/machinery/door/airlock/external,
/obj/structure/fans/tiny,
/turf/open/floor/holofloor/dark,
/area/awaymission/outbound_expedition/ruin/old_shipyard)
"KZ" = (
/obj/machinery/door/airlock/maintenance,
/obj/effect/decal/cleanable/dirt/dust,
/turf/open/floor/catwalk_floor/iron_dark,
/area/awaymission/outbound_expedition/ruin/old_shipyard)
"LR" = (
/obj/machinery/light/red/directional/west,
/obj/effect/decal/cleanable/dirt/dust,
/turf/open/floor/catwalk_floor/iron_dark,
/area/awaymission/outbound_expedition/ruin/old_shipyard)
"Mk" = (
/obj/machinery/door/airlock/maintenance,
/obj/effect/decal/cleanable/dirt/dust,
/turf/open/floor/iron,
/area/awaymission/outbound_expedition/ruin/old_shipyard)
"Mv" = (
/obj/effect/decal/cleanable/dirt/dust,
/obj/machinery/light/warm/no_nightlight/directional/west,
/turf/open/floor/iron,
/area/awaymission/outbound_expedition/ruin/old_shipyard)
"Mw" = (
/turf/open/floor/iron/stairs{
	dir = 1
	},
/area/awaymission/outbound_expedition/ruin/old_shipyard)
"Nz" = (
/obj/effect/spawner/structure/window/reinforced,
/obj/structure/disposalpipe/segment,
/turf/open/floor/plating,
/area/awaymission/outbound_expedition/ruin/old_shipyard)
"NK" = (
/obj/structure/table,
/obj/effect/decal/cleanable/dirt/dust,
/obj/item/gun/ballistic/automatic/pistol/cfa_snub{
	desc = "An  easily-concealable pistol chambered for 4.2x30mm. This one was under a desk lamp, for some reason."
	},
/obj/item/flashlight/lamp,
/turf/open/floor/iron,
/area/awaymission/outbound_expedition/ruin/old_shipyard)
"NX" = (
/obj/structure/table,
/obj/effect/decal/cleanable/dirt/dust,
/obj/item/phone,
/turf/open/floor/iron,
/area/awaymission/outbound_expedition/ruin/old_shipyard)
"OB" = (
/obj/effect/decal/cleanable/dirt/dust,
/obj/machinery/pipedispenser,
/turf/open/floor/iron,
/area/awaymission/outbound_expedition/ruin/old_shipyard)
"OR" = (
/obj/machinery/light/very_dim/directional/west,
/turf/open/floor/iron/shuttle/cargo{
	dir = 1
	},
/area/awaymission/outbound_expedition/ruin/old_shipyard)
"Pc" = (
/obj/effect/decal/cleanable/dirt/dust,
/turf/open/floor/holofloor/dark,
/area/awaymission/outbound_expedition/ruin/old_shipyard)
"Py" = (
/obj/machinery/power/apc/auto_name/directional/east,
/obj/structure/cable,
/turf/open/floor/iron/shuttle/arrivals,
/area/awaymission/outbound_expedition/ruin/old_shipyard)
"Qk" = (
/obj/effect/spawner/structure/window/reinforced/shuttle,
/turf/open/floor/plating,
/area/awaymission/outbound_expedition/ruin/old_shipyard)
"QW" = (
/obj/effect/decal/cleanable/dirt/dust,
/obj/structure/closet/crate/wooden,
/obj/item/electronics/airalarm,
/obj/machinery/button/crematorium{
	id = "ruinCrematorium";
	pixel_x = -24;
	pixel_y = 0
	},
/turf/open/floor/iron,
/area/awaymission/outbound_expedition/ruin/old_shipyard)
"Ry" = (
/obj/effect/decal/cleanable/dirt/dust,
/obj/machinery/portable_atmospherics/pump,
/turf/open/floor/catwalk_floor/iron_dark,
/area/awaymission/outbound_expedition/ruin/old_shipyard)
"Sh" = (
/obj/effect/decal/cleanable/dirt/dust,
/obj/machinery/power/apc/auto_name/directional/west{
	start_charge = 100
	},
/obj/structure/cable,
/turf/open/floor/iron,
/area/awaymission/outbound_expedition/ruin/old_shipyard)
"Ta" = (
/obj/effect/decal/cleanable/dirt/dust,
/obj/structure/closet/crate/trashcart,
/obj/item/storage/bag/trash,
/turf/open/floor/catwalk_floor/iron_dark,
/area/awaymission/outbound_expedition/ruin/old_shipyard)
"Vn" = (
/obj/effect/turf_decal/tile/yellow/half/contrasted{
	dir = 1
	},
/obj/effect/decal/cleanable/dirt/dust,
/turf/open/floor/iron,
/area/awaymission/outbound_expedition/ruin/old_shipyard)
"VL" = (
/obj/item/kirbyplants/random,
/obj/effect/decal/cleanable/dirt/dust,
/turf/open/floor/holofloor/dark,
/area/awaymission/outbound_expedition/ruin/old_shipyard)
"VT" = (
/obj/structure/chair/comfy/shuttle{
	dir = 8
	},
/turf/open/floor/iron/shuttle/arrivals,
/area/awaymission/outbound_expedition/ruin/old_shipyard)
"WA" = (
/obj/effect/decal/cleanable/dirt/dust,
/obj/structure/fence/door/opened,
/turf/open/floor/iron,
/area/awaymission/outbound_expedition/ruin/old_shipyard)
"WD" = (
/obj/machinery/light/warm/no_nightlight/directional/east,
/turf/open/floor/iron/shuttle/arrivals,
/area/awaymission/outbound_expedition/ruin/old_shipyard)
"Xk" = (
/obj/machinery/door/airlock/maintenance,
/obj/structure/cable,
/obj/effect/decal/cleanable/dirt/dust,
/turf/open/floor/iron,
/area/awaymission/outbound_expedition/ruin/old_shipyard)
"Xx" = (
/turf/template_noop,
/area/template_noop)
"XA" = (
/obj/effect/decal/cleanable/dirt/dust,
/obj/structure/chair{
	dir = 4
	},
/turf/open/floor/iron,
/area/awaymission/outbound_expedition/ruin/old_shipyard)
"YU" = (
/obj/effect/decal/cleanable/dirt/dust,
/turf/open/floor/iron,
/area/awaymission/outbound_expedition/ruin/old_shipyard)
"ZK" = (
/obj/machinery/disposal/bin,
/obj/structure/disposalpipe/trunk{
	dir = 1
	},
/obj/effect/decal/cleanable/dirt/dust,
/turf/open/floor/plating,
/area/awaymission/outbound_expedition/ruin/old_shipyard)

(1,1,1) = {"
Xx
Xx
Xx
Xx
Xx
Xx
Xx
Xx
Xx
Xx
Xx
Xx
Xx
Xx
Xx
Xx
Xx
Xx
Xx
Xx
Xx
Xx
Xx
Xx
Xx
Xx
Xx
Xx
Xx
Xx
"}
(2,1,1) = {"
Xx
Xx
Xx
Xx
Xx
Xx
Xx
Xx
Xx
Xx
Xx
Xx
Xx
Xx
Xx
Xx
Xx
Xx
Xx
Xx
Xx
Xx
Xx
Xx
Xx
Xx
Xx
Xx
Xx
Xx
"}
(3,1,1) = {"
Xx
Xx
Xx
Xx
Xx
Xx
Xx
Xx
Xx
Xx
JQ
zm
zm
zm
zm
zm
zm
JQ
zm
zm
JQ
zm
zm
zm
zm
zm
zm
JQ
Xx
Xx
"}
(4,1,1) = {"
Xx
Xx
Xx
Xx
Xx
Xx
Xx
Xx
Xx
Xx
qx
aT
nG
nG
KZ
dl
dl
LR
dl
dl
dl
dl
dl
ta
ta
JD
ta
zm
Xx
Xx
"}
(5,1,1) = {"
Xx
Xx
Xx
Xx
Xx
Xx
Xx
Xx
Xx
Xx
DP
Nz
ZK
ds
zm
aT
hp
Ry
aT
gp
nw
aT
oS
oS
aT
dl
ta
zm
Xx
Xx
"}
(6,1,1) = {"
Xx
Xx
zm
zm
zm
zm
zm
zm
zm
zm
zm
zm
zm
zm
zm
zm
zm
zm
zm
zm
zm
zm
zm
zm
zm
dl
ta
zm
Xx
Xx
"}
(7,1,1) = {"
Xx
Xx
zm
OB
tf
wS
YU
YU
YU
YU
YU
YU
YU
Mv
Ak
QW
il
zm
Vn
YU
zm
uW
XA
sx
zm
dl
ta
zm
Xx
Xx
"}
(8,1,1) = {"
Xx
Xx
zm
YU
YU
YU
YU
YU
YU
YU
YU
YU
YU
YU
WA
YU
YU
Bk
Vn
YU
Ir
bQ
YU
Fg
zm
dl
ta
zm
Xx
Xx
"}
(9,1,1) = {"
Xx
Xx
zm
AC
kr
xp
Ke
Ke
Ke
YU
YU
tH
sy
AC
Ak
Hx
sp
zm
Vn
YU
zm
mS
mS
ee
zm
dl
ta
zm
Xx
Xx
"}
(10,1,1) = {"
Xx
Xx
zm
AC
kr
Ke
Au
yU
Ke
Qk
Qk
xp
sy
AC
zm
zm
zm
zm
Vn
YU
zm
zm
zm
zm
zm
dl
ta
zm
Xx
Xx
"}
(11,1,1) = {"
Xx
Xx
zm
AC
kr
Ke
Ke
CL
xp
pv
zc
Qk
sy
AC
aT
Gr
pr
zm
Vn
YU
Sh
YU
zm
Ta
fu
dl
ta
zm
Xx
Xx
"}
(12,1,1) = {"
Xx
Xx
zm
AC
AC
bh
OR
GD
Mw
qx
VT
Qk
AC
AC
aT
CS
YU
Mk
Vn
YU
ym
ym
Xk
ta
ta
HC
ta
zm
Xx
Xx
"}
(13,1,1) = {"
Xx
Xx
zm
AC
kr
Ke
Ke
CL
Ke
Fu
Fu
Ke
sy
AC
aT
NK
NX
zm
Vn
YU
JQ
zm
zm
zm
zm
zm
zm
JQ
Xx
Xx
"}
(14,1,1) = {"
Xx
Xx
zm
AC
kr
Ke
jc
qx
Ke
Ke
Ke
Ke
sy
AC
aT
aT
aT
zm
Vn
YU
zm
Xx
Xx
Xx
Xx
Xx
Xx
Xx
Xx
Xx
"}
(15,1,1) = {"
Xx
Xx
zm
AC
kr
Ke
kL
WD
qx
Py
Jf
Ke
sy
AC
YU
YU
YU
Bk
Vn
YU
zm
Xx
Xx
Xx
Xx
Xx
Xx
Xx
Xx
Xx
"}
(16,1,1) = {"
Xx
Xx
zm
AC
kr
Ke
hM
Ke
hM
Ke
hM
Ke
sy
AC
YU
YU
YU
lh
Vn
YU
zm
Xx
Xx
Xx
Xx
Xx
Xx
Xx
Xx
Xx
"}
(17,1,1) = {"
Xx
Xx
zm
FO
kr
xp
hb
Ke
hb
Ke
hb
xp
sy
AC
zm
zm
zm
zm
Vn
YU
zm
Xx
Xx
Xx
Xx
Xx
Xx
Xx
Xx
Xx
"}
(18,1,1) = {"
Xx
Xx
zm
AC
AC
xV
YU
YU
YU
YU
YU
tH
AC
AC
zm
hY
Dk
zm
Vn
YU
aT
Xx
Xx
Xx
Xx
Xx
Xx
Xx
Xx
Xx
"}
(19,1,1) = {"
Xx
Xx
zm
zm
zm
bs
bs
bs
bs
bs
bs
bs
zm
zm
zm
hY
Pc
zm
Vn
YU
aT
Xx
Xx
Xx
Xx
Xx
Xx
Xx
Xx
Xx
"}
(20,1,1) = {"
Xx
Xx
Xx
Xx
Xx
DX
Xx
Xx
Xx
Xx
Xx
DX
aT
Pc
BF
Pc
Pc
BF
Vn
YU
aT
Xx
Xx
Xx
Xx
Xx
Xx
Xx
Xx
Xx
"}
(21,1,1) = {"
Xx
Xx
Xx
Xx
Xx
DX
Xx
Xx
Xx
Xx
Xx
DX
aT
Pc
zm
zm
zm
zm
zm
zm
JQ
Xx
Xx
Xx
Xx
Xx
Xx
Xx
Xx
Xx
"}
(22,1,1) = {"
Xx
Xx
Xx
Xx
Xx
DX
Xx
Xx
Xx
Xx
Xx
DX
aT
Pc
Pc
fP
VL
zm
Xx
Xx
Xx
Xx
Xx
Xx
Xx
Xx
Xx
Xx
Xx
Xx
"}
(23,1,1) = {"
Xx
Xx
Xx
Xx
Xx
DX
Xx
Xx
Xx
Xx
Xx
DX
zm
EZ
EZ
Pc
Pc
zm
Xx
Xx
Xx
Xx
Xx
Xx
Xx
Xx
Xx
Xx
Xx
Xx
"}
(24,1,1) = {"
Xx
Xx
Xx
Xx
Xx
DX
Xx
Xx
Xx
Xx
Xx
DX
zm
zm
zm
Kw
zm
zm
Xx
Xx
Xx
Xx
Xx
Xx
Xx
Xx
Xx
Xx
Xx
Xx
"}
(25,1,1) = {"
Xx
Xx
Xx
Xx
Xx
DX
Xx
Xx
Xx
Xx
Xx
DX
Xx
Xx
Xx
Xx
Xx
Xx
Xx
Xx
Xx
Xx
Xx
Xx
Xx
Xx
Xx
Xx
Xx
Xx
"}
(26,1,1) = {"
Xx
Xx
Xx
Xx
Xx
sZ
Xx
Xx
Xx
Xx
Xx
sZ
Xx
Xx
Xx
Xx
Xx
Xx
Xx
Xx
Xx
Xx
Xx
Xx
Xx
Xx
Xx
Xx
Xx
Xx
"}
(27,1,1) = {"
Xx
Xx
Xx
Xx
Xx
Xx
Xx
Xx
Xx
Xx
Xx
Xx
Xx
Xx
Xx
Xx
Xx
Xx
Xx
Xx
Xx
Xx
Xx
Xx
Xx
Xx
Xx
Xx
Xx
Xx
"}
(28,1,1) = {"
Xx
Xx
Xx
Xx
Xx
Xx
Xx
Xx
Xx
Xx
Xx
Xx
Xx
Xx
Xx
Xx
Xx
Xx
Xx
Xx
Xx
Xx
Xx
Xx
Xx
Xx
Xx
Xx
Xx
Xx
"}
(29,1,1) = {"
Xx
Xx
Xx
Xx
Xx
Xx
Xx
Xx
Xx
Xx
Xx
Xx
Xx
Xx
Xx
Xx
Xx
Xx
Xx
Xx
Xx
Xx
Xx
Xx
Xx
Xx
Xx
Xx
Xx
Xx
"}
(30,1,1) = {"
Xx
Xx
Xx
Xx
Xx
Xx
Xx
Xx
Xx
Xx
Xx
Xx
Xx
Xx
Xx
Xx
Xx
Xx
Xx
Xx
Xx
Xx
Xx
Xx
Xx
Xx
Xx
Xx
Xx
Xx
"}
