//MAP CONVERTED BY dmm2tgm.py THIS HEADER COMMENT PREVENTS RECONVERSION, DO NOT REMOVE
"a" = (
/turf/template_noop,
/area/template_noop)
"b" = (
/obj/structure/bed,
/obj/item/bedsheet/orange,
/obj/effect/mob_spawn/corpse/human/prisoner,
/turf/open/floor/iron/sepia,
/area/awaymission/outbound_expedition/ruin/prison)
"c" = (
/obj/machinery/power/shuttle_engine/heater,
/turf/closed/indestructible/opshuttle,
/area/awaymission/outbound_expedition/ruin/prison)
"d" = (
/obj/effect/landmark/outbound/ruin_shuttle_interdictor,
/turf/open/floor/plating/airless,
/area/awaymission/outbound_expedition/ruin/prison)
"e" = (
/obj/structure/table/reinforced,
/turf/closed/mineral/random/asteroid,
/area/awaymission/outbound_expedition/ruin/prison)
"f" = (
/obj/machinery/modular_computer/console,
/turf/closed/mineral/random/asteroid,
/area/awaymission/outbound_expedition/ruin/prison)
"g" = (
/mob/living/simple_animal/hostile/asteroid/hivelord,
/turf/open/misc/asteroid/airless,
/area/awaymission/outbound_expedition/ruin/prison)
"h" = (
/obj/effect/spawner/random/contraband/narcotics,
/obj/machinery/light/broken/directional/east,
/turf/open/floor/iron/sepia,
/area/awaymission/outbound_expedition/ruin/prison)
"i" = (
/obj/machinery/power/shuttle_engine/propulsion,
/turf/open/space/basic,
/area/awaymission/outbound_expedition/ruin/prison)
"j" = (
/obj/machinery/light/directional/south,
/turf/open/floor/mineral/titanium/tiled/airless,
/area/awaymission/outbound_expedition/ruin/prison)
"m" = (
/turf/open/misc/asteroid/airless,
/area/awaymission/outbound_expedition/ruin/prison)
"p" = (
/obj/structure/girder/reinforced,
/turf/open/floor/plating/airless,
/area/awaymission/outbound_expedition/ruin/prison)
"q" = (
/obj/effect/decal/cleanable/vomit/old,
/turf/open/floor/iron/sepia,
/area/awaymission/outbound_expedition/ruin/prison)
"r" = (
/obj/effect/spawner/structure/window/reinforced/shuttle,
/turf/closed/mineral/random/asteroid,
/area/awaymission/outbound_expedition/ruin/prison)
"s" = (
/obj/effect/spawner/structure/window/reinforced/shuttle,
/turf/open/floor/plating/airless,
/area/awaymission/outbound_expedition/ruin/prison)
"t" = (
/turf/open/floor/carpet/red/airless,
/area/awaymission/outbound_expedition/ruin/prison)
"u" = (
/obj/machinery/power/shuttle_engine/propulsion/burst/right,
/turf/open/space/basic,
/area/awaymission/outbound_expedition/ruin/prison)
"w" = (
/obj/structure/table/reinforced,
/turf/open/floor/carpet/red/airless,
/area/awaymission/outbound_expedition/ruin/prison)
"x" = (
/obj/machinery/power/shuttle_engine/propulsion/burst/left,
/turf/open/space/basic,
/area/awaymission/outbound_expedition/ruin/prison)
"y" = (
/obj/structure/girder/reinforced,
/turf/open/misc/asteroid/airless,
/area/awaymission/outbound_expedition/ruin/prison)
"z" = (
/turf/open/floor/plating/airless,
/area/awaymission/outbound_expedition/ruin/prison)
"A" = (
/obj/structure/closet/secure_closet/security,
/obj/machinery/light/broken/directional/north,
/turf/open/floor/mineral/titanium/tiled/airless,
/area/awaymission/outbound_expedition/ruin/prison)
"B" = (
/obj/machinery/door/airlock/external/ruin,
/obj/effect/mapping_helpers/airlock/cutaiwire,
/obj/effect/mapping_helpers/airlock/access/all/security,
/turf/open/floor/mineral/titanium/tiled/airless,
/area/awaymission/outbound_expedition/ruin/prison)
"D" = (
/obj/structure/closet/secure_closet/contraband{
	name = "confiscation locker"
	},
/obj/effect/spawner/random/exotic/antag_gear,
/obj/effect/spawner/random/exotic/antag_gear_weak,
/obj/effect/spawner/random/contraband/prison,
/obj/effect/spawner/random/contraband/prison,
/obj/machinery/light/directional/south,
/turf/open/floor/mineral/titanium/tiled/airless,
/area/awaymission/outbound_expedition/ruin/prison)
"E" = (
/turf/open/floor/mineral/titanium/tiled/airless,
/area/awaymission/outbound_expedition/ruin/prison)
"G" = (
/turf/closed/mineral/random/asteroid,
/area/awaymission/outbound_expedition/ruin/prison)
"H" = (
/obj/structure/girder/reinforced,
/turf/template_noop,
/area/template_noop)
"I" = (
/obj/machinery/door/airlock/security/old,
/obj/effect/mapping_helpers/airlock/cutaiwire,
/obj/effect/mapping_helpers/airlock/access/all/security,
/turf/open/floor/mineral/titanium/tiled/airless,
/area/awaymission/outbound_expedition/ruin/prison)
"J" = (
/mob/living/basic/cockroach,
/turf/open/floor/iron/sepia,
/area/awaymission/outbound_expedition/ruin/prison)
"L" = (
/mob/living/simple_animal/hostile/asteroid/hivelord,
/turf/open/floor/plating/airless,
/area/awaymission/outbound_expedition/ruin/prison)
"M" = (
/turf/open/floor/iron/sepia,
/area/awaymission/outbound_expedition/ruin/prison)
"N" = (
/obj/machinery/light/broken/directional/south,
/turf/open/misc/asteroid/airless,
/area/awaymission/outbound_expedition/ruin/prison)
"O" = (
/obj/machinery/light/broken/directional/north,
/turf/open/floor/plating/airless,
/area/awaymission/outbound_expedition/ruin/prison)
"P" = (
/obj/structure/bed{
	dir = 4
	},
/obj/item/bedsheet/orange{
	dir = 4
	},
/obj/effect/mob_spawn/corpse/human/prisoner,
/obj/effect/decal/cleanable/blood,
/turf/open/floor/iron/sepia,
/area/awaymission/outbound_expedition/ruin/prison)
"R" = (
/obj/structure/filingcabinet,
/turf/open/floor/plating/airless,
/area/awaymission/outbound_expedition/ruin/prison)
"S" = (
/obj/structure/chair/office{
	dir = 4
	},
/turf/open/misc/asteroid/airless,
/area/awaymission/outbound_expedition/ruin/prison)
"T" = (
/obj/structure/toilet{
	dir = 4
	},
/obj/machinery/light/directional/west,
/turf/open/floor/iron/sepia,
/area/awaymission/outbound_expedition/ruin/prison)
"U" = (
/mob/living/simple_animal/hostile/asteroid/basilisk{
	environment_smash = 0
	},
/turf/open/misc/asteroid/airless,
/area/awaymission/outbound_expedition/ruin/prison)
"V" = (
/obj/machinery/door/airlock/security/old,
/obj/effect/mapping_helpers/airlock/cutaiwire,
/obj/effect/mapping_helpers/airlock/access/all/security/hos,
/turf/open/floor/plating/airless,
/area/awaymission/outbound_expedition/ruin/prison)
"X" = (
/obj/structure/bed{
	dir = 4
	},
/obj/item/bedsheet/orange{
	dir = 4
	},
/turf/open/floor/iron/sepia,
/area/awaymission/outbound_expedition/ruin/prison)
"Y" = (
/turf/closed/indestructible/opshuttle,
/area/awaymission/outbound_expedition/ruin/prison)
"Z" = (
/obj/structure/bed,
/obj/item/bedsheet/orange,
/obj/effect/spawner/random/contraband/narcotics,
/turf/open/floor/iron/sepia,
/area/awaymission/outbound_expedition/ruin/prison)

(1,1,1) = {"
a
a
a
a
a
a
a
a
a
a
a
a
a
a
a
a
a
a
a
a
a
a
a
a
a
"}
(2,1,1) = {"
a
a
a
a
a
a
a
a
a
a
a
a
a
a
a
a
a
a
a
a
a
a
a
a
a
"}
(3,1,1) = {"
a
a
a
a
a
a
a
a
a
a
a
a
a
a
a
a
a
a
a
a
a
a
a
a
a
"}
(4,1,1) = {"
a
a
a
a
a
a
a
a
a
a
a
a
a
a
a
a
a
a
a
a
a
a
a
a
a
"}
(5,1,1) = {"
a
a
a
a
a
a
a
a
a
a
a
a
a
a
a
a
a
a
a
a
a
a
a
a
a
"}
(6,1,1) = {"
a
a
a
a
a
a
a
a
a
a
a
a
a
a
a
a
a
a
a
a
a
a
a
a
a
"}
(7,1,1) = {"
a
a
a
a
a
a
a
a
a
a
a
a
a
a
a
a
a
a
a
a
a
a
a
a
a
"}
(8,1,1) = {"
a
a
a
a
a
a
a
a
a
a
a
a
a
a
a
a
a
a
a
a
a
a
a
a
a
"}
(9,1,1) = {"
a
a
a
a
a
a
a
a
a
a
Y
Y
Y
Y
Y
x
a
a
c
i
a
a
a
a
a
"}
(10,1,1) = {"
a
a
a
a
H
m
a
y
Y
Y
Y
A
E
D
Y
Y
Y
Y
c
i
a
a
a
a
a
"}
(11,1,1) = {"
a
a
a
a
m
G
y
w
e
R
Y
L
E
d
Y
P
T
X
c
i
a
a
a
a
a
"}
(12,1,1) = {"
a
a
a
m
G
G
r
m
t
g
V
E
E
E
I
M
M
J
s
a
a
a
a
a
a
"}
(13,1,1) = {"
a
a
a
m
G
G
r
f
S
N
Y
Y
I
Y
Y
J
q
M
s
a
a
a
a
a
a
"}
(14,1,1) = {"
a
a
a
m
G
G
G
G
G
m
p
E
z
E
Y
Z
h
b
c
i
a
a
a
a
a
"}
(15,1,1) = {"
a
a
a
m
G
G
G
G
y
y
Y
O
E
j
Y
Y
Y
Y
c
i
a
a
a
a
a
"}
(16,1,1) = {"
a
a
a
m
G
G
G
G
m
a
Y
Y
B
Y
Y
u
a
a
c
i
a
a
a
a
a
"}
(17,1,1) = {"
a
a
a
a
m
G
G
U
m
m
a
a
a
a
a
a
a
a
a
a
a
a
a
a
a
"}
(18,1,1) = {"
a
a
a
a
a
m
m
m
m
a
a
a
a
a
a
a
a
a
a
a
a
a
a
a
a
"}
(19,1,1) = {"
a
a
a
a
a
a
a
m
a
a
a
a
a
a
a
a
a
a
a
a
a
a
a
a
a
"}
(20,1,1) = {"
a
a
a
a
a
a
a
a
a
a
a
a
a
a
a
a
a
a
a
a
a
a
a
a
a
"}
(21,1,1) = {"
a
a
a
a
a
a
a
a
a
a
a
a
a
a
a
a
a
a
a
a
a
a
a
a
a
"}
(22,1,1) = {"
a
a
a
a
a
a
a
a
a
a
a
a
a
a
a
a
a
a
a
a
a
a
a
a
a
"}
(23,1,1) = {"
a
a
a
a
a
a
a
a
a
a
a
a
a
a
a
a
a
a
a
a
a
a
a
a
a
"}
(24,1,1) = {"
a
a
a
a
a
a
a
a
a
a
a
a
a
a
a
a
a
a
a
a
a
a
a
a
a
"}
(25,1,1) = {"
a
a
a
a
a
a
a
a
a
a
a
a
a
a
a
a
a
a
a
a
a
a
a
a
a
"}
