"a" = (/turf/open/space/basic,/area/space)
"r" = (/turf/open/floor/plating,/area/awaymission/outbound_expedition/ruin/raider)
"N" = (/obj/item/gun/ballistic/rifle/boltaction/brand_new,/turf/open/floor/plating,/area/awaymission/outbound_expedition/ruin/raider)
"P" = (/obj/effect/landmark/outbound/raider_spawn,/turf/open/floor/plating,/area/awaymission/outbound_expedition/ruin/raider)

(1,1,1) = {"
aaaaaaaaaa
aaaaaaaaaa
aarrrrraaa
aarrPrraaa
aarPrPraaa
aarNNNraaa
aaaaaaaaaa
aaaaaaaaaa
aaaaaaaaaa
aaaaaaaaaa
"}
