//MAP CONVERTED BY dmm2tgm.py THIS HEADER COMMENT PREVENTS RECONVERSION, DO NOT REMOVE
"a" = (
/obj/structure/lattice,
/turf/template_noop,
/area/template_noop)
"c" = (
/obj/machinery/computer{
	desc = "A display that was once used to chart paths for a small but reliable shuttle. Turns out it's kind of hard for bandits to maintain their stuff.";
	dir = 8;
	name = "broken navigation computer"
	},
/obj/effect/decal/cleanable/dirt,
/turf/open/floor/iron,
/area/awaymission/outbound_expedition/ruin/raider)
"d" = (
/obj/machinery/power/shuttle_engine/propulsion/burst/right{
	dir = 8
	},
/obj/effect/decal/cleanable/dirt,
/turf/open/floor/plating/airless,
/area/awaymission/outbound_expedition/ruin/raider)
"g" = (
/obj/effect/spawner/structure/window/reinforced,
/obj/machinery/door/poddoor/shutters{
	dir = 8;
	id = "banditwindowbridge"
	},
/turf/open/floor/plating,
/area/awaymission/outbound_expedition/ruin/raider)
"h" = (
/obj/item/ammo_casing/a762{
	pixel_x = 8
	},
/obj/effect/decal/cleanable/dirt,
/obj/effect/decal/cleanable/robot_debris/old,
/turf/open/floor/iron,
/area/awaymission/outbound_expedition/ruin/raider)
"i" = (
/turf/closed/wall/rust,
/area/awaymission/outbound_expedition/ruin/raider)
"l" = (
/obj/structure/fans/tiny/forcefield,
/obj/machinery/door/poddoor{
	id = "raiderairlocknorth"
	},
/obj/machinery/button/door/directional/east{
	id = "raiderairlocknorth";
	name = "external door control"
	},
/obj/effect/decal/cleanable/cobweb,
/turf/open/floor/plating,
/area/awaymission/outbound_expedition/ruin/raider)
"o" = (
/obj/machinery/cryopod{
	dir = 1
	},
/obj/effect/landmark/outbound/raider_spawn,
/turf/open/floor/iron,
/area/awaymission/outbound_expedition/ruin/raider)
"r" = (
/obj/machinery/power/shuttle_engine/propulsion/burst{
	dir = 8
	},
/obj/effect/decal/cleanable/dirt,
/obj/effect/decal/cleanable/dirt,
/turf/open/floor/plating/airless,
/area/awaymission/outbound_expedition/ruin/raider)
"s" = (
/obj/item/trash/boritos,
/obj/item/ammo_casing/a556/ap{
	dir = 5;
	pixel_x = -4;
	pixel_y = 8
	},
/obj/effect/decal/cleanable/ants,
/turf/open/floor/iron,
/area/awaymission/outbound_expedition/ruin/raider)
"t" = (
/turf/closed/wall,
/area/awaymission/outbound_expedition/ruin/raider)
"v" = (
/obj/structure/cannon/trash{
	anchorable_cannon = 1;
	can_be_unanchored = 1;
	desc = "You suddenly wonder just how much you had to drink last night.";
	dir = 4;
	fires_before_deconstruction = INFINITY;
	max_integrity = INFINITY;
	name = "the prototype"
	},
/obj/item/wrench/combat{
	desc = "It's like a normal wrench but edgier. 'FOR ANCHORING DOWN THE CANNON' is etched onto the handle.";
	pixel_x = 4;
	pixel_y = 14
	},
/obj/effect/decal/cleanable/dirt,
/obj/effect/decal/cleanable/dirt,
/turf/open/floor/iron,
/area/awaymission/outbound_expedition/ruin/raider)
"w" = (
/obj/effect/spawner/structure/window/reinforced,
/obj/machinery/door/poddoor/shutters{
	dir = 1;
	id = "banditwindowbridge"
	},
/turf/open/floor/plating,
/area/awaymission/outbound_expedition/ruin/raider)
"x" = (
/obj/structure/fermenting_barrel/gunpowder{
	desc = "A large wooden barrel for holding gunpowder. Got a beaker?"
	},
/turf/open/floor/iron,
/area/awaymission/outbound_expedition/ruin/raider)
"y" = (
/obj/machinery/cryopod,
/obj/effect/decal/cleanable/dirt,
/obj/effect/landmark/outbound/raider_spawn,
/turf/open/floor/iron,
/area/awaymission/outbound_expedition/ruin/raider)
"E" = (
/obj/machinery/power/shuttle_engine/propulsion/burst/left{
	dir = 8
	},
/obj/effect/decal/cleanable/dirt,
/obj/effect/decal/cleanable/dirt,
/turf/open/floor/plating/airless,
/area/awaymission/outbound_expedition/ruin/raider)
"G" = (
/obj/effect/decal/cleanable/dirt,
/obj/effect/decal/cleanable/dirt,
/obj/effect/decal/cleanable/shreds,
/turf/open/floor/iron,
/area/awaymission/outbound_expedition/ruin/raider)
"H" = (
/obj/structure/table/reinforced,
/obj/item/trash/can{
	pixel_x = 8;
	pixel_y = 4
	},
/obj/item/trash/cheesie{
	pixel_x = -3;
	pixel_y = 4
	},
/obj/effect/decal/cleanable/dirt,
/turf/open/floor/iron,
/area/awaymission/outbound_expedition/ruin/raider)
"I" = (
/obj/item/ammo_casing/b460{
	dir = 5;
	pixel_x = -2;
	pixel_y = -10
	},
/obj/effect/decal/cleanable/dirt,
/turf/open/floor/iron,
/area/awaymission/outbound_expedition/ruin/raider)
"J" = (
/obj/item/trash/cnds{
	pixel_x = -6;
	pixel_y = -2
	},
/obj/effect/decal/cleanable/oil/slippery,
/turf/open/floor/iron,
/area/awaymission/outbound_expedition/ruin/raider)
"K" = (
/obj/structure/chair/comfy/shuttle{
	dir = 4
	},
/obj/machinery/light/directional/north,
/obj/effect/decal/cleanable/dirt,
/turf/open/floor/iron,
/area/awaymission/outbound_expedition/ruin/raider)
"L" = (
/obj/structure/fans/tiny/forcefield{
	dir = 1
	},
/obj/machinery/door/poddoor{
	id = "raiderairlocksouth"
	},
/obj/machinery/button/door/directional/east{
	id = "raiderairlocksouth";
	name = "external door control"
	},
/obj/effect/decal/cleanable/cobweb/cobweb2,
/turf/open/floor/plating,
/area/awaymission/outbound_expedition/ruin/raider)
"N" = (
/obj/effect/decal/cleanable/dirt,
/obj/effect/decal/cleanable/dirt,
/obj/effect/decal/cleanable/robot_debris/down,
/turf/open/floor/iron,
/area/awaymission/outbound_expedition/ruin/raider)
"O" = (
/obj/structure/chair/comfy/shuttle{
	dir = 4
	},
/obj/machinery/light/directional/south,
/obj/effect/decal/cleanable/dirt,
/obj/effect/decal/cleanable/vomit/old,
/turf/open/floor/iron,
/area/awaymission/outbound_expedition/ruin/raider)
"Q" = (
/obj/structure/closet/toolcloset,
/obj/item/stack/cannonball/trashball/four,
/obj/item/stack/cannonball/trashball/four,
/obj/item/stack/cannonball/trashball/four,
/obj/machinery/light/directional/north,
/obj/effect/decal/cleanable/dirt,
/obj/effect/decal/cleanable/robot_debris/up,
/obj/item/reagent_containers/cup/beaker/large,
/obj/item/reagent_containers/cup/beaker/large,
/obj/item/ammo_casing/caseless/rocket/weak,
/turf/open/floor/iron,
/area/awaymission/outbound_expedition/ruin/raider)
"R" = (
/obj/item/ammo_casing/a762{
	pixel_x = 3;
	pixel_y = 7
	},
/obj/effect/decal/cleanable/oil/streak,
/obj/effect/decal/cleanable/dirt,
/turf/open/floor/iron,
/area/awaymission/outbound_expedition/ruin/raider)
"S" = (
/obj/structure/window/reinforced/plasma/spawner/directional/east,
/obj/machinery/power/shuttle_engine/heater{
	dir = 8
	},
/obj/effect/decal/cleanable/dirt,
/turf/open/floor/plating/airless,
/area/awaymission/outbound_expedition/ruin/raider)
"V" = (
/obj/machinery/button/door/directional/east{
	id = "banditwindowbridge";
	name = "window shutter control"
	},
/obj/item/ammo_casing/a762{
	pixel_x = -13;
	pixel_y = 10
	},
/obj/item/ammo_casing/a762{
	pixel_x = 8;
	pixel_y = -4
	},
/obj/effect/decal/cleanable/dirt,
/obj/effect/decal/cleanable/dirt,
/turf/open/floor/iron,
/area/awaymission/outbound_expedition/ruin/raider)
"W" = (
/obj/structure/closet,
/obj/item/kinetic_crusher,
/obj/item/clothing/head/utility/bomb_hood/security,
/obj/item/food/chips/shrimp,
/obj/item/food/cornchips/purple,
/obj/item/trash/raisins,
/obj/machinery/light/directional/south,
/obj/item/trash/tray,
/obj/effect/decal/cleanable/dirt,
/obj/item/bikehorn/airhorn,
/turf/open/floor/iron,
/area/awaymission/outbound_expedition/ruin/raider)
"Y" = (
/obj/effect/spawner/structure/window/reinforced,
/obj/machinery/door/poddoor/shutters{
	id = "banditwindowbridge"
	},
/turf/open/floor/plating,
/area/awaymission/outbound_expedition/ruin/raider)
"Z" = (
/obj/machinery/computer{
	desc = "A long-since fried computer that used to be for piloting a shuttle. Looks like your warranty's overdue too.";
	dir = 8;
	name = "broken flight computer"
	},
/obj/item/food/taco{
	desc = "A taco so old that it has literally fossilized, with part of it now turned into crude oil from the heat pressure of a shuttle's glovebox.";
	layer = 2;
	name = "glovebox taco"
	},
/turf/open/floor/iron,
/area/awaymission/outbound_expedition/ruin/raider)

(1,1,1) = {"
a
E
r
d
a
"}
(2,1,1) = {"
i
S
S
S
t
"}
(3,1,1) = {"
i
x
R
v
i
"}
(4,1,1) = {"
t
Q
N
W
i
"}
(5,1,1) = {"
i
y
s
o
t
"}
(6,1,1) = {"
l
J
I
h
L
"}
(7,1,1) = {"
t
y
G
o
i
"}
(8,1,1) = {"
i
K
V
O
t
"}
(9,1,1) = {"
Y
Z
H
c
w
"}
(10,1,1) = {"
Y
g
g
g
w
"}
