//MAP CONVERTED BY dmm2tgm.py THIS HEADER COMMENT PREVENTS RECONVERSION, DO NOT REMOVE
"a" = (
/turf/template_noop,
/area/template_noop)
"r" = (
/turf/open/floor/plating,
/area/awaymission/outbound_expedition/ruin/raider)
"N" = (
/obj/item/gun/ballistic/rifle/boltaction/brand_new,
/turf/open/floor/plating,
/area/awaymission/outbound_expedition/ruin/raider)
"P" = (
/obj/effect/landmark/outbound/raider_spawn,
/turf/open/floor/plating,
/area/awaymission/outbound_expedition/ruin/raider)

(1,1,1) = {"
a
a
a
a
a
a
a
a
a
a
"}
(2,1,1) = {"
a
a
a
a
a
a
a
a
a
a
"}
(3,1,1) = {"
a
a
r
r
r
r
a
a
a
a
"}
(4,1,1) = {"
a
a
r
r
P
N
a
a
a
a
"}
(5,1,1) = {"
a
a
r
P
r
N
a
a
a
a
"}
(6,1,1) = {"
a
a
r
r
P
N
a
a
a
a
"}
(7,1,1) = {"
a
a
r
r
r
r
a
a
a
a
"}
(8,1,1) = {"
a
a
a
a
a
a
a
a
a
a
"}
(9,1,1) = {"
a
a
a
a
a
a
a
a
a
a
"}
(10,1,1) = {"
a
a
a
a
a
a
a
a
a
a
"}
