"a" = (/turf/open/space/basic,/area/space)
"o" = (/obj/effect/landmark/outbound/scrapper_evac_point,/turf/open/floor/plating/rust/lowpressure,/area/awaymission/outbound_expedition/ruin/scrapper)
"K" = (/obj/machinery/porta_turret/syndicate/scrapper_drone,/turf/open/floor/plating/rust/lowpressure,/area/awaymission/outbound_expedition/ruin/scrapper)
"W" = (/turf/open/floor/plating/rust/lowpressure,/area/awaymission/outbound_expedition/ruin/scrapper)

(1,1,1) = {"
aaaaaaaaaaaaaaaaaaaaaaaaa
aaaaaaaaaaaaaaaaaaaaaaaaa
aaaaaaaaaaaaaaaaaaaaaaaaa
aaaaaaaaaaaaaaaaaaaaaaaaa
aaaaaaaaaaaaaaaaaaaaaaaaa
aaaaaaaaaaaaaaaaaaaaaaaaa
aaaaaaaaaWaaaaaaaaaaaaaaa
aaaaaaaaaWWaaKaaaaaaaaaaa
aaaaaaaaaWWWWWaWWaaaaaaaa
aaaaaaaaaWWWWWWWaaaaaaaaa
aaaaaaaaKWWWoWWaaaaaaaaaa
aaaaaaaaaWWWWWWWaaaaaaaaa
aaaaaaaaaWWaWaaaaaaaaaaaa
aaaaaaaaWWaaWKaaaaaaaaaaa
aaaaaaaaaaaaaaaaaaaaaaaaa
aaaaaaaaaaaaaaaaaaaaaaaaa
aaaaaaaaaaaaaaaaaaaaaaaaa
aaaaaaaaaaaaaaaaaaaaaaaaa
aaaaaaaaaaaaaaaaaaaaaaaaa
aaaaaaaaaaaaaaaaaaaaaaaaa
aaaaaaaaaaaaaaaaaaaaaaaaa
aaaaaaaaaaaaaaaaaaaaaaaaa
aaaaaaaaaaaaaaaaaaaaaaaaa
aaaaaaaaaaaaaaaaaaaaaaaaa
aaaaaaaaaaaaaaaaaaaaaaaaa
"}
