//MAP CONVERTED BY dmm2tgm.py THIS HEADER COMMENT PREVENTS RECONVERSION, DO NOT REMOVE
"aG" = (
/obj/effect/gibspawner/generic,
/obj/machinery/light{
	dir = 1
	},
/turf/open/floor/plating/airless,
/area/awaymission/outbound_expedition/ruin/sg_reviver)
"aZ" = (
/obj/structure/light_puzzle{
	pixel_y = 32;
	puzzle_id = "solgov2"
	},
/obj/structure/light_puzzle{
	pixel_x = 32;
	puzzle_id = "solgov3"
	},
/turf/open/floor/iron,
/area/awaymission/outbound_expedition/ruin/sg_reviver)
"bn" = (
/obj/structure/window/reinforced/plasma{
	dir = 1
	},
/turf/template_noop,
/area/template_noop)
"br" = (
/obj/structure/window/reinforced/plasma{
	dir = 1
	},
/obj/structure/window/reinforced/plasma{
	dir = 8
	},
/turf/open/floor/iron,
/area/awaymission/outbound_expedition/ruin/sg_reviver)
"bJ" = (
/obj/effect/mob_spawn/corpse/human/scientist,
/obj/effect/gibspawner/generic,
/obj/machinery/light,
/turf/open/floor/iron,
/area/awaymission/outbound_expedition/ruin/sg_reviver)
"bX" = (
/obj/structure/window/reinforced/plasma{
	dir = 4
	},
/obj/structure/window/reinforced/plasma{
	dir = 8
	},
/mob/living/simple_animal/hostile/looter/crusher,
/turf/open/floor/iron,
/area/awaymission/outbound_expedition/ruin/sg_reviver)
"cl" = (
/obj/structure/decorative/shelf/alcohol,
/obj/effect/gibspawner/generic,
/turf/open/floor/iron,
/area/awaymission/outbound_expedition/ruin/sg_reviver)
"dB" = (
/obj/structure/window/reinforced/plasma{
	dir = 1
	},
/obj/structure/window/reinforced/plasma{
	dir = 4
	},
/turf/open/floor/iron,
/area/awaymission/outbound_expedition/ruin/sg_reviver)
"dQ" = (
/mob/living/simple_animal/hostile/retaliate/clown/clownhulk/chlown,
/turf/open/floor/iron,
/area/awaymission/outbound_expedition/ruin/sg_reviver)
"gN" = (
/obj/structure/window/reinforced/plasma{
	dir = 1
	},
/obj/structure/lattice,
/turf/template_noop,
/area/template_noop)
"hy" = (
/obj/machinery/portable_atmospherics/scrubber,
/turf/open/floor/iron,
/area/awaymission/outbound_expedition/ruin/sg_reviver)
"hZ" = (
/obj/structure/lattice,
/mob/living/simple_animal/hostile/looter/ranged/space,
/turf/template_noop,
/area/awaymission/outbound_expedition/ruin/sg_reviver)
"is" = (
/obj/machinery/door/airlock/vault{
	name = "Heavy Security Door"
	},
/obj/effect/mapping_helpers/airlock/locked,
/turf/open/floor/iron,
/area/awaymission/outbound_expedition/ruin/sg_reviver)
"jB" = (
/turf/closed/indestructible/fakeglass,
/area/awaymission/outbound_expedition/ruin/sg_reviver)
"kT" = (
/obj/structure/table/reinforced,
/obj/item/reviver,
/turf/open/floor/iron,
/area/awaymission/outbound_expedition/ruin/sg_reviver)
"lf" = (
/obj/structure/window/reinforced/plasma{
	dir = 4
	},
/turf/template_noop,
/area/template_noop)
"ll" = (
/obj/structure/rack/gunrack,
/turf/open/floor/iron,
/area/awaymission/outbound_expedition/ruin/sg_reviver)
"lL" = (
/obj/structure/lattice,
/obj/structure/girder/reinforced,
/turf/template_noop,
/area/template_noop)
"lP" = (
/obj/machinery/light,
/turf/open/floor/iron,
/area/awaymission/outbound_expedition/ruin/sg_reviver)
"nm" = (
/obj/structure/decorative/shelf/soda_multipacks,
/turf/open/floor/iron,
/area/awaymission/outbound_expedition/ruin/sg_reviver)
"oH" = (
/obj/structure/table/wood,
/turf/open/floor/iron,
/area/awaymission/outbound_expedition/ruin/sg_reviver)
"pq" = (
/obj/structure/door_assembly/door_assembly_vault,
/turf/open/floor/plating/airless,
/area/awaymission/outbound_expedition/ruin/sg_reviver)
"pK" = (
/obj/machinery/portable_atmospherics/pump,
/turf/open/floor/iron,
/area/awaymission/outbound_expedition/ruin/sg_reviver)
"qf" = (
/obj/structure/lattice,
/mob/living/simple_animal/hostile/looter/ranged/space/laser,
/turf/template_noop,
/area/awaymission/outbound_expedition/ruin/sg_reviver)
"ri" = (
/obj/structure/decorative/shelf/alcohol_assortment,
/turf/open/floor/iron,
/area/awaymission/outbound_expedition/ruin/sg_reviver)
"rB" = (
/obj/structure/tank_dispenser,
/turf/open/floor/iron,
/area/awaymission/outbound_expedition/ruin/sg_reviver)
"rY" = (
/obj/item/shard/plasma,
/obj/structure/lattice,
/turf/template_noop,
/area/template_noop)
"sa" = (
/obj/structure/window/reinforced/plasma{
	dir = 4
	},
/obj/structure/lattice,
/turf/template_noop,
/area/template_noop)
"sr" = (
/obj/structure/decorative/shelf/crates1,
/turf/open/floor/iron,
/area/awaymission/outbound_expedition/ruin/sg_reviver)
"sQ" = (
/obj/effect/gibspawner/generic,
/obj/structure/showcase/horrific_experiment,
/turf/open/floor/iron,
/area/awaymission/outbound_expedition/ruin/sg_reviver)
"tD" = (
/obj/structure/window/reinforced/plasma{
	dir = 1
	},
/obj/structure/window/reinforced/plasma{
	dir = 4
	},
/obj/effect/gibspawner/generic,
/turf/open/floor/iron,
/area/awaymission/outbound_expedition/ruin/sg_reviver)
"va" = (
/obj/structure/window/reinforced/plasma{
	dir = 1
	},
/obj/structure/window/reinforced/plasma{
	dir = 8
	},
/obj/effect/gibspawner/generic,
/turf/open/floor/iron,
/area/awaymission/outbound_expedition/ruin/sg_reviver)
"vt" = (
/obj/structure/window/reinforced/plasma,
/obj/structure/window/reinforced/plasma{
	dir = 4
	},
/mob/living/simple_animal/hostile/looter,
/turf/open/floor/iron,
/area/awaymission/outbound_expedition/ruin/sg_reviver)
"wy" = (
/mob/living/simple_animal/hostile/retaliate/clown/mutant/glutton{
	desc = "You don't think praying is going to save you.";
	health = 1500;
	maxHealth = 1500;
	melee_damage_upper = 10;
	name = "glown";
	rapid_melee = 2;
	speed = 5
	},
/turf/open/floor/iron,
/area/awaymission/outbound_expedition/ruin/sg_reviver)
"xo" = (
/obj/structure/rack/shelf,
/obj/item/ammo_box/magazine/smgm9mm{
	pixel_x = 6
	},
/obj/item/ammo_box/magazine/smgm9mm{
	pixel_x = 3
	},
/obj/item/ammo_box/magazine/smgm9mm,
/turf/open/floor/iron,
/area/awaymission/outbound_expedition/ruin/sg_reviver)
"xQ" = (
/obj/structure/table/reinforced,
/obj/machinery/button/door{
	id = "solgovshutters";
	name = "hermetic seal control";
	pixel_y = 1
	},
/turf/open/floor/iron,
/area/awaymission/outbound_expedition/ruin/sg_reviver)
"xV" = (
/obj/machinery/door/poddoor/shutters/indestructible{
	id = "solgovshutters"
	},
/turf/open/floor/iron,
/area/awaymission/outbound_expedition/ruin/sg_reviver)
"yA" = (
/obj/machinery/door/airlock/vault{
	name = "Heavy Security Door"
	},
/turf/open/floor/plating/airless,
/area/awaymission/outbound_expedition/ruin/sg_reviver)
"zl" = (
/obj/structure/window/reinforced/plasma{
	dir = 1
	},
/obj/structure/window/reinforced/plasma{
	dir = 4
	},
/turf/template_noop,
/area/template_noop)
"zs" = (
/mob/living/simple_animal/hostile/looter/big,
/turf/open/floor/iron,
/area/awaymission/outbound_expedition/ruin/sg_reviver)
"Au" = (
/obj/item/shard/plasma,
/turf/template_noop,
/area/template_noop)
"AP" = (
/obj/structure/decorative/shelf,
/turf/open/floor/iron,
/area/awaymission/outbound_expedition/ruin/sg_reviver)
"Bg" = (
/obj/machinery/door/puzzle/light{
	name = "Heavy Blast Door"
	puzzle_id = "solgov1"
	},
/obj/machinery/door/puzzle/light{
	name = "Heavy Blast Door"
	puzzle_id = "solgov2"
	},
/obj/machinery/door/puzzle/light{
	name = "Heavy Blast Door"
	puzzle_id = "solgov3"
	},
/obj/machinery/door/puzzle/light{
	name = "Heavy Blast Door"
	puzzle_id = "solgov4"
	},
/turf/open/floor/iron,
/area/awaymission/outbound_expedition/ruin/sg_reviver)
"BQ" = (
/obj/structure/window/reinforced/plasma,
/obj/structure/lattice,
/turf/template_noop,
/area/template_noop)
"BT" = (
/obj/machinery/door/airlock/vault{
	name = "Heavy Security Door"
	},
/turf/open/floor/iron,
/area/awaymission/outbound_expedition/ruin/sg_reviver)
"BY" = (
/turf/closed/indestructible/riveted,
/area/awaymission/outbound_expedition/ruin/sg_reviver)
"BZ" = (
/obj/structure/window/reinforced/plasma{
	dir = 1
	},
/obj/structure/window/reinforced/plasma{
	dir = 8
	},
/turf/template_noop,
/area/template_noop)
"Cu" = (
/obj/structure/window/reinforced/plasma,
/obj/structure/window/reinforced/plasma{
	dir = 8
	},
/turf/open/floor/iron,
/area/awaymission/outbound_expedition/ruin/sg_reviver)
"CK" = (
/obj/structure/decorative/shelf/milk_big,
/turf/open/floor/iron,
/area/awaymission/outbound_expedition/ruin/sg_reviver)
"CZ" = (
/mob/living/simple_animal/hostile/looter/ranged/space,
/obj/machinery/light,
/turf/open/floor/plating/airless,
/area/awaymission/outbound_expedition/ruin/sg_reviver)
"Dl" = (
/obj/structure/lattice,
/turf/template_noop,
/area/template_noop)
"Dp" = (
/obj/effect/gibspawner/generic,
/obj/structure/showcase/machinery/cloning_pod,
/turf/open/floor/iron,
/area/awaymission/outbound_expedition/ruin/sg_reviver)
"DE" = (
/obj/structure/table/reinforced,
/turf/open/floor/iron,
/area/awaymission/outbound_expedition/ruin/sg_reviver)
"Fc" = (
/obj/structure/showcase/horrific_experiment,
/turf/open/floor/iron,
/area/awaymission/outbound_expedition/ruin/sg_reviver)
"Fv" = (
/obj/effect/gibspawner/generic,
/obj/machinery/light{
	dir = 1
	},
/turf/open/floor/iron,
/area/awaymission/outbound_expedition/ruin/sg_reviver)
"FM" = (
/obj/structure/window/reinforced/plasma{
	dir = 1
	},
/obj/structure/window/reinforced/plasma{
	dir = 4
	},
/obj/effect/mob_spawn/corpse/human/scientist,
/obj/effect/gibspawner/generic,
/turf/open/floor/iron,
/area/awaymission/outbound_expedition/ruin/sg_reviver)
"FS" = (
/obj/machinery/light{
	dir = 1
	},
/turf/open/floor/iron,
/area/awaymission/outbound_expedition/ruin/sg_reviver)
"Ia" = (
/obj/machinery/light{
	dir = 8
	},
/turf/open/floor/iron,
/area/awaymission/outbound_expedition/ruin/sg_reviver)
"Id" = (
/obj/machinery/door/puzzle/light{
	name = "Heavy Blast Door"
	puzzle_id = "solgov5"
	},
/obj/machinery/door/puzzle/light{
	name = "Heavy Blast Door"
	puzzle_id = "solgov6"
	},
/obj/machinery/door/puzzle/light{
	name = "Heavy Blast Door"
	puzzle_id = "solgov7"
	},
/obj/machinery/door/puzzle/light{
	name = "Heavy Blast Door"
	puzzle_id = "solgov8"
	},
/turf/open/floor/iron,
/area/awaymission/outbound_expedition/ruin/sg_reviver)
"Ij" = (
/obj/structure/rack/gunrack,
/obj/item/gun/ballistic/automatic/proto/unrestricted{
	desc = "A prototype three-round burst 9mm submachine gun, designated 'MP-99'. Has a threaded barrel for suppressors.";
	name = "\improper SolGov MP99";
	pixel_x = 3;
	pixel_y = 3
	},
/obj/item/gun/ballistic/automatic/proto/unrestricted{
	desc = "A prototype three-round burst 9mm submachine gun, designated 'MP-99'. Has a threaded barrel for suppressors.";
	name = "\improper SolGov MP99";
	pixel_x = 3;
	pixel_y = -4
	},
/turf/open/floor/iron,
/area/awaymission/outbound_expedition/ruin/sg_reviver)
"Iz" = (
/obj/effect/mob_spawn/corpse/human/scientist,
/obj/effect/gibspawner/generic,
/turf/open/floor/iron,
/area/awaymission/outbound_expedition/ruin/sg_reviver)
"JA" = (
/mob/living/simple_animal/hostile/looter/ranged,
/turf/open/floor/iron,
/area/awaymission/outbound_expedition/ruin/sg_reviver)
"JH" = (
/obj/structure/window/reinforced/plasma{
	dir = 4
	},
/obj/structure/window/reinforced/plasma{
	dir = 8
	},
/turf/open/floor/iron,
/area/awaymission/outbound_expedition/ruin/sg_reviver)
"Ke" = (
/obj/effect/mob_spawn/corpse/human/scientist,
/obj/effect/gibspawner/generic,
/obj/machinery/light{
	dir = 4
	},
/turf/open/floor/iron,
/area/awaymission/outbound_expedition/ruin/sg_reviver)
"Kw" = (
/obj/structure/window/reinforced/plasma,
/obj/structure/window/reinforced/plasma{
	dir = 1
	},
/obj/effect/gibspawner/generic,
/turf/open/floor/iron,
/area/awaymission/outbound_expedition/ruin/sg_reviver)
"KF" = (
/obj/structure/decorative/shelf/crates,
/obj/machinery/light{
	dir = 8
	},
/turf/open/floor/iron,
/area/awaymission/outbound_expedition/ruin/sg_reviver)
"KH" = (
/obj/structure/light_puzzle{
	pixel_x = 32;
	puzzle_id = "solgov4"
	},
/obj/structure/light_puzzle{
	pixel_y = -32;
	puzzle_id = "solgov5"
	},
/turf/open/floor/iron,
/area/awaymission/outbound_expedition/ruin/sg_reviver)
"LD" = (
/obj/structure/window/reinforced/plasma,
/obj/structure/window/reinforced/plasma{
	dir = 8
	},
/turf/template_noop,
/area/template_noop)
"LL" = (
/obj/structure/window/reinforced/plasma{
	dir = 8
	},
/obj/structure/lattice,
/turf/template_noop,
/area/template_noop)
"MA" = (
/obj/structure/window/reinforced/plasma{
	dir = 8
	},
/turf/template_noop,
/area/template_noop)
"Np" = (
/mob/living/simple_animal/hostile/looter/big,
/obj/machinery/light{
	dir = 8
	},
/turf/open/floor/iron,
/area/awaymission/outbound_expedition/ruin/sg_reviver)
"NO" = (
/mob/living/simple_animal/hostile/looter/ranged/space/laser,
/turf/open/floor/iron,
/area/awaymission/outbound_expedition/ruin/sg_reviver)
"NZ" = (
/obj/structure/window/reinforced/plasma,
/obj/structure/window/reinforced/plasma{
	dir = 4
	},
/turf/template_noop,
/area/template_noop)
"OE" = (
/turf/closed/wall/r_wall,
/area/awaymission/outbound_expedition/ruin/sg_reviver)
"Ph" = (
/turf/open/floor/plating/airless,
/area/awaymission/outbound_expedition/ruin/sg_reviver)
"PQ" = (
/obj/structure/decorative/shelf/soda_milk,
/turf/open/floor/iron,
/area/awaymission/outbound_expedition/ruin/sg_reviver)
"Qh" = (
/obj/structure/decorative/shelf/milkjugs,
/obj/machinery/light{
	dir = 8
	},
/turf/open/floor/iron,
/area/awaymission/outbound_expedition/ruin/sg_reviver)
"QE" = (
/obj/structure/window/reinforced/plasma,
/obj/structure/window/reinforced/plasma{
	dir = 1
	},
/turf/open/floor/iron,
/area/awaymission/outbound_expedition/ruin/sg_reviver)
"QO" = (
/obj/structure/light_puzzle{
	pixel_y = -32;
	puzzle_id = "solgov6"
	},
/obj/structure/light_puzzle{
	pixel_x = -32;
	puzzle_id = "solgov7"
	},
/turf/open/floor/iron,
/area/awaymission/outbound_expedition/ruin/sg_reviver)
"RD" = (
/obj/structure/chair/wood{
	dir = 8
	},
/obj/effect/mob_spawn/corpse/human/scientist,
/obj/effect/gibspawner/generic,
/obj/machinery/light,
/turf/open/floor/iron,
/area/awaymission/outbound_expedition/ruin/sg_reviver)
"SQ" = (
/obj/structure/lattice,
/turf/template_noop,
/area/awaymission/outbound_expedition/ruin/sg_reviver)
"SR" = (
/turf/template_noop,
/area/template_noop)
"Tc" = (
/turf/open/floor/iron,
/area/awaymission/outbound_expedition/ruin/sg_reviver)
"TJ" = (
/obj/machinery/light{
	dir = 4
	},
/turf/open/floor/iron,
/area/awaymission/outbound_expedition/ruin/sg_reviver)
"Ug" = (
/obj/machinery/door/airlock/grunge,
/obj/effect/mapping_helpers/airlock/locked,
/turf/open/floor/iron,
/area/awaymission/outbound_expedition/ruin/sg_reviver)
"Uj" = (
/obj/effect/gibspawner/generic,
/obj/machinery/light,
/turf/open/floor/iron,
/area/awaymission/outbound_expedition/ruin/sg_reviver)
"Um" = (
/obj/structure/window/reinforced/plasma,
/obj/structure/window/reinforced/plasma{
	dir = 4
	},
/turf/open/floor/iron,
/area/awaymission/outbound_expedition/ruin/sg_reviver)
"Vw" = (
/obj/structure/light_puzzle{
	pixel_y = 32;
	puzzle_id = "solgov1"
	},
/obj/structure/light_puzzle{
	pixel_x = -32;
	puzzle_id = "solgov8"
	},
/turf/open/floor/iron,
/area/awaymission/outbound_expedition/ruin/sg_reviver)
"VH" = (
/obj/structure/window/reinforced/plasma,
/obj/structure/window/reinforced/plasma{
	dir = 1
	},
/turf/open/floor/plating/airless,
/area/awaymission/outbound_expedition/ruin/sg_reviver)
"VW" = (
/obj/machinery/door/airlock/grunge,
/turf/open/floor/iron,
/area/awaymission/outbound_expedition/ruin/sg_reviver)
"Wd" = (
/obj/effect/gibspawner/generic,
/obj/structure/rack/shelf,
/obj/item/ammo_box/magazine/smgm9mm/fire{
	pixel_x = 5
	},
/obj/item/ammo_box/magazine/smgm9mm/fire{
	pixel_x = 2
	},
/turf/open/floor/iron,
/area/awaymission/outbound_expedition/ruin/sg_reviver)
"Xk" = (
/obj/structure/rack,
/obj/item/suppressor{
	pixel_x = -1;
	pixel_y = 7
	},
/obj/item/suppressor{
	pixel_x = -1;
	pixel_y = 2
	},
/turf/open/floor/iron,
/area/awaymission/outbound_expedition/ruin/sg_reviver)
"Xo" = (
/obj/effect/gibspawner/generic,
/turf/open/floor/iron,
/area/awaymission/outbound_expedition/ruin/sg_reviver)
"YX" = (
/obj/structure/table/reinforced,
/obj/item/paper/crumpled{
	default_raw_text = "I've dialed SolGov blackops, hopefully they can take care of this mess and recover the prototype. If you're reading this and you're NOT blackops, get the prototype reviver serum out of the central chamber as carefully as you can - we don't have any other copies of it!"
	},
/turf/open/floor/iron,
/area/awaymission/outbound_expedition/ruin/sg_reviver)
"YZ" = (
/obj/structure/window/reinforced/plasma,
/turf/template_noop,
/area/template_noop)
"ZQ" = (
/obj/structure/showcase/machinery/cloning_pod,
/turf/open/floor/iron,
/area/awaymission/outbound_expedition/ruin/sg_reviver)

(1,1,1) = {"
SR
SR
SR
SR
Dl
Dl
Dl
Dl
Dl
BY
BY
BY
BY
BY
BY
BY
Dl
Dl
Dl
Dl
Dl
SR
SR
SR
SR
"}
(2,1,1) = {"
SR
SR
Dl
Dl
Dl
SR
lf
lf
lf
BY
Ij
ll
Xk
Wd
xo
BY
lf
lf
lf
SR
Dl
Dl
Dl
SR
SR
"}
(3,1,1) = {"
SR
Dl
Dl
SR
sa
NZ
br
JH
JH
BT
Tc
Tc
zs
Tc
Tc
BT
JH
JH
Cu
zl
sa
SR
Dl
Dl
SR
"}
(4,1,1) = {"
SR
Dl
SR
NZ
va
JH
vt
BZ
MA
BY
Iz
TJ
Tc
TJ
Tc
BY
MA
LD
FM
JH
Cu
zl
SR
Dl
SR
"}
(5,1,1) = {"
Dl
Dl
BQ
br
Um
BZ
LL
SR
SR
BY
BY
BY
VW
BY
BY
BY
SR
SR
LL
LD
dB
Cu
gN
Dl
Dl
"}
(6,1,1) = {"
Dl
SR
NZ
QE
BZ
SR
Dl
SR
SR
SR
BY
KF
Tc
Qh
BY
SR
SR
SR
Dl
SR
LD
QE
zl
SR
Dl
"}
(7,1,1) = {"
Dl
YZ
va
Um
gN
Dl
Dl
Dl
Dl
Dl
BY
sr
Tc
nm
BY
Dl
Dl
Dl
Dl
Dl
BQ
dB
Cu
bn
Dl
"}
(8,1,1) = {"
Dl
YZ
QE
BZ
SR
SR
Dl
SR
SR
SR
BY
jB
jB
jB
BY
SR
SR
SR
Dl
SR
SR
LD
Kw
bn
Dl
"}
(9,1,1) = {"
Dl
YZ
QE
bn
SR
SR
Dl
SR
BY
BY
BY
ZQ
Xo
ZQ
BY
BY
BY
SR
Dl
SR
SR
YZ
QE
bn
Dl
"}
(10,1,1) = {"
BY
BY
BT
BY
BY
SR
Dl
SR
BY
Vw
Ia
Tc
Tc
Tc
Ia
QO
BY
SR
Dl
SR
BY
BY
yA
BY
lL
"}
(11,1,1) = {"
BY
PQ
Tc
oH
BY
BY
BY
BY
BY
Fv
Fc
jB
Bg
jB
ZQ
Uj
BY
BY
BY
BY
BY
Tc
qf
SQ
SR
"}
(12,1,1) = {"
BY
AP
Tc
RD
BY
FS
Tc
xV
Tc
Tc
jB
OE
Id
OE
jB
Tc
Fc
jB
pK
CZ
BY
aG
Ph
SQ
SR
"}
(13,1,1) = {"
BY
ri
zs
Tc
VW
Tc
Tc
xV
Tc
wy
Bg
Id
kT
Id
Bg
Tc
Xo
jB
hy
Tc
Ph
Ph
SQ
SR
SR
"}
(14,1,1) = {"
BY
cl
Tc
lP
BY
FS
Iz
xV
Xo
Tc
jB
OE
Id
OE
jB
Tc
ZQ
jB
rB
bJ
BY
FS
Ph
SR
SR
"}
(15,1,1) = {"
BY
CK
Tc
JA
BY
BY
BY
BY
BY
FS
Dp
jB
Bg
jB
sQ
lP
BY
BY
BY
BY
BY
hZ
Ph
SQ
SQ
"}
(16,1,1) = {"
BY
BY
BT
BY
BY
SR
Dl
SR
BY
aZ
TJ
Tc
Xo
Tc
TJ
KH
BY
SR
Dl
SR
BY
BY
pq
BY
BY
"}
(17,1,1) = {"
Dl
YZ
QE
bn
SR
SR
Dl
SR
BY
BY
BY
Fc
Tc
ZQ
BY
BY
BY
SR
Dl
SR
SR
YZ
VH
bn
Dl
"}
(18,1,1) = {"
Dl
YZ
QE
zl
SR
SR
Dl
SR
SR
SR
BY
jB
jB
jB
BY
SR
SR
SR
Dl
Au
SR
NZ
QE
bn
Dl
"}
(19,1,1) = {"
Dl
YZ
dB
Cu
gN
Dl
Dl
Dl
Dl
Dl
BY
DE
xQ
YX
BY
Dl
Dl
Dl
Dl
Dl
BQ
br
Um
bn
Dl
"}
(20,1,1) = {"
Dl
SR
LD
QE
zl
SR
Dl
SR
SR
SR
BY
TJ
dQ
Ke
BY
SR
SR
SR
Dl
Au
SR
QE
BZ
SR
Dl
"}
(21,1,1) = {"
Dl
Dl
BQ
tD
Cu
zl
sa
SR
SR
BY
BY
BY
Ug
BY
BY
BY
SR
Au
Dl
SR
Dl
Ph
gN
Dl
Dl
"}
(22,1,1) = {"
SR
Dl
SR
LD
dB
JH
Cu
zl
lf
BY
Tc
Np
Tc
Ia
Xo
BY
lf
NZ
br
Ph
Dl
SR
SR
rY
SR
"}
(23,1,1) = {"
SR
Dl
Dl
SR
LL
LD
dB
bX
JH
BT
Tc
Tc
Tc
JA
Tc
is
JH
JH
Um
bn
Dl
Au
Dl
Dl
SR
"}
(24,1,1) = {"
SR
SR
Dl
Dl
Dl
SR
MA
MA
MA
BY
NO
Tc
Iz
Tc
Tc
BY
MA
MA
MA
SR
rY
Dl
Dl
SR
SR
"}
(25,1,1) = {"
SR
SR
SR
SR
Dl
Dl
Dl
Dl
Dl
BY
BY
BY
BY
BY
BY
BY
Dl
Dl
Dl
Dl
Dl
SR
SR
SR
SR
"}
