"a" = (/turf/open/space/basic,/area/space)
"c" = (/obj/structure/table/reinforced,/obj/item/plate{pixel_y = 5},/obj/item/trash/can/food/peaches/maint{pixel_x = 6},/obj/item/trash/can/food{pixel_x = -5; pixel_y = -5},/turf/open/floor/iron,/area/awaymission/outbound_expedition/ruin/survival)
"h" = (/obj/structure/rack/shelf,/obj/item/reagent_containers/food/drinks/waterbottle/large,/obj/item/reagent_containers/food/drinks/waterbottle/large{pixel_x = -5; pixel_y = 4},/obj/item/reagent_containers/food/drinks/waterbottle{pixel_x = 6},/turf/open/floor/iron,/area/awaymission/outbound_expedition/ruin/survival)
"j" = (/turf/closed/wall/mineral/plastitanium,/area/awaymission/outbound_expedition/ruin/survival)
"k" = (/obj/structure/rack/shelf,/obj/item/light/bulb{pixel_x = -7},/obj/item/light/bulb,/obj/item/light/bulb{pixel_x = 8},/turf/open/floor/iron,/area/awaymission/outbound_expedition/ruin/survival)
"m" = (/turf/closed/wall,/area/awaymission/outbound_expedition/ruin/survival)
"n" = (/turf/open/misc/asteroid/airless,/area/awaymission/outbound_expedition/ruin/survival)
"p" = (/mob/living/simple_animal/hostile/looter/ranged/space/laser,/obj/machinery/light/small/directional/north,/turf/open/floor/iron,/area/awaymission/outbound_expedition/ruin/survival)
"t" = (/turf/closed/mineral/random/asteroid,/area/awaymission/outbound_expedition/ruin/survival)
"v" = (/obj/structure/toilet,/turf/open/floor/iron,/area/awaymission/outbound_expedition/ruin/survival)
"x" = (/obj/machinery/modular_computer/console/preset/civilian{dir = 8},/turf/open/floor/iron,/area/awaymission/outbound_expedition/ruin/survival)
"C" = (/obj/structure/table/reinforced,/obj/item/radio/off,/turf/open/floor/iron,/area/awaymission/outbound_expedition/ruin/survival)
"F" = (/obj/machinery/light/small,/turf/open/floor/iron,/area/awaymission/outbound_expedition/ruin/survival)
"I" = (/obj/machinery/door/airlock/external/ruin,/turf/open/floor/plating,/area/awaymission/outbound_expedition/ruin/survival)
"J" = (/obj/structure/table/reinforced,/obj/item/gun/ballistic/shotgun/m23,/turf/open/floor/iron,/area/awaymission/outbound_expedition/ruin/survival)
"K" = (/obj/effect/mine/explosive,/turf/open/floor/plating,/area/awaymission/outbound_expedition/ruin/survival)
"O" = (/obj/structure/rack/shelf,/obj/machinery/light/small/directional/north,/obj/item/food/canned/peaches/maint{pixel_y = 8},/obj/item/food/canned/peaches/maint{pixel_x = -5; pixel_y = 4},/obj/item/food/canned/peaches/maint{pixel_x = 5; pixel_y = 2},/obj/item/food/canned/peaches/maint,/turf/open/floor/iron,/area/awaymission/outbound_expedition/ruin/survival)
"Q" = (/turf/open/floor/iron,/area/awaymission/outbound_expedition/ruin/survival)
"R" = (/obj/effect/spawner/random/structure/chair_comfy{dir = 4},/turf/open/floor/iron,/area/awaymission/outbound_expedition/ruin/survival)
"V" = (/obj/structure/table/reinforced,/obj/item/storage/box/ammo_box/shotgun_12g,/turf/open/floor/iron,/area/awaymission/outbound_expedition/ruin/survival)
"X" = (/obj/structure/rack/shelf,/obj/item/book/random,/obj/item/book/random,/obj/item/book/random,/obj/effect/spawner/random/exotic/languagebook,/turf/open/floor/iron,/area/awaymission/outbound_expedition/ruin/survival)
"Y" = (/obj/structure/rack/shelf,/obj/item/storage/medkit/ancient{pixel_x = -1; pixel_y = -4},/obj/item/storage/medkit{pixel_x = 3; pixel_y = 5},/turf/open/floor/iron,/area/awaymission/outbound_expedition/ruin/survival)

(1,1,1) = {"
aaaaaaaaaaaaaaaaaaaaaaaaa
aaaaaaaaaaaaaaaaaaaaaaaaa
aaaaaaaaaaaaaaaaaaaaaaaaa
aaaaaaaaannnnnnnnaaaaaaaa
aaaaannnnntttnntnnaaaaaaa
aaaaantttttttttttnnaaaaaa
aaaannttttttttttttnaaaaaa
aaaantttmmmmmmmmmtnaaaaaa
aaaantttmvXpYOhkmtnaaaaaa
aaaantttmQQQQQQQmtnnaaaaa
aaaannttmQQQQQRxmttnaaaaa
aaaaanttmQQQQQQcmttnaaaaa
aaaaanttmVJFQFQCmttnaaaaa
aaaaanntmmmjIjmmmtnaaaaaa
aaaaaanttttjKjttttnaaaaaa
aaaaaanttttjIjtttnnaaaaaa
aaaaaannnnttnnttnnaaaaaaa
aaaaaaaaantnnnnnnaaaaaaaa
aaaaaaaaaannnnnnaaaaaaaaa
aaaaaaaaaaaaaaaaaaaaaaaaa
aaaaaaaaaaaaaaaaaaaaaaaaa
aaaaaaaaaaaaaaaaaaaaaaaaa
aaaaaaaaaaaaaaaaaaaaaaaaa
aaaaaaaaaaaaaaaaaaaaaaaaa
aaaaaaaaaaaaaaaaaaaaaaaaa
"}
