//MAP CONVERTED BY dmm2tgm.py THIS HEADER COMMENT PREVENTS RECONVERSION, DO NOT REMOVE
"a" = (
/turf/open/space/basic,
/area/space)
"b" = (
/obj/structure/railing{
	dir = 4
	},
/obj/structure/railing,
/turf/open/space/basic,
/area/space)
"c" = (
/obj/machinery/door/airlock/grunge,
/turf/open/floor/iron/dark/textured_large,
/area/space)
"d" = (
/obj/structure/fake_stairs/directional/west,
/obj/structure/railing,
/turf/open/floor/plating,
/area/space)
"e" = (
/obj/machinery/door/poddoor/shutters/indestructible,
/turf/open/floor/iron/dark/textured_large,
/area/space)
"f" = (
/obj/structure/fake_stairs/directional/west,
/obj/structure/railing{
	dir = 1
	},
/turf/open/floor/plating,
/area/space)
"g" = (
/obj/structure/fake_stairs/directional/north,
/obj/structure/railing{
	dir = 8
	},
/turf/open/floor/plating,
/area/space)
"h" = (
/obj/structure/railing{
	dir = 4
	},
/turf/open/floor/iron/showroomfloor,
/area/space)
"i" = (
/turf/closed/indestructible/steel,
/area/space)
"j" = (
/obj/structure/fake_stairs/directional/south,
/obj/structure/railing{
	dir = 4
	},
/turf/open/floor/plating,
/area/space)
"k" = (
/obj/structure/fake_stairs/directional/west,
/obj/structure/railing{
	dir = 1
	},
/obj/structure/railing,
/turf/open/floor/plating,
/area/space)
"l" = (
/obj/effect/turf_decal/stripes/red/line{
	dir = 1
	},
/turf/open/floor/plating,
/area/space)
"m" = (
/obj/structure/railing{
	dir = 8
	},
/turf/open/space/basic,
/area/space)
"n" = (
/obj/structure/railing{
	dir = 4
	},
/obj/structure/railing,
/turf/open/floor/iron/showroomfloor,
/area/space)
"o" = (
/obj/effect/spawner/structure/window/reinforced,
/turf/open/floor/plating,
/area/space)
"p" = (
/obj/effect/turf_decal/stripes/red/line{
	dir = 8
	},
/turf/open/floor/plating,
/area/space)
"q" = (
/obj/effect/turf_decal/siding/wideplating_new/dark{
	dir = 4
	},
/turf/open/floor/plating,
/area/space)
"r" = (
/obj/effect/turf_decal/siding/wideplating_new/dark,
/turf/open/floor/plating,
/area/space)
"s" = (
/obj/effect/turf_decal/siding/wideplating_new/dark{
	dir = 8
	},
/turf/open/floor/plating,
/area/space)
"t" = (
/turf/open/floor/plating,
/area/space)
"u" = (
/obj/structure/fluff/metalpole{
	dir = 8
	},
/turf/open/floor/plating,
/area/space)
"v" = (
/obj/structure/railing{
	dir = 10
	},
/turf/open/floor/iron/showroomfloor,
/area/space)
"w" = (
/obj/structure/railing{
	dir = 8
	},
/obj/structure/railing{
	dir = 1
	},
/turf/open/space/basic,
/area/space)
"x" = (
/obj/structure/fluff/metalpole/anchor{
	dir = 4
	},
/turf/open/floor/plating,
/area/space)
"y" = (
/obj/effect/turf_decal/stripes/red/line,
/turf/open/floor/plating,
/area/space)
"z" = (
/obj/effect/turf_decal/siding/thinplating_new/dark{
	dir = 4
	},
/turf/open/floor/iron/smooth_half{
	dir = 1
	},
/area/space)
"A" = (
/obj/effect/turf_decal/siding/wideplating_new/dark{
	dir = 1
	},
/obj/effect/turf_decal/caution/red{
	dir = 1
	},
/turf/open/floor/plating,
/area/space)
"B" = (
/obj/structure/fake_stairs/directional/south,
/obj/structure/railing{
	dir = 8
	},
/turf/open/floor/plating,
/area/space)
"C" = (
/obj/effect/turf_decal/siding/wideplating_new/dark{
	dir = 8
	},
/obj/effect/turf_decal/caution/red{
	dir = 8
	},
/turf/open/floor/plating,
/area/space)
"D" = (
/obj/effect/turf_decal/bot_red,
/obj/structure/marker_beacon/burgundy,
/turf/open/floor/plating,
/area/space)
"E" = (
/obj/structure/fake_stairs/directional/south,
/obj/structure/railing{
	dir = 8
	},
/obj/structure/railing{
	dir = 4
	},
/turf/open/floor/plating,
/area/space)
"F" = (
/turf/open/floor/catwalk_floor/iron_smooth,
/area/space)
"G" = (
/obj/structure/railing{
	dir = 4
	},
/turf/open/space/basic,
/area/space)
"H" = (
/obj/effect/turf_decal/siding/wideplating_new/dark{
	dir = 4
	},
/obj/effect/turf_decal/caution/red{
	dir = 4
	},
/turf/open/floor/plating,
/area/space)
"I" = (
/obj/structure/fake_stairs/directional/north,
/obj/structure/railing{
	dir = 4
	},
/obj/structure/railing{
	dir = 8
	},
/turf/open/floor/plating,
/area/space)
"J" = (
/turf/closed/indestructible/titanium,
/area/space)
"K" = (
/turf/closed/indestructible/titanium/nodiagonal,
/area/space)
"L" = (
/obj/structure/railing,
/turf/open/space/basic,
/area/space)
"M" = (
/turf/open/floor/catwalk_floor,
/area/space)
"N" = (
/obj/effect/turf_decal/siding/wideplating_new/dark{
	dir = 1
	},
/turf/open/floor/plating,
/area/space)
"O" = (
/obj/effect/turf_decal/siding/thinplating_new/dark{
	dir = 8
	},
/turf/open/floor/iron/smooth_half{
	dir = 1
	},
/area/space)
"P" = (
/turf/open/floor/iron/showroomfloor,
/area/space)
"Q" = (
/obj/structure/railing{
	dir = 8
	},
/turf/open/floor/iron/showroomfloor,
/area/space)
"R" = (
/obj/effect/turf_decal/stripes/red/line{
	dir = 4
	},
/turf/open/floor/plating,
/area/space)
"S" = (
/obj/structure/fluff/metalpole{
	dir = 4
	},
/turf/open/floor/plating,
/area/space)
"T" = (
/obj/structure/railing{
	dir = 8
	},
/obj/structure/railing,
/turf/open/floor/iron/showroomfloor,
/area/space)
"U" = (
/obj/effect/turf_decal/siding/wideplating_new/dark,
/obj/effect/turf_decal/caution/red,
/turf/open/floor/plating,
/area/space)
"V" = (
/obj/structure/fluff/metalpole/anchor{
	dir = 8
	},
/turf/open/floor/plating,
/area/space)
"W" = (
/obj/structure/railing{
	dir = 1
	},
/turf/open/space/basic,
/area/space)
"X" = (
/obj/structure/fake_stairs/directional/north,
/turf/open/floor/plating,
/area/space)
"Y" = (
/turf/open/indestructible/binary,
/area/space)

(1,1,1) = {"
i
i
i
i
i
i
i
i
i
i
i
i
i
i
i
i
i
i
i
i
i
i
i
i
i
i
i
i
i
i
i
i
i
i
i
i
i
i
i
i
i
i
i
i
i
i
i
i
i
i
i
i
i
i
i
i
i
i
i
i
i
i
i
i
i
i
i
i
i
i
i
i
i
"}
(2,1,1) = {"
i
i
a
a
i
a
a
a
i
a
a
i
a
a
i
a
a
i
a
a
a
i
a
a
a
i
a
a
a
a
a
i
a
a
i
a
a
a
a
a
i
i
i
a
a
a
a
a
a
a
i
i
a
a
a
a
a
i
i
a
a
a
a
a
i
i
a
a
a
a
a
i
i
"}
(3,1,1) = {"
i
a
a
a
a
a
a
a
a
a
E
c
a
a
a
a
a
a
a
a
a
a
a
a
a
a
a
a
a
a
a
a
a
a
c
a
a
a
a
a
a
i
a
a
a
a
a
a
a
a
a
a
a
a
a
a
a
a
a
a
a
a
a
a
a
a
a
a
a
a
a
a
i
"}
(4,1,1) = {"
i
a
a
a
a
a
a
a
a
a
a
i
a
a
a
a
a
a
a
a
a
a
a
a
a
a
a
a
i
a
a
a
a
a
i
a
a
a
a
a
a
i
a
a
a
a
a
a
a
a
a
a
a
a
a
a
a
a
a
a
a
a
a
a
a
a
a
a
a
a
a
a
i
"}
(5,1,1) = {"
i
i
i
i
i
c
i
i
i
c
i
i
a
a
i
a
a
i
a
a
a
i
a
a
a
i
a
i
i
i
i
i
i
i
i
i
i
i
a
a
a
c
I
a
a
a
a
a
a
a
a
a
a
a
a
a
a
a
a
a
a
a
a
a
a
a
a
a
a
a
a
a
i
"}
(6,1,1) = {"
i
i
a
a
i
a
a
i
a
a
i
i
i
i
i
c
i
i
i
i
i
i
i
c
i
i
i
i
Y
Y
Y
Y
Y
Y
Y
Y
Y
i
a
a
a
i
a
a
a
a
a
a
a
a
a
a
a
a
a
a
a
a
a
a
a
a
a
a
a
a
a
a
a
a
a
a
i
"}
(7,1,1) = {"
i
a
a
a
a
a
a
a
a
a
a
i
Y
Y
Y
Y
Y
Y
Y
i
Y
Y
Y
Y
Y
Y
Y
i
Y
Y
Y
Y
Y
Y
Y
Y
Y
o
a
a
a
i
a
a
a
a
a
a
a
a
a
a
a
a
a
a
a
a
a
a
a
a
a
a
a
a
a
a
a
a
a
i
i
"}
(8,1,1) = {"
i
a
a
a
a
a
a
a
a
a
a
i
Y
Y
Y
Y
Y
Y
Y
i
Y
Y
Y
Y
Y
Y
Y
i
Y
Y
Y
Y
Y
Y
Y
Y
Y
o
a
a
a
i
G
G
G
G
G
i
i
G
a
a
G
G
i
i
a
a
a
a
a
a
a
a
a
a
a
a
a
a
a
i
i
"}
(9,1,1) = {"
i
a
a
a
a
a
a
a
a
a
a
i
Y
Y
Y
Y
Y
Y
Y
i
Y
Y
Y
Y
Y
Y
Y
c
Y
Y
Y
Y
Y
Y
Y
Y
Y
o
a
a
a
i
a
a
a
a
a
i
i
a
f
d
a
a
i
i
a
a
a
a
a
a
a
a
a
a
a
a
a
a
a
a
i
"}
(10,1,1) = {"
i
a
a
a
a
a
a
a
a
a
i
i
Y
Y
Y
Y
Y
Y
Y
i
Y
Y
Y
Y
Y
Y
Y
i
Y
Y
Y
Y
Y
Y
Y
Y
Y
i
a
a
a
i
a
a
a
a
a
a
a
a
a
a
a
a
a
W
a
a
a
a
a
a
a
a
a
a
a
a
a
a
a
a
i
"}
(11,1,1) = {"
i
a
a
a
a
a
a
a
a
a
i
i
Y
Y
Y
Y
Y
Y
Y
i
Y
Y
Y
Y
Y
Y
Y
i
Y
Y
Y
Y
Y
Y
Y
Y
Y
i
i
c
i
i
a
a
a
a
a
a
a
a
a
a
a
a
a
W
a
a
a
a
a
a
a
a
a
a
a
a
a
a
a
a
i
"}
(12,1,1) = {"
i
a
a
a
a
a
a
a
a
a
a
i
i
i
i
c
i
i
i
i
i
i
i
c
i
i
i
i
i
c
i
i
i
c
i
i
i
i
a
a
a
i
a
a
a
a
a
a
a
a
a
a
a
a
a
W
a
a
a
a
a
a
a
a
a
a
a
a
a
a
a
a
i
"}
(13,1,1) = {"
i
a
a
a
a
a
a
a
a
a
E
c
a
i
a
a
i
a
i
a
a
i
a
a
a
i
a
a
a
a
a
a
a
a
a
a
a
i
a
a
a
i
Q
Q
v
a
a
a
a
a
a
a
a
a
a
W
a
a
a
a
a
a
a
a
a
B
B
Q
Q
T
a
i
i
"}
(14,1,1) = {"
i
a
a
a
a
a
a
a
a
a
a
i
a
a
a
a
a
a
c
a
a
a
a
a
a
a
a
a
a
a
a
a
a
a
a
a
a
c
a
a
a
c
P
P
P
g
a
a
a
a
a
a
a
a
a
W
a
a
a
a
a
a
a
a
i
o
o
i
c
i
i
i
i
"}
(15,1,1) = {"
i
a
a
a
a
a
a
a
a
a
i
i
a
a
a
a
a
a
i
a
a
a
a
a
a
a
a
a
a
a
a
a
a
a
a
a
a
i
a
a
a
i
P
P
P
X
a
a
a
a
a
a
a
a
i
i
a
a
a
a
a
a
a
a
i
Y
Y
Y
Y
Y
Y
Y
i
"}
(16,1,1) = {"
i
a
a
a
a
a
a
a
a
i
i
i
i
i
c
i
i
i
i
i
i
o
o
i
o
o
i
o
o
i
i
i
i
o
o
i
i
i
i
c
i
i
i
i
i
i
i
i
i
i
i
i
i
i
i
i
i
a
a
a
a
a
a
a
o
Y
Y
Y
Y
Y
Y
Y
i
"}
(17,1,1) = {"
i
a
a
a
a
a
a
a
a
i
i
i
i
a
k
a
i
i
i
i
a
a
a
a
a
a
a
a
a
a
i
i
a
a
a
a
i
i
a
k
a
i
i
a
a
a
a
a
a
a
a
a
a
i
i
i
i
a
a
a
a
a
a
a
o
Y
Y
Y
Y
Y
Y
Y
i
"}
(18,1,1) = {"
i
a
a
a
a
a
a
a
a
a
i
i
a
a
F
a
a
i
i
a
a
a
a
a
a
a
a
a
a
a
a
a
a
a
a
a
a
a
a
F
a
a
a
a
a
a
a
a
a
a
a
a
a
a
i
i
a
a
a
a
a
a
a
a
o
Y
Y
Y
Y
Y
Y
Y
i
"}
(19,1,1) = {"
i
a
a
a
a
a
a
a
a
a
a
a
F
F
a
F
F
a
a
F
F
F
F
F
F
F
F
F
F
F
a
a
F
F
F
F
a
a
F
a
F
a
a
F
F
F
F
F
F
F
F
F
F
F
a
a
a
a
a
a
a
a
a
a
i
Y
Y
Y
Y
Y
Y
Y
i
"}
(20,1,1) = {"
i
i
i
i
i
i
i
i
a
a
a
a
a
a
a
a
a
a
a
a
a
a
a
a
a
a
a
a
a
a
a
a
a
a
a
a
a
a
a
a
a
a
a
a
a
a
a
a
a
a
a
a
a
a
a
a
a
a
a
a
a
a
a
a
i
i
i
i
i
i
i
i
i
"}
(21,1,1) = {"
i
z
i
z
z
i
z
i
z
z
z
z
z
z
z
z
z
z
z
z
z
z
z
z
z
z
z
z
z
z
z
z
z
z
z
z
z
z
z
z
z
z
z
z
z
z
z
z
z
z
z
z
z
z
z
z
z
z
z
z
z
z
z
z
z
i
z
i
z
z
i
z
i
"}
(22,1,1) = {"
i
S
x
S
S
x
S
e
S
x
S
S
x
S
S
x
S
S
x
S
S
x
S
S
x
S
S
x
S
S
x
S
S
x
S
S
x
S
S
x
S
S
x
S
S
x
S
S
x
S
S
x
S
S
x
S
S
x
S
S
x
S
S
x
S
e
S
x
S
S
x
S
i
"}
(23,1,1) = {"
i
M
M
M
M
M
M
e
M
M
M
M
M
M
M
M
M
M
M
M
M
M
M
M
M
M
M
M
M
M
M
M
M
M
M
M
M
M
M
M
M
M
M
M
M
M
M
M
M
M
M
M
M
M
M
M
M
M
M
M
M
M
M
M
M
e
M
M
M
M
M
M
i
"}
(24,1,1) = {"
i
u
V
u
u
V
u
e
u
V
u
u
V
u
u
V
u
u
V
u
u
V
u
u
V
u
u
V
u
u
V
u
u
V
u
u
V
u
u
V
u
u
V
u
u
V
u
u
V
u
u
V
u
u
V
u
u
V
u
u
V
u
u
V
u
e
u
V
u
u
V
u
i
"}
(25,1,1) = {"
i
O
i
O
O
i
O
i
O
O
O
O
O
O
O
O
O
O
O
O
O
O
O
O
O
O
O
O
O
O
O
O
O
O
O
O
O
O
O
O
O
O
O
O
O
O
O
O
O
O
O
O
O
O
O
O
O
O
O
O
O
O
O
O
O
i
O
i
O
O
i
O
i
"}
(26,1,1) = {"
i
i
i
i
i
i
i
i
a
a
a
a
a
a
a
a
a
a
a
a
a
a
a
a
a
a
a
a
a
a
a
a
a
a
a
a
a
a
a
a
a
a
a
a
a
a
a
a
a
a
a
a
a
a
a
a
a
a
a
a
a
a
a
a
i
i
i
i
i
i
i
i
i
"}
(27,1,1) = {"
i
a
a
a
a
a
a
a
a
a
a
a
F
F
F
F
F
a
a
F
F
F
F
F
F
F
F
F
F
F
a
a
F
F
F
F
F
a
F
F
F
a
a
F
F
F
F
F
F
F
F
F
F
F
a
a
a
a
a
a
a
a
a
a
i
Y
Y
Y
Y
Y
Y
Y
i
"}
(28,1,1) = {"
i
a
a
a
a
a
a
a
a
a
a
a
a
a
a
a
a
i
i
a
a
a
a
a
a
a
a
a
a
a
a
a
a
a
a
a
a
F
a
a
a
a
a
a
a
a
a
a
a
a
a
a
a
a
i
i
a
a
a
a
a
a
a
a
i
Y
Y
Y
Y
Y
Y
Y
i
"}
(29,1,1) = {"
i
a
a
a
a
a
i
i
i
i
a
i
i
a
a
a
i
i
i
i
G
G
G
G
G
G
G
G
G
G
i
i
G
G
G
G
a
F
G
G
G
i
i
G
G
G
G
G
G
G
G
G
G
i
i
i
i
a
a
a
a
a
a
a
o
Y
Y
Y
Y
Y
Y
Y
i
"}
(30,1,1) = {"
i
a
a
a
a
a
i
a
a
a
a
a
i
a
a
a
i
i
i
i
s
s
C
s
s
s
s
C
s
s
i
i
s
s
j
j
G
b
s
s
s
i
i
s
s
C
s
s
s
s
C
s
s
i
i
i
i
a
a
a
a
a
a
a
o
Y
Y
Y
Y
Y
Y
Y
i
"}
(31,1,1) = {"
i
a
a
a
a
a
a
a
a
a
a
a
i
a
a
a
a
i
i
t
t
t
t
t
t
t
t
t
t
t
t
t
t
t
t
t
t
t
t
t
t
t
t
t
t
t
t
t
t
t
t
t
t
t
i
i
a
a
a
a
a
a
a
a
i
Y
Y
Y
Y
Y
Y
Y
i
"}
(32,1,1) = {"
i
a
a
a
a
a
i
a
a
a
a
a
i
a
a
a
a
L
N
t
t
t
R
R
R
R
R
R
R
t
t
t
t
R
R
R
R
R
R
R
t
t
t
t
R
R
R
R
R
R
R
t
t
t
r
W
a
a
a
a
a
a
a
a
i
i
i
i
c
i
o
i
i
"}
(33,1,1) = {"
i
a
a
a
a
a
i
a
a
a
a
a
i
a
a
a
a
L
N
t
t
D
t
J
J
J
J
J
t
D
t
t
D
t
J
J
J
J
J
t
D
t
t
D
t
J
J
J
J
J
t
D
t
t
r
W
a
a
a
a
a
a
a
a
a
j
j
h
h
n
a
i
i
"}
(34,1,1) = {"
i
i
i
i
i
i
i
i
i
a
i
i
i
a
a
a
a
L
A
t
y
t
J
K
K
K
K
K
J
t
l
y
t
J
K
K
K
K
K
J
t
l
y
t
J
K
K
K
K
K
J
t
l
t
U
W
a
a
a
a
a
a
a
a
a
a
a
a
a
a
a
a
i
"}
(35,1,1) = {"
i
a
a
a
a
i
a
a
a
a
a
i
a
a
a
a
a
L
N
t
y
J
K
K
K
K
K
K
K
J
l
y
J
K
K
K
K
K
K
K
J
l
y
J
K
K
K
K
K
K
K
J
l
t
r
W
a
a
a
a
a
a
a
a
a
a
a
a
a
a
a
a
i
"}
(36,1,1) = {"
i
a
a
a
a
i
a
a
a
a
a
i
a
a
a
a
a
L
N
t
y
J
K
K
K
K
K
K
K
J
l
y
J
K
K
K
K
K
K
K
J
l
y
J
K
K
K
K
K
K
K
J
l
t
r
W
a
a
a
a
a
a
a
a
a
a
a
a
a
a
a
a
i
"}
(37,1,1) = {"
i
a
a
a
a
a
a
a
a
a
a
a
a
a
a
a
a
L
N
t
y
J
K
K
K
K
K
K
K
J
l
y
J
K
K
K
K
K
K
K
J
l
y
J
K
K
K
K
K
K
K
J
l
t
r
W
a
a
a
a
a
a
a
a
a
a
a
a
a
a
a
a
i
"}
(38,1,1) = {"
i
a
a
a
a
i
a
a
a
a
a
i
a
a
a
a
a
L
N
t
y
J
K
K
K
K
K
K
K
J
l
y
J
K
K
K
K
K
K
K
J
l
y
J
K
K
K
K
K
K
K
J
l
t
r
W
a
a
a
a
a
a
a
a
a
a
a
a
a
a
a
a
i
"}
(39,1,1) = {"
i
a
a
a
a
i
a
a
a
a
a
i
a
a
a
a
a
L
N
t
y
J
K
K
K
K
K
K
K
J
l
y
J
K
K
K
K
K
K
K
J
l
y
J
K
K
K
K
K
K
K
J
l
t
r
W
a
a
a
a
a
a
a
a
a
a
a
a
a
a
a
a
i
"}
(40,1,1) = {"
i
i
i
a
i
i
i
i
i
i
i
i
i
a
a
a
a
L
A
t
y
t
J
K
K
K
K
K
J
t
l
y
t
J
K
K
K
K
K
J
t
l
y
t
J
K
K
K
K
K
J
t
l
t
U
W
a
a
a
a
a
a
a
a
a
a
a
a
a
a
a
a
i
"}
(41,1,1) = {"
i
a
a
a
a
a
a
a
a
a
a
a
a
a
a
a
a
L
N
t
t
D
t
J
J
J
J
J
t
D
t
t
D
t
J
J
J
J
J
t
D
t
t
D
t
J
J
J
J
J
t
D
t
t
r
W
a
a
a
a
a
a
a
a
a
a
a
a
a
a
a
i
i
"}
(42,1,1) = {"
i
a
a
a
a
a
a
a
a
a
a
a
a
a
a
a
a
L
N
t
t
t
p
p
p
p
p
p
p
t
t
t
t
p
p
p
p
p
p
p
t
t
t
t
p
p
p
p
p
p
p
t
t
t
r
W
a
a
a
a
a
a
a
a
a
a
a
a
a
a
a
i
i
"}
(43,1,1) = {"
i
a
a
a
a
a
a
a
a
a
a
a
a
a
a
a
a
i
i
t
t
t
t
t
t
t
t
t
t
t
t
t
t
t
t
t
t
t
t
t
t
t
t
t
t
t
t
t
t
t
t
t
t
t
i
i
a
a
a
a
a
a
a
a
a
a
a
a
a
a
a
a
i
"}
(44,1,1) = {"
i
a
a
a
a
a
a
a
a
a
a
a
a
a
a
a
i
i
i
i
q
q
H
q
q
q
q
H
q
q
i
i
q
q
q
w
m
g
g
q
q
i
i
q
q
H
q
q
q
q
H
q
q
i
i
i
i
a
a
a
a
a
a
a
a
a
a
a
a
a
a
a
i
"}
(45,1,1) = {"
i
a
a
a
a
a
a
a
a
a
a
a
a
a
a
a
i
i
i
i
m
m
m
m
m
m
m
m
m
m
i
i
m
m
m
a
a
m
m
m
m
i
i
m
m
m
m
m
m
m
m
m
m
i
i
i
i
a
a
a
a
a
a
a
a
a
a
a
a
a
a
a
i
"}
(46,1,1) = {"
i
a
a
a
a
a
a
a
a
a
a
a
a
a
a
a
a
i
i
a
a
a
a
a
a
a
a
a
a
a
a
a
a
a
a
a
a
a
a
a
a
a
a
a
a
a
a
a
a
a
a
a
a
a
i
i
a
a
a
a
a
a
a
a
a
a
a
a
a
a
a
a
i
"}
(47,1,1) = {"
i
a
a
a
a
a
a
a
a
a
a
a
a
a
a
a
a
a
a
a
a
a
a
a
a
a
a
a
a
a
a
a
a
a
a
a
a
a
a
a
a
a
a
a
a
a
a
a
a
a
a
a
a
a
a
a
a
a
a
a
a
a
a
a
a
a
a
a
a
a
a
a
i
"}
(48,1,1) = {"
i
a
a
a
a
a
a
a
a
a
a
a
a
a
a
a
a
a
a
a
a
a
a
a
J
J
J
a
a
a
a
a
a
a
a
J
J
J
a
a
a
a
a
a
a
a
J
J
J
a
a
a
a
a
a
a
a
a
a
a
a
a
a
a
a
a
a
a
a
a
a
a
i
"}
(49,1,1) = {"
i
a
a
a
a
a
a
a
a
a
a
a
a
a
a
a
a
a
a
a
a
a
a
J
K
K
K
J
a
a
a
a
a
a
J
K
K
K
J
a
a
a
a
a
a
J
K
K
K
J
a
a
a
a
a
a
a
a
a
a
a
a
a
a
a
a
a
a
a
a
a
a
i
"}
(50,1,1) = {"
i
a
a
a
a
a
a
a
a
a
a
a
a
a
a
a
a
a
a
a
a
a
J
K
K
K
K
K
J
a
a
a
a
J
K
K
K
K
K
J
a
a
a
a
J
K
K
K
K
K
J
a
a
a
a
a
a
a
a
a
a
a
a
a
a
a
a
a
a
a
a
a
i
"}
(51,1,1) = {"
i
a
a
a
a
a
a
a
a
a
a
a
a
a
a
a
a
a
a
a
a
a
J
K
K
K
K
K
J
a
a
a
a
J
K
K
K
K
K
J
a
a
a
a
J
K
K
K
K
K
J
a
a
a
a
a
a
a
a
a
a
a
a
a
a
a
a
a
a
a
a
a
i
"}
(52,1,1) = {"
i
a
a
a
a
a
a
a
a
a
a
a
a
a
a
a
a
a
a
a
a
a
J
K
K
K
K
K
J
a
a
a
a
J
K
K
K
K
K
J
a
a
a
a
J
K
K
K
K
K
J
a
a
a
a
a
a
a
a
a
a
a
a
a
a
a
a
a
a
a
a
a
i
"}
(53,1,1) = {"
i
a
a
a
a
a
a
a
a
a
a
a
a
a
a
a
a
a
a
a
a
a
a
J
K
K
K
J
a
a
a
a
a
a
J
K
K
K
J
a
a
a
a
a
a
J
K
K
K
J
a
a
a
a
a
a
a
a
a
a
a
a
a
a
a
a
a
a
a
a
a
a
i
"}
(54,1,1) = {"
i
a
a
a
a
a
a
a
a
a
a
a
a
a
a
a
a
a
a
a
a
a
a
a
J
J
J
a
a
a
a
a
a
a
a
J
J
J
a
a
a
a
a
a
a
a
J
J
J
a
a
a
a
a
a
a
a
a
a
a
a
a
a
a
a
a
a
a
a
a
a
a
i
"}
(55,1,1) = {"
i
a
a
a
a
a
a
a
a
a
a
a
a
a
a
a
a
a
a
a
a
a
a
a
a
a
a
a
a
a
a
a
a
a
a
a
a
a
a
a
a
a
a
a
a
a
a
a
a
a
a
a
a
a
a
a
a
a
a
a
a
a
a
a
a
a
a
a
a
a
a
a
i
"}
(56,1,1) = {"
i
a
a
a
a
a
a
a
a
a
a
a
a
a
a
a
a
i
i
a
a
a
a
a
a
a
a
a
a
a
a
a
a
a
a
a
a
a
a
a
a
a
a
a
a
a
a
a
a
a
a
a
a
a
i
i
a
a
a
a
a
a
a
a
a
a
a
a
a
a
a
a
i
"}
(57,1,1) = {"
i
a
a
a
a
a
a
a
a
a
a
a
a
a
a
a
i
i
i
i
a
a
a
a
a
a
a
a
a
a
i
i
a
a
a
a
a
a
a
a
a
i
i
a
a
a
a
a
a
a
a
a
a
i
i
i
i
a
a
a
a
a
a
a
a
a
a
a
a
a
a
a
i
"}
(58,1,1) = {"
i
a
a
a
a
a
a
a
a
a
a
a
a
a
a
a
i
i
i
i
a
a
a
a
a
a
a
a
a
a
i
i
a
a
a
a
a
a
a
a
a
i
i
a
a
a
a
a
a
a
a
a
a
i
i
i
i
a
a
a
a
a
a
a
a
a
a
a
a
a
a
a
i
"}
(59,1,1) = {"
i
a
a
a
a
a
a
a
a
a
a
a
a
a
a
a
a
i
i
a
a
a
a
a
a
a
a
a
a
a
a
a
a
a
a
a
a
a
a
a
a
a
a
a
a
a
a
a
a
a
a
a
a
a
i
i
a
a
a
a
a
a
a
a
a
a
a
a
a
a
a
a
i
"}
(60,1,1) = {"
i
a
a
a
a
a
a
a
a
a
a
a
a
a
a
a
a
a
a
a
a
a
a
a
a
a
a
a
a
a
a
a
a
a
a
a
a
a
a
a
a
a
a
a
a
a
a
a
a
a
a
a
a
a
a
a
a
a
a
a
a
a
a
a
a
a
a
a
a
a
a
a
i
"}
(61,1,1) = {"
i
a
a
a
a
a
a
a
a
a
a
a
a
a
a
a
a
a
a
a
a
a
a
a
a
a
a
a
a
a
a
a
a
a
a
a
a
a
a
a
a
a
a
a
a
a
a
a
a
a
a
a
a
a
a
a
a
a
a
a
a
a
a
a
a
a
a
a
a
a
a
a
i
"}
(62,1,1) = {"
i
a
a
a
a
a
a
a
a
a
a
a
a
a
a
a
a
a
a
a
a
a
a
a
a
a
a
a
a
a
a
a
a
a
a
a
a
a
a
a
a
a
a
a
a
a
a
a
a
a
a
a
a
a
a
a
a
a
a
a
a
a
a
a
a
a
a
a
a
a
a
a
i
"}
(63,1,1) = {"
i
a
a
a
a
a
a
a
a
a
a
a
a
a
a
a
a
a
a
a
a
a
a
a
a
a
a
a
a
a
a
a
a
a
a
a
a
a
a
a
a
a
a
a
a
a
a
a
a
a
a
a
a
a
a
a
a
a
a
a
a
a
a
a
a
a
a
a
a
a
a
a
i
"}
(64,1,1) = {"
i
a
a
a
a
a
a
a
a
a
a
a
a
a
a
a
a
a
a
a
a
a
a
a
a
a
a
a
a
a
a
a
a
a
a
a
a
a
a
a
a
a
a
a
a
a
a
a
a
a
a
a
a
a
a
a
a
a
a
a
a
a
a
a
a
a
a
a
a
a
a
a
i
"}
(65,1,1) = {"
i
a
a
a
a
a
a
a
a
a
a
a
a
a
a
a
a
a
a
a
a
a
a
a
a
a
a
a
a
a
a
a
a
a
a
a
a
a
a
a
a
a
a
a
a
a
a
a
a
a
a
a
a
a
a
a
a
a
a
a
a
a
a
a
a
a
a
a
a
a
a
a
i
"}
(66,1,1) = {"
i
a
a
a
a
a
a
a
a
a
a
a
a
a
a
a
a
a
a
a
a
a
a
a
a
a
a
a
a
a
a
a
a
a
a
a
a
a
a
a
a
a
a
a
a
a
a
a
a
a
a
a
a
a
a
a
a
a
a
a
a
a
a
a
a
a
a
a
a
a
a
a
i
"}
(67,1,1) = {"
i
a
a
a
a
a
a
a
a
a
a
a
a
a
a
a
a
a
a
a
a
a
a
a
a
a
a
a
a
a
a
a
a
a
a
a
a
a
a
a
a
a
a
a
a
a
a
a
a
a
a
a
a
a
a
a
a
a
a
a
a
a
a
a
a
a
a
a
a
a
a
a
i
"}
(68,1,1) = {"
i
a
a
a
a
a
a
a
a
a
a
a
a
a
a
a
a
a
a
a
a
a
a
a
a
a
a
a
a
a
a
a
a
a
a
a
a
a
a
a
a
a
a
a
a
a
a
a
a
a
a
a
a
a
a
a
a
a
a
a
a
a
a
a
a
a
a
a
a
a
a
a
i
"}
(69,1,1) = {"
i
a
a
a
a
a
a
a
a
a
a
a
a
a
a
a
a
a
a
a
a
a
a
a
a
a
a
a
a
a
a
a
a
a
a
a
a
a
a
a
a
a
a
a
a
a
a
a
a
a
a
a
a
a
a
a
a
a
a
a
a
a
a
a
a
a
a
a
a
a
a
a
i
"}
(70,1,1) = {"
i
a
a
a
a
a
a
a
a
a
a
a
a
a
a
a
a
a
a
a
a
a
a
a
a
a
a
a
a
a
a
a
a
a
a
a
a
a
a
a
a
a
a
a
a
a
a
a
a
a
a
a
a
a
a
a
a
a
a
a
a
a
a
a
a
a
a
a
a
a
a
a
i
"}
(71,1,1) = {"
i
a
a
a
a
a
a
a
a
a
a
a
a
a
a
a
a
a
a
a
a
a
a
a
a
a
a
a
a
a
a
a
a
a
a
a
a
a
a
a
a
a
a
a
a
a
a
a
a
a
a
a
a
a
a
a
a
a
a
a
a
a
a
a
a
a
a
a
a
a
a
a
i
"}
(72,1,1) = {"
i
a
a
a
a
a
a
a
a
a
a
a
a
a
a
a
a
a
a
a
a
a
a
a
a
a
a
a
a
a
a
a
a
a
a
a
a
a
a
a
a
a
a
a
a
a
a
a
a
a
a
a
a
a
a
a
a
a
a
a
a
a
a
a
a
a
a
a
a
a
a
a
i
"}
(73,1,1) = {"
i
i
i
i
i
i
i
i
i
i
i
i
i
i
i
i
i
i
i
i
i
i
i
i
i
i
i
i
i
i
i
i
i
i
i
i
i
i
i
i
i
i
i
i
i
i
i
i
i
i
i
i
i
i
i
i
i
i
i
i
i
i
i
i
i
i
i
i
i
i
i
i
i
"}
