//MAP CONVERTED BY dmm2tgm.py THIS HEADER COMMENT PREVENTS RECONVERSION, DO NOT REMOVE
"a" = (
/turf/template_noop,
/area/template_noop)
"b" = (
/obj/machinery/door/poddoor/shutters/indestructible,
/turf/open/floor/iron/dark/textured_large,
/area/deepmaints)
"c" = (
/obj/machinery/light/small/red/dim/directional/east,
/obj/structure/chair/plastic{
	dir = 8
	},
/obj/effect/spawner/random/deep_maintenance_single_item/loose_medical,
/turf/open/floor/plating,
/area/deepmaints)
"f" = (
/obj/structure/chair/plastic{
	dir = 8
	},
/turf/open/floor/plating,
/area/deepmaints)
"g" = (
/obj/effect/turf_decal/siding/thinplating_new/dark{
	dir = 4
	},
/turf/open/floor/iron/smooth,
/area/deepmaints)
"h" = (
/obj/machinery/light/small/red/dim/directional/east,
/turf/open/floor/plating,
/area/deepmaints)
"i" = (
/obj/machinery/door/poddoor/shutters/indestructible/preopen,
/obj/structure/chair/plastic,
/turf/open/floor/iron/dark/textured_large,
/area/deepmaints)
"k" = (
/turf/open/floor/plating,
/area/deepmaints)
"m" = (
/turf/open/floor/iron/smooth_large,
/area/deepmaints)
"n" = (
/obj/effect/turf_decal/siding/thinplating_new/dark{
	dir = 4
	},
/turf/open/floor/iron/smooth_half{
	dir = 1
	},
/area/deepmaints)
"q" = (
/obj/structure/chair/plastic{
	dir = 1
	},
/turf/open/floor/plating,
/area/deepmaints)
"r" = (
/obj/structure/deepmaints_entrance/exit,
/turf/open/floor/catwalk_floor/iron_smooth,
/area/deepmaints)
"s" = (
/obj/structure/bed/maint,
/turf/open/floor/iron/smooth_half{
	dir = 1
	},
/area/deepmaints)
"t" = (
/turf/closed/indestructible/steel,
/area/deepmaints)
"u" = (
/obj/structure/bonfire,
/obj/effect/spawner/random/deep_maintenance_single_item/loose_food,
/turf/open/floor/plating,
/area/deepmaints)
"w" = (
/obj/machinery/door/poddoor/shutters/indestructible/preopen,
/turf/open/floor/iron/dark/textured_large,
/area/deepmaints)
"x" = (
/obj/structure/chair/plastic{
	dir = 4
	},
/turf/open/floor/iron/smooth_large,
/area/deepmaints)
"y" = (
/obj/machinery/light/small/red/dim/directional/north,
/turf/open/floor/iron/smooth_half{
	dir = 1
	},
/area/deepmaints)
"A" = (
/obj/effect/turf_decal/siding/thinplating_new/dark{
	dir = 8
	},
/obj/structure/bed/maint,
/turf/open/floor/iron/smooth_half{
	dir = 1
	},
/area/deepmaints)
"F" = (
/obj/effect/spawner/random/deep_maintenance/ration_crate,
/turf/open/floor/iron/smooth_half{
	dir = 1
	},
/area/deepmaints)
"G" = (
/obj/machinery/light/small/red/dim/directional/south,
/turf/open/floor/iron/smooth_half{
	dir = 1
	},
/area/deepmaints)
"H" = (
/obj/effect/turf_decal/siding/thinplating_new/dark{
	dir = 4
	},
/obj/structure/bed/maint,
/turf/open/floor/iron/smooth_half{
	dir = 1
	},
/area/deepmaints)
"I" = (
/obj/modular_map_connector{
	dir = 1
	},
/turf/template_noop,
/area/template_noop)
"J" = (
/turf/open/floor/iron/smooth_half{
	dir = 1
	},
/area/deepmaints)
"L" = (
/turf/open/floor/catwalk_floor/iron_smooth,
/area/deepmaints)
"M" = (
/obj/effect/turf_decal/siding/thinplating_new/dark{
	dir = 8
	},
/obj/effect/spawner/random/trash/hobo_squat,
/turf/open/floor/iron/smooth_half{
	dir = 1
	},
/area/deepmaints)
"N" = (
/obj/structure/marker_beacon/jade,
/turf/open/floor/iron/smooth_half{
	dir = 1
	},
/area/deepmaints)
"P" = (
/obj/effect/turf_decal/siding/thinplating_new/dark{
	dir = 4
	},
/obj/effect/spawner/random/structure/shipping_container,
/turf/open/floor/iron/smooth_half{
	dir = 1
	},
/area/deepmaints)
"Q" = (
/obj/machinery/door/airlock/grunge,
/turf/open/floor/iron/dark/textured_large,
/area/deepmaints)
"R" = (
/obj/effect/turf_decal/siding/thinplating_new/dark{
	dir = 8
	},
/turf/open/floor/iron/smooth_half{
	dir = 1
	},
/area/deepmaints)
"S" = (
/turf/open/floor/catwalk_floor,
/area/deepmaints)
"U" = (
/obj/effect/turf_decal/siding/thinplating_new/dark{
	dir = 4
	},
/obj/structure/marker_beacon/jade,
/turf/open/floor/iron/smooth_half{
	dir = 1
	},
/area/deepmaints)
"V" = (
/obj/effect/spawner/random/structure/crate_loot,
/turf/open/floor/iron/smooth_half{
	dir = 1
	},
/area/deepmaints)
"W" = (
/obj/effect/spawner/random/deep_maintenance_single_item/loose_office,
/turf/open/floor/iron/smooth_half{
	dir = 1
	},
/area/deepmaints)
"X" = (
/obj/effect/turf_decal/siding/thinplating_new/dark{
	dir = 8
	},
/obj/effect/spawner/random/deep_maintenance/mothic_ration_crate,
/turf/open/floor/iron/smooth_half{
	dir = 1
	},
/area/deepmaints)
"Y" = (
/obj/machinery/door/poddoor/shutters/indestructible,
/turf/open/indestructible/plating,
/area/deepmaints)

(1,1,1) = {"
t
a
a
a
a
a
a
a
a
a
a
a
a
a
a
a
a
a
I
"}
(2,1,1) = {"
t
a
a
a
a
a
a
a
a
a
a
a
a
a
a
a
a
a
a
"}
(3,1,1) = {"
t
a
a
a
a
a
a
a
a
a
a
a
a
a
a
a
a
a
a
"}
(4,1,1) = {"
t
a
a
a
a
a
a
a
a
a
a
a
a
a
a
a
a
a
a
"}
(5,1,1) = {"
t
a
a
a
a
a
a
a
a
a
a
a
a
a
a
a
a
a
a
"}
(6,1,1) = {"
t
t
t
t
t
t
t
t
t
t
t
t
t
t
t
t
t
t
t
"}
(7,1,1) = {"
t
y
J
t
V
J
t
s
G
t
y
F
t
W
J
t
N
G
t
"}
(8,1,1) = {"
Q
L
L
m
L
L
m
L
L
Q
L
L
x
L
L
m
L
r
t
"}
(9,1,1) = {"
t
n
P
g
n
n
g
n
H
t
n
n
g
n
n
g
U
n
t
"}
(10,1,1) = {"
b
k
k
k
k
k
k
k
k
i
k
u
k
q
k
k
k
k
Y
"}
(11,1,1) = {"
b
S
S
S
S
S
S
S
S
w
S
S
S
S
S
S
S
S
Y
"}
(12,1,1) = {"
b
k
k
h
k
k
h
k
k
w
k
f
c
k
k
h
k
k
Y
"}
(13,1,1) = {"
t
M
R
t
R
A
t
X
R
t
R
R
t
R
R
t
R
R
t
"}
(14,1,1) = {"
t
t
t
t
t
t
t
t
t
t
t
t
t
t
t
t
t
t
t
"}
(15,1,1) = {"
t
a
a
a
a
a
a
a
a
a
a
a
a
a
a
a
a
a
a
"}
(16,1,1) = {"
t
a
a
a
a
a
a
a
a
a
a
a
a
a
a
a
a
a
a
"}
(17,1,1) = {"
t
a
a
a
a
a
a
a
a
a
a
a
a
a
a
a
a
a
a
"}
(18,1,1) = {"
t
a
a
a
a
a
a
a
a
a
a
a
a
a
a
a
a
a
a
"}
(19,1,1) = {"
t
a
a
a
a
a
a
a
a
a
a
a
a
a
a
a
a
a
a
"}
