//MAP CONVERTED BY dmm2tgm.py THIS HEADER COMMENT PREVENTS RECONVERSION, DO NOT REMOVE
"a" = (
/turf/template_noop,
/area/template_noop)
"b" = (
/obj/effect/spawner/random/deep_maintenance_single_item/loose_food,
/turf/open/floor/iron/smooth_half{
	dir = 1
	},
/area/deepmaints)
"c" = (
/obj/machinery/door/poddoor/shutters/indestructible,
/turf/open/floor/iron/dark/textured_large,
/area/deepmaints)
"e" = (
/obj/effect/spawner/random/structure/crate_empty,
/turf/open/floor/plating,
/area/deepmaints)
"g" = (
/obj/effect/turf_decal/siding/thinplating_new/dark{
	dir = 4
	},
/turf/open/floor/iron/smooth,
/area/deepmaints)
"h" = (
/obj/machinery/light/small/red/dim/directional/east,
/turf/open/floor/plating,
/area/deepmaints)
"i" = (
/obj/machinery/photocopier,
/turf/open/floor/iron/dark/textured_large,
/area/deepmaints)
"k" = (
/turf/open/floor/plating,
/area/deepmaints)
"l" = (
/obj/effect/spawner/random/deep_maintenance/chest_drawer,
/turf/open/floor/iron/dark/textured_large,
/area/deepmaints)
"m" = (
/turf/open/floor/iron/smooth_large,
/area/deepmaints)
"n" = (
/obj/effect/turf_decal/siding/thinplating_new/dark{
	dir = 4
	},
/turf/open/floor/iron/smooth_half{
	dir = 1
	},
/area/deepmaints)
"o" = (
/obj/effect/turf_decal/siding/thinplating_new/dark{
	dir = 8
	},
/obj/effect/spawner/random/deep_maintenance/lost_cargo,
/turf/open/floor/iron/smooth_half{
	dir = 1
	},
/area/deepmaints)
"p" = (
/turf/open/floor/wood/large,
/area/deepmaints)
"q" = (
/obj/effect/spawner/random/vending/colavend,
/turf/open/floor/iron/smooth_half{
	dir = 1
	},
/area/deepmaints)
"r" = (
/obj/structure/deepmaints_entrance/exit,
/turf/open/floor/catwalk_floor/iron_smooth,
/area/deepmaints)
"s" = (
/obj/structure/table,
/obj/effect/spawner/random/deep_maintenance_single_item/loose_office,
/turf/open/floor/iron/dark/textured_large,
/area/deepmaints)
"t" = (
/turf/closed/indestructible/steel,
/area/deepmaints)
"u" = (
/obj/effect/spawner/structure/window/reinforced,
/turf/open/floor/plating,
/area/deepmaints)
"v" = (
/obj/item/kirbyplants/random/fullysynthetic,
/obj/machinery/light/small/dim/directional/west,
/turf/open/floor/iron/dark/textured_large,
/area/deepmaints)
"w" = (
/obj/machinery/door/poddoor/shutters/indestructible/preopen,
/turf/open/floor/iron/dark/textured_large,
/area/deepmaints)
"x" = (
/obj/machinery/modular_computer/preset/civilian{
	dir = 4
	},
/obj/machinery/light/small/dim/directional/west,
/turf/open/floor/iron/dark/textured_large,
/area/deepmaints)
"y" = (
/obj/machinery/light/small/red/dim/directional/north,
/turf/open/floor/iron/smooth_half{
	dir = 1
	},
/area/deepmaints)
"z" = (
/obj/structure/table,
/turf/open/floor/iron/dark/textured_large,
/area/deepmaints)
"A" = (
/obj/effect/turf_decal/siding/thinplating_new/dark{
	dir = 4
	},
/obj/effect/spawner/random/deep_maintenance_single_item/loose_medical,
/turf/open/floor/iron/smooth_half{
	dir = 1
	},
/area/deepmaints)
"B" = (
/obj/item/kirbyplants/random/fullysynthetic,
/turf/open/floor/iron/dark/textured_large,
/area/deepmaints)
"C" = (
/obj/effect/turf_decal/siding/thinplating_new/dark{
	dir = 8
	},
/obj/effect/spawner/random/structure/closet_maintenance,
/turf/open/floor/iron/smooth_half{
	dir = 1
	},
/area/deepmaints)
"D" = (
/obj/effect/turf_decal/siding/thinplating_new/dark{
	dir = 8
	},
/obj/structure/closet/emcloset,
/turf/open/floor/iron/smooth_half{
	dir = 1
	},
/area/deepmaints)
"F" = (
/obj/structure/chair/office/light,
/turf/open/floor/carpet/green,
/area/deepmaints)
"G" = (
/obj/machinery/light/small/red/dim/directional/south,
/turf/open/floor/iron/smooth_half{
	dir = 1
	},
/area/deepmaints)
"H" = (
/obj/structure/table,
/obj/effect/spawner/random/decoration/ornament,
/turf/open/floor/iron/dark/textured_large,
/area/deepmaints)
"I" = (
/obj/modular_map_connector{
	dir = 1
	},
/turf/template_noop,
/area/template_noop)
"J" = (
/turf/open/floor/iron/smooth_half{
	dir = 1
	},
/area/deepmaints)
"K" = (
/turf/open/floor/carpet/green,
/area/deepmaints)
"L" = (
/turf/open/floor/catwalk_floor/iron_smooth,
/area/deepmaints)
"M" = (
/obj/effect/spawner/random/structure/crate_loot,
/turf/open/floor/plating,
/area/deepmaints)
"N" = (
/obj/structure/marker_beacon/jade,
/turf/open/floor/iron/smooth_half{
	dir = 1
	},
/area/deepmaints)
"O" = (
/obj/structure/table,
/obj/effect/spawner/random/deep_maintenance_single_item/loose_medical,
/turf/open/floor/iron/dark/textured_large,
/area/deepmaints)
"P" = (
/obj/effect/turf_decal/siding/thinplating_new/dark{
	dir = 4
	},
/obj/effect/spawner/random/structure/crate_loot,
/turf/open/floor/iron/smooth,
/area/deepmaints)
"Q" = (
/obj/machinery/door/airlock/grunge,
/turf/open/floor/iron/dark/textured_large,
/area/deepmaints)
"R" = (
/obj/effect/turf_decal/siding/thinplating_new/dark{
	dir = 8
	},
/turf/open/floor/iron/smooth_half{
	dir = 1
	},
/area/deepmaints)
"S" = (
/turf/open/floor/catwalk_floor,
/area/deepmaints)
"T" = (
/obj/structure/closet/emcloset,
/turf/open/floor/iron/smooth_half{
	dir = 1
	},
/area/deepmaints)
"U" = (
/obj/effect/turf_decal/siding/thinplating_new/dark{
	dir = 4
	},
/obj/structure/marker_beacon/jade,
/turf/open/floor/iron/smooth_half{
	dir = 1
	},
/area/deepmaints)
"V" = (
/obj/effect/spawner/random/vending/snackvend,
/turf/open/floor/iron/smooth_half{
	dir = 1
	},
/area/deepmaints)
"W" = (
/obj/effect/spawner/random/structure/chair_maintenance{
	dir = 1
	},
/turf/open/floor/wood/large,
/area/deepmaints)
"X" = (
/obj/effect/spawner/random/structure/chair_flipped,
/turf/open/floor/wood/large,
/area/deepmaints)
"Y" = (
/obj/machinery/door/poddoor/shutters/indestructible,
/turf/open/indestructible/plating,
/area/deepmaints)
"Z" = (
/obj/structure/bookcase/random,
/turf/open/floor/iron/dark/textured_large,
/area/deepmaints)

(1,1,1) = {"
t
a
a
a
a
a
a
a
a
a
a
a
a
a
a
a
a
a
I
"}
(2,1,1) = {"
t
a
a
a
a
a
a
a
a
a
a
a
a
a
a
a
a
a
a
"}
(3,1,1) = {"
t
a
a
a
a
a
a
a
a
a
a
a
a
a
a
a
a
a
a
"}
(4,1,1) = {"
t
a
a
a
a
a
a
a
a
a
a
a
a
a
a
a
a
a
a
"}
(5,1,1) = {"
t
a
a
a
a
a
a
a
a
a
a
a
a
a
a
a
a
a
a
"}
(6,1,1) = {"
t
t
t
t
t
t
t
t
t
t
t
t
t
t
t
t
t
t
t
"}
(7,1,1) = {"
t
y
T
t
J
J
t
b
G
t
y
J
t
V
q
t
N
G
t
"}
(8,1,1) = {"
Q
L
L
m
L
L
m
L
L
Q
L
L
m
L
L
m
L
r
t
"}
(9,1,1) = {"
t
n
n
g
A
n
g
n
n
t
n
n
P
n
n
g
U
n
t
"}
(10,1,1) = {"
c
k
k
k
k
k
k
k
k
w
k
M
M
e
k
k
k
k
Y
"}
(11,1,1) = {"
c
S
S
S
S
S
S
S
S
w
S
S
S
S
S
S
S
S
Y
"}
(12,1,1) = {"
c
k
k
h
k
k
h
k
k
w
k
k
h
k
k
h
k
k
Y
"}
(13,1,1) = {"
t
D
R
t
o
R
t
R
R
t
R
R
t
R
R
t
C
R
t
"}
(14,1,1) = {"
t
t
t
t
u
u
t
Q
t
t
t
t
t
t
t
t
t
t
t
"}
(15,1,1) = {"
t
l
O
x
H
p
v
p
B
t
a
a
a
a
a
a
a
a
a
"}
(16,1,1) = {"
t
l
K
F
z
W
p
p
l
t
a
a
a
a
a
a
a
a
a
"}
(17,1,1) = {"
t
K
K
K
s
X
p
p
Z
t
a
a
a
a
a
a
a
a
a
"}
(18,1,1) = {"
t
i
p
p
p
p
p
p
Z
t
a
a
a
a
a
a
a
a
a
"}
(19,1,1) = {"
t
t
t
t
t
t
t
t
t
t
a
a
a
a
a
a
a
a
a
"}
