//MAP CONVERTED BY dmm2tgm.py THIS HEADER COMMENT PREVENTS RECONVERSION, DO NOT REMOVE
"a" = (
/obj/machinery/door/window/brigdoor{
	id = "scicell";
	name = "Science Holding Cell";
	req_access = list("brig_entrance")
	},
/obj/effect/turf_decal/tile/red/fourcorners,
/turf/open/floor/iron,
/area/station/security/checkpoint/science/research)
"b" = (
/obj/machinery/door_timer{
	id = "scicell";
	name = "Science Cell";
	pixel_x = -32;
	pixel_y = -32
	},
/obj/structure/cable,
/obj/machinery/atmospherics/components/unary/vent_scrubber/on/layer2{
	dir = 1
	},
/obj/machinery/power/apc/auto_name/directional/west,
/obj/machinery/button/door/directional/west{
	id = "scidoor";
	name = "Science Cell Control";
	normaldoorcontrol = 1;
	pixel_y = -12;
	req_access = list("brig_entrance")
	},
/obj/effect/turf_decal/tile/red/anticorner/contrasted{
	dir = 8
	},
/obj/item/kirbyplants/random,
/turf/open/floor/iron,
/area/station/security/checkpoint/science/research)
"c" = (
/obj/structure/table/reinforced,
/obj/item/book/manual/wiki/security_space_law,
/obj/item/radio,
/obj/machinery/status_display/ai/directional/north,
/obj/structure/reagent_dispensers/wall/peppertank/directional/east,
/obj/effect/turf_decal/tile/red/anticorner/contrasted{
	dir = 4
	},
/turf/open/floor/iron,
/area/station/security/checkpoint/science/research)
"e" = (
/obj/machinery/light/directional/east,
/obj/machinery/camera/directional/east{
	c_tag = "Security Post - Science";
	network = list("ss13","rd")
	},
/obj/structure/cable,
/obj/machinery/airalarm/directional/east,
/obj/effect/turf_decal/tile/red/anticorner/contrasted,
/obj/structure/table/reinforced,
/obj/machinery/recharger,
/turf/open/floor/iron,
/area/station/security/checkpoint/science/research)
"i" = (
/turf/closed/wall,
/area/station/security/checkpoint/science/research)
"k" = (
/obj/machinery/light/directional/north,
/obj/item/radio/intercom/directional/north,
/obj/effect/turf_decal/tile/red/half/contrasted{
	dir = 1
	},
/obj/structure/closet/secure_closet/security/science,
/turf/open/floor/iron,
/area/station/security/checkpoint/science/research)
"m" = (
/obj/structure/closet/secure_closet/brig{
	id = "scicell";
	name = "Science Cell Locker"
	},
/obj/structure/cable,
/obj/effect/turf_decal/tile/red/anticorner/contrasted{
	dir = 4
	},
/turf/open/floor/iron,
/area/station/security/checkpoint/science/research)
"q" = (
/obj/structure/cable,
/obj/effect/turf_decal/tile/red/half/contrasted,
/turf/open/floor/iron,
/area/station/security/checkpoint/science/research)
"t" = (
/obj/machinery/door/firedoor,
/obj/machinery/door/airlock/security{
	name = "Science Guard's Office"
	},
/obj/structure/cable,
/obj/effect/turf_decal/stripes/line{
	dir = 8
	},
/obj/effect/turf_decal/stripes/line{
	dir = 4
	},
/obj/machinery/atmospherics/pipe/smart/manifold4w/supply/hidden/layer4,
/obj/machinery/atmospherics/pipe/smart/manifold4w/scrubbers/hidden/layer2,
/obj/effect/turf_decal/tile/red/fourcorners,
/obj/effect/mapping_helpers/airlock/access/all/science/sci_guard,
/turf/open/floor/iron,
/area/station/security/checkpoint/science/research)
"y" = (
/turf/closed/wall/r_wall,
/area/station/security/checkpoint/science/research)
"z" = (
/turf/closed/wall/r_wall,
/area/station/maintenance/port/greater)
"A" = (
/obj/structure/cable,
/obj/machinery/atmospherics/pipe/smart/manifold4w/supply/hidden/layer4,
/obj/machinery/atmospherics/pipe/smart/manifold4w/scrubbers/hidden/layer2,
/obj/effect/turf_decal/tile/red/half/contrasted{
	dir = 8
	},
/obj/effect/landmark/start/science_guard,
/turf/open/floor/iron,
/area/station/security/checkpoint/science/research)
"B" = (
/obj/machinery/atmospherics/pipe/smart/manifold4w/scrubbers/hidden/layer2,
/obj/effect/turf_decal/tile/red/half/contrasted{
	dir = 8
	},
/obj/effect/landmark/start/science_guard,
/turf/open/floor/iron,
/area/station/security/checkpoint/science/research)
"C" = (
/obj/effect/spawner/structure/window/reinforced,
/obj/structure/cable,
/turf/open/floor/plating,
/area/station/security/checkpoint/science/research)
"F" = (
/obj/structure/closet/secure_closet/security/science,
/obj/machinery/status_display/evac/directional/north,
/obj/structure/extinguisher_cabinet/directional/north{
	pixel_x = -32
	},
/obj/machinery/firealarm/directional/west,
/obj/machinery/light_switch/directional/west{
	pixel_x = -38
	},
/obj/effect/turf_decal/tile/red/anticorner/contrasted{
	dir = 1
	},
/turf/open/floor/iron,
/area/station/security/checkpoint/science/research)
"J" = (
/obj/machinery/computer/security{
	dir = 8
	},
/obj/structure/cable,
/obj/effect/turf_decal/tile/red/fourcorners,
/turf/open/floor/iron,
/area/station/security/checkpoint/science/research)
"K" = (
/obj/structure/chair{
	dir = 4
	},
/obj/structure/cable,
/obj/effect/turf_decal/tile/red/anticorner/contrasted{
	dir = 1
	},
/turf/open/floor/iron,
/area/station/security/checkpoint/science/research)
"L" = (
/obj/machinery/computer/secure_data{
	dir = 8
	},
/obj/effect/turf_decal/tile/red/anticorner/contrasted,
/turf/open/floor/iron,
/area/station/security/checkpoint/science/research)
"N" = (
/obj/effect/turf_decal/tile/red/half/contrasted{
	dir = 1
	},
/turf/open/floor/iron,
/area/station/security/checkpoint/science/research)
"O" = (
/obj/effect/turf_decal/tile/neutral/fourcorners,
/obj/effect/landmark/start/science_guard,
/turf/open/floor/iron,
/area/station/security/checkpoint/science/research)
"P" = (
/obj/machinery/door/firedoor,
/obj/machinery/door/airlock/security{
	name = "Science Guard's Office"
	},
/obj/effect/turf_decal/stripes/line{
	dir = 8
	},
/obj/effect/turf_decal/stripes/line{
	dir = 4
	},
/obj/effect/mapping_helpers/airlock/access/all/science/sci_guard,
/turf/open/floor/iron,
/area/station/security/checkpoint/science/research)
"Q" = (
/obj/effect/turf_decal/tile/red/half/contrasted,
/turf/open/floor/iron,
/area/station/security/checkpoint/science/research)
"R" = (
/obj/structure/cable,
/obj/effect/turf_decal/tile/red/anticorner/contrasted,
/turf/open/floor/iron,
/area/station/security/checkpoint/science/research)
"T" = (
/obj/machinery/holopad,
/obj/structure/cable,
/obj/effect/turf_decal/tile/neutral/fourcorners,
/obj/effect/landmark/start/science_guard,
/turf/open/floor/iron,
/area/station/security/checkpoint/science/research)
"U" = (
/obj/structure/chair/office{
	dir = 4
	},
/obj/structure/cable,
/obj/effect/turf_decal/tile/neutral/fourcorners,
/obj/effect/landmark/start/science_guard,
/turf/open/floor/iron,
/area/station/security/checkpoint/science/research)
"V" = (
/obj/structure/chair{
	dir = 4
	},
/obj/effect/turf_decal/tile/red/anticorner/contrasted{
	dir = 8
	},
/turf/open/floor/iron,
/area/station/security/checkpoint/science/research)
"W" = (
/obj/machinery/computer/mecha{
	dir = 8
	},
/obj/effect/turf_decal/tile/red/anticorner/contrasted{
	dir = 4
	},
/turf/open/floor/iron,
/area/station/security/checkpoint/science/research)
"X" = (
/obj/machinery/atmospherics/components/unary/vent_pump/on/layer4,
/obj/effect/turf_decal/tile/red/half/contrasted{
	dir = 8
	},
/obj/effect/landmark/start/science_guard,
/turf/open/floor/iron,
/area/station/security/checkpoint/science/research)

(1,1,1) = {"
z
i
C
t
C
i
i
C
C
i
"}
(2,1,1) = {"
y
F
X
A
B
b
C
K
V
C
"}
(3,1,1) = {"
y
k
O
U
T
q
a
N
Q
C
"}
(4,1,1) = {"
y
c
L
J
W
e
C
m
R
C
"}
(5,1,1) = {"
y
y
C
C
C
y
y
C
P
i
"}
