//MAP CONVERTED BY dmm2tgm.py THIS HEADER COMMENT PREVENTS RECONVERSION, DO NOT REMOVE
"a" = (
/turf/closed/wall,
/area/station/security/checkpoint/medical)
"b" = (
/obj/item/pen,
/obj/structure/table/reinforced,
/obj/structure/reagent_dispensers/wall/peppertank/directional/east,
/obj/item/folder/red,
/obj/machinery/newscaster/directional/north,
/obj/item/screwdriver{
	pixel_y = 10
	},
/obj/item/radio/off,
/obj/effect/turf_decal/tile/red/fourcorners,
/obj/machinery/recharger{
	pixel_y = 4
	},
/turf/open/floor/iron/dark,
/area/station/security/checkpoint/medical)
"c" = (
/obj/effect/spawner/structure/window/reinforced,
/obj/structure/cable,
/obj/machinery/door/poddoor/preopen{
	id = "medsecprivacy";
	name = "Privacy Shutter"
	},
/turf/open/floor/plating,
/area/station/security/checkpoint/medical)
"d" = (
/obj/effect/turf_decal/trimline/red/filled/corner{
	dir = 8
	},
/obj/structure/cable,
/obj/machinery/atmospherics/pipe/smart/manifold4w/scrubbers/hidden/layer2,
/turf/open/floor/iron/dark,
/area/station/security/checkpoint/medical)
"k" = (
/obj/effect/turf_decal/trimline/red/filled/line{
	dir = 10
	},
/obj/structure/cable,
/obj/machinery/atmospherics/pipe/smart/manifold4w/supply/hidden/layer4,
/obj/machinery/atmospherics/pipe/smart/manifold4w/scrubbers/hidden/layer2,
/turf/open/floor/iron/dark,
/area/station/security/checkpoint/medical)
"l" = (
/obj/machinery/door/firedoor,
/obj/machinery/door/airlock/security{
	name = "Orderly's Office"
	},
/obj/structure/cable,
/obj/machinery/atmospherics/pipe/smart/manifold4w/supply/hidden/layer4,
/obj/machinery/atmospherics/pipe/smart/manifold4w/scrubbers/hidden/layer2,
/obj/effect/turf_decal/tile/red/fourcorners,
/obj/effect/mapping_helpers/airlock/access/all/medical,
/turf/open/floor/iron/dark,
/area/station/security/checkpoint/medical)
"m" = (
/obj/machinery/door/poddoor/preopen{
	id = "medsecprivacy";
	name = "Privacy Shutter"
	},
/obj/structure/table/reinforced,
/obj/machinery/door/firedoor,
/obj/machinery/door/window/brigdoor/left/directional/north{
	name = "Orderly Office's Desk";
	req_access = list("brig_entrance")
	},
/turf/open/floor/plating,
/area/station/security/checkpoint/medical)
"n" = (
/obj/effect/turf_decal/trimline/red/filled/line{
	dir = 8
	},
/obj/effect/landmark/start/orderly,
/turf/open/floor/iron/dark,
/area/station/security/checkpoint/medical)
"o" = (
/obj/machinery/requests_console/directional/north{
	department = "Security";
	departmentType = 3;
	name = "Security Requests Console"
	},
/obj/machinery/light/directional/north,
/obj/machinery/camera/directional/north{
	c_tag = "Security Post - Medbay";
	network = list("ss13","medbay")
	},
/obj/effect/turf_decal/tile/red/fourcorners,
/obj/structure/closet/secure_closet/security/med,
/obj/item/book/manual/wiki/security_space_law,
/turf/open/floor/iron/dark,
/area/station/security/checkpoint/medical)
"p" = (
/obj/effect/turf_decal/trimline/red/filled/line{
	dir = 6
	},
/obj/effect/landmark/start/orderly,
/turf/open/floor/iron/dark,
/area/station/security/checkpoint/medical)
"s" = (
/obj/effect/turf_decal/trimline/red/filled/line{
	dir = 1
	},
/obj/machinery/holopad,
/obj/effect/landmark/start/orderly,
/turf/open/floor/iron/dark,
/area/station/security/checkpoint/medical)
"B" = (
/obj/structure/chair/office{
	dir = 8
	},
/obj/effect/turf_decal/trimline/red/filled/line{
	dir = 10
	},
/obj/effect/landmark/start/orderly,
/turf/open/floor/iron/dark,
/area/station/security/checkpoint/medical)
"E" = (
/obj/machinery/door/poddoor/preopen{
	id = "medsecprivacy";
	name = "Privacy Shutter"
	},
/obj/structure/table/reinforced,
/obj/machinery/door/firedoor,
/obj/machinery/door/window/brigdoor/right/directional/north{
	name = "Orderly Office's Desk";
	req_access = list("brig_entrance")
	},
/turf/open/floor/plating,
/area/station/security/checkpoint/medical)
"G" = (
/obj/machinery/button/door/directional/east{
	id = "medsecprivacy";
	name = "Privacy Shutters Control";
	req_access = list("brig_entrance")
	},
/obj/effect/turf_decal/trimline/red/filled/line{
	dir = 5
	},
/turf/open/floor/iron/dark,
/area/station/security/checkpoint/medical)
"H" = (
/obj/effect/turf_decal/trimline/red/filled/line{
	dir = 9
	},
/obj/machinery/power/apc/auto_name/directional/west,
/obj/structure/cable,
/obj/machinery/atmospherics/components/unary/vent_pump/on/layer4,
/obj/effect/landmark/start/orderly,
/turf/open/floor/iron/dark,
/area/station/security/checkpoint/medical)
"S" = (
/obj/machinery/atmospherics/pipe/smart/manifold4w/scrubbers/hidden/layer2,
/obj/effect/turf_decal/trimline/red/filled/line{
	dir = 4
	},
/obj/structure/cable,
/turf/open/floor/iron/dark,
/area/station/security/checkpoint/medical)
"T" = (
/obj/machinery/airalarm/directional/west,
/obj/structure/closet/secure_closet/security/med,
/obj/effect/turf_decal/tile/red/fourcorners,
/turf/open/floor/iron/dark,
/area/station/security/checkpoint/medical)
"V" = (
/obj/item/radio/intercom/directional/west,
/obj/machinery/computer/secure_data{
	dir = 4
	},
/obj/machinery/button/door/directional/west{
	id = "MedbayFoyer";
	name = "Medbay Doors Control";
	normaldoorcontrol = 1;
	pixel_y = -9
	},
/obj/effect/turf_decal/tile/red/fourcorners,
/turf/open/floor/iron/dark,
/area/station/security/checkpoint/medical)
"X" = (
/obj/machinery/atmospherics/components/unary/vent_scrubber/on/layer2{
	dir = 1
	},
/obj/effect/turf_decal/trimline/red/filled/line{
	dir = 4
	},
/obj/effect/landmark/start/orderly,
/turf/open/floor/iron/dark,
/area/station/security/checkpoint/medical)
"Z" = (
/obj/machinery/computer/security/telescreen{
	desc = "Used for monitoring medbay to ensure patient safety.";
	dir = 4;
	name = "Medbay Monitor";
	network = list("medbay");
	pixel_x = -32
	},
/obj/machinery/light_switch/directional/west{
	pixel_x = -20
	},
/obj/machinery/computer/med_data{
	dir = 4
	},
/obj/machinery/light/directional/west,
/obj/effect/turf_decal/tile/red/fourcorners,
/turf/open/floor/iron/dark,
/area/station/security/checkpoint/medical)

(1,1,1) = {"
a
a
a
l
a
a
a
"}
(2,1,1) = {"
a
T
H
k
Z
V
a
"}
(3,1,1) = {"
a
o
s
d
n
B
m
"}
(4,1,1) = {"
a
b
G
S
X
p
E
"}
(5,1,1) = {"
a
a
a
c
c
c
a
"}
