//MAP CONVERTED BY dmm2tgm.py THIS HEADER COMMENT PREVENTS RECONVERSION, DO NOT REMOVE
"a" = (
/obj/effect/spawner/structure/window/reinforced,
/obj/structure/cable,
/turf/open/floor/plating,
/area/station/security/checkpoint/supply)
"b" = (
/obj/machinery/door/airlock/security{
	name = "Custom Agent's Office"
	},
/obj/machinery/door/firedoor,
/obj/machinery/atmospherics/pipe/smart/manifold4w/supply/hidden/layer4,
/obj/machinery/atmospherics/pipe/smart/manifold4w/scrubbers/hidden/layer2,
/obj/effect/mapping_helpers/airlock/access/all/supply/customs,
/turf/open/floor/iron,
/area/station/security/checkpoint/supply)
"c" = (
/obj/machinery/computer/security/mining{
	dir = 4
	},
/obj/machinery/light/directional/north,
/obj/item/radio/intercom/directional/west,
/obj/effect/turf_decal/tile/red/half/contrasted{
	dir = 4
	},
/turf/open/floor/iron,
/area/station/security/checkpoint/supply)
"d" = (
/obj/structure/cable,
/obj/machinery/atmospherics/components/unary/vent_scrubber/on/layer2{
	dir = 4
	},
/obj/effect/landmark/start/customs_agent,
/turf/open/floor/iron,
/area/station/security/checkpoint/supply)
"k" = (
/turf/closed/wall,
/area/station/maintenance/port/fore)
"n" = (
/obj/effect/turf_decal/tile/red/anticorner/contrasted{
	dir = 8
	},
/obj/structure/closet/secure_closet/security/cargo,
/turf/open/floor/iron,
/area/station/security/checkpoint/supply)
"o" = (
/obj/structure/table/reinforced,
/obj/machinery/recharger{
	pixel_y = 4
	},
/obj/item/radio/off{
	pixel_x = -11;
	pixel_y = -3
	},
/obj/effect/turf_decal/tile/red/half/contrasted{
	dir = 1
	},
/turf/open/floor/iron,
/area/station/security/checkpoint/supply)
"p" = (
/turf/closed/wall,
/area/station/security/checkpoint/supply)
"u" = (
/obj/structure/chair/office,
/obj/machinery/requests_console/directional/north{
	department = "Security";
	departmentType = 3;
	name = "Security Requests Console"
	},
/obj/effect/landmark/start/customs_agent,
/turf/open/floor/iron,
/area/station/security/checkpoint/supply)
"v" = (
/obj/structure/closet/secure_closet/security/cargo,
/obj/machinery/airalarm/directional/north,
/obj/effect/turf_decal/tile/red/half/contrasted,
/turf/open/floor/iron,
/area/station/security/checkpoint/supply)
"w" = (
/obj/structure/reagent_dispensers/wall/peppertank/directional/east,
/obj/machinery/atmospherics/pipe/smart/manifold4w/supply/hidden/layer4,
/obj/machinery/atmospherics/pipe/smart/manifold4w/scrubbers/hidden/layer2,
/obj/effect/landmark/start/customs_agent,
/turf/open/floor/iron,
/area/station/security/checkpoint/supply)
"y" = (
/obj/item/kirbyplants/random,
/obj/structure/disposalpipe/segment{
	dir = 10
	},
/turf/open/floor/iron,
/area/station/cargo/storage)
"E" = (
/obj/structure/cable,
/obj/machinery/power/apc/auto_name/directional/east,
/obj/machinery/atmospherics/components/unary/vent_pump/on/layer4,
/obj/machinery/atmospherics/pipe/smart/manifold4w/scrubbers/hidden/layer2,
/obj/effect/landmark/start/customs_agent,
/turf/open/floor/iron,
/area/station/security/checkpoint/supply)
"K" = (
/obj/machinery/computer/secure_data{
	dir = 4
	},
/obj/structure/cable,
/obj/effect/turf_decal/tile/red/half/contrasted{
	dir = 4
	},
/turf/open/floor/iron,
/area/station/security/checkpoint/supply)
"T" = (
/obj/structure/table/reinforced,
/obj/item/paper_bin{
	pixel_x = 1;
	pixel_y = 9
	},
/obj/item/pen{
	pixel_x = 1;
	pixel_y = 9
	},
/obj/item/book/manual/wiki/security_space_law,
/obj/machinery/camera/directional/south{
	c_tag = "Security Post - Cargo"
	},
/obj/effect/turf_decal/tile/red/anticorner/contrasted{
	dir = 4
	},
/turf/open/floor/iron,
/area/station/security/checkpoint/supply)
"U" = (
/obj/structure/cable,
/obj/machinery/atmospherics/pipe/smart/manifold4w/scrubbers/hidden/layer2,
/obj/effect/landmark/start/customs_agent,
/turf/open/floor/iron,
/area/station/security/checkpoint/supply)

(1,1,1) = {"
p
p
a
a
y
"}
(2,1,1) = {"
p
c
K
a
a
"}
(3,1,1) = {"
k
u
d
o
a
"}
(4,1,1) = {"
k
n
U
T
p
"}
(5,1,1) = {"
k
v
E
w
b
"}
(6,1,1) = {"
k
k
k
k
k
"}
