//MAP CONVERTED BY dmm2tgm.py THIS HEADER COMMENT PREVENTS RECONVERSION, DO NOT REMOVE
"a" = (
/turf/closed/wall/r_wall,
/area/station/engineering/atmos/pumproom)
"d" = (
/obj/structure/cable,
/obj/machinery/atmospherics/pipe/smart/manifold4w/scrubbers/hidden/layer2,
/obj/effect/landmark/start/engineering_guard,
/turf/open/floor/iron,
/area/station/security/checkpoint/engineering)
"f" = (
/obj/machinery/atmospherics/pipe/smart/simple/scrubbers/visible{
	dir = 4
	},
/turf/closed/wall,
/area/station/security/checkpoint/engineering)
"h" = (
/obj/machinery/atmospherics/pipe/smart/simple/scrubbers/visible{
	dir = 4
	},
/turf/closed/wall/r_wall,
/area/station/security/checkpoint/engineering)
"i" = (
/obj/structure/chair{
	dir = 4
	},
/obj/effect/landmark/start/engineering_guard,
/obj/effect/turf_decal/tile/red/half/contrasted{
	dir = 8
	},
/turf/open/floor/iron,
/area/station/security/checkpoint/engineering)
"j" = (
/turf/closed/wall/r_wall,
/area/station/engineering/transit_tube)
"n" = (
/obj/structure/closet/secure_closet/security/engine,
/obj/machinery/airalarm/directional/east,
/obj/machinery/requests_console/directional/south{
	department = "Security";
	departmentType = 5;
	name = "Security Requests Console"
	},
/obj/machinery/firealarm/directional/south{
	pixel_x = 26
	},
/obj/effect/turf_decal/tile/red/anticorner/contrasted,
/turf/open/floor/iron,
/area/station/security/checkpoint/engineering)
"s" = (
/obj/structure/table,
/obj/machinery/recharger{
	pixel_y = 4
	},
/obj/structure/reagent_dispensers/wall/peppertank/directional/east,
/obj/effect/turf_decal/tile/red/anticorner/contrasted{
	dir = 4
	},
/turf/open/floor/iron,
/area/station/security/checkpoint/engineering)
"t" = (
/obj/machinery/computer/secure_data,
/obj/effect/turf_decal/tile/red/half/contrasted{
	dir = 1
	},
/turf/open/floor/iron,
/area/station/security/checkpoint/engineering)
"w" = (
/obj/structure/table,
/obj/item/screwdriver{
	pixel_y = 10
	},
/obj/item/geiger_counter{
	pixel_x = 7;
	pixel_y = 3
	},
/obj/item/radio/off{
	pixel_x = -5;
	pixel_y = 2
	},
/obj/effect/turf_decal/tile/red/anticorner/contrasted{
	dir = 1
	},
/turf/open/floor/iron,
/area/station/security/checkpoint/engineering)
"x" = (
/obj/structure/cable,
/obj/machinery/atmospherics/pipe/smart/manifold4w/supply/hidden/layer4,
/obj/machinery/atmospherics/pipe/smart/manifold4w/scrubbers/hidden/layer2,
/obj/effect/landmark/start/engineering_guard,
/obj/effect/turf_decal/tile/red/half/contrasted{
	dir = 8
	},
/turf/open/floor/iron,
/area/station/security/checkpoint/engineering)
"D" = (
/obj/effect/spawner/structure/window/reinforced,
/obj/structure/cable,
/turf/open/floor/plating,
/area/station/security/checkpoint/engineering)
"L" = (
/obj/machinery/light/directional/east,
/obj/machinery/computer/security/telescreen/minisat{
	dir = 8;
	pixel_x = 26
	},
/obj/effect/turf_decal/tile/red/half/contrasted{
	dir = 4
	},
/obj/structure/closet/secure_closet/security/engine,
/turf/open/floor/iron,
/area/station/security/checkpoint/engineering)
"N" = (
/obj/machinery/atmospherics/pipe/smart/simple/scrubbers/visible{
	dir = 10
	},
/turf/closed/wall/r_wall,
/area/station/engineering/atmos/pumproom)
"O" = (
/obj/machinery/camera/autoname{
	dir = 5
	},
/obj/structure/cable,
/obj/machinery/atmospherics/components/unary/vent_scrubber/on/layer2{
	dir = 1
	},
/obj/machinery/power/apc/auto_name/directional/south,
/obj/effect/landmark/start/engineering_guard,
/obj/effect/turf_decal/tile/red/half/contrasted,
/turf/open/floor/iron,
/area/station/security/checkpoint/engineering)
"S" = (
/obj/structure/chair{
	dir = 4
	},
/obj/machinery/newscaster/directional/south,
/obj/effect/landmark/start/engineering_guard,
/obj/item/radio/intercom/directional/west,
/obj/effect/turf_decal/tile/red/anticorner/contrasted{
	dir = 8
	},
/turf/open/floor/iron,
/area/station/security/checkpoint/engineering)
"T" = (
/obj/structure/chair/office{
	dir = 1
	},
/obj/effect/landmark/start/engineering_guard,
/obj/structure/cable,
/obj/machinery/atmospherics/components/unary/vent_pump/on/layer4{
	dir = 8
	},
/obj/machinery/atmospherics/pipe/smart/manifold4w/scrubbers/hidden/layer2,
/turf/open/floor/iron,
/area/station/security/checkpoint/engineering)
"X" = (
/obj/structure/table,
/obj/item/paper_bin{
	pixel_x = -1;
	pixel_y = 5
	},
/obj/item/pen,
/obj/machinery/computer/security/telescreen{
	desc = "Used for monitoring the engine.";
	dir = 8;
	name = "Engine Monitor";
	network = list("engine");
	pixel_x = 26
	},
/obj/machinery/button/door/directional/east{
	id = "Engineering";
	name = "Engineering Lockdown";
	pixel_y = 16;
	req_access = list("brig_entrance")
	},
/obj/machinery/button/door/directional/east{
	id = "atmos";
	name = "Atmospherics Lockdown";
	pixel_y = 24;
	req_access = list("brig_entrance")
	},
/obj/effect/turf_decal/tile/red/half/contrasted{
	dir = 4
	},
/turf/open/floor/iron,
/area/station/security/checkpoint/engineering)
"Y" = (
/obj/machinery/door/airlock/security{
	name = "Engineering Guard's Office"
	},
/obj/machinery/door/firedoor,
/obj/structure/cable,
/obj/machinery/atmospherics/pipe/smart/manifold4w/supply/hidden/layer4,
/obj/machinery/atmospherics/pipe/smart/manifold4w/scrubbers/hidden/layer2,
/obj/effect/turf_decal/tile/red/fourcorners,
/obj/effect/mapping_helpers/airlock/access/all/engineering/engie_guard,
/turf/open/floor/iron,
/area/station/security/checkpoint/engineering)
"Z" = (
/turf/closed/wall,
/area/station/security/checkpoint/engineering)

(1,1,1) = {"
D
D
Y
D
Z
f
"}
(2,1,1) = {"
D
w
x
i
S
f
"}
(3,1,1) = {"
D
t
T
d
O
h
"}
(4,1,1) = {"
D
s
X
L
n
N
"}
(5,1,1) = {"
j
j
j
j
j
a
"}
