"br" = (/mob/living/simple_animal/hostile/russian/ranged/officer,/obj/machinery/light/small{dir = 4},/turf/open/floor/plasteel/white,/area/ruin/space/has_grav/powered{name = "Unexplored Location"})
"cP" = (/obj/structure/chair/office{dir = 8},/turf/open/floor/plasteel/white,/area/ruin/space/has_grav/powered{name = "Unexplored Location"})
"da" = (/turf/template_noop,/area/template_noop)
"dI" = (/turf/open/floor/plating/airless,/area/ruin/space/has_grav/powered{name = "Unexplored Location"})
"ev" = (/obj/structure/table,/obj/item/food/meat/steak/bear,/turf/open/floor/plasteel/white,/area/ruin/space/has_grav/powered{name = "Unexplored Location"})
"fV" = (/obj/structure/table,/obj/item/food/meat/steak/bear,/obj/machinery/light/small{dir = 1},/turf/open/floor/plasteel/white,/area/ruin/space/has_grav/powered{name = "Unexplored Location"})
"hG" = (/obj/machinery/computer{desc = "A computer long since rendered non-functional due to lack of maintenance. Spitting out error messages."; dir = 4; name = "Broken Computer"},/obj/machinery/light/small{dir = 8},/turf/open/floor/plasteel/white,/area/ruin/space/has_grav/powered{name = "Unexplored Location"})
"io" = (/obj/effect/spawner/structure/window/shuttle,/turf/open/floor/plasteel/white,/area/ruin/space/has_grav/powered{name = "Unexplored Location"})
"is" = (/obj/structure/rack,/obj/item/gun/ballistic/automatic/surplus,/obj/item/gun/ballistic/automatic/surplus{pixel_y = -7},/obj/item/ammo_box/magazine/m10mm/rifle{pixel_x = 6; pixel_y = 9},/obj/item/ammo_box/magazine/m10mm/rifle{pixel_x = 1; pixel_y = 9},/obj/item/ammo_box/magazine/m10mm/rifle{pixel_x = -4; pixel_y = 9},/obj/item/ammo_box/magazine/m10mm/rifle{pixel_x = -9; pixel_y = 9},/turf/open/floor/plasteel/white,/area/ruin/space/has_grav/powered{name = "Unexplored Location"})
"ku" = (/obj/machinery/porta_turret/syndicate{dir = 8; pixel_x = 32; pixel_y = 4},/turf/template_noop,/area/template_noop)
"kx" = (/mob/living/simple_animal/hostile/russian,/turf/open/floor/plasteel/white,/area/ruin/space/has_grav/powered{name = "Unexplored Location"})
"lk" = (/obj/structure/shuttle/engine/huge,/turf/template_noop,/area/ruin/space/has_grav/powered{name = "Unexplored Location"})
"lT" = (/turf/template_noop,/area/ruin/space/has_grav/powered{name = "Unexplored Location"})
"nr" = (/obj/structure/table,/obj/item/food/burger/bearger,/obj/machinery/light/small,/turf/open/floor/plasteel/white,/area/ruin/space/has_grav/powered{name = "Unexplored Location"})
"nF" = (/obj/effect/spawner/structure/window/shuttle,/turf/open/floor/plating,/area/ruin/space/has_grav/powered{name = "Unexplored Location"})
"nG" = (/turf/open/floor/plasteel/stairs/left,/area/ruin/space/has_grav/powered{name = "Unexplored Location"})
"nH" = (/obj/structure/table,/obj/item/food/bearsteak,/turf/open/floor/plasteel/white,/area/ruin/space/has_grav/powered{name = "Unexplored Location"})
"oI" = (/obj/structure/table,/obj/item/food/meat/steak/bear,/obj/machinery/light/small,/turf/open/floor/plasteel/white,/area/ruin/space/has_grav/powered{name = "Unexplored Location"})
"oY" = (/obj/structure/chair/office,/turf/open/floor/plasteel/white,/area/ruin/space/has_grav/powered{name = "Unexplored Location"})
"qg" = (/obj/machinery/computer{desc = "A computer long since rendered non-functional due to lack of maintenance. Spitting out error messages."; dir = 8; name = "Broken Computer"},/turf/open/floor/plasteel/white,/area/ruin/space/has_grav/powered{name = "Unexplored Location"})
"qU" = (/obj/structure/shuttle/engine/heater,/turf/closed/wall/mineral/titanium,/area/ruin/space/has_grav/powered{name = "Unexplored Location"})
"tm" = (/turf/open/floor/plasteel/white,/area/ruin/space/has_grav/powered{name = "Unexplored Location"})
"uU" = (/obj/structure/shuttle/engine/large,/turf/template_noop,/area/ruin/space/has_grav/powered{name = "Unexplored Location"})
"vA" = (/obj/machinery/computer{desc = "A computer long since rendered non-functional due to lack of maintenance. Spitting out error messages."; name = "Broken Computer"},/turf/open/floor/plasteel/white,/area/ruin/space/has_grav/powered{name = "Unexplored Location"})
"wO" = (/obj/structure/chair/office{dir = 4},/turf/open/floor/plasteel/white,/area/ruin/space/has_grav/powered{name = "Unexplored Location"})
"xj" = (/obj/effect/spawner/structure/window/shuttle,/obj/machinery/door/poddoor,/turf/open/floor/plating,/area/ruin/space/has_grav/powered{name = "Unexplored Location"})
"xo" = (/obj/machinery/light/small{dir = 8},/turf/open/floor/plasteel/white,/area/ruin/space/has_grav/powered{name = "Unexplored Location"})
"xp" = (/obj/machinery/light/small,/turf/open/floor/plasteel/white,/area/ruin/space/has_grav/powered{name = "Unexplored Location"})
"ys" = (/turf/closed/wall/mineral/titanium,/area/ruin/space/has_grav/powered{name = "Unexplored Location"})
"yQ" = (/obj/structure/table,/obj/item/food/meat/cutlet/bear,/obj/machinery/light/small{dir = 8},/turf/open/floor/plasteel/white,/area/ruin/space/has_grav/powered{name = "Unexplored Location"})
"zu" = (/mob/living/simple_animal/hostile/russian/ranged/officer,/obj/machinery/light/small{dir = 8},/turf/open/floor/plasteel/white,/area/ruin/space/has_grav/powered{name = "Unexplored Location"})
"zy" = (/obj/structure/table,/turf/open/floor/plasteel/white,/area/ruin/space/has_grav/powered{name = "Unexplored Location"})
"Bf" = (/turf/open/floor/plasteel/white/corner,/area/ruin/space/has_grav/powered{name = "Unexplored Location"})
"Cw" = (/mob/living/simple_animal/hostile/bear/russian,/turf/open/floor/plasteel/white,/area/ruin/space/has_grav/powered{name = "Unexplored Location"})
"CX" = (/obj/structure/chair{dir = 8},/obj/effect/mob_spawn/human/corpse/assistant,/obj/machinery/light/small{dir = 4},/turf/open/floor/plasteel/white,/area/ruin/space/has_grav/powered{name = "Unexplored Location"})
"DD" = (/obj/effect/decal/cleanable/blood/splatter,/obj/machinery/light/small{dir = 4},/turf/open/floor/plasteel/white,/area/ruin/space/has_grav/powered{name = "Unexplored Location"})
"ED" = (/mob/living/simple_animal/hostile/russian/ranged,/turf/open/floor/plasteel/white/corner,/area/ruin/space/has_grav/powered{name = "Unexplored Location"})
"Hc" = (/obj/machinery/light/small{dir = 1},/turf/open/floor/plasteel/white,/area/ruin/space/has_grav/powered{name = "Unexplored Location"})
"Hq" = (/obj/machinery/door/airlock/external,/obj/structure/fans/tiny,/turf/open/floor/plating,/area/ruin/space/has_grav/powered{name = "Unexplored Location"})
"Hy" = (/obj/machinery/door/airlock/security/glass,/turf/open/floor/plasteel/white,/area/ruin/space/has_grav/powered{name = "Unexplored Location"})
"HQ" = (/obj/structure/table,/obj/item/food/meat/cutlet/bear,/turf/open/floor/plasteel/white,/area/ruin/space/has_grav/powered{name = "Unexplored Location"})
"Ih" = (/turf/open/floor/plasteel/white/side{dir = 1},/area/ruin/space/has_grav/powered{name = "Unexplored Location"})
"IC" = (/turf/open/floor/plasteel/white/corner{dir = 4},/area/ruin/space/has_grav/powered{name = "Unexplored Location"})
"IR" = (/obj/structure/chair{dir = 4},/obj/effect/mob_spawn/human/corpse/cargo_tech,/obj/machinery/light/small{dir = 8},/turf/open/floor/plasteel/white,/area/ruin/space/has_grav/powered{name = "Unexplored Location"})
"IU" = (/obj/machinery/computer{desc = "A computer long since rendered non-functional due to lack of maintenance. Spitting out error messages."; dir = 4; name = "Broken Computer"},/turf/open/floor/plasteel/white,/area/ruin/space/has_grav/powered{name = "Unexplored Location"})
"Jo" = (/obj/effect/decal/cleanable/blood/splatter,/turf/open/floor/plasteel/white,/area/ruin/space/has_grav/powered{name = "Unexplored Location"})
"LR" = (/turf/open/floor/plasteel/white/corner{dir = 1},/area/ruin/space/has_grav/powered{name = "Unexplored Location"})
"LU" = (/obj/machinery/light/small{dir = 4},/turf/open/floor/plasteel/white,/area/ruin/space/has_grav/powered{name = "Unexplored Location"})
"MR" = (/obj/structure/chair{dir = 8},/obj/effect/mob_spawn/human/corpse/cargo_tech,/obj/machinery/light/small{dir = 4},/turf/open/floor/plasteel/white,/area/ruin/space/has_grav/powered{name = "Unexplored Location"})
"MT" = (/obj/effect/decal/cleanable/blood,/turf/open/floor/plasteel/white,/area/ruin/space/has_grav/powered{name = "Unexplored Location"})
"Nw" = (/obj/machinery/porta_turret/syndicate{dir = 4; pixel_x = -32; pixel_y = 4},/turf/template_noop,/area/template_noop)
"NJ" = (/turf/open/floor/plasteel/stairs/right,/area/ruin/space/has_grav/powered{name = "Unexplored Location"})
"OX" = (/turf/open/floor/plasteel/white/corner{dir = 8},/area/ruin/space/has_grav/powered{name = "Unexplored Location"})
"QT" = (/obj/effect/decal/cleanable/blood,/turf/open/floor/plasteel/white/corner{dir = 4},/area/ruin/space/has_grav/powered{name = "Unexplored Location"})
"Rg" = (/obj/machinery/porta_turret/syndicate{dir = 10; pixel_x = 32; pixel_y = 4},/turf/template_noop,/area/template_noop)
"Rj" = (/obj/effect/decal/cleanable/blood,/obj/machinery/light/small{dir = 4},/turf/open/floor/plasteel/white,/area/ruin/space/has_grav/powered{name = "Unexplored Location"})
"RA" = (/obj/structure/table,/obj/item/food/burger/bearger,/obj/machinery/light/small{dir = 8},/turf/open/floor/plasteel/white,/area/ruin/space/has_grav/powered{name = "Unexplored Location"})
"Sb" = (/obj/machinery/computer{desc = "A computer long since rendered non-functional due to lack of maintenance. Spitting out error messages."; dir = 1; name = "Broken Computer"},/turf/open/floor/plasteel/white,/area/ruin/space/has_grav/powered{name = "Unexplored Location"})
"SQ" = (/turf/open/floor/plasteel/white/side,/area/ruin/space/has_grav/powered{name = "Unexplored Location"})
"Us" = (/obj/structure/chair{dir = 4},/obj/effect/mob_spawn/human/corpse/assistant,/obj/machinery/light/small{dir = 8},/turf/open/floor/plasteel/white,/area/ruin/space/has_grav/powered{name = "Unexplored Location"})
"Vw" = (/turf/open/floor/plasteel/stairs/medium,/area/ruin/space/has_grav/powered{name = "Unexplored Location"})
"Vy" = (/mob/living/simple_animal/hostile/russian/ranged/trooper,/turf/open/floor/plasteel/white,/area/ruin/space/has_grav/powered{name = "Unexplored Location"})
"Wt" = (/obj/machinery/porta_turret/syndicate{dir = 6; pixel_x = -32; pixel_y = 4},/turf/template_noop,/area/template_noop)
"Xa" = (/obj/structure/table,/obj/item/food/burger/bearger,/turf/open/floor/plasteel/white,/area/ruin/space/has_grav/powered{name = "Unexplored Location"})
"XH" = (/obj/structure/table,/obj/item/food/meat/steak/bear,/obj/machinery/light/small{dir = 4},/turf/open/floor/plasteel/white,/area/ruin/space/has_grav/powered{name = "Unexplored Location"})
"XQ" = (/mob/living/simple_animal/hostile/russian/ranged/mosin,/turf/open/floor/plasteel/white/corner{dir = 8},/area/ruin/space/has_grav/powered{name = "Unexplored Location"})
"Zp" = (/obj/structure/chair/office{dir = 1},/turf/open/floor/plasteel/white,/area/ruin/space/has_grav/powered{name = "Unexplored Location"})
"ZG" = (/obj/item/gps/spaceruin,/turf/open/floor/plasteel/white,/area/ruin/space/has_grav/powered{name = "Unexplored Location"})

(1,1,1) = {"
daysysysysxjxjxjxjxjxjxjysysysysda
daysRAvAvAvAHctmtmtmHcvAvAvAXHysda
daxjevtmZptmtmtmtmtmtmtmZptmnHxjda
daxjevtmtmtmtmtmtmtmtmtmtmtmevxjda
RgysystmtmtmtmtmtmtmtmtmtmtmysysWt
dadaysyszutmtmtmtmtmtmtmbrysysdada
dadadaysnHEDOXBfSQOXBfXQevysdadada
dadadaysevXaxptmtmJoxpHQXaysdadada
daysysysysysysnGVwNJysysysysysysda
dayshGMTXaevfVtmtmtmfVnHevtmDDysda
daHqtmtmkxICLRICIhLRQTLRkxtmtmHqda
daystmJotmtmtmtmtmtmtmtmtmtmtmysda
ysysystmtmRjysnFtmnFysxotmtmysysys
ysIRHytmtmtmnFIUcPqgnFtmMTtmHyCXys
ysysystmtmtmnFtmVytmnFtmtmtmysysys
ysUsHytmJotmnFIUwOqgnFtmtmtmHyMRys
ysysystmtmtmnFtmVytmnFtmtmtmysysys
ysUsHytmtmtmnFIUcPqgnFtmtmtmHyMRys
ysysystmtmtmysnFnFnFystmtmtmysysys
daysnHtmtmtmHctmtmtmHctmtmtmzyysda
daysyQkxtmtmtmtmtmtmtmtmtmkxXHysda
daysevtmtmtmysysysysystmtmtmXaysda
daystmtmtmLUysZGCwisysxotmtmtmysda
daystmtmtmtmysioHyioystmtmtmtmysda
kuysevtmtmtmtmtmtmtmtmtmtmtmnHysNw
daysnrevHQtmoYtmtmtmoYtmHQevoIysda
daysqUqUqUysSbtmxptmSbysqUqUqUysda
daysdIdIdIysqUqUysqUqUysdIdIdIysda
daysdIdIdIysdIdIysdIdIysdIdIdIysda
dayslklTlTysuUlTysuUlTyslklTlTysda
"}
