//MAP CONVERTED BY dmm2tgm.py THIS HEADER COMMENT PREVENTS RECONVERSION, DO NOT REMOVE
"a" = (
/obj/machinery/vending/dorms,
/turf/template_noop,
/area/template_noop)

(1,1,1) = {"
a
"}
