//MAP CONVERTED BY dmm2tgm.py THIS HEADER COMMENT PREVENTS RECONVERSION, DO NOT REMOVE
"a" = (
/obj/machinery/cryopod/prison/directional/west{
	quiet = 1
	},
/turf/template_noop,
/area/template_noop)
"r" = (
/obj/machinery/cryopod/prison/directional/north,
/turf/template_noop,
/area/template_noop)
"P" = (
/turf/template_noop,
/area/template_noop)

(1,1,1) = {"
r
P
P
P
P
a
"}
