//MAP CONVERTED BY dmm2tgm.py THIS HEADER COMMENT PREVENTS RECONVERSION, DO NOT REMOVE
"a" = (
/obj/machinery/atmospherics/components/unary/delam_scram/directional/west,
/turf/template_noop,
/area/template_noop)
"q" = (
/obj/effect/turf_decal/stripes/red/box,
/turf/template_noop,
/area/template_noop)
"s" = (
/obj/structure/cable,
/obj/machinery/incident_display/delam/directional/north,
/turf/open/floor/iron/half{
	dir = 1
	},
/area/station/engineering/lobby)
"x" = (
/turf/template_noop,
/area/template_noop)
"I" = (
/obj/effect/spawner/structure/window/reinforced/plasma,
/obj/structure/cable,
/obj/item/folder/biscuit/confidential/delam,
/turf/open/floor/plating,
/area/station/engineering/supermatter/room)
"O" = (
/obj/machinery/button/delam_scram,
/turf/closed/wall/r_wall,
/area/station/engineering/supermatter/room)
"S" = (
/obj/effect/turf_decal/stripes/red/box,
/turf/open/floor/iron/half{
	dir = 1
	},
/area/station/engineering/lobby)

(1,1,1) = {"
s
S
x
x
"}
(2,1,1) = {"
I
O
x
x
"}
(3,1,1) = {"
x
q
x
x
"}
(4,1,1) = {"
x
x
x
x
"}
(5,1,1) = {"
x
x
x
x
"}
(6,1,1) = {"
x
x
x
x
"}
(7,1,1) = {"
x
x
x
x
"}
(8,1,1) = {"
x
x
x
a
"}
