//MAP CONVERTED BY dmm2tgm.py THIS HEADER COMMENT PREVENTS RECONVERSION, DO NOT REMOVE
"a" = (
/turf/template_noop,
/area/template_noop)
"b" = (
/obj/effect/spawner/structure/window/reinforced,
/turf/open/floor/plating,
/area/station/hallway/floor2/fore)
"c" = (
/obj/docking_port/stationary{
	dheight = 3;
	dir = 8;
	dwidth = 8;
	height = 11;
	shuttle_id = "ferry_home";
	name = "Port Bay 2";
	width = 20
	},
/turf/template_noop,
/area/template_noop)
"e" = (
/obj/structure/marker_beacon/lime,
/turf/template_noop,
/area/template_noop)
"i" = (
/obj/effect/spawner/random/vending/snackvend,
/turf/open/floor/iron/dark,
/area/station/hallway/floor2/fore)
"m" = (
/turf/closed/wall,
/area/station/hallway/floor2/fore)
"r" = (
/turf/open/floor/iron/dark/side{
	dir = 8
	},
/area/station/hallway/floor2/fore)
"t" = (
/obj/machinery/door/airlock/external{
	name = "Transport Airlock"
	},
/obj/effect/mapping_helpers/airlock/cyclelink_helper{
	dir = 4
	},
/turf/open/floor/iron/dark/textured,
/area/station/hallway/floor2/fore)
"u" = (
/obj/structure/marker_beacon/burgundy,
/turf/template_noop,
/area/template_noop)
"w" = (
/obj/machinery/airalarm/directional/west,
/obj/machinery/light/directional/west,
/turf/open/floor/iron/dark/side{
	dir = 9
	},
/area/station/hallway/floor2/fore)
"x" = (
/obj/effect/turf_decal/stripes/line{
	dir = 8
	},
/turf/open/floor/iron/dark/textured,
/area/station/hallway/floor2/fore)
"J" = (
/obj/machinery/camera/autoname/directional/west,
/obj/machinery/light/directional/west,
/turf/open/floor/iron/dark/side{
	dir = 8
	},
/area/station/hallway/floor2/fore)
"O" = (
/obj/machinery/door/airlock/external{
	name = "Transport Airlock"
	},
/obj/effect/mapping_helpers/airlock/cyclelink_helper{
	dir = 8
	},
/turf/open/floor/iron/dark/textured,
/area/station/hallway/floor2/fore)
"P" = (
/obj/structure/sign/nanotrasen,
/turf/closed/wall,
/area/station/hallway/floor2/fore)
"R" = (
/obj/item/radio/intercom/directional/west,
/obj/effect/spawner/random/engineering/tracking_beacon,
/turf/open/floor/iron/dark/side{
	dir = 10
	},
/area/station/hallway/floor2/fore)
"U" = (
/turf/open/floor/engine/hull/reinforced,
/area/template_noop)
"Z" = (
/turf/open/floor/iron/dark/textured,
/area/station/hallway/floor2/fore)

(1,1,1) = {"
a
a
a
a
a
a
a
a
a
a
a
a
a
a
a
a
a
a
a
a
a
a
a
a
"}
(2,1,1) = {"
a
e
a
a
a
a
a
a
e
a
a
a
a
a
a
u
a
a
a
a
a
a
u
a
"}
(3,1,1) = {"
a
a
a
a
a
a
a
a
a
a
a
a
a
a
a
a
a
a
a
a
a
a
a
a
"}
(4,1,1) = {"
a
a
a
a
a
a
a
a
a
a
a
a
a
a
a
a
a
a
a
a
a
a
a
a
"}
(5,1,1) = {"
a
a
a
a
a
a
a
a
a
a
a
a
a
a
a
a
a
a
a
a
a
a
a
a
"}
(6,1,1) = {"
a
a
a
a
a
a
a
a
a
a
a
a
a
a
a
a
a
a
a
a
a
a
a
a
"}
(7,1,1) = {"
a
e
a
a
a
a
a
a
a
a
a
a
a
a
a
a
a
a
a
a
a
a
u
a
"}
(8,1,1) = {"
a
a
a
a
a
a
a
a
a
a
a
a
a
a
a
a
a
a
a
a
a
a
a
a
"}
(9,1,1) = {"
a
a
a
a
a
a
a
a
a
a
a
a
a
c
a
a
a
a
a
a
a
a
a
a
"}
(10,1,1) = {"
a
a
a
a
a
a
a
a
a
a
a
b
t
t
b
a
a
a
a
a
a
a
a
a
"}
(11,1,1) = {"
a
a
a
a
a
a
a
a
a
a
a
b
x
x
b
a
a
a
a
a
a
a
a
a
"}
(12,1,1) = {"
a
e
a
a
a
a
a
a
e
a
a
b
Z
Z
b
u
a
a
a
a
a
a
u
a
"}
(13,1,1) = {"
a
a
a
a
a
a
a
a
a
a
m
b
Z
Z
b
m
m
m
m
a
a
a
a
a
"}
(14,1,1) = {"
a
a
a
a
a
a
a
a
a
a
m
b
O
O
b
P
m
m
m
a
a
a
a
a
"}
(15,1,1) = {"
a
a
a
a
a
a
a
a
a
a
w
r
r
r
r
J
R
i
m
a
a
a
a
a
"}

(1,1,2) = {"
a
a
a
a
a
a
a
a
a
a
a
a
a
a
a
a
a
a
a
a
a
a
a
a
"}
(2,1,2) = {"
a
a
a
a
a
a
a
a
a
a
a
a
a
a
a
a
a
a
a
a
a
a
a
a
"}
(3,1,2) = {"
a
a
a
a
a
a
a
a
a
a
a
a
a
a
a
a
a
a
a
a
a
a
a
a
"}
(4,1,2) = {"
a
a
a
a
a
a
a
a
a
a
a
a
a
a
a
a
a
a
a
a
a
a
a
a
"}
(5,1,2) = {"
a
a
a
a
a
a
a
a
a
a
a
a
a
a
a
a
a
a
a
a
a
a
a
a
"}
(6,1,2) = {"
a
a
a
a
a
a
a
a
a
a
a
a
a
a
a
a
a
a
a
a
a
a
a
a
"}
(7,1,2) = {"
a
a
a
a
a
a
a
a
a
a
a
a
a
a
a
a
a
a
a
a
a
a
a
a
"}
(8,1,2) = {"
a
a
a
a
a
a
a
a
a
a
a
a
a
a
a
a
a
a
a
a
a
a
a
a
"}
(9,1,2) = {"
a
a
a
a
a
a
a
a
a
a
a
a
a
a
a
a
a
a
a
a
a
a
a
a
"}
(10,1,2) = {"
a
a
a
a
a
a
a
a
a
a
a
U
U
U
U
a
a
a
a
a
a
a
a
a
"}
(11,1,2) = {"
a
a
a
a
a
a
a
a
a
a
a
U
U
U
U
a
a
a
a
a
a
a
a
a
"}
(12,1,2) = {"
a
a
a
a
a
a
a
a
a
a
a
U
a
a
a
a
a
a
a
a
a
a
a
a
"}
(13,1,2) = {"
a
a
a
a
a
a
a
a
a
a
a
a
a
a
a
a
a
a
a
a
a
a
a
a
"}
(14,1,2) = {"
a
a
a
a
a
a
a
a
a
a
a
a
a
a
a
a
a
a
a
a
a
a
a
a
"}
(15,1,2) = {"
a
a
a
a
a
a
a
a
a
a
a
a
a
a
a
a
a
a
a
a
a
a
a
a
"}
