//MAP CONVERTED BY dmm2tgm.py THIS HEADER COMMENT PREVENTS RECONVERSION, DO NOT REMOVE
"a" = (
/turf/template_noop,
/area/template_noop)
"b" = (
/obj/effect/turf_decal/tile/purple{
	dir = 1
	},
/obj/effect/turf_decal/tile/purple,
/obj/structure/closet/secure_closet/barber,
/obj/machinery/camera/directional/west,
/obj/machinery/firealarm/directional/west,
/turf/open/floor/iron,
/area/station/service/barber)
"c" = (
/obj/structure/table/glass,
/obj/effect/turf_decal/tile/purple{
	dir = 1
	},
/obj/effect/turf_decal/tile/purple,
/obj/structure/mirror/directional/east,
/obj/item/reagent_containers/spray/barbers_aid{
	pixel_x = 6
	},
/obj/item/razor{
	pixel_x = -6
	},
/turf/open/floor/iron,
/area/station/service/barber)
"d" = (
/obj/effect/turf_decal/tile/purple{
	dir = 1
	},
/obj/structure/table/wood,
/obj/machinery/power/apc/auto_name/directional/west,
/obj/structure/cable,
/obj/effect/turf_decal/tile/purple,
/obj/item/lipstick/random,
/turf/open/floor/iron,
/area/station/service/barber)
"e" = (
/obj/machinery/vending/barbervend,
/obj/effect/turf_decal/tile/purple{
	dir = 1
	},
/obj/effect/turf_decal/tile/purple,
/turf/open/floor/iron,
/area/station/service/barber)
"k" = (
/obj/structure/disposalpipe/segment,
/obj/effect/spawner/structure/window/reinforced,
/obj/structure/curtain/cloth/fancy/mechanical{
	id = "barbershopcurtains"
	},
/turf/open/floor/plating,
/area/station/service/barber)
"l" = (
/obj/machinery/atmospherics/pipe/smart/manifold4w/supply/hidden/layer4,
/obj/machinery/atmospherics/pipe/smart/manifold4w/scrubbers/hidden/layer2,
/obj/structure/cable,
/obj/machinery/door/airlock/service{
	name = "Barber"
	},
/obj/machinery/door/firedoor/solid,
/turf/open/floor/iron/white,
/area/station/service/barber)
"m" = (
/obj/structure/table/glass,
/obj/effect/turf_decal/tile/purple{
	dir = 1
	},
/obj/effect/turf_decal/tile/purple,
/obj/structure/mirror/directional/east,
/obj/item/reagent_containers/dropper,
/obj/item/hairbrush/comb{
	pixel_y = 10
	},
/turf/open/floor/iron,
/area/station/service/barber)
"n" = (
/obj/machinery/atmospherics/pipe/smart/manifold4w/supply/hidden/layer4,
/obj/machinery/atmospherics/pipe/smart/manifold4w/scrubbers/hidden/layer2,
/obj/structure/cable,
/obj/effect/turf_decal/tile/purple{
	dir = 1
	},
/obj/effect/turf_decal/tile/purple,
/turf/open/floor/iron,
/area/station/service/barber)
"q" = (
/obj/structure/sink/directional/east,
/obj/structure/mirror/directional/west,
/turf/open/floor/iron/checker,
/area/station/service/barber)
"s" = (
/obj/effect/turf_decal/tile/purple{
	dir = 1
	},
/obj/effect/turf_decal/tile/purple,
/obj/structure/chair/comfy/barber_chair{
	dir = 4
	},
/obj/machinery/light/directional/south,
/obj/machinery/airalarm/directional/south,
/turf/open/floor/iron,
/area/station/service/barber)
"u" = (
/obj/structure/table/glass,
/obj/effect/turf_decal/tile/purple{
	dir = 1
	},
/obj/effect/turf_decal/tile/purple,
/obj/item/lipstick/random,
/obj/item/reagent_containers/spray/quantum_hair_dye{
	pixel_x = 6
	},
/obj/machinery/button/curtain{
	id = "barbershopcurtains";
	pixel_y = 2;
	pixel_x = 26;
	dir = 8
	},
/turf/open/floor/iron,
/area/station/service/barber)
"v" = (
/turf/closed/wall,
/area/station/service/barber)
"w" = (
/obj/machinery/camera/autoname/directional/west,
/obj/structure/closet/secure_closet/psychology,
/obj/structure/cable,
/turf/open/floor/wood/parquet,
/area/station/medical/psychology)
"A" = (
/obj/structure/bed/pod,
/turf/open/floor/iron/checker,
/area/station/service/barber)
"B" = (
/obj/machinery/atmospherics/pipe/smart/manifold4w/supply/hidden/layer4,
/obj/machinery/atmospherics/pipe/smart/manifold4w/scrubbers/hidden/layer2,
/obj/effect/turf_decal/tile/purple{
	dir = 1
	},
/obj/effect/turf_decal/tile/purple,
/turf/open/floor/iron,
/area/station/service/barber)
"D" = (
/obj/machinery/door/airlock/service{
	name = "Barber"
	},
/obj/effect/mapping_helpers/airlock/access/any/service/maintenance,
/obj/machinery/door/firedoor/solid,
/turf/open/floor/plating,
/area/station/service/barber)
"E" = (
/obj/effect/turf_decal/tile/purple{
	dir = 1
	},
/obj/effect/turf_decal/tile/purple,
/obj/machinery/atmospherics/components/unary/vent_pump/on/layer4{
	dir = 1
	},
/turf/open/floor/iron,
/area/station/service/barber)
"H" = (
/obj/effect/turf_decal/tile/purple{
	dir = 1
	},
/obj/effect/turf_decal/tile/purple,
/obj/structure/chair/comfy/barber_chair{
	dir = 4
	},
/turf/open/floor/iron,
/area/station/service/barber)
"J" = (
/obj/effect/turf_decal/tile/purple{
	dir = 1
	},
/obj/effect/turf_decal/tile/purple,
/obj/effect/landmark/start/barber,
/obj/machinery/atmospherics/components/unary/vent_scrubber/on/layer2{
	dir = 8
	},
/turf/open/floor/iron,
/area/station/service/barber)
"M" = (
/obj/structure/chair/office/light{
	dir = 4
	},
/turf/open/floor/iron/checker,
/area/station/service/barber)
"N" = (
/obj/structure/cable,
/turf/template_noop,
/area/template_noop)
"R" = (
/obj/machinery/dryer{
	pixel_y = 29
	},
/turf/open/floor/iron/checker,
/area/station/service/barber)
"S" = (
/obj/machinery/power/apc/auto_name/directional/west,
/obj/structure/cable,
/turf/template_noop,
/area/template_noop)
"V" = (
/obj/machinery/door/morgue,
/turf/open/floor/iron/checker,
/area/station/service/barber)
"W" = (
/obj/effect/landmark/start/hangover,
/turf/open/floor/iron/checker,
/area/station/service/barber)
"X" = (
/obj/effect/spawner/structure/window/reinforced,
/obj/structure/curtain/cloth/fancy/mechanical{
	id = "barbershopcurtains"
	},
/turf/open/floor/plating,
/area/station/service/barber)
"Z" = (
/obj/structure/table/glass,
/obj/item/hairbrush,
/obj/item/lipstick/random,
/obj/machinery/light/small/directional/east,
/turf/open/floor/iron/checker,
/area/station/service/barber)

(1,1,1) = {"
a
a
a
a
a
a
a
a
a
a
a
"}
(2,1,1) = {"
a
v
v
v
v
v
a
a
a
a
a
"}
(3,1,1) = {"
a
X
d
b
e
v
v
v
v
a
a
"}
(4,1,1) = {"
N
l
n
B
E
V
W
q
D
a
a
"}
(5,1,1) = {"
a
X
H
J
s
v
R
M
v
a
a
"}
(6,1,1) = {"
a
k
m
u
c
v
Z
A
v
a
a
"}
(7,1,1) = {"
a
v
v
v
v
v
v
v
v
w
S
"}
