//MAP CONVERTED BY dmm2tgm.py THIS HEADER COMMENT PREVENTS RECONVERSION, DO NOT REMOVE
"a" = (
/turf/template_noop,
/area/template_noop)
"b" = (
/obj/machinery/atmospherics/components/unary/delam_scram/directional/west,
/turf/template_noop,
/area/template_noop)
"c" = (
/obj/effect/spawner/structure/window/reinforced/plasma,
/obj/structure/cable,
/turf/open/floor/plating,
/area/station/engineering/supermatter/room)
"e" = (
/obj/machinery/atmospherics/pipe/smart/manifold4w/scrubbers/hidden/layer2,
/obj/structure/cable,
/obj/machinery/atmospherics/pipe/smart/manifold4w/supply/hidden/layer4,
/obj/structure/disposalpipe/segment{
	dir = 4
	},
/obj/machinery/incident_display/delam/directional/north,
/turf/open/floor/iron,
/area/station/engineering/lobby)
"n" = (
/obj/machinery/button/door/directional/north{
	id = "Secure Storage";
	req_access = list("engineering")
	},
/turf/template_noop,
/area/template_noop)
"o" = (
/obj/structure/sign/delam_procedure/directional/west,
/turf/template_noop,
/area/template_noop)
"q" = (
/obj/effect/turf_decal/stripes/red/box,
/turf/template_noop,
/area/template_noop)
"v" = (
/obj/structure/cable,
/turf/open/floor/iron/half{
	dir = 1
	},
/area/station/engineering/lobby)
"y" = (
/obj/effect/turf_decal/tile/red{
	dir = 8
	},
/obj/machinery/atmospherics/pipe/smart/manifold4w/scrubbers/hidden/layer2,
/obj/structure/cable,
/obj/machinery/atmospherics/pipe/smart/manifold4w/supply/hidden/layer4,
/obj/structure/disposalpipe/segment{
	dir = 4
	},
/turf/open/floor/iron,
/area/station/engineering/lobby)
"A" = (
/obj/machinery/button/delam_scram,
/turf/closed/wall/r_wall,
/area/station/engineering/supermatter/room)
"C" = (
/obj/effect/turf_decal/stripes/red/box,
/turf/open/floor/iron/half{
	dir = 1
	},
/area/station/engineering/lobby)
"P" = (
/obj/structure/sign/delam_procedure,
/turf/template_noop,
/area/template_noop)

(1,1,1) = {"
n
a
a
a
a
a
a
"}
(2,1,1) = {"
a
a
a
a
a
a
a
"}
(3,1,1) = {"
a
a
a
a
a
a
a
"}
(4,1,1) = {"
e
a
P
v
C
a
a
"}
(5,1,1) = {"
y
a
a
c
A
a
a
"}
(6,1,1) = {"
a
a
a
a
q
o
a
"}
(7,1,1) = {"
a
a
a
a
a
a
a
"}
(8,1,1) = {"
a
a
a
a
a
a
a
"}
(9,1,1) = {"
a
a
a
a
a
a
a
"}
(10,1,1) = {"
a
a
a
a
a
a
a
"}
(11,1,1) = {"
a
a
a
a
a
a
b
"}
