//MAP CONVERTED BY dmm2tgm.py THIS HEADER COMMENT PREVENTS RECONVERSION, DO NOT REMOVE
"a" = (
/turf/template_noop,
/area/template_noop)
"e" = (
/obj/structure/flora/ausbushes/sparsegrass,
/obj/structure/window/reinforced/spawner/east,
/turf/open/floor/plating/grass,
/area/template_noop)
"f" = (
/obj/structure/chair/sofa/bench/left,
/turf/open/floor/plating/grass,
/area/template_noop)
"g" = (
/obj/structure/flora/junglebush/c,
/turf/open/floor/plating/grass,
/area/template_noop)
"h" = (
/obj/machinery/light/directional/south,
/turf/open/floor/plating/grass,
/area/template_noop)
"i" = (
/obj/structure/flora/ausbushes/sparsegrass,
/turf/open/floor/plating/grass,
/area/template_noop)
"k" = (
/obj/structure/flora/rock/jungle,
/turf/open/floor/plating/grass,
/area/template_noop)
"l" = (
/obj/structure/chair/sofa/bench/right{
	dir = 8
	},
/turf/open/floor/plating/grass,
/area/template_noop)
"n" = (
/obj/structure/flora/tree/jungle/small{
	icon_state = "tree6"
	},
/turf/open/floor/plating/grass,
/area/template_noop)
"o" = (
/obj/machinery/light/directional/east,
/turf/open/floor/plating/grass,
/area/template_noop)
"p" = (
/obj/structure/flora/ausbushes/lavendergrass,
/obj/machinery/light/directional/north,
/turf/open/floor/plating/grass,
/area/template_noop)
"u" = (
/obj/structure/sign/poster/official/random{
	pixel_y = 32
	},
/turf/open/floor/plating/grass,
/area/template_noop)
"v" = (
/obj/structure/flora/ausbushes/lavendergrass,
/turf/open/floor/plating/grass,
/area/template_noop)
"w" = (
/obj/structure/flora/ausbushes/lavendergrass,
/obj/structure/sign/poster/official/random{
	pixel_y = -32
	},
/turf/open/floor/plating/grass,
/area/template_noop)
"x" = (
/obj/machinery/door/firedoor/border_only{
	dir = 4
	},
/obj/modular_map_connector,
/turf/open/floor/plating/cobblestone,
/area/template_noop)
"y" = (
/obj/structure/flora/ausbushes/brflowers,
/obj/machinery/light/directional/north,
/turf/open/floor/plating/grass,
/area/template_noop)
"z" = (
/obj/structure/chair/sofa/bench/right,
/turf/open/floor/plating/grass,
/area/template_noop)
"B" = (
/obj/structure/flora/junglebush/large,
/obj/machinery/light/directional/east,
/turf/open/floor/plating/grass,
/area/template_noop)
"D" = (
/turf/open/floor/plating/cobblestone,
/area/template_noop)
"G" = (
/obj/structure/flora/tree/jungle/small{
	icon_state = "tree5"
	},
/turf/open/floor/plating/grass,
/area/template_noop)
"H" = (
/obj/structure/flora/ausbushes/brflowers,
/turf/open/floor/plating/grass,
/area/template_noop)
"J" = (
/obj/structure/window/reinforced/spawner/east,
/turf/open/floor/plating/grass,
/area/template_noop)
"K" = (
/obj/structure/flora/ausbushes/leafybush,
/turf/open/floor/plating/grass,
/area/template_noop)
"M" = (
/turf/open/floor/plating/grass,
/area/template_noop)
"N" = (
/obj/machinery/door/firedoor/border_only{
	dir = 4
	},
/turf/open/floor/plating/cobblestone,
/area/template_noop)
"O" = (
/obj/structure/flora/ausbushes/sparsegrass,
/obj/structure/flora/ausbushes/lavendergrass,
/turf/open/floor/plating/grass,
/area/template_noop)
"S" = (
/obj/structure/flora/ausbushes/sparsegrass,
/obj/structure/chair/sofa/bench/left{
	dir = 8
	},
/turf/open/floor/plating/grass,
/area/template_noop)
"T" = (
/obj/structure/flora/junglebush,
/turf/open/floor/plating/grass,
/area/template_noop)
"Z" = (
/obj/structure/flora/ausbushes/leafybush,
/obj/machinery/light/directional/north,
/turf/open/floor/plating/grass,
/area/template_noop)

(1,1,1) = {"
a
p
g
l
S
a
a
"}
(2,1,1) = {"
a
i
D
D
D
H
a
"}
(3,1,1) = {"
a
D
D
n
D
i
a
"}
(4,1,1) = {"
a
Z
M
D
D
K
z
"}
(5,1,1) = {"
a
a
M
D
G
D
f
"}
(6,1,1) = {"
a
a
y
D
D
M
B
"}
(7,1,1) = {"
a
a
u
D
i
v
a
"}
(8,1,1) = {"
a
a
O
D
o
i
a
"}
(9,1,1) = {"
a
a
D
D
a
a
a
"}
(10,1,1) = {"
i
T
D
H
a
a
a
"}
(11,1,1) = {"
k
D
D
w
a
a
a
"}
(12,1,1) = {"
p
D
D
h
a
a
a
"}
(13,1,1) = {"
J
N
x
e
a
a
a
"}
