//MAP CONVERTED BY dmm2tgm.py THIS HEADER COMMENT PREVENTS RECONVERSION, DO NOT REMOVE
"a" = (
/turf/template_noop,
/area/template_noop)
"b" = (
/obj/structure/chair/sofa/bench/right{
	dir = 8
	},
/turf/open/floor/plating/asteroid/snow/indestructible/planet,
/area/template_noop)
"c" = (
/obj/effect/turf_decal/weather/snow/corner,
/obj/effect/turf_decal/weather/snow/corner{
	dir = 9
	},
/turf/open/floor/plating/cobblestone/planet,
/area/template_noop)
"d" = (
/obj/structure/flora/grass/green,
/turf/open/floor/plating/asteroid/snow/indestructible/planet,
/area/template_noop)
"g" = (
/obj/structure/sign/poster/official/random{
	pixel_y = -32
	},
/obj/effect/turf_decal/weather/snow/corner{
	dir = 5
	},
/turf/open/floor/plating/cobblestone/planet,
/area/template_noop)
"h" = (
/obj/structure/flora/rock/pile/icy,
/turf/open/floor/plating/asteroid/snow/indestructible/planet,
/area/template_noop)
"n" = (
/obj/structure/flora/grass/brown,
/turf/open/floor/plating/asteroid/snow/indestructible/planet,
/area/template_noop)
"q" = (
/obj/effect/turf_decal/weather/snow/corner{
	dir = 4
	},
/turf/open/floor/plating/cobblestone/planet,
/area/template_noop)
"r" = (
/obj/structure/flora/rock/icy,
/turf/open/floor/plating/asteroid/snow/indestructible/planet,
/area/template_noop)
"s" = (
/obj/effect/turf_decal/weather/snow/corner{
	dir = 6
	},
/turf/open/floor/plating/cobblestone/planet,
/area/template_noop)
"u" = (
/obj/machinery/light/directional/east,
/turf/open/floor/plating/asteroid/snow/indestructible/planet,
/area/template_noop)
"v" = (
/obj/effect/turf_decal/weather/snow/corner{
	dir = 10
	},
/turf/open/floor/plating/cobblestone/planet,
/area/template_noop)
"x" = (
/obj/machinery/door/firedoor/border_only{
	dir = 4
	},
/obj/modular_map_connector,
/obj/effect/turf_decal/weather/snow/corner,
/turf/open/floor/plating/cobblestone/planet,
/area/template_noop)
"z" = (
/obj/effect/turf_decal/weather/snow/corner{
	dir = 5
	},
/obj/effect/turf_decal/weather/snow/corner,
/turf/open/floor/plating/cobblestone/planet,
/area/template_noop)
"B" = (
/obj/structure/flora/grass/both,
/turf/open/floor/plating/asteroid/snow/indestructible/planet,
/area/template_noop)
"C" = (
/obj/effect/turf_decal/weather/snow/corner{
	dir = 9
	},
/turf/open/floor/plating/cobblestone/planet,
/area/template_noop)
"F" = (
/obj/machinery/light/directional/north,
/obj/structure/flora/grass/green,
/turf/open/floor/plating/asteroid/snow/indestructible/planet,
/area/template_noop)
"G" = (
/obj/effect/turf_decal/weather/snow/corner{
	dir = 1
	},
/turf/open/floor/plating/cobblestone/planet,
/area/template_noop)
"I" = (
/obj/effect/turf_decal/weather/snow/corner{
	dir = 8
	},
/turf/open/floor/plating/cobblestone/planet,
/area/template_noop)
"J" = (
/obj/machinery/light/directional/south,
/obj/structure/flora/grass/brown,
/turf/open/floor/plating/asteroid/snow/indestructible/planet,
/area/template_noop)
"K" = (
/obj/structure/chair/sofa/bench/left,
/turf/open/floor/plating/asteroid/snow/indestructible/planet,
/area/template_noop)
"L" = (
/obj/structure/window/reinforced/spawner/east,
/obj/structure/flora/grass/brown,
/turf/open/floor/plating/asteroid/snow/indestructible/planet,
/area/template_noop)
"M" = (
/obj/machinery/light/directional/north,
/turf/open/floor/plating/asteroid/snow/indestructible/planet,
/area/template_noop)
"N" = (
/obj/effect/turf_decal/weather/snow/corner{
	dir = 10
	},
/obj/effect/turf_decal/weather/snow/corner{
	dir = 1
	},
/turf/open/floor/plating/cobblestone/planet,
/area/template_noop)
"O" = (
/obj/structure/chair/sofa/bench/right,
/turf/open/floor/plating/asteroid/snow/indestructible/planet,
/area/template_noop)
"Q" = (
/obj/effect/turf_decal/weather/snow/corner{
	dir = 6
	},
/obj/effect/turf_decal/weather/snow/corner{
	dir = 1
	},
/turf/open/floor/plating/cobblestone/planet,
/area/template_noop)
"R" = (
/obj/machinery/door/firedoor/border_only{
	dir = 4
	},
/obj/effect/turf_decal/weather/snow/corner{
	dir = 9
	},
/turf/open/floor/plating/cobblestone/planet,
/area/template_noop)
"S" = (
/obj/structure/sign/poster/official/random{
	pixel_y = 32
	},
/obj/structure/flora/rock/pile/icy,
/turf/open/floor/plating/asteroid/snow/indestructible/planet,
/area/template_noop)
"T" = (
/turf/open/floor/plating/asteroid/snow/indestructible/planet,
/area/template_noop)
"W" = (
/obj/structure/flora/tree/pine{
	icon_state = "pine_2"
	},
/turf/open/floor/plating/asteroid/snow/indestructible/planet,
/area/template_noop)
"X" = (
/obj/structure/flora/tree/pine,
/turf/open/floor/plating/asteroid/snow/indestructible/planet,
/area/template_noop)
"Y" = (
/obj/structure/chair/sofa/bench/left{
	dir = 8
	},
/turf/open/floor/plating/asteroid/snow/indestructible/planet,
/area/template_noop)
"Z" = (
/obj/structure/window/reinforced/spawner/east,
/turf/open/floor/plating/asteroid/snow/indestructible/planet,
/area/template_noop)

(1,1,1) = {"
a
M
n
b
Y
a
a
"}
(2,1,1) = {"
a
I
v
T
d
T
a
"}
(3,1,1) = {"
a
q
q
v
T
B
a
"}
(4,1,1) = {"
a
M
d
z
T
h
O
"}
(5,1,1) = {"
a
a
T
W
c
T
K
"}
(6,1,1) = {"
a
a
M
C
s
d
u
"}
(7,1,1) = {"
a
a
S
Q
B
T
a
"}
(8,1,1) = {"
a
a
B
T
u
X
a
"}
(9,1,1) = {"
a
a
n
C
a
a
a
"}
(10,1,1) = {"
T
X
h
G
a
a
a
"}
(11,1,1) = {"
r
T
T
g
a
a
a
"}
(12,1,1) = {"
F
T
N
J
a
a
a
"}
(13,1,1) = {"
Z
R
x
L
a
a
a
"}
