//MAP CONVERTED BY dmm2tgm.py THIS HEADER COMMENT PREVENTS RECONVERSION, DO NOT REMOVE
"a" = (
/turf/template_noop,
/area/template_noop)
"d" = (
/obj/structure/flora/ausbushes/sparsegrass,
/turf/open/floor/plating/beach/sand,
/area/template_noop)
"e" = (
/obj/structure/flora/ausbushes/sparsegrass,
/obj/structure/flora/ausbushes/ppflowers,
/obj/machinery/light/directional/north,
/turf/open/floor/plating/beach/sand,
/area/template_noop)
"g" = (
/obj/machinery/light/directional/north,
/turf/open/floor/plating/beach/coastline_t/sandwater_inner{
	dir = 1
	},
/area/template_noop)
"i" = (
/obj/machinery/light/directional/north,
/obj/structure/flora/ausbushes/sparsegrass,
/obj/structure/flora/ausbushes/brflowers,
/turf/open/floor/plating/beach/sand,
/area/template_noop)
"k" = (
/obj/modular_map_connector,
/turf/open/floor/plating/beach/sand,
/area/template_noop)
"m" = (
/turf/open/floor/plating/beach/coastline_t{
	dir = 10
	},
/area/template_noop)
"u" = (
/obj/structure/flora/ausbushes/reedbush,
/turf/open/floor/plating/beach/coastline_t/sandwater_inner{
	dir = 8
	},
/area/template_noop)
"v" = (
/obj/machinery/light/directional/east,
/turf/open/floor/plating/beach/sand,
/area/template_noop)
"w" = (
/obj/effect/overlay/coconut,
/turf/open/floor/plating/beach/sand,
/area/template_noop)
"x" = (
/obj/structure/flora/tree/palm,
/turf/open/floor/plating/beach/coastline_t/sandwater_inner,
/area/template_noop)
"y" = (
/turf/open/floor/plating/beach/coastline_t,
/area/template_noop)
"z" = (
/obj/structure/fluff/beach_umbrella/security,
/turf/open/floor/plating/beach/coastline_t/sandwater_inner{
	dir = 8
	},
/area/template_noop)
"A" = (
/obj/machinery/light/directional/east,
/obj/item/toy/seashell,
/turf/open/floor/plating/beach/coastline_t,
/area/template_noop)
"C" = (
/obj/structure/sign/poster/official/random{
	pixel_y = -32
	},
/turf/open/floor/plating/beach/sand,
/area/template_noop)
"D" = (
/obj/machinery/light/directional/south,
/turf/open/floor/plating/beach/sand,
/area/template_noop)
"E" = (
/turf/open/floor/plating/beach/coastline_t/sandwater_inner{
	dir = 8
	},
/area/template_noop)
"F" = (
/obj/item/toy/seashell,
/turf/open/floor/plating/beach/coastline_t{
	dir = 10
	},
/area/template_noop)
"G" = (
/obj/structure/fluff/beach_umbrella/science,
/turf/open/floor/plating/beach/coastline_t/sandwater_inner{
	dir = 8
	},
/area/template_noop)
"H" = (
/obj/item/clothing/head/collectable/pirate{
	pixel_x = 2;
	pixel_y = -8
	},
/obj/structure/fluff{
	density = 1;
	desc = "Ha ha ha, you fool!";
	icon = 'icons/obj/stack_objects.dmi';
	icon_state = "sheet-gold_3";
	name = "fool's gold"
	},
/obj/item/reagent_containers/food/drinks/bottle/rum{
	pixel_x = -7;
	pixel_y = 2
	},
/turf/open/floor/plating/beach/coastline_t{
	dir = 5
	},
/area/template_noop)
"I" = (
/turf/open/floor/plating/beach/sand,
/area/template_noop)
"J" = (
/turf/open/floor/plating/beach/coastline_t/sandwater_inner,
/area/template_noop)
"L" = (
/turf/open/floor/plating/beach/coastline_t{
	dir = 6
	},
/area/template_noop)
"M" = (
/turf/open/floor/plating/beach/coastline_t{
	dir = 8
	},
/area/template_noop)
"R" = (
/turf/open/floor/plating/beach/coastline_t{
	dir = 4
	},
/area/template_noop)
"S" = (
/obj/structure/flora/tree/palm,
/turf/open/floor/plating/beach/sand,
/area/template_noop)
"T" = (
/obj/structure/flora/ausbushes/reedbush,
/obj/machinery/light/directional/east,
/turf/open/floor/plating/beach/coastline_t/sandwater_inner{
	dir = 1
	},
/area/template_noop)
"X" = (
/obj/structure/fluff/beach_umbrella,
/turf/open/floor/plating/beach/coastline_t{
	dir = 8
	},
/area/template_noop)
"Y" = (
/turf/open/floor/plating/beach/coastline_b,
/area/template_noop)
"Z" = (
/obj/structure/sign/poster/official/random{
	pixel_x = 32
	},
/turf/open/floor/plating/beach/sand,
/area/template_noop)

(1,1,1) = {"
e
I
u
F
Y
Y
Y
Y
Y
Y
Y
Y
H
a
"}
(2,1,1) = {"
I
I
d
G
M
M
M
X
m
Y
Y
Y
Y
Y
"}
(3,1,1) = {"
I
I
I
I
I
S
I
I
E
M
M
m
Y
Y
"}
(4,1,1) = {"
g
I
I
I
I
I
I
I
I
d
S
E
m
Y
"}
(5,1,1) = {"
a
d
w
J
R
T
d
Z
v
I
I
I
A
Y
"}
(6,1,1) = {"
a
i
x
L
Y
a
a
a
a
a
a
a
a
a
"}
(7,1,1) = {"
a
I
y
Y
Y
a
a
a
a
a
a
a
a
a
"}
(8,1,1) = {"
a
I
z
a
a
a
a
a
a
a
a
a
a
a
"}
(9,1,1) = {"
a
I
C
a
a
a
a
a
a
a
a
a
a
a
"}
(10,1,1) = {"
I
I
d
a
a
a
a
a
a
a
a
a
a
a
"}
(11,1,1) = {"
I
k
D
a
a
a
a
a
a
a
a
a
a
a
"}
