//MAP CONVERTED BY dmm2tgm.py THIS HEADER COMMENT PREVENTS RECONVERSION, DO NOT REMOVE
"a" = (
/turf/template_noop,
/area/template_noop)
"b" = (
/obj/structure/chair/sofa/bench/right{
	dir = 8
	},
/turf/open/floor/plating/beach/sand,
/area/template_noop)
"d" = (
/obj/structure/flora/tree/palm,
/turf/open/floor/plating/beach/sand,
/area/template_noop)
"e" = (
/obj/structure/flora/ausbushes/sparsegrass,
/obj/structure/flora/ausbushes/brflowers,
/turf/open/floor/plating/beach/sand,
/area/template_noop)
"g" = (
/obj/structure/sign/poster/official/random{
	pixel_y = -32
	},
/turf/open/floor/plating/beach/sand,
/area/template_noop)
"h" = (
/obj/structure/flora/ausbushes/sparsegrass,
/turf/open/floor/plating/beach/sand,
/area/template_noop)
"i" = (
/obj/structure/flora/ausbushes/sparsegrass,
/obj/structure/flora/ausbushes/ppflowers,
/turf/open/floor/plating/beach/sand,
/area/template_noop)
"j" = (
/obj/machinery/light/directional/north,
/obj/structure/flora/ausbushes/sparsegrass,
/obj/structure/flora/ausbushes/brflowers,
/turf/open/floor/plating/beach/sand,
/area/template_noop)
"k" = (
/obj/machinery/light/directional/east,
/obj/item/toy/seashell,
/turf/open/floor/plating/beach/coastline_t,
/area/template_noop)
"u" = (
/obj/machinery/light/directional/east,
/turf/open/floor/plating/beach/coastline_t/sandwater_inner{
	dir = 1
	},
/area/template_noop)
"w" = (
/obj/structure/flora/ausbushes/reedbush,
/turf/open/floor/plating/beach/coastline_t,
/area/template_noop)
"x" = (
/obj/machinery/door/firedoor/border_only{
	dir = 4
	},
/obj/modular_map_connector,
/turf/open/floor/plating/beach/sand,
/area/template_noop)
"y" = (
/obj/structure/flora/tree/palm,
/obj/structure/flora/ausbushes/reedbush,
/turf/open/floor/plating/beach/coastline_t/sandwater_inner,
/area/template_noop)
"z" = (
/turf/open/floor/plating/beach/coastline_t/sandwater_inner{
	dir = 4
	},
/area/template_noop)
"A" = (
/obj/item/toy/seashell,
/turf/open/floor/plating/beach/sand,
/area/template_noop)
"C" = (
/turf/open/floor/plating/beach/coastline_t{
	dir = 4
	},
/area/template_noop)
"D" = (
/obj/structure/fluff/beach_umbrella,
/turf/open/floor/plating/beach/coastline_t{
	dir = 1
	},
/area/template_noop)
"F" = (
/obj/machinery/light/directional/north,
/obj/structure/flora/ausbushes/reedbush,
/turf/open/floor/plating/beach/coastline_t{
	dir = 8
	},
/area/template_noop)
"G" = (
/turf/open/floor/plating/beach/coastline_b,
/area/template_noop)
"I" = (
/turf/open/floor/plating/beach/sand,
/area/template_noop)
"J" = (
/obj/machinery/light/directional/south,
/turf/open/floor/plating/beach/sand,
/area/template_noop)
"K" = (
/obj/structure/chair/sofa/bench/left,
/turf/open/floor/plating/beach/sand,
/area/template_noop)
"L" = (
/obj/structure/window/reinforced/spawner/east,
/turf/open/floor/plating/beach/sand,
/area/template_noop)
"M" = (
/obj/machinery/light/directional/north,
/turf/open/floor/plating/beach/sand,
/area/template_noop)
"O" = (
/obj/structure/chair/sofa/bench/right,
/turf/open/floor/plating/beach/sand,
/area/template_noop)
"R" = (
/obj/machinery/door/firedoor/border_only{
	dir = 4
	},
/turf/open/floor/plating/beach/sand,
/area/template_noop)
"S" = (
/obj/structure/sign/poster/official/random{
	pixel_y = 32
	},
/turf/open/floor/plating/beach/sand,
/area/template_noop)
"T" = (
/turf/open/floor/plating/beach/coastline_b{
	dir = 1
	},
/area/template_noop)
"U" = (
/mob/living/simple_animal/crab,
/turf/open/floor/plating/beach/sand,
/area/template_noop)
"X" = (
/obj/item/toy/seashell,
/turf/open/floor/plating/beach/coastline_t{
	dir = 1
	},
/area/template_noop)
"Y" = (
/obj/structure/chair/sofa/bench/left{
	dir = 8
	},
/turf/open/floor/plating/beach/sand,
/area/template_noop)
"Z" = (
/obj/structure/window/reinforced/spawner/east,
/obj/structure/flora/tree/palm,
/obj/effect/overlay/coconut,
/turf/open/floor/plating/beach/sand,
/area/template_noop)

(1,1,1) = {"
a
j
I
b
Y
a
a
"}
(2,1,1) = {"
a
I
I
I
h
U
a
"}
(3,1,1) = {"
a
I
I
I
I
I
a
"}
(4,1,1) = {"
a
M
d
I
I
h
O
"}
(5,1,1) = {"
a
a
i
I
I
A
K
"}
(6,1,1) = {"
a
a
M
I
y
C
u
"}
(7,1,1) = {"
a
a
S
h
w
G
a
"}
(8,1,1) = {"
a
a
I
I
k
G
a
"}
(9,1,1) = {"
a
a
I
I
a
a
a
"}
(10,1,1) = {"
T
D
I
I
a
a
a
"}
(11,1,1) = {"
T
X
e
g
a
a
a
"}
(12,1,1) = {"
F
z
I
J
a
a
a
"}
(13,1,1) = {"
Z
R
x
L
a
a
a
"}
