//MAP CONVERTED BY dmm2tgm.py THIS HEADER COMMENT PREVENTS RECONVERSION, DO NOT REMOVE
"a" = (
/turf/template_noop,
/area/template_noop)
"e" = (
/obj/machinery/light/directional/north,
/turf/open/floor/plating/grass,
/area/template_noop)
"f" = (
/obj/structure/flora/ausbushes/leafybush,
/turf/open/floor/plating/grass,
/area/template_noop)
"h" = (
/obj/structure/flora/tree/jungle/small{
	icon_state = "tree4"
	},
/turf/open/floor/plating/grass,
/area/template_noop)
"i" = (
/obj/structure/flora/ausbushes/brflowers,
/turf/open/floor/plating/grass,
/area/template_noop)
"k" = (
/obj/modular_map_connector,
/turf/open/floor/plating/cobblestone,
/area/template_noop)
"l" = (
/obj/structure/chair/sofa/bench/right{
	dir = 8
	},
/turf/open/floor/plating/grass,
/area/template_noop)
"n" = (
/obj/structure/sign/poster/official/random{
	pixel_y = -32
	},
/turf/open/floor/plating/cobblestone,
/area/template_noop)
"o" = (
/obj/structure/flora/rock/pile,
/turf/open/floor/plating/grass,
/area/template_noop)
"u" = (
/obj/structure/flora/ausbushes/fullgrass,
/obj/machinery/light/directional/south,
/turf/open/floor/plating/grass,
/area/template_noop)
"v" = (
/obj/item/storage/basket,
/obj/structure/fluff/beach_umbrella/science{
	pixel_x = 3;
	pixel_y = 14
	},
/turf/open/floor/carpet/red,
/area/template_noop)
"w" = (
/obj/structure/flora/tree/jungle/small{
	icon_state = "tree6"
	},
/turf/open/floor/plating/grass,
/area/template_noop)
"x" = (
/obj/machinery/light/directional/south,
/turf/open/floor/plating/grass,
/area/template_noop)
"y" = (
/obj/structure/flora/rock/jungle,
/turf/open/floor/plating/grass,
/area/template_noop)
"z" = (
/turf/open/floor/plating/grass,
/area/template_noop)
"B" = (
/obj/structure/flora/tree/jungle/small{
	icon_state = "tree5"
	},
/turf/open/floor/plating/grass,
/area/template_noop)
"D" = (
/turf/open/floor/plating/cobblestone,
/area/template_noop)
"G" = (
/obj/structure/flora/ausbushes/lavendergrass,
/turf/open/floor/plating/cobblestone,
/area/template_noop)
"H" = (
/obj/structure/flora/ausbushes/fullgrass,
/turf/open/floor/plating/grass,
/area/template_noop)
"J" = (
/obj/structure/sign/poster/official/random{
	pixel_x = 32
	},
/turf/open/floor/plating/grass,
/area/template_noop)
"K" = (
/obj/structure/flora/ausbushes/sparsegrass,
/turf/open/floor/plating/grass,
/area/template_noop)
"M" = (
/obj/structure/flora/junglebush,
/turf/open/floor/plating/grass,
/area/template_noop)
"N" = (
/obj/structure/flora/rock/jungle,
/obj/machinery/light/directional/east,
/turf/open/floor/plating/grass,
/area/template_noop)
"O" = (
/obj/machinery/light/directional/east,
/obj/item/toy/seashell,
/turf/open/floor/plating/grass,
/area/template_noop)
"S" = (
/obj/structure/chair/sofa/bench/left{
	dir = 8
	},
/turf/open/floor/plating/grass,
/area/template_noop)
"Z" = (
/obj/structure/flora/ausbushes/sparsegrass,
/obj/structure/flora/ausbushes/fullgrass,
/turf/open/floor/plating/grass,
/area/template_noop)

(1,1,1) = {"
e
K
H
z
z
o
z
z
z
z
l
S
z
a
"}
(2,1,1) = {"
D
f
i
D
v
z
z
B
D
H
z
z
H
z
"}
(3,1,1) = {"
D
D
D
z
H
D
D
D
D
D
D
H
i
z
"}
(4,1,1) = {"
e
z
D
D
D
D
z
z
Z
M
D
D
K
z
"}
(5,1,1) = {"
a
H
D
D
w
y
i
J
N
D
D
G
O
f
"}
(6,1,1) = {"
a
z
z
f
x
a
a
a
a
a
a
a
a
a
"}
(7,1,1) = {"
a
h
D
z
Z
a
a
a
a
a
a
a
a
a
"}
(8,1,1) = {"
a
e
D
a
a
a
a
a
a
a
a
a
a
a
"}
(9,1,1) = {"
a
z
n
a
a
a
a
a
a
a
a
a
a
a
"}
(10,1,1) = {"
z
D
o
a
a
a
a
a
a
a
a
a
a
a
"}
(11,1,1) = {"
D
k
u
a
a
a
a
a
a
a
a
a
a
a
"}
