//MAP CONVERTED BY dmm2tgm.py THIS HEADER COMMENT PREVENTS RECONVERSION, DO NOT REMOVE
"a" = (
/turf/template_noop,
/area/template_noop)
"b" = (
/obj/structure/chair/sofa/bench/right{
	dir = 8
	},
/turf/open/floor/plating/grass/jungle,
/area/template_noop)
"d" = (
/obj/structure/flora/tree/jungle/small{
	icon_state = "tree4"
	},
/turf/open/floor/plating/grass/jungle,
/area/template_noop)
"f" = (
/turf/open/floor/plating/dirt/jungle/dark,
/area/template_noop)
"g" = (
/obj/structure/sign/poster/official/random{
	pixel_y = -32
	},
/turf/open/floor/plating/grass/jungle,
/area/template_noop)
"h" = (
/obj/structure/flora/ausbushes/fullgrass,
/turf/open/floor/plating/grass/jungle,
/area/template_noop)
"j" = (
/obj/structure/flora/grass/jungle,
/obj/structure/flora/ausbushes/fernybush,
/turf/open/floor/plating/grass/jungle,
/area/template_noop)
"k" = (
/obj/machinery/light/directional/east,
/obj/structure/flora/rock/jungle,
/turf/open/floor/plating/grass/jungle,
/area/template_noop)
"m" = (
/obj/structure/flora/junglebush/c,
/turf/open/floor/plating/grass/jungle,
/area/template_noop)
"o" = (
/obj/structure/flora/rock/pile/largejungle,
/turf/open/floor/plating/grass/jungle,
/area/template_noop)
"p" = (
/obj/structure/flora/tree/jungle/small{
	icon_state = "tree5"
	},
/turf/open/floor/plating/grass/jungle,
/area/template_noop)
"u" = (
/obj/machinery/light/directional/east,
/turf/open/floor/plating/grass/jungle,
/area/template_noop)
"x" = (
/obj/machinery/door/firedoor/border_only{
	dir = 4
	},
/obj/modular_map_connector,
/turf/open/floor/plating/dirt/jungle/dark,
/area/template_noop)
"B" = (
/obj/structure/flora/grass/jungle,
/obj/structure/flora/ausbushes/fullgrass,
/turf/open/floor/plating/grass/jungle,
/area/template_noop)
"F" = (
/obj/machinery/light/directional/north,
/obj/structure/flora/junglebush/b,
/turf/open/floor/plating/grass/jungle,
/area/template_noop)
"H" = (
/obj/structure/flora/ausbushes/fernybush,
/turf/open/floor/plating/grass/jungle,
/area/template_noop)
"J" = (
/obj/machinery/light/directional/south,
/turf/open/floor/plating/grass/jungle,
/area/template_noop)
"K" = (
/obj/structure/chair/sofa/bench/left,
/turf/open/floor/plating/grass/jungle,
/area/template_noop)
"M" = (
/obj/machinery/light/directional/north,
/turf/open/floor/plating/grass/jungle,
/area/template_noop)
"O" = (
/obj/structure/chair/sofa/bench/right,
/turf/open/floor/plating/grass/jungle,
/area/template_noop)
"P" = (
/obj/structure/flora/tree/jungle,
/turf/open/floor/plating/grass/jungle,
/area/template_noop)
"Q" = (
/obj/structure/flora/junglebush/large,
/turf/open/floor/plating/grass/jungle,
/area/template_noop)
"R" = (
/obj/machinery/door/firedoor/border_only{
	dir = 4
	},
/turf/open/floor/plating/dirt/jungle/dark,
/area/template_noop)
"S" = (
/obj/structure/sign/poster/official/random{
	pixel_y = 32
	},
/obj/structure/flora/junglebush/large{
	icon_state = "bush3"
	},
/turf/open/floor/plating/grass/jungle,
/area/template_noop)
"T" = (
/turf/open/floor/plating/grass/jungle,
/area/template_noop)
"V" = (
/obj/structure/flora/junglebush/b,
/turf/open/floor/plating/grass/jungle,
/area/template_noop)
"W" = (
/obj/structure/flora/rock/jungle,
/turf/open/floor/plating/grass/jungle,
/area/template_noop)
"X" = (
/obj/structure/flora/grass/jungle,
/turf/open/floor/plating/grass/jungle,
/area/template_noop)
"Y" = (
/obj/structure/chair/sofa/bench/left{
	dir = 8
	},
/turf/open/floor/plating/grass/jungle,
/area/template_noop)
"Z" = (
/obj/structure/window/reinforced/spawner/east,
/turf/open/floor/plating/grass/jungle,
/area/template_noop)

(1,1,1) = {"
a
M
T
b
Y
a
a
"}
(2,1,1) = {"
a
f
B
W
T
X
a
"}
(3,1,1) = {"
a
T
f
h
Q
T
a
"}
(4,1,1) = {"
a
M
d
m
j
h
O
"}
(5,1,1) = {"
a
a
B
f
f
T
K
"}
(6,1,1) = {"
a
a
M
f
p
V
u
"}
(7,1,1) = {"
a
a
S
f
B
T
a
"}
(8,1,1) = {"
a
a
B
f
k
T
a
"}
(9,1,1) = {"
a
a
T
f
a
a
a
"}
(10,1,1) = {"
T
X
f
H
a
a
a
"}
(11,1,1) = {"
X
o
B
g
a
a
a
"}
(12,1,1) = {"
F
P
f
J
a
a
a
"}
(13,1,1) = {"
Z
R
x
Z
a
a
a
"}
