//MAP CONVERTED BY dmm2tgm.py THIS HEADER COMMENT PREVENTS RECONVERSION, DO NOT REMOVE
"a" = (
/turf/template_noop,
/area/template_noop)
"b" = (
/obj/structure/chair/sofa/bench/right{
	dir = 8
	},
/turf/open/floor/plating/sandy_dirt,
/area/template_noop)
"d" = (
/obj/structure/flora/rock/pile,
/turf/open/floor/plating/dirt/jungle/dark,
/area/template_noop)
"g" = (
/obj/structure/sign/poster/official/random{
	pixel_y = -32
	},
/turf/open/floor/plating/dirt/jungle/dark,
/area/template_noop)
"k" = (
/obj/machinery/light/directional/east,
/turf/open/floor/plating/dirt/jungle/dark,
/area/template_noop)
"n" = (
/obj/structure/flora/rock/pile,
/turf/open/floor/plating/sandy_dirt,
/area/template_noop)
"u" = (
/obj/machinery/light/directional/east,
/turf/open/floor/plating/sandy_dirt,
/area/template_noop)
"v" = (
/obj/machinery/light/directional/north,
/turf/open/floor/plating/dirt/jungle/dark,
/area/template_noop)
"x" = (
/obj/machinery/door/firedoor/border_only{
	dir = 4
	},
/obj/modular_map_connector,
/turf/open/floor/plating/cobblestone/dungeon,
/area/template_noop)
"B" = (
/turf/open/floor/plating/sandy_dirt,
/area/template_noop)
"C" = (
/obj/structure/flora/rock,
/turf/open/floor/plating/dirt/jungle/dark,
/area/template_noop)
"I" = (
/turf/open/floor/plating/cobblestone/dungeon,
/area/template_noop)
"J" = (
/obj/machinery/light/directional/south,
/obj/structure/flora/rock,
/turf/open/floor/plating/dirt/jungle/dark,
/area/template_noop)
"K" = (
/obj/structure/chair/sofa/bench/left,
/turf/open/floor/plating/sandy_dirt,
/area/template_noop)
"L" = (
/obj/structure/window/reinforced/spawner/east,
/turf/open/floor/plating/sandy_dirt,
/area/template_noop)
"M" = (
/obj/machinery/light/directional/north,
/turf/open/floor/plating/sandy_dirt,
/area/template_noop)
"O" = (
/obj/structure/chair/sofa/bench/right,
/turf/open/floor/plating/sandy_dirt,
/area/template_noop)
"P" = (
/obj/structure/flora/ausbushes/sparsegrass,
/turf/open/floor/plating/sandy_dirt,
/area/template_noop)
"R" = (
/obj/machinery/door/firedoor/border_only{
	dir = 4
	},
/turf/open/floor/plating/cobblestone/dungeon,
/area/template_noop)
"S" = (
/obj/structure/sign/poster/official/random{
	pixel_y = 32
	},
/obj/structure/flora/rock/pile,
/turf/open/floor/plating/sandy_dirt,
/area/template_noop)
"V" = (
/turf/open/floor/plating/dirt/jungle/dark,
/area/template_noop)
"X" = (
/turf/closed/indestructible/rock,
/area/template_noop)
"Y" = (
/obj/structure/chair/sofa/bench/left{
	dir = 8
	},
/turf/open/floor/plating/sandy_dirt,
/area/template_noop)
"Z" = (
/obj/structure/window/reinforced/spawner/east,
/obj/structure/flora/ausbushes/sparsegrass,
/turf/open/floor/plating/dirt/jungle/dark,
/area/template_noop)

(1,1,1) = {"
a
M
n
b
Y
a
a
"}
(2,1,1) = {"
a
I
I
V
P
B
a
"}
(3,1,1) = {"
a
I
I
I
I
B
a
"}
(4,1,1) = {"
a
M
d
I
C
I
O
"}
(5,1,1) = {"
a
a
V
I
I
I
K
"}
(6,1,1) = {"
a
a
v
I
I
n
u
"}
(7,1,1) = {"
a
a
S
I
V
X
a
"}
(8,1,1) = {"
a
a
B
V
k
X
a
"}
(9,1,1) = {"
a
a
P
I
a
a
a
"}
(10,1,1) = {"
X
X
I
I
a
a
a
"}
(11,1,1) = {"
X
n
I
g
a
a
a
"}
(12,1,1) = {"
M
I
I
J
a
a
a
"}
(13,1,1) = {"
Z
R
x
L
a
a
a
"}
