//MAP CONVERTED BY dmm2tgm.py THIS HEADER COMMENT PREVENTS RECONVERSION, DO NOT REMOVE
"a" = (
/turf/template_noop,
/area/template_noop)
"b" = (
/obj/structure/flora/ausbushes/stalkybush,
/obj/machinery/light/directional/north,
/turf/open/floor/plating/sandy_dirt,
/area/template_noop)
"d" = (
/obj/machinery/light/directional/north,
/turf/open/floor/plating/sandy_dirt,
/area/template_noop)
"g" = (
/obj/structure/flora/rock,
/obj/machinery/light/directional/north,
/turf/open/floor/plating/sandy_dirt,
/area/template_noop)
"k" = (
/obj/structure/flora/rock/pile,
/turf/open/floor/plating/sandy_dirt,
/area/template_noop)
"n" = (
/obj/structure/sign/poster/official/random{
	pixel_y = 32
	},
/turf/open/floor/plating/dirt/jungle/dark,
/area/template_noop)
"u" = (
/obj/structure/flora/ausbushes/sparsegrass,
/turf/open/floor/plating/dirt/jungle/dark,
/area/template_noop)
"v" = (
/obj/modular_map_connector,
/turf/open/floor/plating/cobblestone/dungeon,
/area/template_noop)
"x" = (
/obj/structure/flora/rock,
/turf/open/floor/plating/sandy_dirt,
/area/template_noop)
"B" = (
/turf/open/floor/plating/sandy_dirt,
/area/template_noop)
"C" = (
/turf/open/floor/plating/dirt/jungle/dark,
/area/template_noop)
"H" = (
/obj/structure/chair/sofa/bench/left,
/turf/open/floor/plating/sandy_dirt,
/area/template_noop)
"I" = (
/turf/open/floor/plating/cobblestone/dungeon,
/area/template_noop)
"J" = (
/turf/closed/indestructible/rock,
/area/template_noop)
"K" = (
/obj/structure/flora/ausbushes/sparsegrass,
/obj/structure/sign/poster/official/random{
	pixel_x = 32
	},
/turf/open/floor/plating/sandy_dirt,
/area/template_noop)
"L" = (
/obj/structure/chair/sofa/bench/right{
	dir = 8
	},
/turf/open/floor/plating/sandy_dirt,
/area/template_noop)
"M" = (
/obj/structure/flora/ausbushes/stalkybush,
/turf/open/floor/plating/sandy_dirt,
/area/template_noop)
"O" = (
/obj/structure/flora/rock,
/turf/open/floor/plating/dirt/jungle/dark,
/area/template_noop)
"P" = (
/obj/structure/chair/sofa/bench/left{
	dir = 8
	},
/turf/open/floor/plating/sandy_dirt,
/area/template_noop)
"R" = (
/obj/item/flashlight/lantern,
/turf/open/floor/plating/cobblestone/dungeon,
/area/template_noop)
"S" = (
/obj/structure/flora/ausbushes/sparsegrass,
/obj/machinery/light/directional/east,
/turf/open/floor/plating/sandy_dirt,
/area/template_noop)
"V" = (
/obj/structure/flora/ausbushes/sparsegrass,
/turf/open/floor/plating/sandy_dirt,
/area/template_noop)
"X" = (
/obj/structure/flora/rock/pile{
	icon_state = "basalt3"
	},
/turf/open/floor/plating/sandy_dirt,
/area/template_noop)
"Y" = (
/obj/machinery/light/directional/east,
/turf/open/floor/plating/sandy_dirt,
/area/template_noop)
"Z" = (
/obj/structure/chair/sofa/bench/right,
/turf/open/floor/plating/sandy_dirt,
/area/template_noop)

(1,1,1) = {"
b
V
B
k
L
P
B
B
M
B
B
B
B
a
"}
(2,1,1) = {"
C
I
I
B
C
B
B
I
I
B
V
B
B
Z
"}
(3,1,1) = {"
I
I
C
I
I
V
C
C
I
C
X
B
x
H
"}
(4,1,1) = {"
d
B
B
C
O
J
J
R
M
I
I
C
B
B
"}
(5,1,1) = {"
a
k
I
B
J
J
J
J
S
I
C
u
Y
K
"}
(6,1,1) = {"
a
d
u
x
J
a
a
a
a
a
a
a
a
a
"}
(7,1,1) = {"
a
C
B
J
J
a
a
a
a
a
a
a
a
a
"}
(8,1,1) = {"
a
C
I
a
a
a
a
a
a
a
a
a
a
a
"}
(9,1,1) = {"
a
n
C
a
a
a
a
a
a
a
a
a
a
a
"}
(10,1,1) = {"
g
u
C
a
a
a
a
a
a
a
a
a
a
a
"}
(11,1,1) = {"
I
v
B
a
a
a
a
a
a
a
a
a
a
a
"}
