//MAP CONVERTED BY dmm2tgm.py THIS HEADER COMMENT PREVENTS RECONVERSION, DO NOT REMOVE
"bm" = (
/turf/closed/wall/mineral/titanium/shuttle_wall/window/cargo{
	icon_state = "1,11"
	},
/area/shuttle/supply/cockpit)
"bT" = (
/obj/machinery/light/directional/west,
/obj/machinery/computer{
	desc = "This WAS a helmsman's console, before it became a coffee's console."
	},
/turf/open/floor/iron/shuttle/cargo,
/area/shuttle/supply/cockpit)
"cE" = (
/turf/closed/wall/mineral/titanium/shuttle_wall/window/cargo{
	icon_state = "0,0"
	},
/area/shuttle/supply)
"dg" = (
/obj/effect/decal/cleanable/oil/slippery,
/turf/open/floor/iron/shuttle/cargo,
/area/shuttle/supply)
"do" = (
/turf/closed/wall/mineral/titanium/shuttle_wall/cargo{
	icon_state = "3,10"
	},
/area/shuttle/supply/cockpit)
"ds" = (
/obj/docking_port/mobile/supply,
/obj/machinery/door/airlock/grunge{
	name = "Supply Shuttle Airlock";
	req_access = list("cargo")
	},
/turf/open/floor/iron/shuttle/cargo{
	icon_state = "floor_box"
	},
/area/shuttle/supply)
"dv" = (
/turf/closed/wall/mineral/titanium/shuttle_wall/cargo{
	icon_state = "1,1"
	},
/area/shuttle/supply)
"eb" = (
/turf/closed/wall/mineral/titanium/shuttle_wall/cargo{
	icon_state = "0,6"
	},
/area/shuttle/supply)
"fr" = (
/turf/closed/wall/mineral/titanium/shuttle_wall/cargo{
	icon_state = "4,1"
	},
/area/shuttle/supply)
"go" = (
/obj/machinery/button/door/directional/east{
	id = "QMLoaddoor2";
	name = "Loading Doors";
	pixel_y = 8
	},
/obj/machinery/button/door/directional/east{
	id = "QMLoaddoor";
	name = "Loading Doors";
	pixel_y = -8
	},
/obj/machinery/light/directional/east,
/turf/open/floor/iron/shuttle/cargo,
/area/shuttle/supply)
"jn" = (
/turf/closed/wall/mineral/titanium/shuttle_wall/cargo{
	icon_state = "1,8"
	},
/area/shuttle/supply/cockpit)
"kb" = (
/obj/effect/decal/cleanable/oil/streak,
/turf/open/floor/iron/shuttle/cargo,
/area/shuttle/supply)
"kz" = (
/obj/machinery/light/directional/west,
/obj/effect/decal/cleanable/dirt/dust,
/turf/open/floor/iron/shuttle/cargo{
	icon_state = "floor_mainta"
	},
/area/shuttle/supply)
"lq" = (
/turf/closed/wall/mineral/titanium/shuttle_wall/window/cargo{
	icon_state = "4,0"
	},
/area/shuttle/supply)
"lz" = (
/obj/machinery/light/directional/north,
/turf/open/floor/iron/shuttle/cargo,
/area/shuttle/supply)
"me" = (
/turf/closed/wall/mineral/titanium/shuttle_wall/cargo{
	icon_state = "0,11"
	},
/area/shuttle/supply/cockpit)
"mp" = (
/turf/closed/wall/mineral/titanium/shuttle_wall/cargo,
/area/shuttle/supply)
"mH" = (
/turf/closed/wall/mineral/titanium/shuttle_wall/cargo{
	icon_state = "6,6"
	},
/area/shuttle/supply)
"mP" = (
/obj/effect/decal/cleanable/dirt/dust,
/turf/open/floor/iron/shuttle/cargo{
	icon_state = "floor_box"
	},
/area/shuttle/supply)
"ob" = (
/turf/open/floor/iron/shuttle/cargo{
	icon_state = "floor_box"
	},
/area/shuttle/supply)
"qx" = (
/turf/closed/wall/mineral/titanium/shuttle_wall/cargo{
	icon_state = "6,3"
	},
/area/shuttle/supply)
"qN" = (
/obj/structure/chair/comfy/shuttle{
	dir = 1
	},
/obj/structure/closet/emcloset/wall{
	pixel_x = -28
	},
/obj/effect/decal/cleanable/dirt/dust,
/obj/item/radio/intercom/directional/south,
/turf/open/floor/iron/shuttle/cargo,
/area/shuttle/supply/cockpit)
"rY" = (
/obj/effect/decal/cleanable/dirt/dust,
/turf/open/floor/iron/shuttle/cargo{
	icon_state = "floor_maintb"
	},
/area/shuttle/supply)
"rZ" = (
/turf/closed/wall/mineral/titanium/shuttle_wall/cargo{
	icon_state = "6,10"
	},
/area/shuttle/supply)
"sa" = (
/obj/structure/table/reinforced,
/obj/item/paper/crumpled/muddy{
	info = "Toddy spilled his damn coffee all over the console, don't expect to manually pilot the Consign until we can get a repair guy. Which, uh, might be a while..."
	},
/turf/open/floor/iron/shuttle/cargo,
/area/shuttle/supply/cockpit)
"tp" = (
/turf/closed/wall/mineral/titanium/shuttle_wall/window/cargo{
	icon_state = "2,0"
	},
/area/shuttle/supply)
"uk" = (
/obj/machinery/conveyor{
	dir = 8;
	id = "QMLoad"
	},
/obj/machinery/door/poddoor{
	id = "QMLoaddoor";
	name = "Supply Dock Loading Door"
	},
/turf/open/floor/plating,
/area/shuttle/supply)
"uI" = (
/turf/closed/wall/mineral/titanium/shuttle_wall/window/cargo{
	icon_state = "2,11"
	},
/area/shuttle/supply/cockpit)
"vy" = (
/turf/closed/wall/mineral/titanium/shuttle_wall/cargo{
	icon_state = "0,5"
	},
/area/shuttle/supply)
"vF" = (
/turf/closed/wall/mineral/titanium/shuttle_wall/window/cargo{
	icon_state = "5,0"
	},
/area/shuttle/supply)
"wR" = (
/obj/machinery/door/airlock/grunge{
	name = "Supply Shuttle Airlock";
	req_access = list("cargo")
	},
/turf/open/floor/iron/shuttle/cargo{
	icon_state = "floor_box"
	},
/area/shuttle/supply)
"zx" = (
/turf/closed/wall/mineral/titanium/shuttle_wall/window/cargo{
	icon_state = "4,11"
	},
/area/shuttle/supply)
"zQ" = (
/turf/open/floor/iron/shuttle/cargo{
	icon_state = "floor_out"
	},
/area/shuttle/supply)
"FF" = (
/obj/structure/extinguisher_cabinet/directional/north,
/turf/open/floor/iron/shuttle/cargo,
/area/shuttle/supply)
"GD" = (
/turf/closed/wall/mineral/titanium/shuttle_wall/cargo{
	icon_state = "5,1"
	},
/area/shuttle/supply)
"Hd" = (
/turf/closed/wall/mineral/titanium/shuttle_wall/cargo{
	icon_state = "5,10"
	},
/area/shuttle/supply)
"Ho" = (
/turf/closed/wall/mineral/titanium/shuttle_wall/window/cargo{
	icon_state = "3,0"
	},
/area/shuttle/supply)
"Is" = (
/turf/closed/wall/mineral/titanium/shuttle_wall/window/cargo{
	icon_state = "1,0"
	},
/area/shuttle/supply)
"Iw" = (
/obj/structure/closet/shuttle/engivent{
	pixel_y = -33
	},
/turf/open/floor/iron/shuttle/cargo,
/area/shuttle/supply)
"IQ" = (
/turf/closed/wall/mineral/titanium/shuttle_wall/cargo{
	icon_state = "0,4"
	},
/area/shuttle/supply)
"Jp" = (
/turf/closed/wall/mineral/titanium/shuttle_wall/cargo{
	icon_state = "4,10"
	},
/area/shuttle/supply)
"MI" = (
/turf/closed/wall/mineral/titanium/shuttle_wall/cargo{
	icon_state = "3,11"
	},
/area/shuttle/supply/cockpit)
"MU" = (
/turf/closed/wall/mineral/titanium/shuttle_wall/cargo{
	icon_state = "0,9"
	},
/area/shuttle/supply/cockpit)
"OI" = (
/turf/closed/wall/mineral/titanium/shuttle_wall/cargo{
	icon_state = "6,9"
	},
/area/shuttle/supply)
"OZ" = (
/turf/closed/wall/mineral/titanium/shuttle_wall/cargo{
	icon_state = "2,1"
	},
/area/shuttle/supply)
"PA" = (
/obj/structure/chair/comfy/shuttle{
	dir = 1
	},
/obj/effect/decal/cleanable/dirt/dust,
/turf/open/floor/iron/shuttle/cargo,
/area/shuttle/supply/cockpit)
"Ro" = (
/obj/machinery/door/airlock/grunge{
	name = "Supply Shuttle Cockpit";
	req_access = list("cargo")
	},
/turf/open/floor/iron/shuttle/cargo,
/area/shuttle/supply/cockpit)
"Rr" = (
/turf/closed/wall/mineral/titanium/shuttle_wall/cargo{
	icon_state = "0,2"
	},
/area/shuttle/supply)
"RT" = (
/obj/effect/decal/cleanable/dirt/dust,
/turf/open/floor/iron/shuttle/cargo,
/area/shuttle/supply)
"Tj" = (
/turf/closed/wall/mineral/titanium/shuttle_wall/cargo{
	icon_state = "0,8"
	},
/area/shuttle/supply/cockpit)
"TR" = (
/turf/closed/wall/mineral/titanium/shuttle_wall/cargo{
	icon_state = "6,2"
	},
/area/shuttle/supply)
"Uz" = (
/turf/closed/wall/mineral/titanium/shuttle_wall/window/cargo{
	icon_state = "6,0"
	},
/area/shuttle/supply)
"UP" = (
/turf/closed/wall/mineral/titanium/shuttle_wall/cargo{
	icon_state = "0,1"
	},
/area/shuttle/supply)
"Vv" = (
/turf/closed/wall/mineral/titanium/shuttle_wall/cargo{
	icon_state = "0,10"
	},
/area/shuttle/supply/cockpit)
"VT" = (
/turf/closed/wall/mineral/titanium/shuttle_wall/cargo{
	icon_state = "6,1"
	},
/area/shuttle/supply)
"WL" = (
/turf/closed/wall/mineral/titanium/shuttle_wall/cargo{
	icon_state = "2,8"
	},
/area/shuttle/supply/cockpit)
"Xq" = (
/turf/open/floor/iron/shuttle/cargo,
/area/shuttle/supply)
"Xz" = (
/obj/machinery/conveyor{
	dir = 4;
	id = "QMLoad2"
	},
/obj/machinery/door/poddoor{
	id = "QMLoaddoor2";
	name = "Supply Dock Loading Door"
	},
/turf/open/floor/plating,
/area/shuttle/supply)
"XT" = (
/turf/closed/wall/mineral/titanium/shuttle_wall/cargo{
	icon_state = "0,3"
	},
/area/shuttle/supply)
"Ys" = (
/turf/template_noop,
/area/template_noop)
"YV" = (
/turf/closed/wall/mineral/titanium/shuttle_wall/cargo{
	icon_state = "0,7"
	},
/area/shuttle/supply)
"Zv" = (
/turf/closed/wall/mineral/titanium/shuttle_wall/cargo{
	icon_state = "3,8"
	},
/area/shuttle/supply/cockpit)
"Zz" = (
/turf/open/floor/iron/shuttle/cargo{
	icon_state = "floor_in"
	},
/area/shuttle/supply)

(1,1,1) = {"
me
Vv
MU
Tj
YV
eb
vy
IQ
XT
Rr
UP
cE
"}
(2,1,1) = {"
bm
bT
qN
jn
rY
kz
ob
ob
mP
mP
dv
Is
"}
(3,1,1) = {"
uI
sa
PA
WL
Xq
RT
ob
ob
ob
ob
OZ
tp
"}
(4,1,1) = {"
MI
do
Ro
Zv
FF
Xq
Xq
Xq
Xq
Iw
mp
Ho
"}
(5,1,1) = {"
zx
Jp
lz
RT
Xq
dg
kb
RT
Xq
Xq
fr
lq
"}
(6,1,1) = {"
Ys
Hd
Xq
Zz
ob
go
ob
zQ
Xq
Xq
GD
vF
"}
(7,1,1) = {"
Ys
rZ
OI
Xz
wR
mH
ds
uk
qx
TR
VT
Uz
"}
