//MAP CONVERTED BY dmm2tgm.py THIS HEADER COMMENT PREVENTS RECONVERSION, DO NOT REMOVE
"aK" = (
/turf/closed/wall/mineral/titanium/shuttle_wall/window/cargo{
	dir = 1;
	icon_state = "0,2"
	},
/area/shuttle/supply)
"bh" = (
/turf/closed/wall/mineral/titanium/shuttle_wall/window/cargo{
	dir = 1;
	icon_state = "4,10"
	},
/area/shuttle/supply)
"fh" = (
/turf/closed/wall/mineral/titanium/shuttle_wall/window/cargo{
	dir = 1;
	icon_state = "3,0"
	},
/area/shuttle/supply)
"gz" = (
/turf/closed/wall/mineral/titanium/shuttle_wall/window/cargo{
	dir = 1;
	icon_state = "4,11"
	},
/area/shuttle/supply)
"hv" = (
/turf/closed/wall/mineral/titanium/shuttle_wall/window/cargo{
	dir = 1;
	icon_state = "2,11"
	},
/area/shuttle/supply/cockpit)
"hC" = (
/turf/open/floor/iron/shuttle/cargo{
	dir = 1
	},
/area/shuttle/supply)
"hV" = (
/turf/open/floor/iron/shuttle/cargo{
	dir = 1;
	icon_state = "floor_box"
	},
/area/shuttle/supply)
"ib" = (
/turf/closed/wall/mineral/titanium/shuttle_wall/window/cargo{
	dir = 1;
	icon_state = "5,0"
	},
/area/shuttle/supply)
"iz" = (
/turf/closed/wall/mineral/titanium/shuttle_wall/window/cargo{
	dir = 1;
	icon_state = "6,10"
	},
/area/shuttle/supply)
"jI" = (
/turf/closed/wall/mineral/titanium/shuttle_wall/window/cargo{
	dir = 1;
	icon_state = "0,7"
	},
/area/shuttle/supply)
"kh" = (
/turf/closed/wall/mineral/titanium/shuttle_wall/window/cargo{
	dir = 1;
	icon_state = "6,0"
	},
/area/shuttle/supply)
"ku" = (
/obj/effect/decal/cleanable/oil/streak,
/turf/open/floor/iron/shuttle/cargo{
	dir = 1
	},
/area/shuttle/supply)
"lb" = (
/obj/docking_port/mobile/supply{
	dir = 4;
	dwidth = 4
	},
/obj/machinery/door/airlock/grunge{
	name = "Supply Shuttle Airlock";
	req_access = list("cargo")
	},
/turf/open/floor/iron/shuttle/cargo{
	dir = 1
	},
/area/shuttle/supply)
"mX" = (
/turf/closed/wall/mineral/titanium/shuttle_wall/window/cargo{
	dir = 1;
	icon_state = "2,1"
	},
/area/shuttle/supply)
"nk" = (
/turf/closed/wall/mineral/titanium/shuttle_wall/window/cargo{
	dir = 1;
	icon_state = "3,10"
	},
/area/shuttle/supply/cockpit)
"nr" = (
/turf/closed/wall/mineral/titanium/shuttle_wall/window/cargo{
	dir = 1;
	icon_state = "4,0"
	},
/area/shuttle/supply)
"oA" = (
/turf/closed/wall/mineral/titanium/shuttle_wall/window/cargo{
	dir = 1;
	icon_state = "0,10"
	},
/area/shuttle/supply/cockpit)
"oU" = (
/turf/closed/wall/mineral/titanium/shuttle_wall/window/cargo{
	dir = 1;
	icon_state = "5,1"
	},
/area/shuttle/supply)
"pD" = (
/obj/effect/decal/cleanable/dirt/dust,
/obj/structure/chair/comfy/shuttle,
/obj/structure/closet/emcloset/wall{
	pixel_x = 28
	},
/obj/item/radio/intercom/directional/north,
/turf/open/floor/iron/shuttle/cargo{
	dir = 1
	},
/area/shuttle/supply/cockpit)
"rU" = (
/turf/closed/wall/mineral/titanium/shuttle_wall/window/cargo{
	dir = 1;
	icon_state = "2,0"
	},
/area/shuttle/supply)
"sz" = (
/obj/machinery/door/airlock/grunge{
	name = "Supply Shuttle Cockpit";
	req_access = list("cargo")
	},
/turf/open/floor/iron/shuttle/cargo{
	dir = 1
	},
/area/shuttle/supply/cockpit)
"sN" = (
/obj/effect/decal/cleanable/dirt/dust,
/turf/open/floor/iron/shuttle/cargo{
	dir = 1;
	icon_state = "floor_maintb"
	},
/area/shuttle/supply)
"sR" = (
/obj/effect/decal/cleanable/dirt/dust,
/turf/open/floor/iron/shuttle/cargo{
	dir = 1
	},
/area/shuttle/supply)
"tG" = (
/turf/closed/wall/mineral/titanium/shuttle_wall/window/cargo{
	dir = 1;
	icon_state = "6,8_Delta"
	},
/area/shuttle/supply)
"uB" = (
/obj/structure/table/reinforced,
/obj/item/paper/crumpled/muddy{
	info = "Toddy spilled his damn coffee all over the console, don't expect to manually pilot the Consign until we can get a repair guy. Which, uh, might be a while...<hr><FONT COLOR='blue'>Oh, by the way, I'm using this note now to complain about the fact we had to build a whole replica Consign for this station specifically? They could have just adjusted the docking parameters but noooo, 'wah the door is an inch off!' God, those corpos can <b>suck my wrench.</b></FONT>"
	},
/turf/open/floor/iron/shuttle/cargo{
	dir = 1
	},
/area/shuttle/supply/cockpit)
"uI" = (
/turf/closed/wall/mineral/titanium/shuttle_wall/window/cargo{
	dir = 1;
	icon_state = "1,1"
	},
/area/shuttle/supply)
"vd" = (
/obj/machinery/conveyor{
	dir = 8;
	id = "cargounload"
	},
/obj/machinery/door/poddoor{
	id = "cargounload";
	name = "Supply Dock Unloading Door"
	},
/turf/open/floor/plating,
/area/shuttle/supply)
"ws" = (
/turf/closed/wall/mineral/titanium/shuttle_wall/window/cargo{
	dir = 1
	},
/area/shuttle/supply)
"ww" = (
/obj/effect/decal/cleanable/dirt/dust,
/turf/open/floor/iron/shuttle/cargo{
	dir = 1;
	icon_state = "floor_mainta"
	},
/area/shuttle/supply)
"wI" = (
/turf/open/floor/iron/shuttle/cargo{
	dir = 1;
	icon_state = "floor_in"
	},
/area/shuttle/supply)
"xI" = (
/turf/closed/wall/mineral/titanium/shuttle_wall/window/cargo{
	dir = 1;
	icon_state = "3,11"
	},
/area/shuttle/supply/cockpit)
"xV" = (
/turf/closed/wall/mineral/titanium/shuttle_wall/window/cargo{
	dir = 1;
	icon_state = "1,11"
	},
/area/shuttle/supply/cockpit)
"zx" = (
/turf/closed/wall/mineral/titanium/shuttle_wall/window/cargo{
	dir = 1;
	icon_state = "0,1"
	},
/area/shuttle/supply)
"zP" = (
/turf/template_noop,
/area/template_noop)
"Ay" = (
/turf/closed/wall/mineral/titanium/shuttle_wall/window/cargo{
	dir = 1;
	icon_state = "3,8"
	},
/area/shuttle/supply/cockpit)
"AU" = (
/obj/machinery/light/directional/south,
/turf/open/floor/iron/shuttle/cargo{
	dir = 1
	},
/area/shuttle/supply)
"CR" = (
/turf/closed/wall/mineral/titanium/shuttle_wall/window/cargo{
	dir = 1;
	icon_state = "1,0"
	},
/area/shuttle/supply)
"Ff" = (
/turf/closed/wall/mineral/titanium/shuttle_wall/window/cargo{
	dir = 1;
	icon_state = "0,8"
	},
/area/shuttle/supply/cockpit)
"FG" = (
/turf/closed/wall/mineral/titanium/shuttle_wall/cargo{
	dir = 1;
	icon_state = "6,6"
	},
/area/shuttle/supply)
"FR" = (
/turf/closed/wall/mineral/titanium/shuttle_wall/window/cargo{
	dir = 1;
	icon_state = "1,8"
	},
/area/shuttle/supply/cockpit)
"Gf" = (
/obj/machinery/door/poddoor{
	id = "cargoload";
	name = "Supply Dock Loading Door"
	},
/obj/machinery/conveyor{
	dir = 4;
	id = "cargoload"
	},
/turf/open/floor/plating,
/area/shuttle/supply)
"Hz" = (
/turf/closed/wall/mineral/titanium/shuttle_wall/window/cargo{
	dir = 1;
	icon_state = "6,1"
	},
/area/shuttle/supply)
"KM" = (
/obj/machinery/computer{
	desc = "This WAS a helmsman's console, before it became a coffee's console.";
	dir = 1
	},
/obj/machinery/light/directional/east,
/turf/open/floor/iron/shuttle/cargo{
	dir = 1
	},
/area/shuttle/supply/cockpit)
"Lh" = (
/obj/machinery/light/directional/east,
/turf/open/floor/iron/shuttle/cargo{
	dir = 1;
	icon_state = "floor_box"
	},
/area/shuttle/supply)
"MA" = (
/turf/closed/wall/mineral/titanium/shuttle_wall/window/cargo{
	dir = 1;
	icon_state = "0,0"
	},
/area/shuttle/supply)
"Oi" = (
/turf/closed/wall/mineral/titanium/shuttle_wall/window/cargo{
	dir = 1;
	icon_state = "0,3"
	},
/area/shuttle/supply)
"Ow" = (
/obj/effect/decal/cleanable/dirt/dust,
/turf/open/floor/iron/shuttle/cargo{
	dir = 1;
	icon_state = "floor_box"
	},
/area/shuttle/supply)
"PH" = (
/turf/closed/wall/mineral/titanium/shuttle_wall/window/cargo{
	dir = 1;
	icon_state = "2,8"
	},
/area/shuttle/supply/cockpit)
"PS" = (
/obj/effect/decal/cleanable/dirt/dust,
/obj/structure/chair/comfy/shuttle,
/turf/open/floor/iron/shuttle/cargo{
	dir = 1
	},
/area/shuttle/supply/cockpit)
"Qm" = (
/turf/closed/wall/mineral/titanium/shuttle_wall/window/cargo{
	dir = 1;
	icon_state = "0,9"
	},
/area/shuttle/supply/cockpit)
"Qx" = (
/obj/structure/closet/shuttle/engivent{
	pixel_y = 33
	},
/turf/open/floor/iron/shuttle/cargo{
	dir = 1
	},
/area/shuttle/supply)
"QJ" = (
/turf/closed/wall/mineral/titanium/shuttle_wall/window/cargo{
	dir = 1;
	icon_state = "0,4"
	},
/area/shuttle/supply)
"Sz" = (
/turf/closed/wall/mineral/titanium/shuttle_wall/window/cargo{
	dir = 1;
	icon_state = "5,10"
	},
/area/shuttle/supply)
"To" = (
/turf/closed/wall/mineral/titanium/shuttle_wall/window/cargo{
	dir = 1;
	icon_state = "0,11"
	},
/area/shuttle/supply/cockpit)
"TO" = (
/turf/closed/wall/mineral/titanium/shuttle_wall/window/cargo{
	dir = 1;
	icon_state = "6,9_Delta"
	},
/area/shuttle/supply)
"Uj" = (
/turf/open/floor/iron/shuttle/cargo{
	dir = 1;
	icon_state = "floor_out"
	},
/area/shuttle/supply)
"UC" = (
/obj/machinery/button/door/directional/west{
	id = "cargoload";
	name = "Loading Doors";
	pixel_y = -8
	},
/obj/machinery/button/door/directional/west{
	id = "cargounload";
	name = "Loading Doors";
	pixel_y = 8
	},
/obj/machinery/light/directional/west,
/turf/open/floor/iron/shuttle/cargo{
	dir = 1
	},
/area/shuttle/supply)
"UX" = (
/turf/closed/wall/mineral/titanium/shuttle_wall/window/cargo{
	dir = 1;
	icon_state = "6,2_Delta"
	},
/area/shuttle/supply)
"VP" = (
/obj/effect/decal/cleanable/oil/slippery,
/turf/open/floor/iron/shuttle/cargo{
	dir = 1
	},
/area/shuttle/supply)
"Xb" = (
/obj/machinery/door/airlock/grunge{
	name = "Supply Shuttle Airlock";
	req_access = list("cargo")
	},
/turf/open/floor/iron/shuttle/cargo{
	dir = 1
	},
/area/shuttle/supply)
"Xe" = (
/turf/closed/wall/mineral/titanium/shuttle_wall/window/cargo{
	dir = 1;
	icon_state = "4,1"
	},
/area/shuttle/supply)
"Xp" = (
/obj/structure/extinguisher_cabinet/directional/south,
/turf/open/floor/iron/shuttle/cargo{
	dir = 1
	},
/area/shuttle/supply)
"Ye" = (
/turf/closed/wall/mineral/titanium/shuttle_wall/window/cargo{
	dir = 1;
	icon_state = "0,5"
	},
/area/shuttle/supply)
"ZB" = (
/turf/closed/wall/mineral/titanium/shuttle_wall/window/cargo{
	dir = 1;
	icon_state = "0,6"
	},
/area/shuttle/supply)

(1,1,1) = {"
kh
Hz
UX
vd
lb
FG
Xb
Gf
tG
TO
iz
zP
"}
(2,1,1) = {"
ib
oU
hC
Uj
hV
UC
hV
wI
hC
hC
Sz
zP
"}
(3,1,1) = {"
nr
Xe
hC
sR
hC
hC
hC
sR
hC
AU
bh
gz
"}
(4,1,1) = {"
fh
ws
Qx
hC
ku
VP
hC
Xp
Ay
sz
nk
xI
"}
(5,1,1) = {"
rU
mX
hV
hV
hV
hV
sR
hC
PH
PS
uB
hv
"}
(6,1,1) = {"
CR
uI
Ow
Ow
hV
Lh
ww
sN
FR
pD
KM
xV
"}
(7,1,1) = {"
MA
zx
aK
Oi
QJ
Ye
ZB
jI
Ff
Qm
oA
To
"}
