//MAP CONVERTED BY dmm2tgm.py THIS HEADER COMMENT PREVENTS RECONVERSION, DO NOT REMOVE
"aK" = (
/obj/structure/marker_beacon/burgundy,
/obj/structure/shuttle/engine/propulsion/in_wall{
	dir = 4;
	pixel_x = 32
	},
/turf/closed/wall/mineral/titanium/nodiagonal,
/area/shuttle/supply)
"bh" = (
/turf/closed/wall/mineral/titanium/nodiagonal,
/area/shuttle/supply)
"fh" = (
/obj/structure/fluff/metalpole/end{
	dir = 1;
	pixel_y = 32
	},
/turf/closed/wall/mineral/titanium/spaceship/nodiagonal,
/area/shuttle/supply)
"hv" = (
/obj/effect/spawner/structure/window/reinforced/shuttle,
/turf/open/floor/plating,
/area/shuttle/supply/cockpit)
"hC" = (
/obj/effect/decal/cleanable/dirt/dust,
/obj/effect/turf_decal/tile/neutral/diagonal_edge,
/obj/effect/turf_decal/tile/neutral/diagonal_centre,
/turf/open/floor/iron/dark/diagonal,
/area/shuttle/supply)
"hV" = (
/obj/effect/decal/cleanable/dirt/dust,
/obj/effect/turf_decal/caution/white{
	dir = 4
	},
/turf/open/floor/iron/shuttle/cargo{
	dir = 1
	},
/area/shuttle/supply)
"iz" = (
/obj/structure/marker_beacon/olive,
/obj/structure/fluff/metalpole/end{
	pixel_y = -32
	},
/turf/closed/wall/mineral/titanium/nodiagonal,
/area/shuttle/supply)
"kh" = (
/obj/structure/fluff/metalpole/end{
	dir = 1;
	pixel_y = 32
	},
/turf/closed/wall/mineral/titanium/spaceship,
/area/shuttle/supply)
"lb" = (
/obj/docking_port/mobile/supply{
	dir = 4;
	dwidth = 4
	},
/obj/machinery/door/airlock/grunge{
	name = "Supply Shuttle Airlock";
	req_access = list("cargo")
	},
/obj/effect/turf_decal/delivery/white,
/turf/open/floor/iron/dark/textured_large,
/area/shuttle/supply)
"oU" = (
/obj/effect/decal/cleanable/dirt/dust,
/obj/effect/turf_decal/tile/neutral/diagonal_edge,
/obj/effect/turf_decal/tile/neutral/diagonal_centre,
/obj/effect/turf_decal/box/white/corners{
	dir = 8
	},
/turf/open/floor/iron/dark/diagonal,
/area/shuttle/supply)
"pD" = (
/obj/effect/decal/cleanable/dirt/dust,
/obj/structure/chair/comfy/shuttle,
/obj/structure/closet/emcloset/wall{
	pixel_x = 28
	},
/obj/item/radio/intercom/directional/north,
/turf/open/floor/iron/shuttle/cargo{
	dir = 1
	},
/area/shuttle/supply/cockpit)
"sz" = (
/obj/machinery/door/airlock/grunge{
	name = "Supply Shuttle Cockpit";
	req_access = list("cargo")
	},
/obj/effect/turf_decal/delivery/white,
/turf/open/floor/iron/dark/textured_large,
/area/shuttle/supply/cockpit)
"sN" = (
/obj/effect/decal/cleanable/dirt/dust,
/obj/effect/turf_decal/tile/neutral/diagonal_edge,
/obj/effect/turf_decal/tile/neutral/diagonal_centre,
/obj/effect/turf_decal/box/white/corners,
/turf/open/floor/iron/dark/diagonal,
/area/shuttle/supply)
"sR" = (
/obj/effect/decal/cleanable/dirt/dust,
/turf/open/floor/iron/shuttle/cargo{
	dir = 1
	},
/area/shuttle/supply)
"uB" = (
/obj/structure/table/reinforced,
/obj/item/paper/crumpled/muddy{
	default_raw_text = "Toddy spilled his damn coffee all over the console, don't expect to manually pilot the Consign until we can get a repair guy. Which, uh, might be a while...<hr><FONT COLOR='blue'>Oh, by the way, I'm using this note now to complain about the fact we had to build a whole replica Consign for this station specifically? They could have just adjusted the docking parameters but noooo, 'wah the door is an inch off!' God, those corpos can <b>suck my wrench.</b></FONT>"
	},
/obj/effect/decal/cleanable/dirt/dust,
/turf/open/floor/iron/dark/smooth_large,
/area/shuttle/supply/cockpit)
"vd" = (
/obj/machinery/conveyor{
	dir = 8;
	id = "cargounload"
	},
/obj/machinery/door/poddoor{
	id = "cargounload";
	name = "Supply Dock Unloading Door"
	},
/turf/open/floor/plating,
/area/shuttle/supply)
"wI" = (
/obj/effect/decal/cleanable/dirt/dust,
/obj/effect/turf_decal/loading_area/white{
	dir = 4
	},
/turf/open/floor/iron/shuttle/cargo{
	dir = 1
	},
/area/shuttle/supply)
"xI" = (
/turf/closed/wall/mineral/titanium,
/area/shuttle/supply/cockpit)
"zx" = (
/turf/closed/wall/mineral/titanium/spaceship/nodiagonal,
/area/shuttle/supply)
"zP" = (
/turf/template_noop,
/area/template_noop)
"AU" = (
/obj/machinery/light/directional/south,
/obj/effect/decal/cleanable/dirt/dust,
/turf/open/floor/iron/shuttle/cargo{
	dir = 1
	},
/area/shuttle/supply)
"CR" = (
/obj/effect/turf_decal/stripes/line{
	dir = 1
	},
/obj/structure/shuttle/engine/propulsion{
	dir = 1
	},
/turf/open/floor/plating/airless,
/area/shuttle/supply)
"Gf" = (
/obj/machinery/door/poddoor{
	id = "cargoload";
	name = "Supply Dock Loading Door"
	},
/obj/machinery/conveyor{
	dir = 4;
	id = "cargoload"
	},
/turf/open/floor/plating,
/area/shuttle/supply)
"KM" = (
/obj/machinery/computer{
	desc = "This WAS a helmsman's console, before it became a coffee's console.";
	dir = 1
	},
/obj/machinery/light/directional/east,
/obj/effect/decal/cleanable/dirt/dust,
/turf/open/floor/iron/dark/smooth_large,
/area/shuttle/supply/cockpit)
"Lh" = (
/obj/effect/decal/cleanable/dirt/dust,
/obj/effect/turf_decal/tile/neutral/diagonal_edge,
/obj/effect/turf_decal/tile/neutral/diagonal_centre,
/obj/effect/turf_decal/box/white/corners{
	dir = 4
	},
/obj/machinery/light/directional/east,
/turf/open/floor/iron/dark/diagonal,
/area/shuttle/supply)
"Ow" = (
/obj/effect/decal/cleanable/dirt/dust,
/obj/effect/turf_decal/tile/neutral/diagonal_edge,
/obj/effect/turf_decal/tile/neutral/diagonal_centre,
/obj/effect/turf_decal/box/white/corners{
	dir = 4
	},
/turf/open/floor/iron/dark/diagonal,
/area/shuttle/supply)
"PH" = (
/turf/closed/wall/mineral/titanium/nodiagonal,
/area/shuttle/supply/cockpit)
"PS" = (
/obj/effect/decal/cleanable/dirt/dust,
/obj/structure/chair/comfy/shuttle,
/turf/open/floor/iron/shuttle/cargo{
	dir = 1
	},
/area/shuttle/supply/cockpit)
"Qm" = (
/obj/structure/shuttle/engine/propulsion/in_wall{
	dir = 4;
	pixel_x = 32
	},
/turf/closed/wall/mineral/titanium/nodiagonal,
/area/shuttle/supply/cockpit)
"Qx" = (
/obj/structure/closet/shuttle/engivent{
	pixel_y = 33
	},
/obj/effect/decal/cleanable/dirt/dust,
/obj/effect/turf_decal/tile/neutral/diagonal_edge,
/obj/effect/turf_decal/tile/neutral/diagonal_centre,
/obj/effect/turf_decal/box/white/corners{
	dir = 1
	},
/turf/open/floor/iron/dark/diagonal,
/area/shuttle/supply)
"To" = (
/obj/structure/marker_beacon/burgundy,
/obj/structure/fluff/metalpole/end{
	pixel_y = -32
	},
/turf/closed/wall/mineral/titanium/nodiagonal,
/area/shuttle/supply/cockpit)
"TO" = (
/obj/structure/shuttle/engine/propulsion/in_wall{
	dir = 8;
	pixel_x = -32
	},
/turf/closed/wall/mineral/titanium/nodiagonal,
/area/shuttle/supply)
"Uj" = (
/obj/effect/decal/cleanable/dirt/dust,
/obj/effect/turf_decal/loading_area/white{
	dir = 8
	},
/turf/open/floor/iron/shuttle/cargo{
	dir = 1
	},
/area/shuttle/supply)
"UC" = (
/obj/machinery/button/door/directional/west{
	id = "cargoload";
	name = "Loading Doors";
	pixel_y = -8
	},
/obj/machinery/button/door/directional/west{
	id = "cargounload";
	name = "Loading Doors";
	pixel_y = 8
	},
/obj/machinery/light/directional/west,
/obj/effect/decal/cleanable/dirt/dust,
/turf/open/floor/iron/shuttle/cargo{
	dir = 1
	},
/area/shuttle/supply)
"UX" = (
/obj/structure/marker_beacon/olive,
/obj/structure/shuttle/engine/propulsion/in_wall{
	dir = 8;
	pixel_x = -32
	},
/turf/closed/wall/mineral/titanium/nodiagonal,
/area/shuttle/supply)
"VP" = (
/obj/effect/decal/cleanable/dirt/dust,
/obj/effect/turf_decal/tile/neutral/diagonal_edge,
/obj/effect/turf_decal/tile/neutral/diagonal_centre,
/obj/effect/turf_decal/box/white/corners{
	dir = 1
	},
/turf/open/floor/iron/dark/diagonal,
/area/shuttle/supply)
"Xb" = (
/obj/machinery/door/airlock/grunge{
	name = "Supply Shuttle Airlock";
	req_access = list("cargo")
	},
/obj/effect/turf_decal/delivery/white,
/turf/open/floor/iron/dark/textured_large,
/area/shuttle/supply)
"Xe" = (
/obj/structure/window/reinforced/plasma/spawner,
/obj/effect/turf_decal/stripes/line,
/obj/structure/shuttle/engine/heater{
	dir = 1
	},
/turf/open/floor/plating/airless,
/area/shuttle/supply)
"Xp" = (
/obj/structure/extinguisher_cabinet/directional/south,
/obj/effect/decal/cleanable/dirt/dust,
/obj/effect/turf_decal/tile/neutral/diagonal_edge,
/obj/effect/turf_decal/tile/neutral/diagonal_centre,
/obj/effect/turf_decal/box/white/corners{
	dir = 8
	},
/turf/open/floor/iron/dark/diagonal,
/area/shuttle/supply)

(1,1,1) = {"
kh
zx
UX
vd
lb
bh
Xb
Gf
bh
TO
iz
zP
"}
(2,1,1) = {"
CR
Xe
sR
Uj
hV
UC
hV
wI
sR
sR
bh
zP
"}
(3,1,1) = {"
CR
Xe
sR
sR
sR
sR
sR
sR
sR
AU
bh
zP
"}
(4,1,1) = {"
fh
zx
Qx
oU
sR
VP
hC
Xp
PH
sz
PH
xI
"}
(5,1,1) = {"
CR
Xe
hC
hC
sR
hC
hC
hC
PH
PS
uB
hv
"}
(6,1,1) = {"
CR
Xe
Ow
sN
sR
Lh
hC
sN
PH
pD
KM
hv
"}
(7,1,1) = {"
kh
zx
aK
bh
bh
bh
bh
bh
PH
Qm
PH
To
"}
