//MAP CONVERTED BY dmm2tgm.py THIS HEADER COMMENT PREVENTS RECONVERSION, DO NOT REMOVE
"a" = (
/turf/template_noop,
/area/template_noop)
"b" = (
/turf/closed/wall/mineral/titanium/nodiagonal,
/area/shuttle/baserunner)
"c" = (
/obj/effect/spawner/structure/window/reinforced/shuttle,
/turf/open/floor/plating,
/area/shuttle/baserunner)
"f" = (
/obj/structure/cable,
/obj/machinery/atmospherics/pipe/smart/manifold4w/supply/hidden/layer4,
/turf/open/floor/iron/shuttle/evac,
/area/shuttle/baserunner)
"g" = (
/obj/machinery/computer/shuttle/common_docks{
	dir = 8
	},
/obj/effect/turf_decal/bot_white,
/turf/open/floor/iron/dark/smooth_large,
/area/shuttle/baserunner)
"h" = (
/obj/machinery/atmospherics/components/unary/engine{
	dir = 8
	},
/obj/effect/turf_decal/stripes/line{
	dir = 8
	},
/turf/open/floor/plating/airless,
/area/shuttle/baserunner)
"i" = (
/obj/effect/turf_decal/tile/neutral,
/obj/effect/turf_decal/tile/neutral{
	dir = 4
	},
/obj/effect/turf_decal/tile/neutral{
	dir = 1
	},
/obj/effect/turf_decal/tile/neutral{
	dir = 8
	},
/obj/effect/turf_decal/siding/thinplating/dark{
	dir = 8
	},
/turf/open/floor/iron/dark,
/area/shuttle/baserunner)
"j" = (
/obj/machinery/atmospherics/components/tank/air{
	dir = 1;
	piping_layer = 4
	},
/obj/effect/turf_decal/bot_white,
/turf/open/floor/iron/dark/smooth_large,
/area/shuttle/baserunner)
"k" = (
/obj/machinery/atmospherics/components/unary/vent_pump/on/layer4{
	dir = 8
	},
/turf/open/floor/iron/shuttle/evac,
/area/shuttle/baserunner)
"l" = (
/obj/machinery/atmospherics/pipe/smart/manifold4w/orange/visible,
/obj/machinery/meter,
/obj/structure/rack,
/obj/item/stack/sheet/mineral/plasma/thirty,
/obj/item/wrench,
/obj/effect/turf_decal/bot_white,
/turf/open/floor/iron/dark/smooth_large,
/area/shuttle/baserunner)
"m" = (
/turf/closed/wall/mineral/plastitanium/nodiagonal,
/area/shuttle/baserunner)
"n" = (
/obj/machinery/power/smes/engineering{
	charge = 1e+006
	},
/obj/structure/cable,
/obj/machinery/atmospherics/components/unary/vent_pump/on/layer4,
/obj/machinery/airalarm/directional/north,
/obj/machinery/light/cold/directional/east,
/turf/open/floor/iron/dark/smooth_large,
/area/shuttle/baserunner)
"o" = (
/obj/effect/spawner/structure/window/reinforced/plasma/plastitanium,
/obj/machinery/atmospherics/pipe/smart/manifold4w/orange/visible,
/obj/structure/shuttle/engine/heater{
	dir = 8
	},
/turf/open/floor/plating,
/area/shuttle/baserunner)
"r" = (
/obj/effect/turf_decal/tile/neutral,
/obj/effect/turf_decal/tile/neutral{
	dir = 4
	},
/obj/effect/turf_decal/tile/neutral{
	dir = 1
	},
/obj/effect/turf_decal/tile/neutral{
	dir = 8
	},
/obj/effect/turf_decal/siding/thinplating/dark{
	dir = 6
	},
/obj/effect/turf_decal/box/corners,
/turf/open/floor/iron/dark,
/area/shuttle/baserunner)
"t" = (
/obj/machinery/atmospherics/pipe/smart/manifold4w/supply/hidden/layer4,
/obj/structure/extinguisher_cabinet/directional/east,
/turf/open/floor/catwalk_floor,
/area/shuttle/baserunner)
"u" = (
/obj/structure/cable,
/obj/machinery/atmospherics/pipe/smart/manifold4w/supply/hidden/layer4,
/turf/open/floor/catwalk_floor,
/area/shuttle/baserunner)
"v" = (
/obj/effect/turf_decal/mining,
/turf/closed/wall/mineral/plastitanium/nodiagonal,
/area/shuttle/baserunner)
"x" = (
/turf/closed/wall/mineral/plastitanium,
/area/shuttle/baserunner)
"y" = (
/turf/closed/wall/mineral/titanium,
/area/shuttle/baserunner)
"z" = (
/turf/closed/wall/mineral/titanium/interior,
/area/shuttle/baserunner)
"A" = (
/obj/machinery/portable_atmospherics/canister/carbon_dioxide,
/obj/machinery/atmospherics/components/unary/portables_connector/visible{
	dir = 1
	},
/obj/effect/turf_decal/bot_white,
/turf/open/floor/iron/dark/smooth_large,
/area/shuttle/baserunner)
"B" = (
/obj/effect/turf_decal/tile/neutral,
/obj/effect/turf_decal/tile/neutral{
	dir = 4
	},
/obj/effect/turf_decal/tile/neutral{
	dir = 1
	},
/obj/effect/turf_decal/tile/neutral{
	dir = 8
	},
/obj/effect/turf_decal/siding/thinplating/dark{
	dir = 10
	},
/obj/effect/turf_decal/box/corners{
	dir = 8
	},
/turf/open/floor/iron/dark,
/area/shuttle/baserunner)
"D" = (
/turf/closed/wall/mineral/titanium/survival,
/area/shuttle/baserunner)
"E" = (
/obj/machinery/power/terminal{
	dir = 4
	},
/obj/structure/cable,
/obj/machinery/power/port_gen/pacman,
/obj/effect/turf_decal/bot_white,
/turf/open/floor/iron/dark/smooth_large,
/area/shuttle/baserunner)
"F" = (
/obj/structure/cable,
/obj/machinery/atmospherics/pipe/smart/manifold4w/supply/hidden/layer4,
/obj/machinery/airalarm/directional/west,
/turf/open/floor/iron/shuttle/evac,
/area/shuttle/baserunner)
"G" = (
/obj/structure/cable,
/obj/machinery/atmospherics/pipe/smart/manifold4w/supply/hidden/layer4,
/obj/effect/turf_decal/delivery/white,
/obj/machinery/door/airlock/hatch,
/obj/machinery/door/firedoor,
/turf/open/floor/iron/dark/textured_large,
/area/shuttle/baserunner)
"H" = (
/obj/effect/turf_decal/bot_white,
/obj/structure/extinguisher_cabinet/directional/north,
/obj/structure/rack/shelf,
/obj/item/survivalcapsule,
/obj/item/crowbar/red,
/obj/item/tank/internals/emergency_oxygen/double,
/obj/item/storage/medkit/emergency,
/turf/open/floor/iron/dark/smooth_large,
/area/shuttle/baserunner)
"J" = (
/obj/effect/turf_decal/tile/neutral{
	dir = 4
	},
/obj/effect/turf_decal/tile/neutral,
/obj/effect/turf_decal/tile/neutral{
	dir = 8
	},
/obj/effect/turf_decal/tile/neutral{
	dir = 1
	},
/obj/effect/turf_decal/siding/thinplating/dark{
	dir = 5
	},
/obj/effect/turf_decal/box/corners{
	dir = 4
	},
/obj/structure/closet/crate/cardboard/fops,
/obj/item/storage/bag/garment/exp_pilot,
/turf/open/floor/iron/dark,
/area/shuttle/baserunner)
"K" = (
/obj/effect/turf_decal/tile/neutral{
	dir = 4
	},
/obj/effect/turf_decal/tile/neutral,
/obj/effect/turf_decal/tile/neutral{
	dir = 8
	},
/obj/effect/turf_decal/tile/neutral{
	dir = 1
	},
/obj/effect/turf_decal/siding/thinplating/dark{
	dir = 9
	},
/obj/effect/turf_decal/box/corners{
	dir = 1
	},
/turf/open/floor/iron/dark,
/area/shuttle/baserunner)
"L" = (
/obj/machinery/atmospherics/components/unary/vent_pump/on/layer4{
	dir = 1
	},
/obj/machinery/button/door/directional/west{
	id = "skiffext";
	name = "External Airlock Bolt Control";
	normaldoorcontrol = 1;
	specialfunctions = 4
	},
/turf/open/floor/iron/shuttle/evac,
/area/shuttle/baserunner)
"P" = (
/obj/effect/turf_decal/delivery/white,
/obj/structure/fans/tiny,
/obj/machinery/door/airlock/external{
	id_tag = "skiffext"
	},
/obj/docking_port/mobile{
	dwidth = 6;
	height = 7;
	id = "baserunner";
	launch_status = 0;
	name = "MS Baserunner";
	port_direction = 8;
	preferred_direction = 4;
	width = 12
	},
/turf/open/floor/iron/dark/textured_large,
/area/shuttle/baserunner)
"Q" = (
/obj/structure/cable,
/obj/machinery/power/apc/auto_name/directional/north,
/obj/effect/turf_decal/bot_white,
/obj/structure/chair/comfy/shuttle,
/turf/open/floor/iron/dark/smooth_large,
/area/shuttle/baserunner)
"R" = (
/obj/machinery/atmospherics/components/binary/pump/on{
	dir = 1
	},
/turf/open/floor/catwalk_floor,
/area/shuttle/baserunner)
"U" = (
/obj/machinery/atmospherics/pipe/smart/manifold4w/supply/hidden/layer4,
/obj/machinery/light/cold/directional/west,
/turf/open/floor/iron/shuttle/evac,
/area/shuttle/baserunner)
"V" = (
/obj/structure/chair/comfy/shuttle{
	dir = 4
	},
/obj/item/radio/intercom/directional/north,
/turf/open/floor/iron/shuttle/ferry,
/area/shuttle/baserunner)
"X" = (
/obj/effect/turf_decal/bot_white,
/obj/structure/chair/comfy/shuttle,
/turf/open/floor/iron/dark/smooth_large,
/area/shuttle/baserunner)
"Y" = (
/obj/effect/turf_decal/tile/neutral,
/obj/effect/turf_decal/tile/neutral{
	dir = 4
	},
/obj/effect/turf_decal/tile/neutral{
	dir = 1
	},
/obj/effect/turf_decal/tile/neutral{
	dir = 8
	},
/obj/machinery/light/cold/directional/east,
/obj/effect/turf_decal/siding/thinplating/dark{
	dir = 4
	},
/turf/open/floor/iron/dark,
/area/shuttle/baserunner)
"Z" = (
/obj/machinery/porta_turret/centcom_shuttle{
	dir = 4
	},
/turf/closed/wall/mineral/titanium/nodiagonal,
/area/shuttle/baserunner)

(1,1,1) = {"
a
D
a
a
a
D
a
"}
(2,1,1) = {"
a
m
h
h
h
m
a
"}
(3,1,1) = {"
a
m
o
o
o
m
x
"}
(4,1,1) = {"
a
v
E
l
R
A
v
"}
(5,1,1) = {"
a
b
n
u
t
j
b
"}
(6,1,1) = {"
z
b
b
G
b
b
b
"}
(7,1,1) = {"
b
X
F
f
U
L
P
"}
(8,1,1) = {"
b
Q
f
K
i
B
b
"}
(9,1,1) = {"
b
H
k
J
Y
r
b
"}
(10,1,1) = {"
y
b
V
b
b
b
b
"}
(11,1,1) = {"
a
c
g
c
a
Z
y
"}
(12,1,1) = {"
a
y
c
b
a
a
a
"}
