//MAP CONVERTED BY dmm2tgm.py THIS HEADER COMMENT PREVENTS RECONVERSION, DO NOT REMOVE
"bs" = (
/turf/closed/wall/mineral/plastitanium,
/area/shuttle/vulture)
"bP" = (
/obj/machinery/ship_weapon/mining_laser{
	dir = 4
	},
/turf/closed/wall/mineral/titanium,
/area/shuttle/vulture)
"cz" = (
/obj/machinery/atmospherics/pipe/smart/manifold4w/orange/visible,
/obj/structure/sign/plaques/kiddie{
	desc = "A sign commemorating this particular shuttle's construction specifications and patent. In large text at the bottom it reads, AlLei manufacturing, patent circa 2562.";
	name = "\improper Shuttle Design & Production Model Plaque"
	},
/turf/open/floor/iron/dark/smooth_large,
/area/shuttle/vulture)
"do" = (
/turf/closed/wall/mineral/titanium/nodiagonal,
/area/shuttle/vulture)
"dG" = (
/obj/structure/cable,
/obj/machinery/atmospherics/pipe/smart/manifold4w/supply/hidden/layer4,
/obj/machinery/atmospherics/pipe/smart/manifold4w/scrubbers/hidden/layer2,
/turf/open/floor/iron/shuttle/evac,
/area/shuttle/vulture)
"ep" = (
/obj/machinery/atmospherics/pipe/smart/manifold4w/supply/hidden/layer4,
/obj/machinery/atmospherics/pipe/smart/manifold4w/scrubbers/hidden/layer2,
/turf/open/floor/iron/shuttle/evac,
/area/shuttle/vulture)
"ip" = (
/obj/machinery/transporter,
/obj/effect/turf_decal/box/white,
/turf/open/floor/engine,
/area/shuttle/vulture)
"iI" = (
/obj/machinery/atmospherics/components/binary/volume_pump{
	dir = 1
	},
/turf/open/floor/catwalk_floor/iron_dark,
/area/shuttle/vulture)
"je" = (
/obj/machinery/recharge_station,
/obj/effect/turf_decal/bot_white,
/obj/machinery/atmospherics/components/unary/vent_scrubber/on/layer2{
	dir = 8
	},
/turf/open/floor/iron/dark/smooth_large,
/area/shuttle/vulture)
"lk" = (
/obj/structure/table/reinforced/plastitaniumglass,
/obj/machinery/microwave,
/turf/open/floor/iron/dark/smooth_large,
/area/shuttle/vulture)
"lD" = (
/obj/machinery/atmospherics/pipe/smart/manifold4w/supply/hidden/layer4,
/obj/machinery/atmospherics/pipe/smart/manifold4w/scrubbers/hidden/layer2,
/turf/open/floor/wood/large,
/area/shuttle/vulture)
"lI" = (
/obj/machinery/light/cold/directional/east,
/obj/machinery/atmospherics/pipe/smart/manifold4w/scrubbers/hidden/layer2,
/turf/open/floor/wood/large,
/area/shuttle/vulture)
"lS" = (
/obj/machinery/atmospherics/pipe/smart/manifold4w/orange/visible,
/obj/machinery/atmospherics/pipe/smart/manifold4w/supply/hidden/layer4,
/turf/open/floor/catwalk_floor/iron_dark,
/area/shuttle/vulture)
"mx" = (
/obj/machinery/power/smes/engineering{
	charge = 1e+006
	},
/obj/effect/turf_decal/bot_white,
/obj/structure/cable,
/turf/open/floor/iron/dark/smooth_large,
/area/shuttle/vulture)
"mM" = (
/obj/machinery/atmospherics/components/unary/portables_connector/visible{
	dir = 1
	},
/obj/machinery/portable_atmospherics/canister/carbon_dioxide,
/obj/effect/turf_decal/bot_white,
/turf/open/floor/iron/dark/smooth_large,
/area/shuttle/vulture)
"nl" = (
/obj/effect/turf_decal/delivery/white,
/obj/machinery/door/airlock/service/glass,
/obj/machinery/atmospherics/pipe/smart/manifold4w/supply/hidden/layer4,
/obj/machinery/atmospherics/pipe/smart/manifold4w/scrubbers/hidden/layer2,
/turf/open/floor/iron/dark/textured_large,
/area/shuttle/vulture)
"od" = (
/obj/machinery/atmospherics/pipe/smart/manifold4w/orange/visible,
/obj/machinery/meter,
/obj/machinery/firealarm/directional/west,
/obj/machinery/light/cold/directional/west,
/turf/open/floor/catwalk_floor/iron_dark,
/area/shuttle/vulture)
"pC" = (
/obj/machinery/computer/monitor,
/obj/effect/turf_decal/bot_white,
/obj/machinery/firealarm/directional/north,
/turf/open/floor/iron/dark/smooth_large,
/area/shuttle/vulture)
"pX" = (
/turf/closed/wall/mineral/plastitanium/nodiagonal,
/area/shuttle/vulture)
"ql" = (
/obj/effect/turf_decal/tile/neutral{
	dir = 1
	},
/obj/effect/turf_decal/tile/neutral{
	dir = 8
	},
/obj/effect/turf_decal/tile/neutral{
	dir = 4
	},
/obj/effect/turf_decal/tile/neutral,
/obj/effect/turf_decal/box/white/corners{
	dir = 8
	},
/obj/effect/turf_decal/box/white/corners,
/obj/structure/closet/crate/cardboard/fops,
/obj/item/storage/bag/garment/exp_pilot,
/turf/open/floor/iron/dark,
/area/shuttle/vulture)
"qp" = (
/obj/effect/turf_decal/siding/thinplating/dark{
	dir = 1
	},
/obj/structure/rack/shelf,
/obj/item/clothing/head/welding,
/obj/item/weldingtool/largetank,
/obj/item/wrench,
/obj/item/crowbar/red,
/obj/effect/turf_decal/bot_white,
/obj/machinery/firealarm/directional/east,
/obj/machinery/light/cold/directional/east,
/turf/open/floor/iron/dark/smooth_large,
/area/shuttle/vulture)
"qQ" = (
/obj/structure/bed/pod,
/obj/item/bedsheet/black,
/obj/effect/turf_decal/bot_white,
/obj/machinery/airalarm/directional/north,
/turf/open/floor/iron/dark/smooth_large,
/area/shuttle/vulture)
"ra" = (
/obj/machinery/modular_computer/console/preset/engineering{
	dir = 8
	},
/obj/effect/turf_decal/bot_white,
/turf/open/floor/iron/dark/smooth_large,
/area/shuttle/vulture)
"rJ" = (
/obj/machinery/computer/shuttle/common_docks{
	dir = 8
	},
/obj/effect/turf_decal/bot_white,
/turf/open/floor/iron/dark/smooth_large,
/area/shuttle/vulture)
"uB" = (
/obj/machinery/power/terminal{
	dir = 4
	},
/obj/structure/cable,
/turf/open/floor/catwalk_floor/iron_dark,
/area/shuttle/vulture)
"wi" = (
/obj/structure/rack/shelf,
/obj/effect/spawner/random/food_or_drink/donkpockets,
/obj/effect/spawner/random/food_or_drink/donkpockets{
	pixel_y = 4
	},
/obj/effect/turf_decal/bot_white,
/obj/machinery/firealarm/directional/south,
/obj/machinery/atmospherics/components/unary/vent_scrubber/on/layer2{
	dir = 1
	},
/turf/open/floor/iron/dark/smooth_large,
/area/shuttle/vulture)
"xy" = (
/obj/effect/turf_decal/delivery/white,
/obj/machinery/door/airlock/engineering,
/obj/structure/cable,
/obj/machinery/atmospherics/pipe/smart/manifold4w/supply/hidden/layer4,
/obj/machinery/atmospherics/pipe/smart/manifold4w/scrubbers/hidden/layer2,
/turf/open/floor/iron/dark/textured_large,
/area/shuttle/vulture)
"xN" = (
/obj/machinery/atmospherics/components/unary/engine{
	dir = 8
	},
/obj/effect/turf_decal/stripes/line{
	dir = 8
	},
/turf/open/floor/plating/airless,
/area/shuttle/vulture)
"yl" = (
/obj/machinery/door/poddoor/preopen{
	id = "vulture_shutter"
	},
/obj/effect/spawner/structure/window/reinforced/shuttle,
/turf/open/floor/plating,
/area/shuttle/vulture)
"yq" = (
/obj/docking_port/mobile{
	dir = 2;
	dwidth = 7;
	height = 11;
	id = "vulture";
	launch_status = 0;
	name = "MS Vulture";
	port_direction = 8;
	preferred_direction = 4;
	width = 15
	},
/obj/structure/fans/tiny,
/obj/effect/turf_decal/delivery/white,
/obj/machinery/door/airlock/external,
/turf/open/floor/iron/dark/textured_large,
/area/shuttle/vulture)
"yB" = (
/obj/structure/chair/comfy/shuttle{
	dir = 1
	},
/obj/machinery/atmospherics/components/unary/vent_scrubber/on/layer2,
/turf/open/floor/iron/shuttle/evac,
/area/shuttle/vulture)
"zh" = (
/obj/effect/turf_decal/delivery/white,
/obj/machinery/door/airlock/corporate/glass,
/obj/machinery/atmospherics/pipe/smart/manifold4w/supply/hidden/layer4,
/obj/machinery/atmospherics/pipe/smart/manifold4w/scrubbers/hidden/layer2,
/turf/open/floor/iron/dark/textured_large,
/area/shuttle/vulture)
"Ab" = (
/obj/machinery/space_heater,
/obj/effect/turf_decal/bot_white,
/obj/machinery/atmospherics/components/unary/vent_pump/on/layer4,
/turf/open/floor/iron/dark/smooth_large,
/area/shuttle/vulture)
"Ao" = (
/obj/structure/chair/comfy/shuttle{
	dir = 4
	},
/obj/machinery/airalarm/directional/south,
/turf/open/floor/iron/shuttle/evac,
/area/shuttle/vulture)
"AI" = (
/obj/structure/table/reinforced/plastitaniumglass,
/obj/machinery/cell_charger,
/obj/item/stock_parts/cell/high,
/obj/structure/extinguisher_cabinet/directional/west,
/turf/open/floor/iron/dark/smooth_large,
/area/shuttle/vulture)
"AR" = (
/obj/structure/rack/shelf,
/obj/item/storage/toolbox/mechanical,
/obj/effect/spawner/random/engineering/tool,
/obj/effect/spawner/random/engineering/flashlight,
/obj/item/binoculars,
/obj/effect/turf_decal/bot_white,
/obj/machinery/light/cold/directional/north,
/turf/open/floor/iron/dark/smooth_large,
/area/shuttle/vulture)
"BM" = (
/obj/structure/table/reinforced/plastitaniumglass,
/obj/machinery/recharger,
/turf/open/floor/iron/dark/smooth_large,
/area/shuttle/vulture)
"Cl" = (
/turf/template_noop,
/area/template_noop)
"DY" = (
/obj/machinery/atmospherics/components/unary/vent_pump/on/layer4,
/turf/open/floor/iron/shuttle/evac,
/area/shuttle/vulture)
"DZ" = (
/obj/effect/turf_decal/tile/neutral{
	dir = 1
	},
/obj/effect/turf_decal/tile/neutral{
	dir = 8
	},
/obj/effect/turf_decal/tile/neutral{
	dir = 4
	},
/obj/effect/turf_decal/tile/neutral,
/obj/effect/turf_decal/box/white/corners{
	dir = 4
	},
/obj/effect/turf_decal/box/white/corners,
/obj/structure/reagent_dispensers/watertank,
/turf/open/floor/iron/dark,
/area/shuttle/vulture)
"Ej" = (
/obj/structure/closet/secure_closet/personal,
/obj/effect/turf_decal/bot_white,
/obj/machinery/atmospherics/components/unary/vent_pump/on/layer4,
/turf/open/floor/iron/dark/smooth_large,
/area/shuttle/vulture)
"FH" = (
/obj/structure/closet/crate/secure/plasma,
/obj/item/stack/sheet/mineral/plasma/thirty,
/obj/effect/turf_decal/bot_white,
/turf/open/floor/iron/dark/smooth_large,
/area/shuttle/vulture)
"FU" = (
/obj/effect/turf_decal/siding/thinplating/dark/corner,
/obj/structure/cable,
/obj/structure/extinguisher_cabinet/directional/west,
/obj/machinery/atmospherics/pipe/smart/manifold4w/supply/hidden/layer4,
/obj/machinery/atmospherics/pipe/smart/manifold4w/scrubbers/hidden/layer2,
/turf/open/floor/iron/shuttle/evac,
/area/shuttle/vulture)
"IP" = (
/obj/effect/turf_decal/bot,
/obj/machinery/holopad/secure,
/obj/machinery/atmospherics/pipe/smart/manifold4w/scrubbers/hidden/layer2,
/turf/open/floor/iron/dark/smooth_large,
/area/shuttle/vulture)
"JV" = (
/obj/structure/chair/comfy/shuttle{
	dir = 8
	},
/obj/effect/turf_decal/bot_white,
/obj/machinery/airalarm/directional/east,
/obj/machinery/atmospherics/components/unary/vent_scrubber/on/layer2{
	dir = 8
	},
/turf/open/floor/iron/dark/smooth_large,
/area/shuttle/vulture)
"KX" = (
/obj/machinery/atmospherics/pipe/smart/manifold4w/orange/visible,
/obj/machinery/atmospherics/components/unary/portables_connector/visible/layer2{
	dir = 4
	},
/obj/machinery/portable_atmospherics/canister/tier_2,
/obj/effect/turf_decal/bot_white,
/turf/open/floor/iron/dark/smooth_large,
/area/shuttle/vulture)
"La" = (
/obj/effect/turf_decal/siding/thinplating/dark/corner{
	dir = 4
	},
/obj/machinery/atmospherics/pipe/smart/manifold4w/supply/hidden/layer4,
/obj/machinery/atmospherics/pipe/smart/manifold4w/scrubbers/hidden/layer2,
/turf/open/floor/iron/shuttle/evac,
/area/shuttle/vulture)
"Lz" = (
/obj/effect/turf_decal/siding/thinplating/dark,
/obj/structure/window/reinforced/spawner,
/obj/structure/chair/comfy/shuttle{
	dir = 8
	},
/obj/effect/turf_decal/bot_white,
/obj/machinery/power/apc/auto_name/directional/east,
/obj/structure/cable,
/obj/machinery/atmospherics/components/unary/vent_pump/on/layer4{
	dir = 8
	},
/turf/open/floor/iron/dark/smooth_large,
/area/shuttle/vulture)
"Mb" = (
/turf/closed/wall/mineral/titanium,
/area/shuttle/vulture)
"Ms" = (
/obj/machinery/atmospherics/pipe/smart/manifold4w/supply/hidden/layer4,
/obj/machinery/atmospherics/pipe/smart/manifold4w/scrubbers/hidden/layer2,
/turf/open/floor/catwalk_floor/iron_dark,
/area/shuttle/vulture)
"OO" = (
/turf/closed/wall/mineral/titanium/spaceship/nodiagonal,
/area/shuttle/vulture)
"Ph" = (
/obj/effect/turf_decal/tile/neutral{
	dir = 1
	},
/obj/effect/turf_decal/tile/neutral{
	dir = 8
	},
/obj/effect/turf_decal/tile/neutral{
	dir = 4
	},
/obj/effect/turf_decal/tile/neutral,
/obj/effect/turf_decal/box/white/corners{
	dir = 4
	},
/obj/effect/turf_decal/box/white/corners{
	dir = 1
	},
/obj/structure/ore_box,
/turf/open/floor/iron/dark,
/area/shuttle/vulture)
"Pl" = (
/obj/structure/rack/shelf,
/obj/item/tank/internals/emergency_oxygen/double,
/obj/item/pickaxe/mini,
/obj/item/clothing/mask/gas/explorer,
/obj/effect/turf_decal/bot_white,
/obj/machinery/light/cold/directional/north,
/obj/machinery/atmospherics/components/unary/vent_pump/on/layer4{
	dir = 4
	},
/turf/open/floor/iron/dark/smooth_large,
/area/shuttle/vulture)
"QG" = (
/obj/structure/rack,
/obj/item/stack/rods/fifty,
/obj/item/stack/sheet/iron/twenty,
/obj/item/stack/sheet/mineral/titanium/fifty,
/obj/effect/turf_decal/bot_white,
/obj/structure/extinguisher_cabinet/directional/east,
/turf/open/floor/iron/dark/smooth_large,
/area/shuttle/vulture)
"Ra" = (
/obj/machinery/atmospherics/components/tank/carbon_dioxide,
/obj/effect/turf_decal/bot_white,
/obj/machinery/airalarm/directional/north,
/turf/open/floor/iron/dark/smooth_large,
/area/shuttle/vulture)
"Td" = (
/obj/structure/table/reinforced/plastitaniumglass,
/obj/item/modular_computer/laptop/preset/civilian,
/obj/machinery/button/door/directional/north{
	id = "vulture_shutter"
	},
/turf/open/floor/iron/dark/smooth_large,
/area/shuttle/vulture)
"Tm" = (
/obj/machinery/portable_atmospherics/canister/oxygen,
/obj/machinery/atmospherics/components/unary/portables_connector/visible/layer4,
/obj/effect/turf_decal/bot_white,
/turf/open/floor/iron/dark/smooth_large,
/area/shuttle/vulture)
"To" = (
/obj/machinery/atmospherics/pipe/smart/manifold4w/orange/visible,
/obj/machinery/atmospherics/components/binary/pump/on/layer2{
	dir = 8
	},
/obj/machinery/atmospherics/pipe/smart/manifold4w/supply/hidden/layer4,
/turf/open/floor/catwalk_floor/iron_dark,
/area/shuttle/vulture)
"UX" = (
/obj/effect/turf_decal/tile/neutral{
	dir = 1
	},
/obj/effect/turf_decal/tile/neutral{
	dir = 8
	},
/obj/effect/turf_decal/tile/neutral{
	dir = 4
	},
/obj/effect/turf_decal/tile/neutral,
/obj/effect/turf_decal/box/white/corners{
	dir = 8
	},
/obj/effect/turf_decal/box/white/corners{
	dir = 1
	},
/obj/structure/closet/crate/secure/gear,
/obj/item/reagent_containers/glass/bucket,
/obj/item/mop,
/obj/item/lightreplacer,
/obj/item/storage/bag/ore,
/turf/open/floor/iron/dark,
/area/shuttle/vulture)
"Xw" = (
/obj/machinery/light/cold/directional/west,
/obj/machinery/atmospherics/pipe/smart/manifold4w/supply/hidden/layer4,
/obj/machinery/atmospherics/pipe/smart/manifold4w/scrubbers/hidden/layer2,
/turf/open/floor/iron/shuttle/evac,
/area/shuttle/vulture)
"XM" = (
/obj/machinery/atmospherics/pipe/smart/manifold4w/supply/hidden/layer4,
/turf/open/floor/catwalk_floor/iron_dark,
/area/shuttle/vulture)
"Yu" = (
/obj/structure/cable,
/obj/machinery/atmospherics/pipe/smart/manifold4w/supply/hidden/layer4,
/obj/machinery/atmospherics/pipe/smart/manifold4w/scrubbers/hidden/layer2,
/turf/open/floor/catwalk_floor/iron_dark,
/area/shuttle/vulture)
"Zb" = (
/obj/structure/shuttle/engine/heater{
	dir = 8
	},
/obj/effect/spawner/structure/window/reinforced/plasma/plastitanium,
/obj/machinery/atmospherics/pipe/smart/manifold4w/orange/visible,
/turf/open/floor/plating,
/area/shuttle/vulture)
"Zf" = (
/obj/effect/turf_decal/delivery/white,
/obj/machinery/door/airlock/external/glass,
/obj/machinery/atmospherics/pipe/smart/manifold4w/supply/hidden/layer4,
/obj/machinery/atmospherics/pipe/smart/manifold4w/scrubbers/hidden/layer2,
/turf/open/floor/iron/dark/textured_large,
/area/shuttle/vulture)
"Zs" = (
/obj/structure/cable,
/obj/machinery/power/port_gen/pacman,
/obj/effect/turf_decal/bot_white,
/turf/open/floor/iron/dark/smooth_large,
/area/shuttle/vulture)
"ZR" = (
/obj/effect/turf_decal/siding/thinplating/dark{
	dir = 4
	},
/obj/machinery/atmospherics/pipe/smart/manifold4w/supply/hidden/layer4,
/obj/machinery/atmospherics/pipe/smart/manifold4w/scrubbers/hidden/layer2,
/turf/open/floor/iron/shuttle/evac,
/area/shuttle/vulture)

(1,1,1) = {"
Cl
Cl
OO
Cl
Cl
OO
Cl
Cl
OO
Cl
Cl
"}
(2,1,1) = {"
Cl
Cl
pX
xN
xN
pX
xN
xN
pX
Cl
Cl
"}
(3,1,1) = {"
Cl
bs
pX
Zb
Zb
pX
Zb
Zb
pX
bs
Cl
"}
(4,1,1) = {"
Cl
pX
Tm
XM
KX
od
cz
iI
mM
pX
Cl
"}
(5,1,1) = {"
Cl
do
Ra
lS
To
uB
Zs
QG
FH
do
Cl
"}
(6,1,1) = {"
Mb
do
do
Ab
Yu
mx
do
do
do
do
Cl
"}
(7,1,1) = {"
do
Pl
do
do
xy
do
do
Ph
ql
do
Mb
"}
(8,1,1) = {"
yq
Ms
Zf
Xw
dG
FU
ZR
La
ep
UX
do
"}
(9,1,1) = {"
do
je
yl
ep
JV
Lz
ip
qp
ep
DZ
do
"}
(10,1,1) = {"
Mb
do
do
nl
do
do
do
do
zh
do
do
"}
(11,1,1) = {"
Cl
do
Ej
lD
lk
do
AR
DY
ep
AI
yl
"}
(12,1,1) = {"
Cl
do
qQ
lI
wi
do
pC
yB
IP
BM
yl
"}
(13,1,1) = {"
Cl
do
do
do
do
do
do
Td
Ao
do
Mb
"}
(14,1,1) = {"
Cl
do
bP
Cl
Cl
Cl
yl
ra
rJ
yl
Cl
"}
(15,1,1) = {"
Cl
Cl
Cl
Cl
Cl
Cl
do
yl
yl
Mb
Cl
"}
