//MAP CONVERTED BY dmm2tgm.py THIS HEADER COMMENT PREVENTS RECONVERSION, DO NOT REMOVE
"a" = (
/turf/template_noop,
/area/template_noop)
"d" = (
/obj/structure/chair/comfy/shuttle{
	dir = 4
	},
/obj/structure/window/reinforced/spawner/west,
/obj/effect/turf_decal/siding/thinplating/dark/end{
	dir = 1
	},
/turf/open/floor/iron/shuttle/evac,
/area/shuttle/workman)
"e" = (
/obj/effect/turf_decal/mining,
/turf/closed/wall/mineral/plastitanium/nodiagonal,
/area/shuttle/workman)
"h" = (
/obj/machinery/atmospherics/pipe/smart/manifold4w/orange/visible,
/obj/machinery/meter,
/obj/machinery/atmospherics/pipe/smart/manifold4w/supply/hidden/layer4,
/obj/effect/turf_decal/tile/neutral{
	dir = 4
	},
/obj/effect/turf_decal/tile/neutral{
	dir = 1
	},
/obj/effect/turf_decal/tile/neutral{
	dir = 8
	},
/obj/effect/turf_decal/tile/neutral,
/turf/open/floor/iron/dark,
/area/shuttle/workman)
"m" = (
/turf/closed/wall/mineral/titanium/nodiagonal,
/area/shuttle/workman)
"q" = (
/obj/machinery/atmospherics/components/unary/vent_pump/on/layer4{
	dir = 8
	},
/obj/machinery/power/terminal{
	dir = 1
	},
/obj/structure/cable,
/obj/effect/turf_decal/tile/neutral{
	dir = 4
	},
/obj/effect/turf_decal/tile/neutral{
	dir = 1
	},
/obj/effect/turf_decal/tile/neutral{
	dir = 8
	},
/obj/effect/turf_decal/tile/neutral,
/turf/open/floor/iron/dark,
/area/shuttle/workman)
"t" = (
/obj/effect/turf_decal/siding/thinplating/dark/end,
/obj/machinery/holopad/secure,
/obj/item/radio/intercom/directional/east,
/turf/open/floor/iron/shuttle/evac,
/area/shuttle/workman)
"v" = (
/obj/machinery/atmospherics/pipe/smart/manifold4w/supply/hidden/layer4,
/turf/open/floor/catwalk_floor,
/area/shuttle/workman)
"w" = (
/turf/closed/wall/mineral/titanium/survival,
/area/shuttle/workman)
"x" = (
/obj/effect/spawner/structure/window/reinforced/shuttle,
/turf/open/floor/plating,
/area/shuttle/workman)
"y" = (
/obj/effect/turf_decal/delivery/white,
/obj/machinery/door/airlock/external{
	id_tag = "workmanext"
	},
/obj/structure/cable,
/obj/structure/fans/tiny,
/obj/docking_port/mobile{
	dwidth = 5;
	height = 5;
	id = "baserunner";
	launch_status = 0;
	name = "MS Baserunner";
	port_direction = 8;
	preferred_direction = 4;
	width = 9
	},
/turf/open/floor/iron/dark/textured_large,
/area/shuttle/workman)
"D" = (
/obj/machinery/button/door/directional/east{
	id = "workmanext";
	name = "External Airlock Bolt Control";
	normaldoorcontrol = 1;
	specialfunctions = 4
	},
/obj/structure/cable,
/turf/open/floor/catwalk_floor,
/area/shuttle/workman)
"E" = (
/turf/closed/wall/mineral/titanium,
/area/shuttle/workman)
"G" = (
/obj/structure/shuttle/engine/heater{
	dir = 8
	},
/obj/effect/spawner/structure/window/reinforced/plasma/plastitanium,
/obj/machinery/atmospherics/pipe/smart/manifold4w/orange/visible,
/turf/open/floor/plating,
/area/shuttle/workman)
"J" = (
/turf/closed/wall/mineral/plastitanium/nodiagonal,
/area/shuttle/workman)
"K" = (
/obj/machinery/transporter,
/obj/effect/turf_decal/bot_white,
/turf/open/floor/iron/dark/textured_large,
/area/shuttle/workman)
"L" = (
/obj/machinery/computer/shuttle/common_docks{
	dir = 8
	},
/obj/effect/turf_decal/bot_white,
/turf/open/floor/iron/dark/textured_large,
/area/shuttle/workman)
"M" = (
/obj/structure/cable,
/obj/machinery/power/apc/auto_name/directional/north,
/obj/item/storage/bag/garment/exp_pilot,
/obj/structure/closet/crate/cardboard/fops,
/turf/open/floor/catwalk_floor,
/area/shuttle/workman)
"O" = (
/turf/closed/wall/mineral/plastitanium,
/area/shuttle/workman)
"R" = (
/obj/machinery/portable_atmospherics/canister/carbon_dioxide,
/obj/machinery/atmospherics/components/unary/portables_connector/visible{
	dir = 1
	},
/obj/effect/turf_decal/tile/neutral{
	dir = 4
	},
/obj/effect/turf_decal/tile/neutral{
	dir = 1
	},
/obj/effect/turf_decal/tile/neutral{
	dir = 8
	},
/obj/effect/turf_decal/tile/neutral,
/obj/structure/extinguisher_cabinet/directional/west,
/turf/open/floor/iron/dark,
/area/shuttle/workman)
"T" = (
/obj/machinery/power/smes/engineering{
	charge = 1e+006
	},
/obj/structure/cable,
/obj/effect/turf_decal/tile/neutral{
	dir = 4
	},
/obj/effect/turf_decal/tile/neutral{
	dir = 1
	},
/obj/effect/turf_decal/tile/neutral{
	dir = 8
	},
/obj/effect/turf_decal/tile/neutral,
/obj/machinery/airalarm/directional/north,
/obj/machinery/light/cold/directional/north,
/turf/open/floor/iron/dark,
/area/shuttle/workman)
"U" = (
/obj/machinery/ship_weapon/mining_laser{
	dir = 4
	},
/turf/closed/wall/mineral/titanium/nodiagonal,
/area/shuttle/workman)
"X" = (
/obj/machinery/atmospherics/components/unary/portables_connector/visible/layer4,
/obj/machinery/portable_atmospherics/canister/oxygen,
/obj/effect/turf_decal/tile/neutral{
	dir = 4
	},
/obj/effect/turf_decal/tile/neutral{
	dir = 1
	},
/obj/effect/turf_decal/tile/neutral{
	dir = 8
	},
/obj/effect/turf_decal/tile/neutral,
/turf/open/floor/iron/dark,
/area/shuttle/workman)
"Y" = (
/obj/machinery/atmospherics/components/unary/engine{
	dir = 8
	},
/obj/effect/turf_decal/stripes/line{
	dir = 8
	},
/turf/open/floor/plating/airless,
/area/shuttle/workman)

(1,1,1) = {"
w
a
a
w
a
"}
(2,1,1) = {"
J
Y
Y
J
a
"}
(3,1,1) = {"
J
G
G
J
O
"}
(4,1,1) = {"
e
X
h
R
e
"}
(5,1,1) = {"
m
M
v
K
m
"}
(6,1,1) = {"
m
T
q
D
y
"}
(7,1,1) = {"
x
d
t
m
m
"}
(8,1,1) = {"
x
L
m
U
E
"}
(9,1,1) = {"
E
x
m
a
a
"}
