//MAP CONVERTED BY dmm2tgm.py THIS HEADER COMMENT PREVENTS RECONVERSION, DO NOT REMOVE
"aH" = (
/obj/effect/rune/convert,
/obj/effect/decal/remains/human,
/obj/effect/decal/cleanable/blood/gibs/body,
/obj/effect/decal/cleanable/blood/gibs/core,
/turf/open/floor/cult,
/area/shuttle/cult_meteor)
"bK" = (
/obj/machinery/computer/communications{
	dir = 8
	},
/turf/open/floor/cult,
/area/shuttle/cult_meteor)
"cW" = (
/turf/open/floor/cult,
/area/shuttle/cult_meteor)
"df" = (
/obj/structure/extinguisher_cabinet/directional/east,
/obj/item/extinguisher{
	safety = 0
	},
/turf/open/floor/cult,
/area/shuttle/cult_meteor)
"eA" = (
/turf/closed/wall/mineral/cult,
/area/shuttle/cult_meteor)
"fC" = (
/obj/structure/dresser,
/turf/open/floor/cult,
/area/shuttle/cult_meteor)
"iP" = (
/obj/structure/bed,
/obj/item/bedsheet/cult,
/turf/open/floor/cult,
/area/shuttle/cult_meteor)
"jN" = (
/obj/item/candle/infinite,
/turf/open/floor/cult,
/area/shuttle/cult_meteor)
"kN" = (
/obj/effect/decal/cleanable/blood/drip,
/turf/open/floor/cult,
/area/shuttle/cult_meteor)
"pG" = (
/obj/structure/extinguisher_cabinet/directional/east,
/obj/item/stack/sheet/runed_metal/five,
/turf/open/floor/cult,
/area/shuttle/cult_meteor)
"qw" = (
/obj/effect/rune/convert,
/obj/effect/decal/remains/human,
/turf/open/floor/cult,
/area/shuttle/cult_meteor)
"rq" = (
/obj/structure/chair/comfy/shuttle{
	dir = 4
	},
/turf/open/floor/cult,
/area/shuttle/cult_meteor)
"rE" = (
/obj/structure/window/reinforced{
	dir = 1
	},
/obj/machinery/power/shuttle_engine/heater,
/turf/open/floor/plating/airless,
/area/shuttle/cult_meteor)
"sa" = (
/obj/item/stack/sheet/runed_metal/five,
/turf/open/floor/cult,
/area/shuttle/cult_meteor)
"tD" = (
/obj/effect/decal/remains/human,
/obj/item/stack/sheet/runed_metal/five,
/turf/open/floor/cult,
/area/shuttle/cult_meteor)
"tQ" = (
/obj/effect/decal/cleanable/blood/gibs/up,
/obj/item/candle/infinite,
/turf/open/floor/cult,
/area/shuttle/cult_meteor)
"tU" = (
/obj/effect/forcefield/cult/permanent,
/turf/open/floor/plating,
/area/shuttle/cult_meteor)
"uG" = (
/obj/structure/table,
/obj/item/storage/medkit/fire,
/turf/open/floor/cult,
/area/shuttle/cult_meteor)
"xQ" = (
/obj/structure/closet/emcloset,
/turf/open/floor/cult,
/area/shuttle/cult_meteor)
"yy" = (
/obj/effect/decal/cleanable/blood/gibs/down,
/turf/open/floor/cult,
/area/shuttle/cult_meteor)
"yA" = (
/obj/structure/table,
/obj/item/storage/medkit/regular{
	pixel_x = 2;
	pixel_y = 3
	},
/obj/item/crowbar,
/obj/item/stack/sheet/runed_metal/five,
/obj/item/stack/sheet/runed_metal/five,
/turf/open/floor/cult,
/area/shuttle/cult_meteor)
"zY" = (
/obj/structure/table,
/obj/item/storage/medkit/fire,
/obj/item/storage/medkit/regular{
	pixel_x = 2;
	pixel_y = 3
	},
/obj/item/crowbar,
/turf/open/floor/cult,
/area/shuttle/cult_meteor)
"BF" = (
/obj/effect/rune/raise_dead,
/turf/open/floor/cult,
/area/shuttle/cult_meteor)
"Cd" = (
/obj/item/storage/medkit/fire,
/obj/item/storage/medkit/regular{
	pixel_x = 2;
	pixel_y = 3
	},
/obj/item/crowbar,
/obj/structure/extinguisher_cabinet/directional/east,
/obj/item/stack/sheet/iron,
/turf/open/floor/cult,
/area/shuttle/cult_meteor)
"De" = (
/obj/effect/rune/narsie,
/turf/open/floor/cult,
/area/shuttle/cult_meteor)
"DJ" = (
/obj/structure/table/wood,
/obj/item/tome,
/turf/open/floor/cult,
/area/shuttle/cult_meteor)
"FB" = (
/obj/machinery/door/airlock/cult/friendly,
/turf/open/floor/plating,
/area/shuttle/cult_meteor)
"FL" = (
/obj/machinery/computer/camera_advanced/shuttle_docker/cult_meteor,
/turf/open/floor/cult,
/area/shuttle/cult_meteor)
"Hf" = (
/obj/machinery/status_display/evac/directional/north,
/turf/open/floor/cult,
/area/shuttle/cult_meteor)
"HK" = (
/obj/machinery/door/airlock/cult/friendly,
/obj/docking_port/mobile/cult_meteor,
/turf/open/floor/plating,
/area/shuttle/cult_meteor)
"Lb" = (
/obj/machinery/door/airlock/cult/glass/friendly,
/turf/open/floor/cult,
/area/shuttle/cult_meteor)
"LN" = (
/obj/structure/extinguisher_cabinet/directional/east,
/turf/open/floor/cult,
/area/shuttle/cult_meteor)
"NA" = (
/obj/machinery/status_display/evac/directional/south,
/turf/open/floor/cult,
/area/shuttle/cult_meteor)
"Od" = (
/turf/template_noop,
/area/template_noop)
"Pn" = (
/obj/machinery/door/airlock/cult/unruned/glass/friendly,
/turf/open/floor/cult,
/area/shuttle/cult_meteor)
"PF" = (
/obj/effect/decal/cleanable/blood,
/turf/open/floor/cult,
/area/shuttle/cult_meteor)
"PN" = (
/obj/structure/chair/comfy/shuttle{
	dir = 8
	},
/obj/structure/extinguisher_cabinet/directional/south,
/turf/open/floor/cult,
/area/shuttle/cult_meteor)
"QR" = (
/obj/structure/destructible/cult/item_dispenser/archives,
/turf/open/floor/cult,
/area/shuttle/cult_meteor)
"Rw" = (
/obj/structure/destructible/cult/item_dispenser/altar,
/turf/open/floor/cult,
/area/shuttle/cult_meteor)
"Sf" = (
/obj/machinery/power/shuttle_engine/propulsion,
/turf/open/floor/plating/airless,
/area/shuttle/cult_meteor)
"Sp" = (
/obj/item/stack/sheet/iron,
/obj/effect/decal/remains/human,
/turf/open/floor/cult,
/area/shuttle/cult_meteor)
"SF" = (
/obj/machinery/computer/security{
	dir = 8
	},
/turf/open/floor/cult,
/area/shuttle/cult_meteor)
"Tk" = (
/obj/structure/chair/comfy/shuttle{
	dir = 8
	},
/turf/open/floor/cult,
/area/shuttle/cult_meteor)
"Uf" = (
/obj/machinery/computer/atmos_alert{
	dir = 4
	},
/turf/open/floor/cult,
/area/shuttle/cult_meteor)
"VD" = (
/obj/structure/destructible/cult/pylon,
/turf/open/floor/cult,
/area/shuttle/cult_meteor)
"Xk" = (
/obj/machinery/computer/shuttle/cult_meteor,
/turf/open/floor/cult,
/area/shuttle/cult_meteor)
"Ye" = (
/obj/machinery/computer/crew{
	dir = 4
	},
/turf/open/floor/cult,
/area/shuttle/cult_meteor)
"Zw" = (
/obj/structure/destructible/cult/item_dispenser/forge/engine,
/turf/open/floor/cult,
/area/shuttle/cult_meteor)
"ZJ" = (
/obj/item/stack/sheet/iron,
/turf/open/floor/cult,
/area/shuttle/cult_meteor)

(1,1,1) = {"
Od
Od
Od
Od
eA
eA
eA
FB
eA
HK
eA
tU
tU
tU
eA
FB
eA
FB
eA
eA
eA
Od
"}
(2,1,1) = {"
Od
eA
eA
eA
eA
cW
cW
cW
cW
cW
cW
cW
cW
cW
cW
cW
eA
cW
cW
ZJ
eA
eA
"}
(3,1,1) = {"
eA
eA
Uf
Ye
eA
cW
PF
cW
jN
cW
BF
cW
jN
cW
cW
PF
tD
cW
cW
ZJ
rE
Sf
"}
(4,1,1) = {"
tU
uG
Tk
PN
eA
sa
cW
tQ
aH
yy
cW
cW
qw
jN
cW
cW
Lb
cW
cW
DJ
rE
Sf
"}
(5,1,1) = {"
tU
Xk
cW
cW
eA
cW
cW
cW
cW
cW
cW
cW
cW
cW
cW
kN
eA
fC
LN
iP
rE
Sf
"}
(6,1,1) = {"
tU
VD
cW
cW
Sp
cW
cW
BF
cW
cW
De
cW
cW
BF
cW
NA
eA
eA
eA
eA
rE
Sf
"}
(7,1,1) = {"
tU
FL
cW
cW
Pn
cW
cW
cW
cW
cW
cW
cW
cW
cW
cW
kN
tU
xQ
Rw
xQ
rE
Sf
"}
(8,1,1) = {"
tU
yA
rq
rq
eA
Hf
cW
jN
qw
cW
cW
cW
qw
jN
PF
cW
Pn
kN
cW
cW
rE
Sf
"}
(9,1,1) = {"
eA
eA
SF
bK
eA
xQ
cW
PF
jN
cW
BF
cW
jN
cW
cW
cW
tU
cW
cW
cW
rE
Sf
"}
(10,1,1) = {"
Od
eA
eA
eA
eA
zY
cW
cW
cW
df
cW
cW
cW
cW
cW
pG
tU
QR
Cd
Zw
eA
eA
"}
(11,1,1) = {"
Od
Od
Od
Od
eA
tU
eA
tU
eA
eA
eA
tU
tU
tU
eA
eA
eA
tU
eA
tU
eA
Od
"}
