//MAP CONVERTED BY dmm2tgm.py THIS HEADER COMMENT PREVENTS RECONVERSION, DO NOT REMOVE
"e" = (
/obj/machinery/power/shuttle_engine/propulsion/burst{
	pixel_y = -13
	},
/obj/structure/marker_beacon/olive,
/turf/closed/wall/mineral/titanium/spaceship/nodiagonal,
/area/shuttle/pod_1)
"p" = (
/obj/structure/marker_beacon/olive,
/turf/closed/wall/mineral/titanium,
/area/shuttle/pod_1)
"B" = (
/obj/structure/marker_beacon/burgundy,
/turf/closed/wall/mineral/titanium,
/area/shuttle/pod_1)
"G" = (
/obj/structure/chair/comfy/shuttle{
	dir = 8;
	pixel_x = 9
	},
/obj/effect/turf_decal/stripes/white/line{
	dir = 4
	},
/obj/effect/turf_decal/stripes/white/line{
	dir = 8
	},
/turf/open/floor/mineral/plastitanium,
/area/shuttle/pod_1)
"K" = (
/obj/machinery/power/shuttle_engine/propulsion/in_wall{
	dir = 4;
	pixel_x = 32
	},
/turf/closed/wall/mineral/titanium/nodiagonal,
/area/shuttle/pod_1)
"L" = (
/turf/closed/wall/mineral/titanium/nodiagonal,
/area/shuttle/pod_1)
"N" = (
/obj/docking_port/mobile/pod{
	port_direction = 2
	},
/obj/effect/turf_decal/delivery/white,
/obj/machinery/door/airlock/survival_pod,
/turf/open/floor/iron/dark/textured_large,
/area/shuttle/pod_1)
"Q" = (
/obj/effect/spawner/structure/window/reinforced/shuttle,
/turf/open/floor/plating,
/area/shuttle/pod_1)
"U" = (
/obj/item/storage/pod{
	pixel_x = -20
	},
/obj/structure/chair/comfy/shuttle{
	dir = 8;
	pixel_x = 9
	},
/obj/machinery/light/red/dim/directional/west,
/obj/effect/turf_decal/stripes/white/line{
	dir = 4
	},
/obj/effect/turf_decal/stripes/white/line{
	dir = 8
	},
/turf/open/floor/mineral/plastitanium,
/area/shuttle/pod_1)
"X" = (
/obj/machinery/computer/shuttle/pod/advanced{
	dir = 4
	},
/obj/machinery/power/shuttle_engine/propulsion/in_wall{
	dir = 8;
	pixel_x = -32
	},
/turf/closed/wall/mineral/titanium/nodiagonal,
/area/shuttle/pod_1)
"Z" = (
/obj/machinery/power/shuttle_engine/propulsion/burst{
	pixel_y = -13
	},
/obj/structure/marker_beacon/burgundy,
/turf/closed/wall/mineral/titanium/spaceship/nodiagonal,
/area/shuttle/pod_1)

(1,1,1) = {"
B
X
L
Z
"}
(2,1,1) = {"
Q
G
U
N
"}
(3,1,1) = {"
p
K
L
e
"}
