//MAP CONVERTED BY dmm2tgm.py THIS HEADER COMMENT PREVENTS RECONVERSION, DO NOT REMOVE
"bZ" = (
/obj/machinery/power/terminal{
	dir = 1
	},
/obj/structure/cable,
/obj/machinery/power/port_gen/pacman/super,
/obj/effect/turf_decal/bot_white,
/obj/machinery/airalarm/directional/east,
/obj/machinery/light/cold/directional/east,
/turf/open/floor/iron/dark/smooth_large,
/area/shuttle/crow)
"eT" = (
/turf/closed/wall/mineral/plastitanium,
/area/shuttle/crow)
"fw" = (
/obj/effect/turf_decal/bot_white,
/obj/structure/rack,
/obj/item/storage/inflatable,
/obj/item/survivalcapsule,
/turf/open/floor/iron/dark/smooth_large,
/area/shuttle/crow)
"fJ" = (
/obj/machinery/atmospherics/pipe/smart/manifold4w/scrubbers/hidden/layer2,
/obj/machinery/atmospherics/pipe/smart/manifold4w/supply/hidden/layer4,
/obj/structure/extinguisher_cabinet/directional/east,
/obj/structure/cable,
/turf/open/floor/iron/shuttle/ferry,
/area/shuttle/crow)
"fM" = (
/obj/structure/rack/shelf,
/obj/item/reagent_containers/food/drinks/waterbottle{
	pixel_x = -5;
	pixel_y = -3
	},
/obj/item/reagent_containers/food/drinks/waterbottle{
	pixel_x = -5
	},
/obj/item/reagent_containers/food/drinks/waterbottle{
	pixel_x = -5;
	pixel_y = 3
	},
/obj/item/reagent_containers/food/drinks/waterbottle{
	pixel_y = -3
	},
/obj/item/reagent_containers/food/drinks/waterbottle,
/obj/item/reagent_containers/food/drinks/waterbottle{
	pixel_y = 3
	},
/obj/item/reagent_containers/food/drinks/waterbottle{
	pixel_x = 5;
	pixel_y = -3
	},
/obj/item/reagent_containers/food/drinks/waterbottle{
	pixel_x = 5
	},
/obj/item/reagent_containers/food/drinks/waterbottle{
	pixel_x = 5;
	pixel_y = 3
	},
/obj/effect/turf_decal/bot_white,
/turf/open/floor/iron/dark/smooth_large,
/area/shuttle/crow)
"gn" = (
/turf/closed/wall/mineral/titanium/spaceship/nodiagonal,
/area/shuttle/crow)
"gD" = (
/obj/machinery/autolathe,
/obj/effect/turf_decal/bot_white,
/obj/machinery/firealarm/directional/east,
/turf/open/floor/iron/dark/smooth_large,
/area/shuttle/crow)
"gX" = (
/obj/machinery/atmospherics/components/tank/carbon_dioxide,
/obj/effect/turf_decal/bot_white,
/turf/open/floor/iron/dark/smooth_large,
/area/shuttle/crow)
"hn" = (
/obj/effect/turf_decal/tile/neutral{
	dir = 4
	},
/obj/effect/turf_decal/tile/neutral{
	dir = 8
	},
/obj/effect/turf_decal/tile/neutral{
	dir = 1
	},
/obj/effect/turf_decal/tile/neutral,
/obj/effect/turf_decal/box/white/corners,
/turf/open/floor/iron/dark,
/area/shuttle/crow)
"hB" = (
/obj/effect/turf_decal/delivery/white,
/obj/structure/cable,
/obj/machinery/atmospherics/pipe/smart/manifold4w/orange/visible,
/obj/machinery/atmospherics/pipe/smart/manifold4w/supply/hidden/layer4,
/obj/machinery/atmospherics/pipe/smart/manifold4w/scrubbers/hidden/layer2,
/obj/machinery/door/airlock/hatch{
	name = "Engineering Access Hatch"
	},
/turf/open/floor/iron/dark/textured_large,
/area/shuttle/crow)
"iO" = (
/obj/machinery/computer/monitor{
	dir = 8
	},
/obj/structure/cable,
/turf/open/floor/iron/dark/smooth_large,
/area/shuttle/crow)
"iP" = (
/obj/effect/turf_decal/bot_white,
/obj/structure/bed/pod{
	dir = 1
	},
/obj/item/bedsheet/black{
	dir = 1
	},
/turf/open/floor/iron/dark/smooth_large,
/area/shuttle/crow)
"jh" = (
/obj/machinery/atmospherics/pipe/smart/manifold4w/scrubbers/hidden/layer2,
/obj/machinery/atmospherics/pipe/smart/manifold4w/supply/hidden/layer4,
/obj/structure/cable,
/turf/open/floor/iron/shuttle/ferry,
/area/shuttle/crow)
"jD" = (
/obj/machinery/atmospherics/components/unary/engine{
	dir = 8
	},
/obj/effect/turf_decal/stripes/line{
	dir = 8
	},
/turf/open/floor/plating/airless,
/area/shuttle/crow)
"jL" = (
/turf/template_noop,
/area/template_noop)
"lD" = (
/obj/effect/turf_decal/bot_white,
/obj/structure/reagent_dispensers/watertank,
/turf/open/floor/iron/dark/smooth_large,
/area/shuttle/crow)
"lI" = (
/obj/effect/spawner/structure/window/reinforced/shuttle,
/obj/machinery/door/poddoor/preopen{
	id = "crow_shutter"
	},
/turf/open/floor/plating,
/area/shuttle/crow)
"mR" = (
/obj/effect/turf_decal/tile/neutral{
	dir = 4
	},
/obj/effect/turf_decal/tile/neutral{
	dir = 8
	},
/obj/effect/turf_decal/tile/neutral{
	dir = 1
	},
/obj/effect/turf_decal/tile/neutral,
/obj/machinery/atmospherics/components/unary/vent_scrubber/on/layer2{
	dir = 1
	},
/turf/open/floor/iron/dark,
/area/shuttle/crow)
"nK" = (
/obj/machinery/computer/monitor{
	dir = 8
	},
/obj/effect/turf_decal/bot_white,
/obj/machinery/light/cold/directional/east,
/turf/open/floor/iron/dark/smooth_large,
/area/shuttle/crow)
"nX" = (
/obj/machinery/computer/crew,
/obj/effect/turf_decal/bot_white,
/turf/open/floor/iron/dark/smooth_large,
/area/shuttle/crow)
"oH" = (
/obj/effect/turf_decal/tile/neutral{
	dir = 4
	},
/obj/effect/turf_decal/tile/neutral{
	dir = 8
	},
/obj/effect/turf_decal/tile/neutral{
	dir = 1
	},
/obj/effect/turf_decal/tile/neutral,
/obj/structure/closet/crate/wooden,
/obj/machinery/atmospherics/components/unary/vent_pump/on/layer4{
	dir = 1
	},
/turf/open/floor/iron/dark,
/area/shuttle/crow)
"oL" = (
/obj/structure/table/reinforced/plastitaniumglass,
/obj/item/modular_computer/tablet/preset/cargo,
/turf/open/floor/iron/dark/smooth_large,
/area/shuttle/crow)
"pi" = (
/obj/structure/cable,
/obj/machinery/atmospherics/components/unary/vent_pump/on/layer4,
/obj/machinery/atmospherics/pipe/smart/manifold4w/scrubbers/hidden/layer2,
/turf/open/floor/iron/shuttle/evac,
/area/shuttle/crow)
"pL" = (
/obj/machinery/modular_computer/console/preset/engineering,
/obj/effect/turf_decal/bot_white,
/obj/structure/cable,
/turf/open/floor/iron/dark/smooth_large,
/area/shuttle/crow)
"qI" = (
/obj/effect/turf_decal/tile/neutral{
	dir = 4
	},
/obj/effect/turf_decal/tile/neutral{
	dir = 8
	},
/obj/effect/turf_decal/tile/neutral{
	dir = 1
	},
/obj/effect/turf_decal/tile/neutral,
/obj/structure/closet/crate/secure/gear,
/turf/open/floor/iron/dark,
/area/shuttle/crow)
"qM" = (
/obj/structure/closet/crate/radiation,
/obj/item/stack/sheet/mineral/uranium{
	amount = 50
	},
/obj/effect/turf_decal/bot_white,
/turf/open/floor/iron/dark/smooth_large,
/area/shuttle/crow)
"rh" = (
/obj/structure/chair/comfy/shuttle{
	dir = 4
	},
/obj/machinery/airalarm/directional/north,
/obj/machinery/light/cold/directional/north,
/obj/machinery/atmospherics/components/unary/vent_pump/on/layer4{
	dir = 8
	},
/obj/structure/cable,
/turf/open/floor/iron/shuttle/evac,
/area/shuttle/crow)
"td" = (
/obj/structure/chair/comfy/shuttle{
	dir = 4
	},
/turf/open/floor/iron/shuttle/evac,
/area/shuttle/crow)
"um" = (
/obj/effect/turf_decal/bot_white,
/obj/structure/rack/shelf,
/obj/item/clothing/head/welding,
/obj/item/weldingtool/largetank,
/obj/item/wrench,
/obj/item/crowbar/red,
/turf/open/floor/iron/dark/smooth_large,
/area/shuttle/crow)
"uQ" = (
/obj/machinery/atmospherics/pipe/smart/manifold4w/scrubbers/hidden/layer2,
/obj/machinery/atmospherics/pipe/smart/manifold4w/supply/hidden/layer4,
/obj/structure/extinguisher_cabinet/directional/north,
/obj/structure/cable,
/turf/open/floor/iron/shuttle/ferry,
/area/shuttle/crow)
"uY" = (
/obj/structure/table/reinforced/plastitaniumglass,
/obj/item/stock_parts/cell/high,
/obj/machinery/cell_charger,
/obj/structure/extinguisher_cabinet/directional/north,
/turf/open/floor/iron/dark/smooth_large,
/area/shuttle/crow)
"wQ" = (
/obj/effect/turf_decal/bot,
/obj/machinery/holopad/secure,
/obj/machinery/atmospherics/pipe/smart/manifold4w/supply/hidden/layer4,
/obj/structure/extinguisher_cabinet/directional/south,
/obj/structure/cable,
/turf/open/floor/iron/dark/smooth_large,
/area/shuttle/crow)
"xw" = (
/obj/effect/turf_decal/delivery/white,
/obj/machinery/door/airlock/corporate/glass{
	name = "Bridge Access"
	},
/obj/machinery/atmospherics/pipe/smart/manifold4w/scrubbers/hidden/layer2,
/obj/machinery/atmospherics/pipe/smart/manifold4w/supply/hidden/layer4,
/obj/structure/cable,
/turf/open/floor/iron/dark/textured_large,
/area/shuttle/crow)
"xH" = (
/obj/machinery/computer/shuttle/exploration_crow{
	dir = 8
	},
/obj/effect/turf_decal/bot_white,
/obj/structure/cable,
/turf/open/floor/iron/dark/smooth_large,
/area/shuttle/crow)
"yZ" = (
/obj/machinery/atmospherics/pipe/smart/manifold4w/orange/visible,
/obj/machinery/atmospherics/components/unary/portables_connector/visible/layer2{
	dir = 4
	},
/obj/machinery/portable_atmospherics/canister/tier_2,
/obj/effect/turf_decal/bot_white,
/turf/open/floor/iron/dark/smooth_large,
/area/shuttle/crow)
"zn" = (
/obj/effect/turf_decal/tile/neutral{
	dir = 4
	},
/obj/effect/turf_decal/tile/neutral{
	dir = 8
	},
/obj/effect/turf_decal/tile/neutral{
	dir = 1
	},
/obj/effect/turf_decal/tile/neutral,
/obj/structure/closet/crate/secure/engineering,
/turf/open/floor/iron/dark,
/area/shuttle/crow)
"zS" = (
/obj/machinery/trade_pad,
/obj/effect/turf_decal/delivery/white,
/turf/open/floor/iron/dark/smooth_large,
/area/shuttle/crow)
"AB" = (
/obj/machinery/atmospherics/components/unary/vent_scrubber/on/layer2,
/obj/machinery/atmospherics/pipe/smart/manifold4w/supply/hidden/layer4,
/obj/structure/cable,
/turf/open/floor/iron/shuttle/evac,
/area/shuttle/crow)
"AU" = (
/obj/machinery/atmospherics/components/unary/portables_connector/visible{
	dir = 1
	},
/obj/machinery/portable_atmospherics/canister/carbon_dioxide,
/obj/effect/turf_decal/bot_white,
/turf/open/floor/iron/dark/smooth_large,
/area/shuttle/crow)
"Bg" = (
/obj/structure/cable,
/obj/machinery/atmospherics/components/unary/vent_scrubber/on/layer2,
/turf/open/floor/iron/shuttle/evac,
/area/shuttle/crow)
"BI" = (
/obj/machinery/atmospherics/components/binary/volume_pump{
	dir = 1
	},
/obj/machinery/atmospherics/pipe/smart/manifold4w/supply/hidden/layer4,
/turf/open/floor/catwalk_floor/iron_dark,
/area/shuttle/crow)
"BT" = (
/obj/machinery/atmospherics/pipe/smart/manifold4w/scrubbers/hidden/layer2,
/obj/machinery/atmospherics/pipe/smart/manifold4w/supply/hidden/layer4,
/obj/machinery/firealarm/directional/west,
/obj/structure/cable,
/turf/open/floor/iron/shuttle/ferry,
/area/shuttle/crow)
"Cc" = (
/obj/effect/turf_decal/delivery/white,
/obj/machinery/door/airlock/service{
	name = "Crew Quarters Access"
	},
/obj/machinery/atmospherics/pipe/smart/manifold4w/scrubbers/hidden/layer2,
/obj/machinery/atmospherics/pipe/smart/manifold4w/supply/hidden/layer4,
/obj/structure/cable,
/turf/open/floor/iron/dark/textured_large,
/area/shuttle/crow)
"Cf" = (
/turf/closed/wall/mineral/titanium,
/area/shuttle/crow)
"CG" = (
/obj/effect/turf_decal/bot_white,
/obj/structure/closet/emcloset,
/obj/machinery/atmospherics/components/unary/vent_pump/on/layer4{
	dir = 4
	},
/turf/open/floor/iron/dark/smooth_large,
/area/shuttle/crow)
"Dy" = (
/turf/open/floor/iron/shuttle/evac,
/area/shuttle/crow)
"Fg" = (
/obj/effect/turf_decal/tile/neutral{
	dir = 4
	},
/obj/effect/turf_decal/tile/neutral{
	dir = 8
	},
/obj/effect/turf_decal/tile/neutral{
	dir = 1
	},
/obj/effect/turf_decal/tile/neutral,
/obj/effect/turf_decal/box/white/corners{
	dir = 8
	},
/turf/open/floor/iron/dark,
/area/shuttle/crow)
"Fv" = (
/obj/machinery/atmospherics/pipe/smart/manifold4w/supply/hidden/layer4,
/obj/machinery/light/cold/directional/east,
/turf/open/floor/catwalk_floor/iron_dark,
/area/shuttle/crow)
"Fz" = (
/obj/machinery/computer/trade_console,
/obj/effect/turf_decal/bot_white,
/obj/machinery/light/cold/directional/north,
/obj/machinery/button/door/directional/north{
	id = "crow_shuttle_cargo"
	},
/turf/open/floor/iron/dark/smooth_large,
/area/shuttle/crow)
"Gg" = (
/obj/structure/cable,
/obj/machinery/atmospherics/pipe/smart/manifold4w/orange/visible,
/obj/machinery/atmospherics/pipe/smart/manifold4w/supply/hidden/layer4,
/obj/machinery/atmospherics/components/binary/pump/on/layer2,
/turf/open/floor/catwalk_floor/iron_dark,
/area/shuttle/crow)
"Ha" = (
/turf/open/floor/iron/shuttle/ferry,
/area/shuttle/crow)
"Hu" = (
/obj/effect/turf_decal/tile/neutral{
	dir = 4
	},
/obj/effect/turf_decal/tile/neutral{
	dir = 8
	},
/obj/effect/turf_decal/tile/neutral{
	dir = 1
	},
/obj/effect/turf_decal/tile/neutral,
/turf/open/floor/iron/dark,
/area/shuttle/crow)
"HK" = (
/obj/structure/rack/shelf,
/obj/item/food/sustenance_bar/wonka{
	pixel_x = -3;
	pixel_y = -3
	},
/obj/item/food/sustenance_bar/wonka{
	pixel_x = -3
	},
/obj/item/food/sustenance_bar/wonka{
	pixel_x = -3;
	pixel_y = 3
	},
/obj/item/food/sustenance_bar/cheese{
	pixel_x = 3;
	pixel_y = -3
	},
/obj/item/food/sustenance_bar/cheese{
	pixel_x = 3
	},
/obj/item/food/sustenance_bar/cheese{
	pixel_x = 3;
	pixel_y = 3
	},
/obj/effect/turf_decal/bot_white,
/obj/machinery/atmospherics/pipe/smart/manifold4w/orange/visible,
/obj/machinery/light/cold/directional/south,
/turf/open/floor/iron/dark/smooth_large,
/area/shuttle/crow)
"HV" = (
/obj/machinery/atmospherics/pipe/smart/manifold4w/scrubbers/hidden/layer2,
/obj/machinery/atmospherics/pipe/smart/manifold4w/supply/hidden/layer4,
/obj/machinery/airalarm/directional/north,
/obj/structure/cable,
/turf/open/floor/iron/shuttle/ferry,
/area/shuttle/crow)
"HY" = (
/obj/effect/turf_decal/tile/neutral{
	dir = 4
	},
/obj/effect/turf_decal/tile/neutral{
	dir = 8
	},
/obj/effect/turf_decal/tile/neutral{
	dir = 1
	},
/obj/effect/turf_decal/tile/neutral,
/obj/effect/turf_decal/box/white/corners{
	dir = 1
	},
/obj/structure/closet/crate/wooden,
/turf/open/floor/iron/dark,
/area/shuttle/crow)
"In" = (
/obj/effect/turf_decal/bot_white,
/obj/structure/rack/shelf,
/obj/item/tank/internals/emergency_oxygen/double,
/obj/item/pickaxe/mini,
/obj/item/clothing/mask/gas/explorer,
/turf/open/floor/iron/dark/smooth_large,
/area/shuttle/crow)
"IN" = (
/obj/structure/table/reinforced/plastitaniumglass,
/obj/machinery/recharger,
/turf/open/floor/iron/dark/smooth_large,
/area/shuttle/crow)
"IS" = (
/obj/effect/turf_decal/delivery/white,
/obj/machinery/door/airlock/external/glass,
/obj/machinery/atmospherics/pipe/smart/manifold4w/scrubbers/hidden/layer2,
/obj/machinery/atmospherics/pipe/smart/manifold4w/supply/hidden/layer4,
/turf/open/floor/iron/dark/textured_large,
/area/shuttle/crow)
"JJ" = (
/obj/effect/turf_decal/tile/neutral{
	dir = 4
	},
/obj/effect/turf_decal/tile/neutral{
	dir = 8
	},
/obj/effect/turf_decal/tile/neutral{
	dir = 1
	},
/obj/effect/turf_decal/tile/neutral,
/obj/effect/turf_decal/box/white/corners{
	dir = 4
	},
/turf/open/floor/iron/dark,
/area/shuttle/crow)
"KC" = (
/obj/effect/turf_decal/tile/neutral{
	dir = 4
	},
/obj/effect/turf_decal/tile/neutral{
	dir = 8
	},
/obj/effect/turf_decal/tile/neutral{
	dir = 1
	},
/obj/effect/turf_decal/tile/neutral,
/obj/structure/closet/crate/secure/science,
/turf/open/floor/iron/dark,
/area/shuttle/crow)
"KH" = (
/obj/effect/turf_decal/tile/neutral{
	dir = 4
	},
/obj/effect/turf_decal/tile/neutral{
	dir = 8
	},
/obj/effect/turf_decal/tile/neutral{
	dir = 1
	},
/obj/effect/turf_decal/tile/neutral,
/obj/effect/turf_decal/box/white/corners{
	dir = 4
	},
/obj/structure/ore_box,
/turf/open/floor/iron/dark,
/area/shuttle/crow)
"KJ" = (
/obj/effect/turf_decal/bot_white,
/obj/structure/window/reinforced/tinted,
/obj/structure/closet/secure_closet/personal,
/turf/open/floor/iron/dark/smooth_large,
/area/shuttle/crow)
"Li" = (
/obj/effect/turf_decal/stripes/line,
/obj/effect/turf_decal/stripes/line{
	dir = 1
	},
/obj/structure/fans/tiny/forcefield,
/obj/machinery/door/poddoor{
	id = "crow_shuttle_cargo"
	},
/turf/open/floor/engine,
/area/shuttle/crow)
"LG" = (
/obj/machinery/atmospherics/pipe/smart/manifold4w/scrubbers/hidden/layer2,
/obj/machinery/atmospherics/pipe/smart/manifold4w/supply/hidden/layer4,
/obj/machinery/firealarm/directional/east,
/turf/open/floor/catwalk_floor/iron_dark,
/area/shuttle/crow)
"MB" = (
/obj/machinery/power/smes/engineering{
	charge = 1e+006
	},
/obj/structure/cable,
/obj/effect/turf_decal/bot_white,
/obj/structure/extinguisher_cabinet/directional/east,
/turf/open/floor/iron/dark/smooth_large,
/area/shuttle/crow)
"MH" = (
/obj/effect/turf_decal/bot_white,
/obj/machinery/recharge_station,
/obj/machinery/atmospherics/components/unary/vent_scrubber/on/layer2{
	dir = 4
	},
/turf/open/floor/iron/dark/smooth_large,
/area/shuttle/crow)
"NJ" = (
/obj/machinery/firealarm/directional/east,
/obj/structure/sign/plaques/kiddie{
	desc = "A sign commemorating this particular shuttle's construction specifications and patent. In large text at the bottom it reads, AlLei manufacturing, patent circa 2562.";
	name = "\improper Shuttle Design & Production Model Plaque"
	},
/turf/open/floor/iron/dark/smooth_large,
/area/shuttle/crow)
"NP" = (
/obj/machinery/atmospherics/pipe/smart/manifold4w/orange/visible,
/obj/machinery/atmospherics/pipe/smart/manifold4w/supply/hidden/layer4,
/obj/machinery/atmospherics/pipe/smart/manifold4w/scrubbers/hidden/layer2,
/obj/machinery/meter,
/turf/open/floor/catwalk_floor/iron_dark,
/area/shuttle/crow)
"OI" = (
/obj/structure/fans/tiny,
/obj/docking_port/mobile{
	dir = 2;
	dwidth = 10;
	height = 11;
	id = "crow";
	launch_status = 0;
	name = "ESS Crow";
	overmap_shuttle_type = /datum/overmap_object/shuttle/ess_crow;
	port_direction = 8;
	preferred_direction = 4;
	width = 18
	},
/obj/effect/turf_decal/delivery/white,
/obj/machinery/door/airlock/external,
/turf/open/floor/iron/dark/textured_large,
/area/shuttle/crow)
"Pc" = (
/obj/machinery/modular_computer/console/preset/engineering{
	dir = 8
	},
/obj/effect/turf_decal/bot_white,
/turf/open/floor/iron/dark/smooth_large,
/area/shuttle/crow)
"QL" = (
/obj/structure/cable,
/obj/machinery/power/apc/auto_name/directional/north{
	cell_type = /obj/item/stock_parts/cell/hyper
	},
/turf/open/floor/iron/shuttle/evac,
/area/shuttle/crow)
"RX" = (
/obj/machinery/atmospherics/components/tank/air{
	dir = 4;
	piping_layer = 4
	},
/obj/effect/turf_decal/bot_white,
/turf/open/floor/iron/dark/smooth_large,
/area/shuttle/crow)
"Sy" = (
/obj/effect/spawner/structure/window/reinforced/plasma/plastitanium,
/obj/structure/shuttle/engine/heater{
	dir = 8
	},
/obj/machinery/atmospherics/pipe/smart/manifold4w/orange/visible,
/turf/open/floor/plating,
/area/shuttle/crow)
"SG" = (
/turf/closed/wall/mineral/plastitanium/nodiagonal,
/area/shuttle/crow)
"Tn" = (
/obj/structure/table/reinforced/plastitaniumglass,
/obj/item/paper_bin/carbon,
/obj/item/pen,
/obj/machinery/airalarm/directional/north,
/turf/open/floor/iron/dark/smooth_large,
/area/shuttle/crow)
"UE" = (
/obj/machinery/atmospherics/pipe/smart/manifold4w/scrubbers/hidden/layer2,
/obj/machinery/atmospherics/pipe/smart/manifold4w/supply/hidden/layer4,
/obj/structure/cable,
/turf/open/floor/iron/shuttle/evac,
/area/shuttle/crow)
"VB" = (
/obj/machinery/atmospherics/pipe/smart/manifold4w/scrubbers/hidden/layer2,
/obj/machinery/atmospherics/pipe/smart/manifold4w/supply/hidden/layer4,
/turf/open/floor/iron/shuttle/ferry,
/area/shuttle/crow)
"WL" = (
/obj/effect/turf_decal/tile/neutral{
	dir = 4
	},
/obj/effect/turf_decal/tile/neutral{
	dir = 8
	},
/obj/effect/turf_decal/tile/neutral{
	dir = 1
	},
/obj/effect/turf_decal/tile/neutral,
/obj/effect/turf_decal/box/white/corners{
	dir = 1
	},
/obj/structure/closet/crate/cardboard/fops,
/obj/item/storage/bag/garment/exp_pilot,
/turf/open/floor/iron/dark,
/area/shuttle/crow)
"WN" = (
/obj/structure/cable,
/obj/machinery/atmospherics/pipe/smart/manifold4w/orange/visible,
/obj/machinery/atmospherics/pipe/smart/manifold4w/supply/hidden/layer4,
/obj/machinery/atmospherics/pipe/smart/manifold4w/scrubbers/hidden/layer2,
/turf/open/floor/iron/shuttle/evac,
/area/shuttle/crow)
"Zo" = (
/turf/closed/wall/mineral/titanium/nodiagonal,
/area/shuttle/crow)
"ZC" = (
/obj/machinery/button/door/directional/north{
	id = "vulture_shutter"
	},
/obj/structure/rack/shelf,
/obj/item/storage/toolbox/mechanical,
/obj/effect/spawner/random/engineering/tool,
/obj/effect/spawner/random/engineering/flashlight,
/turf/open/floor/iron/dark/smooth_large,
/area/shuttle/crow)

(1,1,1) = {"
jL
gn
jL
jL
jL
gn
jL
jL
jL
gn
jL
"}
(2,1,1) = {"
jL
SG
jD
jD
jD
SG
jD
jD
jD
SG
jL
"}
(3,1,1) = {"
eT
SG
Sy
Sy
Sy
SG
Sy
Sy
Sy
SG
eT
"}
(4,1,1) = {"
SG
iP
KJ
fM
HK
Zo
gX
yZ
RX
RX
SG
"}
(5,1,1) = {"
Zo
QL
Bg
pi
WN
hB
Gg
NP
BI
AU
Zo
"}
(6,1,1) = {"
Zo
uY
Dy
gD
UE
Zo
MB
bZ
NJ
qM
Zo
"}
(7,1,1) = {"
Zo
Tn
td
Zo
Cc
Zo
Zo
Zo
Zo
Zo
Zo
"}
(8,1,1) = {"
Zo
nK
Pc
Zo
uQ
BT
HY
KC
Fg
um
Zo
"}
(9,1,1) = {"
Zo
Zo
Zo
Zo
Fz
jh
oH
Hu
Hu
lD
Zo
"}
(10,1,1) = {"
Zo
CG
MH
lI
zS
jh
JJ
Hu
hn
Ha
Li
"}
(11,1,1) = {"
OI
Fv
LG
IS
VB
jh
Ha
Ha
Ha
Ha
Li
"}
(12,1,1) = {"
Cf
Zo
Zo
Zo
Zo
HV
WL
zn
Fg
Ha
Li
"}
(13,1,1) = {"
jL
Zo
ZC
IN
lI
jh
mR
Hu
Hu
fw
Zo
"}
(14,1,1) = {"
jL
lI
pL
AB
xw
fJ
KH
qI
hn
In
Zo
"}
(15,1,1) = {"
jL
lI
nX
wQ
Zo
Zo
Zo
Zo
Zo
Zo
Cf
"}
(16,1,1) = {"
jL
Cf
Zo
rh
oL
lI
jL
jL
jL
jL
jL
"}
(17,1,1) = {"
jL
jL
lI
xH
iO
lI
jL
jL
jL
jL
jL
"}
(18,1,1) = {"
jL
jL
Zo
lI
lI
Cf
jL
jL
jL
jL
jL
"}
