//MAP CONVERTED BY dmm2tgm.py THIS HEADER COMMENT PREVENTS RECONVERSION, DO NOT REMOVE
"a" = (
/turf/closed/wall/mineral/titanium/shuttle_wall/window/mining_labor{
	icon_state = "4,0"
	},
/area/shuttle/labor/advanced)
"c" = (
/obj/structure/cable,
/turf/closed/wall/mineral/titanium/shuttle_wall/window/mining_labor{
	icon_state = "0,4"
	},
/area/shuttle/labor/advanced)
"d" = (
/turf/closed/wall/mineral/titanium/shuttle_wall/mining_labor{
	icon_state = "4,8"
	},
/area/shuttle/labor/advanced)
"e" = (
/obj/structure/chair/comfy/shuttle{
	dir = 4
	},
/turf/open/floor/iron/shuttle/exploration/corner{
	dir = 4
	},
/area/shuttle/labor/advanced)
"f" = (
/obj/machinery/mineral/labor_claim_console{
	machinedir = 1;
	pixel_x = 30
	},
/turf/open/floor/iron/shuttle/exploration/side{
	dir = 8
	},
/area/shuttle/labor/advanced)
"g" = (
/obj/docking_port/mobile{
	dir = 8;
	dwidth = 2;
	height = 5;
	id = "laborcamp";
	name = "labor camp shuttle";
	port_direction = 4;
	width = 9
	},
/obj/machinery/door/airlock/grunge{
	id_tag = "prisonshuttle";
	name = "Labour Shuttle Airlock"
	},
/turf/open/floor/iron/shuttle/exploration/textured_flat{
	dir = 4
	},
/area/shuttle/labor/advanced)
"h" = (
/turf/closed/wall/mineral/titanium/shuttle_wall/window/mining_labor{
	icon_state = "1,8"
	},
/area/shuttle/labor/advanced)
"i" = (
/obj/effect/turf_decal/shuttle/exploration/hazardstripe{
	dir = 1
	},
/obj/effect/decal/cleanable/dirt,
/turf/open/floor/iron/shuttle/exploration/invertcorner_side{
	dir = 8
	},
/area/shuttle/labor/advanced)
"j" = (
/obj/effect/turf_decal/shuttle/exploration/hazardstripe{
	dir = 4
	},
/obj/structure/closet/emcloset/wall{
	pixel_y = -32
	},
/obj/item/clothing/mask/breath{
	pixel_x = -3;
	pixel_y = -3
	},
/obj/item/clothing/mask/breath{
	pixel_x = -3;
	pixel_y = -3
	},
/obj/item/tank/internals/emergency_oxygen{
	pixel_x = 3
	},
/obj/item/tank/internals/emergency_oxygen{
	pixel_x = 3
	},
/obj/item/clothing/suit/hazardvest{
	desc = "A high-visibility lifejacket complete with whistle and slot for oxygen tanks.";
	name = "emergency lifejacket"
	},
/obj/item/clothing/suit/hazardvest{
	desc = "A high-visibility lifejacket complete with whistle and slot for oxygen tanks.";
	name = "emergency lifejacket"
	},
/obj/item/clothing/suit/hazardvest{
	desc = "A high-visibility lifejacket complete with whistle and slot for oxygen tanks.";
	name = "emergency lifejacket"
	},
/obj/item/clothing/suit/hazardvest{
	desc = "A high-visibility lifejacket complete with whistle and slot for oxygen tanks.";
	name = "emergency lifejacket"
	},
/obj/item/clothing/head/hardhat/orange{
	name = "protective hat";
	pixel_y = 9
	},
/obj/item/clothing/head/hardhat/orange{
	name = "protective hat";
	pixel_y = 9
	},
/obj/item/clothing/head/hardhat/orange{
	name = "protective hat";
	pixel_y = 9
	},
/obj/item/clothing/head/hardhat/orange{
	name = "protective hat";
	pixel_y = 9
	},
/turf/open/floor/iron/shuttle/exploration/invertcorner_side{
	dir = 1
	},
/area/shuttle/labor/advanced)
"k" = (
/obj/effect/turf_decal/shuttle/exploration/hazardstripe,
/obj/effect/turf_decal/shuttle/exploration/hazardstripe{
	dir = 4
	},
/obj/machinery/mineral/stacking_unit_console{
	machinedir = 2;
	pixel_x = 27;
	pixel_y = 22
	},
/turf/open/floor/iron/shuttle/exploration/tripleinvertcorner{
	dir = 8
	},
/area/shuttle/labor/advanced)
"l" = (
/turf/closed/wall/mineral/titanium/shuttle_wall/mining_labor,
/area/shuttle/labor/advanced)
"m" = (
/turf/closed/wall/mineral/titanium/shuttle_wall/mining_labor{
	icon_state = "2,8"
	},
/area/shuttle/labor/advanced)
"o" = (
/obj/effect/turf_decal/shuttle/exploration/hazardstripe{
	dir = 1
	},
/turf/open/floor/iron/shuttle/exploration/invertcorner_side_flipped{
	dir = 4
	},
/area/shuttle/labor/advanced)
"p" = (
/obj/machinery/computer/shuttle/labor{
	dir = 4
	},
/obj/effect/turf_decal/shuttle/exploration/hazardstripe{
	dir = 4
	},
/turf/open/floor/iron/shuttle/exploration/corner_invcorner,
/area/shuttle/labor/advanced)
"q" = (
/turf/closed/wall/mineral/titanium/shuttle_wall/mining_labor{
	icon_state = "2,5"
	},
/area/shuttle/labor/advanced)
"r" = (
/obj/structure/cable,
/turf/closed/wall/mineral/titanium/shuttle_wall/window/mining_labor,
/area/shuttle/labor/advanced)
"s" = (
/turf/closed/wall/mineral/titanium/shuttle_wall/mining_labor{
	icon_state = "0,3"
	},
/area/shuttle/labor/advanced)
"t" = (
/turf/closed/wall/mineral/titanium/shuttle_wall/window/mining_labor{
	icon_state = "3,8"
	},
/area/shuttle/labor/advanced)
"u" = (
/turf/closed/wall/mineral/titanium/shuttle_wall/mining_labor{
	icon_state = "4,3"
	},
/area/shuttle/labor/advanced)
"x" = (
/turf/closed/wall/mineral/titanium/shuttle_wall/mining_labor{
	icon_state = "4,1"
	},
/area/shuttle/labor/advanced)
"y" = (
/turf/closed/wall/mineral/titanium/shuttle_wall/mining_labor{
	icon_state = "2,1"
	},
/area/shuttle/labor/advanced)
"z" = (
/turf/closed/wall/mineral/titanium/shuttle_wall/mining_labor{
	icon_state = "1,1"
	},
/area/shuttle/labor/advanced)
"A" = (
/obj/effect/turf_decal/shuttle/exploration/bot,
/obj/structure/chair/comfy/shuttle{
	dir = 8
	},
/turf/open/floor/iron/shuttle/exploration/side,
/area/shuttle/labor/advanced)
"B" = (
/obj/structure/chair/comfy/shuttle{
	dir = 8
	},
/turf/open/floor/iron/shuttle/exploration/side{
	dir = 1
	},
/area/shuttle/labor/advanced)
"C" = (
/turf/closed/wall/mineral/titanium/shuttle_wall/mining_labor{
	icon_state = "4,2"
	},
/area/shuttle/labor/advanced)
"D" = (
/obj/machinery/flasher/directional/north{
	id = "gulagshuttleflasher";
	pixel_x = 8
	},
/obj/machinery/light/small/directional/north,
/turf/open/floor/iron/shuttle/exploration/side,
/area/shuttle/labor/advanced)
"E" = (
/turf/closed/wall/mineral/titanium/shuttle_wall/mining_labor{
	icon_state = "0,5"
	},
/area/shuttle/labor/advanced)
"F" = (
/turf/closed/wall/mineral/titanium/shuttle_wall/mining_labor{
	icon_state = "4,5"
	},
/area/shuttle/labor/advanced)
"H" = (
/obj/structure/chair/comfy/shuttle{
	dir = 4
	},
/turf/open/floor/iron/shuttle/exploration/side{
	dir = 4
	},
/area/shuttle/labor/advanced)
"I" = (
/obj/machinery/door/airlock/grunge{
	name = "Labour Shuttle Airlock";
	req_access = list("brig")
	},
/turf/open/floor/iron/shuttle/exploration/textured_flat{
	dir = 4
	},
/area/shuttle/labor/advanced)
"J" = (
/turf/closed/wall/mineral/titanium/shuttle_wall/window/mining_labor{
	icon_state = "0,0"
	},
/area/shuttle/labor/advanced)
"K" = (
/obj/effect/decal/cleanable/dirt,
/obj/structure/chair/comfy/shuttle{
	dir = 8
	},
/turf/open/floor/iron/shuttle/exploration/blanktile,
/area/shuttle/labor/advanced)
"L" = (
/obj/effect/turf_decal/shuttle/exploration/hazardstripe{
	dir = 1
	},
/obj/effect/turf_decal/shuttle/exploration/hazardstripe,
/obj/effect/turf_decal/shuttle/exploration/hazardstripe{
	dir = 4
	},
/obj/effect/turf_decal/shuttle/exploration/hazardstripe{
	dir = 8
	},
/obj/machinery/mineral/stacking_machine/laborstacker{
	input_dir = 2;
	output_dir = 1
	},
/turf/open/floor/iron/shuttle/exploration/flat,
/area/shuttle/labor/advanced)
"M" = (
/turf/closed/wall/mineral/titanium/shuttle_wall/mining_labor{
	icon_state = "4,7"
	},
/area/shuttle/labor/advanced)
"N" = (
/turf/closed/wall/mineral/titanium/shuttle_wall/mining_labor{
	icon_state = "0,8"
	},
/area/shuttle/labor/advanced)
"O" = (
/turf/closed/wall/mineral/titanium/shuttle_wall/mining_labor{
	icon_state = "0,1"
	},
/area/shuttle/labor/advanced)
"P" = (
/obj/machinery/button/flasher{
	id = "gulagshuttleflasher";
	name = "Flash Control";
	pixel_x = -3;
	pixel_y = -27;
	req_access = list("security")
	},
/obj/effect/decal/cleanable/dirt,
/obj/machinery/light/small/directional/south,
/turf/open/floor/iron/shuttle/exploration/side{
	dir = 1
	},
/area/shuttle/labor/advanced)
"Q" = (
/obj/structure/table/reinforced,
/obj/item/folder/red,
/obj/item/restraints/handcuffs,
/turf/open/floor/iron/shuttle/exploration/corner{
	dir = 8
	},
/area/shuttle/labor/advanced)
"R" = (
/turf/closed/wall/mineral/titanium/shuttle_wall/window/mining_labor{
	icon_state = "1,0"
	},
/area/shuttle/labor/advanced)
"T" = (
/turf/closed/wall/mineral/titanium/shuttle_wall/window/mining_labor{
	icon_state = "2,0"
	},
/area/shuttle/labor/advanced)
"U" = (
/turf/closed/wall/mineral/titanium/shuttle_wall/mining_labor{
	icon_state = "0,7"
	},
/area/shuttle/labor/advanced)
"V" = (
/turf/closed/wall/mineral/titanium/shuttle_wall/window/mining_labor{
	icon_state = "3,0"
	},
/area/shuttle/labor/advanced)
"W" = (
/turf/closed/wall/mineral/titanium/shuttle_wall/mining_labor{
	icon_state = "3,1"
	},
/area/shuttle/labor/advanced)
"Y" = (
/obj/machinery/door/airlock/grunge{
	name = "Labour Shuttle Airlock";
	req_access = list("brig")
	},
/turf/open/floor/iron/shuttle/exploration/textured_flat,
/area/shuttle/labor/advanced)
"Z" = (
/obj/effect/turf_decal/shuttle/exploration/hazardstripe,
/obj/item/radio/intercom/directional/west{
	pixel_x = -21
	},
/turf/open/floor/iron/shuttle/exploration/invertcorner_side{
	dir = 4
	},
/area/shuttle/labor/advanced)

(1,1,1) = {"
d
M
l
F
r
u
C
x
a
"}
(2,1,1) = {"
t
p
Z
Y
o
H
e
W
V
"}
(3,1,1) = {"
m
A
P
q
D
K
B
y
T
"}
(4,1,1) = {"
h
Q
k
L
i
f
j
z
R
"}
(5,1,1) = {"
N
U
I
E
c
s
g
O
J
"}
