//MAP CONVERTED BY dmm2tgm.py THIS HEADER COMMENT PREVENTS RECONVERSION, DO NOT REMOVE
"a" = (
/turf/closed/wall/mineral/titanium/shuttle_wall/window/mining{
	icon_state = "0,6"
	},
/area/shuttle/mining/advanced/public)
"c" = (
/turf/closed/wall/mineral/titanium/shuttle_wall/mining{
	icon_state = "1,6"
	},
/area/shuttle/mining/advanced/public)
"d" = (
/obj/effect/turf_decal/shuttle/exploration/hazardstripe{
	dir = 4
	},
/turf/open/floor/iron/shuttle/exploration/doubleinvertcorner{
	dir = 8
	},
/area/shuttle/mining/advanced/public)
"f" = (
/obj/structure/ore_box,
/obj/machinery/light/small/directional/east,
/turf/open/floor/iron/shuttle/exploration/flat,
/area/shuttle/mining/advanced/public)
"g" = (
/obj/structure/chair/comfy/shuttle{
	dir = 1
	},
/turf/open/floor/iron/shuttle/exploration/side{
	dir = 1
	},
/area/shuttle/mining/advanced/public)
"h" = (
/obj/item/clothing/suit/hazardvest{
	desc = "A high-visibility lifejacket complete with whistle and slot for oxygen tanks.";
	name = "emergency lifejacket"
	},
/obj/item/clothing/suit/hazardvest{
	desc = "A high-visibility lifejacket complete with whistle and slot for oxygen tanks.";
	name = "emergency lifejacket"
	},
/obj/item/clothing/suit/hazardvest{
	desc = "A high-visibility lifejacket complete with whistle and slot for oxygen tanks.";
	name = "emergency lifejacket"
	},
/obj/item/clothing/suit/hazardvest{
	desc = "A high-visibility lifejacket complete with whistle and slot for oxygen tanks.";
	name = "emergency lifejacket"
	},
/obj/item/clothing/suit/hazardvest{
	desc = "A high-visibility lifejacket complete with whistle and slot for oxygen tanks.";
	name = "emergency lifejacket"
	},
/obj/item/tank/internals/emergency_oxygen{
	pixel_x = 3
	},
/obj/item/tank/internals/emergency_oxygen{
	pixel_x = 3
	},
/obj/item/tank/internals/emergency_oxygen{
	pixel_x = 3
	},
/obj/item/tank/internals/emergency_oxygen{
	pixel_x = 3
	},
/obj/item/tank/internals/emergency_oxygen{
	pixel_x = 3
	},
/obj/item/clothing/mask/breath{
	pixel_x = -3;
	pixel_y = -3
	},
/obj/item/clothing/mask/breath{
	pixel_x = -3;
	pixel_y = -3
	},
/obj/item/clothing/mask/breath{
	pixel_x = -3;
	pixel_y = -3
	},
/obj/item/clothing/mask/breath{
	pixel_x = -3;
	pixel_y = -3
	},
/obj/item/clothing/mask/breath{
	pixel_x = -3;
	pixel_y = -3
	},
/obj/item/clothing/head/hardhat/orange{
	name = "protective hat";
	pixel_y = 9
	},
/obj/item/clothing/head/hardhat/orange{
	name = "protective hat";
	pixel_y = 9
	},
/obj/item/clothing/head/hardhat/orange{
	name = "protective hat";
	pixel_y = 9
	},
/obj/item/clothing/head/hardhat/orange{
	name = "protective hat";
	pixel_y = 9
	},
/obj/item/clothing/head/hardhat/orange{
	name = "protective hat";
	pixel_y = 9
	},
/obj/structure/closet/crate/internals,
/obj/item/pickaxe/emergency,
/obj/item/pickaxe/emergency,
/obj/machinery/light/small/directional/west,
/turf/open/floor/iron/shuttle/exploration/flat,
/area/shuttle/mining/advanced/public)
"i" = (
/turf/closed/wall/mineral/titanium/shuttle_wall/mining{
	icon_state = "0,0"
	},
/area/shuttle/mining/advanced/public)
"j" = (
/obj/structure/table/reinforced,
/obj/item/storage/toolbox/emergency,
/obj/machinery/light/small/directional/west,
/obj/item/radio/intercom/directional/north{
	pixel_y = 15
	},
/turf/open/floor/iron/shuttle/exploration/corner,
/area/shuttle/mining/advanced/public)
"k" = (
/turf/closed/wall/mineral/titanium/shuttle_wall/mining{
	icon_state = "0,4"
	},
/area/shuttle/mining/advanced/public)
"l" = (
/obj/structure/chair/comfy/shuttle{
	dir = 1
	},
/turf/open/floor/iron/shuttle/exploration/corner{
	dir = 1
	},
/area/shuttle/mining/advanced/public)
"m" = (
/obj/structure/table/reinforced,
/obj/item/crowbar/red,
/obj/item/wrench,
/obj/item/tank/internals/emergency_oxygen,
/obj/item/clothing/mask/gas,
/obj/machinery/light/small/directional/east,
/turf/open/floor/iron/shuttle/exploration/corner{
	dir = 8
	},
/area/shuttle/mining/advanced/public)
"o" = (
/turf/closed/wall/mineral/titanium/shuttle_wall/window/mining{
	icon_state = "4,6"
	},
/area/shuttle/mining/advanced/public)
"p" = (
/turf/open/floor/iron/shuttle/exploration/side{
	dir = 4
	},
/area/shuttle/mining/advanced/public)
"q" = (
/turf/closed/wall/mineral/titanium/shuttle_wall/mining{
	icon_state = "1,0"
	},
/area/shuttle/mining/advanced/public)
"v" = (
/turf/open/floor/iron/shuttle/exploration/blanktile,
/area/shuttle/mining/advanced/public)
"y" = (
/turf/closed/wall/mineral/titanium/shuttle_wall/mining{
	icon_state = "4,5C"
	},
/area/shuttle/mining/advanced/public)
"B" = (
/obj/docking_port/mobile{
	dir = 8;
	dwidth = 3;
	height = 5;
	id = "mining_common";
	name = "lavaland shuttle";
	port_direction = 4;
	width = 7
	},
/obj/machinery/door/airlock/grunge{
	name = "Public Shuttle Airlock"
	},
/turf/open/floor/iron/shuttle/exploration/textured_flat{
	dir = 4
	},
/area/shuttle/mining/advanced/public)
"D" = (
/turf/closed/wall/mineral/titanium/shuttle_wall/window/mining{
	icon_state = "4,2"
	},
/area/shuttle/mining/advanced/public)
"F" = (
/turf/closed/wall/mineral/titanium/shuttle_wall/mining{
	icon_state = "4,1C"
	},
/area/shuttle/mining/advanced/public)
"H" = (
/turf/closed/wall/mineral/titanium/shuttle_wall/mining{
	icon_state = "0,5"
	},
/area/shuttle/mining/advanced/public)
"I" = (
/turf/closed/wall/mineral/titanium/shuttle_wall/mining{
	icon_state = "0,3"
	},
/area/shuttle/mining/advanced/public)
"J" = (
/turf/closed/wall/mineral/titanium/shuttle_wall/window/mining{
	icon_state = "0,2"
	},
/area/shuttle/mining/advanced/public)
"K" = (
/turf/closed/wall/mineral/titanium/shuttle_wall/mining{
	icon_state = "3,6"
	},
/area/shuttle/mining/advanced/public)
"L" = (
/turf/closed/wall/mineral/titanium/shuttle_wall/mining{
	icon_state = "3,0"
	},
/area/shuttle/mining/advanced/public)
"M" = (
/turf/closed/wall/mineral/titanium/shuttle_wall/mining{
	icon_state = "3,5"
	},
/area/shuttle/mining/advanced/public)
"O" = (
/obj/structure/chair/comfy/shuttle{
	dir = 1
	},
/turf/open/floor/iron/shuttle/exploration/corner{
	dir = 4
	},
/area/shuttle/mining/advanced/public)
"Q" = (
/turf/closed/wall/mineral/titanium/shuttle_wall/mining{
	icon_state = "4,4"
	},
/area/shuttle/mining/advanced/public)
"R" = (
/obj/machinery/computer/shuttle/mining/common{
	name = "public shuttle console"
	},
/obj/effect/turf_decal/shuttle/exploration/hazardstripe,
/turf/open/floor/iron/shuttle/exploration/uside,
/area/shuttle/mining/advanced/public)
"S" = (
/turf/closed/wall/mineral/titanium/shuttle_wall/mining{
	icon_state = "4,0"
	},
/area/shuttle/mining/advanced/public)
"T" = (
/obj/structure/chair/comfy/shuttle{
	dir = 1
	},
/obj/effect/turf_decal/shuttle/exploration/hazardstripe{
	dir = 1
	},
/turf/open/floor/iron/shuttle/exploration/doubleinvertcorner,
/area/shuttle/mining/advanced/public)
"U" = (
/turf/closed/wall/mineral/titanium/shuttle_wall/mining{
	icon_state = "0,1"
	},
/area/shuttle/mining/advanced/public)
"W" = (
/obj/effect/turf_decal/shuttle/exploration/cargostore,
/turf/open/floor/iron/shuttle/exploration/flat,
/area/shuttle/mining/advanced/public)
"X" = (
/turf/closed/wall/mineral/titanium/shuttle_wall/window/mining{
	icon_state = "2,0"
	},
/area/shuttle/mining/advanced/public)
"Y" = (
/turf/closed/wall/mineral/titanium/shuttle_wall/window/mining{
	icon_state = "2,6"
	},
/area/shuttle/mining/advanced/public)
"Z" = (
/turf/closed/wall/mineral/titanium/shuttle_wall/mining{
	icon_state = "1,5"
	},
/area/shuttle/mining/advanced/public)

(1,1,1) = {"
a
H
k
I
J
U
i
"}
(2,1,1) = {"
c
Z
j
p
O
h
q
"}
(3,1,1) = {"
Y
R
T
v
g
W
X
"}
(4,1,1) = {"
K
M
m
d
l
f
L
"}
(5,1,1) = {"
o
y
Q
B
D
F
S
"}
