//MAP CONVERTED BY dmm2tgm.py THIS HEADER COMMENT PREVENTS RECONVERSION, DO NOT REMOVE
"a" = (
/turf/closed/wall/mineral/titanium/shuttle_wall/window/mining{
	icon_state = "0,2"
	},
/area/shuttle/mining/advanced)
"b" = (
/turf/closed/wall/mineral/titanium/shuttle_wall/window/mining{
	icon_state = "2,0"
	},
/area/shuttle/mining/advanced)
"c" = (
/turf/closed/wall/mineral/titanium/shuttle_wall/mining{
	icon_state = "3,5"
	},
/area/shuttle/mining/advanced)
"g" = (
/turf/closed/wall/mineral/titanium/shuttle_wall/mining{
	icon_state = "0,4"
	},
/area/shuttle/mining/advanced)
"l" = (
/turf/closed/wall/mineral/titanium/shuttle_wall/mining{
	icon_state = "0,1"
	},
/area/shuttle/mining/advanced)
"m" = (
/turf/closed/wall/mineral/titanium/shuttle_wall/window/mining{
	icon_state = "4,6"
	},
/area/shuttle/mining/advanced)
"n" = (
/obj/machinery/computer/shuttle/mining,
/obj/effect/turf_decal/shuttle/exploration/hazardstripe,
/turf/open/floor/iron/shuttle/exploration/uside,
/area/shuttle/mining/advanced)
"o" = (
/turf/closed/wall/mineral/titanium/shuttle_wall/mining{
	icon_state = "0,3"
	},
/area/shuttle/mining/advanced)
"p" = (
/turf/open/floor/iron/shuttle/exploration/side{
	dir = 4
	},
/area/shuttle/mining/advanced)
"q" = (
/turf/closed/wall/mineral/titanium/shuttle_wall/mining{
	icon_state = "3,6"
	},
/area/shuttle/mining/advanced)
"r" = (
/turf/closed/wall/mineral/titanium/shuttle_wall/mining{
	icon_state = "1,5"
	},
/area/shuttle/mining/advanced)
"u" = (
/obj/structure/chair/comfy/shuttle{
	dir = 1
	},
/turf/open/floor/iron/shuttle/exploration/corner{
	dir = 1
	},
/area/shuttle/mining/advanced)
"v" = (
/obj/structure/chair/comfy/shuttle{
	dir = 1
	},
/obj/effect/turf_decal/shuttle/exploration/hazardstripe{
	dir = 1
	},
/turf/open/floor/iron/shuttle/exploration/doubleinvertcorner,
/area/shuttle/mining/advanced)
"w" = (
/obj/effect/turf_decal/shuttle/exploration/cargostore,
/turf/open/floor/iron/shuttle/exploration/flat,
/area/shuttle/mining/advanced)
"x" = (
/obj/structure/chair/comfy/shuttle{
	dir = 1
	},
/turf/open/floor/iron/shuttle/exploration/side{
	dir = 1
	},
/area/shuttle/mining/advanced)
"y" = (
/turf/closed/wall/mineral/titanium/shuttle_wall/mining{
	icon_state = "0,0"
	},
/area/shuttle/mining/advanced)
"z" = (
/turf/closed/wall/mineral/titanium/shuttle_wall/window/mining{
	icon_state = "2,6"
	},
/area/shuttle/mining/advanced)
"A" = (
/turf/open/floor/iron/shuttle/exploration/blanktile,
/area/shuttle/mining/advanced)
"B" = (
/obj/effect/turf_decal/shuttle/exploration/hazardstripe{
	dir = 4
	},
/turf/open/floor/iron/shuttle/exploration/doubleinvertcorner{
	dir = 8
	},
/area/shuttle/mining/advanced)
"C" = (
/turf/closed/wall/mineral/titanium/shuttle_wall/mining{
	icon_state = "1,0"
	},
/area/shuttle/mining/advanced)
"D" = (
/turf/closed/wall/mineral/titanium/shuttle_wall/mining{
	icon_state = "3,0"
	},
/area/shuttle/mining/advanced)
"F" = (
/obj/structure/table/reinforced,
/obj/item/storage/toolbox/emergency,
/obj/machinery/light/small/directional/west,
/obj/item/radio/intercom/directional/north{
	pixel_y = 15
	},
/turf/open/floor/iron/shuttle/exploration/corner,
/area/shuttle/mining/advanced)
"H" = (
/obj/structure/table/reinforced,
/obj/item/crowbar/red,
/obj/item/wrench,
/obj/item/tank/internals/emergency_oxygen,
/obj/item/clothing/mask/gas,
/obj/machinery/light/small/directional/east,
/turf/open/floor/iron/shuttle/exploration/corner{
	dir = 8
	},
/area/shuttle/mining/advanced)
"I" = (
/obj/docking_port/mobile{
	dir = 8;
	dwidth = 3;
	height = 5;
	id = "mining";
	name = "mining shuttle";
	port_direction = 4;
	width = 7
	},
/obj/machinery/door/airlock/grunge{
	name = "Mining Shuttle Airlock"
	},
/turf/open/floor/iron/shuttle/exploration/textured_flat{
	dir = 4
	},
/area/shuttle/mining/advanced)
"J" = (
/turf/closed/wall/mineral/titanium/shuttle_wall/mining{
	icon_state = "4,1P"
	},
/area/shuttle/mining/advanced)
"K" = (
/obj/structure/ore_box,
/obj/machinery/light/small/directional/east,
/turf/open/floor/iron/shuttle/exploration/flat,
/area/shuttle/mining/advanced)
"M" = (
/turf/closed/wall/mineral/titanium/shuttle_wall/mining{
	icon_state = "0,5"
	},
/area/shuttle/mining/advanced)
"N" = (
/turf/closed/wall/mineral/titanium/shuttle_wall/mining{
	icon_state = "4,0"
	},
/area/shuttle/mining/advanced)
"O" = (
/turf/closed/wall/mineral/titanium/shuttle_wall/mining{
	icon_state = "4,4"
	},
/area/shuttle/mining/advanced)
"Q" = (
/turf/closed/wall/mineral/titanium/shuttle_wall/window/mining{
	icon_state = "4,2"
	},
/area/shuttle/mining/advanced)
"S" = (
/obj/item/clothing/suit/hazardvest{
	desc = "A high-visibility lifejacket complete with whistle and slot for oxygen tanks.";
	name = "emergency lifejacket"
	},
/obj/item/clothing/suit/hazardvest{
	desc = "A high-visibility lifejacket complete with whistle and slot for oxygen tanks.";
	name = "emergency lifejacket"
	},
/obj/item/clothing/suit/hazardvest{
	desc = "A high-visibility lifejacket complete with whistle and slot for oxygen tanks.";
	name = "emergency lifejacket"
	},
/obj/item/clothing/suit/hazardvest{
	desc = "A high-visibility lifejacket complete with whistle and slot for oxygen tanks.";
	name = "emergency lifejacket"
	},
/obj/item/clothing/suit/hazardvest{
	desc = "A high-visibility lifejacket complete with whistle and slot for oxygen tanks.";
	name = "emergency lifejacket"
	},
/obj/item/tank/internals/emergency_oxygen{
	pixel_x = 3
	},
/obj/item/tank/internals/emergency_oxygen{
	pixel_x = 3
	},
/obj/item/tank/internals/emergency_oxygen{
	pixel_x = 3
	},
/obj/item/tank/internals/emergency_oxygen{
	pixel_x = 3
	},
/obj/item/tank/internals/emergency_oxygen{
	pixel_x = 3
	},
/obj/item/clothing/mask/breath{
	pixel_x = -3;
	pixel_y = -3
	},
/obj/item/clothing/mask/breath{
	pixel_x = -3;
	pixel_y = -3
	},
/obj/item/clothing/mask/breath{
	pixel_x = -3;
	pixel_y = -3
	},
/obj/item/clothing/mask/breath{
	pixel_x = -3;
	pixel_y = -3
	},
/obj/item/clothing/mask/breath{
	pixel_x = -3;
	pixel_y = -3
	},
/obj/item/clothing/head/hardhat/orange{
	name = "protective hat";
	pixel_y = 9
	},
/obj/item/clothing/head/hardhat/orange{
	name = "protective hat";
	pixel_y = 9
	},
/obj/item/clothing/head/hardhat/orange{
	name = "protective hat";
	pixel_y = 9
	},
/obj/item/clothing/head/hardhat/orange{
	name = "protective hat";
	pixel_y = 9
	},
/obj/item/clothing/head/hardhat/orange{
	name = "protective hat";
	pixel_y = 9
	},
/obj/structure/closet/crate/internals,
/obj/item/pickaxe/emergency,
/obj/item/pickaxe/emergency,
/obj/machinery/light/small/directional/west,
/turf/open/floor/iron/shuttle/exploration/flat,
/area/shuttle/mining/advanced)
"T" = (
/turf/closed/wall/mineral/titanium/shuttle_wall/mining{
	icon_state = "4,5P"
	},
/area/shuttle/mining/advanced)
"U" = (
/turf/closed/wall/mineral/titanium/shuttle_wall/mining{
	icon_state = "1,6"
	},
/area/shuttle/mining/advanced)
"V" = (
/turf/closed/wall/mineral/titanium/shuttle_wall/window/mining{
	icon_state = "0,6"
	},
/area/shuttle/mining/advanced)
"Y" = (
/obj/structure/chair/comfy/shuttle{
	dir = 1
	},
/turf/open/floor/iron/shuttle/exploration/corner{
	dir = 4
	},
/area/shuttle/mining/advanced)

(1,1,1) = {"
V
M
g
o
a
l
y
"}
(2,1,1) = {"
U
r
F
p
Y
S
C
"}
(3,1,1) = {"
z
n
v
A
x
w
b
"}
(4,1,1) = {"
q
c
H
B
u
K
D
"}
(5,1,1) = {"
m
T
O
I
Q
J
N
"}
