//MAP CONVERTED BY dmm2tgm.py THIS HEADER COMMENT PREVENTS RECONVERSION, DO NOT REMOVE
"ap" = (
/obj/structure/window/reinforced/survival_pod{
	dir = 1
	},
/obj/structure/window/reinforced/survival_pod,
/turf/open/floor/plating/airless,
/area/shuttle/pirate/nri)
"aW" = (
/obj/effect/turf_decal/bot_red,
/obj/machinery/turretid{
	req_access = list("syndicate");
	pixel_y = -32
	},
/turf/open/floor/pod/dark,
/area/shuttle/pirate/nri)
"be" = (
/obj/structure/closet/crate/secure/weapon{
	anchored = 1
	},
/obj/effect/turf_decal/stripes/line{
	dir = 5
	},
/obj/item/grenade/c4,
/obj/item/grenade/c4,
/obj/item/grenade/c4,
/obj/item/grenade/c4,
/turf/open/floor/pod/dark,
/area/shuttle/pirate/nri)
"bg" = (
/obj/effect/turf_decal/stripes/line,
/obj/machinery/light/small/red/dim/directional/north,
/obj/structure/closet/crate/secure/weapon{
	name = "footlocker";
	desc = "A secure crate to keep all your personal belongings in.";
	anchored = 1
	},
/turf/open/floor/pod/dark,
/area/shuttle/pirate/nri)
"bG" = (
/obj/effect/turf_decal/stripes/line{
	dir = 6
	},
/obj/effect/turf_decal/stripes/line{
	dir = 8
	},
/obj/machinery/light/floor,
/turf/open/floor/engine/hull/reinforced,
/area/shuttle/pirate/nri)
"bM" = (
/obj/machinery/computer/camera_advanced/shuttle_docker/syndicate/pirate{
	dir = 1;
	name = "police shuttle navigation computer"
	},
/obj/machinery/light/very_dim/directional/south,
/turf/open/floor/pod/dark,
/area/shuttle/pirate/nri)
"bQ" = (
/obj/effect/turf_decal/stripes/line{
	dir = 9
	},
/obj/machinery/porta_turret/syndicate/nri_raider{
	dir = 10
	},
/turf/open/floor/engine/hull/reinforced,
/area/shuttle/pirate/nri)
"cc" = (
/obj/machinery/power/shuttle_engine/heater{
	dir = 8
	},
/turf/closed/wall/mineral/titanium/spaceship/nodiagonal,
/area/shuttle/pirate/nri)
"cZ" = (
/obj/structure/window/reinforced/survival_pod{
	dir = 1
	},
/obj/structure/window/reinforced/survival_pod,
/obj/machinery/power/shuttle_engine/propulsion/burst{
	dir = 8
	},
/turf/open/floor/plating/airless,
/area/shuttle/pirate/nri)
"dy" = (
/obj/effect/turf_decal/stripes/line{
	dir = 5
	},
/obj/effect/turf_decal/stripes/line{
	dir = 8
	},
/turf/open/floor/engine/hull/reinforced,
/area/shuttle/pirate/nri)
"dS" = (
/obj/structure/cable,
/obj/machinery/power/shieldwallgen/unlocked/anchored{
	req_access_txt = "syndicate";
	req_one_access_txt = "syndicate";
	shield_range = 12;
	max_integrity = 600;
	armor = list("melee"=30,"bullet"=30,"laser"=20,"energy"=20,"bomb"=10,"bio"=0,"fire"=80,"acid"=70);
	desc = "A heavy-duty reinforced shield generator designed for ship defense.";
	name = "defense shield generator"
	},
/obj/structure/lattice/catwalk,
/turf/open/floor/plating/airless,
/area/shuttle/pirate/nri)
"et" = (
/obj/structure/cable,
/obj/structure/window/reinforced/survival_pod,
/obj/structure/reagent_dispensers/fueltank/large{
	anchored = 1;
	desc = "A tank full of a high quantity of liquid hydrogen fuel. Keep away from open flames and 57mm mortar shells.";
	icon_state = "vat"
	},
/turf/open/floor/plating,
/area/shuttle/pirate/nri)
"ew" = (
/obj/effect/mob_spawn/ghost_role/human/pirate/nri/captain,
/turf/open/floor/pod,
/area/shuttle/pirate/nri)
"ey" = (
/obj/machinery/computer/piratepad_control,
/obj/effect/turf_decal/stripes/line{
	dir = 8
	},
/turf/open/floor/pod/dark,
/area/shuttle/pirate/nri)
"gR" = (
/obj/effect/turf_decal/stripes/line{
	dir = 1
	},
/obj/effect/turf_decal/stripes/corner{
	dir = 8
	},
/turf/open/floor/engine/hull/reinforced,
/area/shuttle/pirate/nri)
"hl" = (
/obj/structure/table/optable,
/obj/item/defibrillator,
/turf/open/floor/pod/dark,
/area/shuttle/pirate/nri)
"hn" = (
/obj/machinery/door/airlock/survival_pod/glass{
	dir = 4
	},
/obj/structure/cable,
/obj/effect/mapping_helpers/airlock/access/all/syndicate/general,
/turf/open/floor/iron/dark,
/area/shuttle/pirate/nri)
"hH" = (
/obj/effect/turf_decal/stripes/line{
	dir = 6
	},
/obj/effect/turf_decal/stripes/line{
	dir = 8
	},
/turf/open/floor/engine/hull/reinforced,
/area/shuttle/pirate/nri)
"hK" = (
/obj/machinery/door/airlock/survival_pod/glass{
	dir = 1
	},
/obj/structure/cable,
/obj/effect/mapping_helpers/airlock/access/all/syndicate/general,
/obj/effect/mapping_helpers/airlock/cutaiwire,
/turf/open/floor/catwalk_floor,
/area/shuttle/pirate/nri)
"hP" = (
/obj/structure/sign/poster/contraband/nri_radar{
	pixel_x = -32
	},
/obj/effect/turf_decal/stripes/line,
/turf/open/floor/pod/dark,
/area/shuttle/pirate/nri)
"hU" = (
/obj/structure/cable,
/turf/open/floor/pod/light,
/area/shuttle/pirate/nri)
"ie" = (
/obj/structure/sign/poster/contraband/nri_rations{
	pixel_y = -32
	},
/obj/effect/turf_decal/stripes/line{
	dir = 8
	},
/turf/open/floor/pod/dark,
/area/shuttle/pirate/nri)
"iq" = (
/obj/machinery/photocopier,
/turf/open/floor/pod,
/area/shuttle/pirate/nri)
"iC" = (
/turf/open/floor/plating/airless,
/area/shuttle/pirate/nri)
"iG" = (
/obj/effect/turf_decal/plaque,
/turf/open/floor/pod/light,
/area/shuttle/pirate/nri)
"jx" = (
/obj/effect/turf_decal/stripes/line{
	dir = 4
	},
/obj/item/circuitboard/computer/advanced_camera,
/obj/structure/frame/computer{
	dir = 8
	},
/turf/open/floor/pod/light,
/area/shuttle/pirate/nri)
"kb" = (
/obj/structure/closet/crate/freezer/blood{
	anchored = 1
	},
/obj/effect/turf_decal/stripes/line{
	dir = 4
	},
/obj/machinery/light/small/red/dim/directional/north,
/turf/open/floor/pod/dark,
/area/shuttle/pirate/nri)
"kX" = (
/obj/effect/turf_decal/stripes/line{
	dir = 1
	},
/obj/effect/turf_decal/stripes/line{
	dir = 10
	},
/turf/open/floor/engine/hull/reinforced,
/area/shuttle/pirate/nri)
"lc" = (
/obj/structure/cable,
/obj/machinery/light/small/red/directional/north,
/turf/open/floor/catwalk_floor,
/area/shuttle/pirate/nri)
"lv" = (
/obj/structure/window/reinforced/survival_pod{
	name = "blast shield"
	},
/obj/machinery/power/shuttle_engine/huge{
	dir = 8
	},
/turf/open/floor/plating/airless,
/area/shuttle/pirate/nri)
"lU" = (
/obj/effect/turf_decal/stripes/line,
/turf/open/floor/pod,
/area/shuttle/pirate/nri)
"lV" = (
/obj/machinery/light/warm/directional/north,
/turf/open/floor/pod/dark,
/area/shuttle/pirate/nri)
"ma" = (
/obj/effect/turf_decal/stripes/line{
	dir = 8
	},
/obj/effect/turf_decal/stripes/corner{
	dir = 4
	},
/obj/machinery/porta_turret/syndicate/nri_raider{
	dir = 5
	},
/turf/open/floor/engine/hull/reinforced,
/area/shuttle/pirate/nri)
"mG" = (
/obj/effect/turf_decal/stripes/line,
/obj/structure/chair/comfy/shuttle{
	dir = 4
	},
/turf/open/floor/pod/dark,
/area/shuttle/pirate/nri)
"mJ" = (
/obj/structure/table/reinforced,
/obj/item/modular_computer/laptop/preset/civilian,
/obj/item/modular_computer/laptop/preset/civilian{
	pixel_y = 4
	},
/obj/item/modular_computer/laptop/preset/civilian{
	pixel_y = 8
	},
/obj/machinery/light/small/red/dim/directional/south,
/turf/open/floor/pod/dark,
/area/shuttle/pirate/nri)
"nD" = (
/obj/structure/window/reinforced/survival_pod,
/turf/open/floor/engine/hull/reinforced,
/area/shuttle/pirate/nri)
"nX" = (
/obj/machinery/light/floor,
/turf/open/floor/engine/hull/reinforced,
/area/shuttle/pirate/nri)
"od" = (
/obj/effect/turf_decal/stripes/line{
	dir = 1
	},
/turf/open/floor/pod,
/area/shuttle/pirate/nri)
"ot" = (
/turf/template_noop,
/area/template_noop)
"ov" = (
/obj/machinery/door/airlock/external,
/obj/effect/mapping_helpers/airlock/access/all/syndicate/general,
/obj/effect/mapping_helpers/airlock/cyclelink_helper,
/obj/effect/mapping_helpers/airlock/cutaiwire,
/obj/structure/fans/tiny,
/turf/open/floor/plating,
/area/shuttle/pirate/nri)
"pb" = (
/obj/machinery/porta_turret/syndicate/nri_raider{
	dir = 5
	},
/turf/closed/wall/mineral/titanium/spaceship/nodiagonal,
/area/shuttle/pirate/nri)
"pt" = (
/obj/machinery/door/airlock/external,
/obj/effect/mapping_helpers/airlock/access/all/syndicate/general,
/obj/effect/mapping_helpers/airlock/cutaiwire,
/obj/effect/mapping_helpers/airlock/cyclelink_helper{
	dir = 1
	},
/obj/docking_port/mobile/pirate{
	name = "NRI IAC-PV 'Evangelium'";
	width = 30;
	height = 15;
	dheight = 15;
	dwidth = 30
	},
/obj/structure/fans/tiny,
/turf/open/floor/plating,
/area/shuttle/pirate/nri)
"pQ" = (
/obj/structure/table/reinforced,
/obj/item/storage/medkit/brute{
	pixel_x = 6;
	pixel_y = 11
	},
/obj/item/storage/medkit/fire{
	pixel_y = 9
	},
/obj/item/storage/medkit/o2{
	pixel_x = 6;
	pixel_y = 5
	},
/obj/item/storage/medkit/toxin{
	pixel_y = 3
	},
/turf/open/floor/pod/dark,
/area/shuttle/pirate/nri)
"ql" = (
/obj/structure/closet/emcloset/anchored,
/turf/open/floor/plating,
/area/shuttle/pirate/nri)
"qz" = (
/obj/effect/turf_decal/stripes/line{
	dir = 9
	},
/turf/open/floor/pod,
/area/shuttle/pirate/nri)
"qJ" = (
/obj/effect/turf_decal/stripes/line{
	dir = 5
	},
/obj/machinery/computer/centcom_announcement{
	dir = 8;
	name = "police announcement console";
	command_name = "NRI Enforcer-Class Starship Telegram";
	desc = "A console used for making priority Internal Affairs Collegium dispatch reports.";
	circuit = null
	},
/turf/open/floor/pod/light,
/area/shuttle/pirate/nri)
"qQ" = (
/obj/machinery/ntnet_relay,
/turf/open/floor/plating,
/area/shuttle/pirate/nri)
"rd" = (
/obj/effect/turf_decal/stripes/line{
	dir = 9
	},
/obj/structure/closet/crate/secure/weapon{
	anchored = 1
	},
/obj/item/airbag,
/obj/item/airbag,
/obj/item/airbag,
/obj/item/airbag,
/obj/item/airbag,
/obj/item/airbag,
/obj/machinery/light/small/red/dim/directional/south,
/turf/open/floor/pod/dark,
/area/shuttle/pirate/nri)
"rg" = (
/obj/structure/rack/gunrack,
/obj/effect/turf_decal/stripes/line,
/obj/item/gun/ballistic/automatic/akm/civvie,
/obj/item/gun/ballistic/automatic/plastikov/nri_pirate,
/obj/item/gun/ballistic/shotgun/m23,
/turf/open/floor/pod/light,
/area/shuttle/pirate/nri)
"rk" = (
/obj/structure/bed/pod,
/obj/effect/turf_decal/stripes/line{
	dir = 1
	},
/obj/item/bedsheet/random,
/obj/machinery/light/small/red/dim/directional/south,
/turf/open/floor/pod/light,
/area/shuttle/pirate/nri)
"rp" = (
/obj/effect/turf_decal/delivery,
/obj/structure/cable,
/turf/open/floor/pod/light,
/area/shuttle/pirate/nri)
"rO" = (
/obj/effect/turf_decal/stripes/line{
	dir = 6
	},
/obj/machinery/iv_drip,
/turf/open/floor/pod,
/area/shuttle/pirate/nri)
"sK" = (
/obj/structure/window/reinforced/survival_pod{
	dir = 8
	},
/obj/machinery/power/shuttle_engine/heater{
	dir = 8
	},
/turf/open/floor/plating,
/area/shuttle/pirate/nri)
"tk" = (
/turf/open/floor/pod/dark,
/area/shuttle/pirate/nri)
"tl" = (
/obj/structure/tank_dispenser/oxygen,
/obj/effect/turf_decal/stripes/line{
	dir = 4
	},
/obj/machinery/light/small/red/dim/directional/south,
/turf/open/floor/pod/dark,
/area/shuttle/pirate/nri)
"tm" = (
/obj/structure/cable,
/obj/machinery/power/terminal,
/turf/open/floor/plating,
/area/shuttle/pirate/nri)
"ty" = (
/obj/structure/cable,
/obj/machinery/power/terminal{
	dir = 1
	},
/turf/open/floor/plating,
/area/shuttle/pirate/nri)
"tN" = (
/obj/machinery/door/airlock/survival_pod/glass{
	dir = 1
	},
/obj/effect/mapping_helpers/airlock/access/all/syndicate/general,
/obj/effect/mapping_helpers/airlock/cutaiwire,
/turf/open/floor/pod,
/area/shuttle/pirate/nri)
"ui" = (
/obj/effect/turf_decal/stripes/line,
/obj/machinery/light/small/red/directional/east,
/obj/machinery/sleeper{
	dir = 8
	},
/turf/open/floor/pod,
/area/shuttle/pirate/nri)
"uw" = (
/obj/structure/table/reinforced,
/obj/machinery/newscaster/directional/north,
/obj/item/paper_bin,
/obj/item/pen,
/obj/machinery/light/very_dim/directional/north,
/turf/open/floor/pod/dark,
/area/shuttle/pirate/nri)
"uU" = (
/obj/structure/cable,
/obj/effect/turf_decal/stripes/line{
	dir = 9
	},
/obj/machinery/suit_storage_unit/nri,
/turf/open/floor/pod,
/area/shuttle/pirate/nri)
"vh" = (
/obj/effect/turf_decal/loading_area{
	dir = 1
	},
/turf/open/floor/plating,
/area/shuttle/pirate/nri)
"vj" = (
/obj/machinery/power/port_gen/pacman/super{
	anchored = 1;
	sheets = 20
	},
/obj/structure/cable,
/turf/open/floor/plating,
/area/shuttle/pirate/nri)
"wb" = (
/turf/open/floor/pod/light,
/area/shuttle/pirate/nri)
"wh" = (
/obj/machinery/defibrillator_mount/directional/east,
/obj/machinery/anesthetic_machine,
/obj/item/tank/internals/anesthetic,
/obj/effect/turf_decal/stripes/line{
	dir = 1
	},
/obj/machinery/light/small/red/directional/east,
/turf/open/floor/pod,
/area/shuttle/pirate/nri)
"wM" = (
/obj/machinery/door/airlock/survival_pod/glass,
/obj/effect/mapping_helpers/airlock/access/all/syndicate/general,
/obj/effect/mapping_helpers/airlock/cutaiwire,
/turf/open/floor/pod,
/area/shuttle/pirate/nri)
"wT" = (
/obj/structure/rack/shelf,
/obj/effect/turf_decal/stripes/line,
/obj/item/ammo_box/magazine/akm/civvie{
	pixel_x = 7
	},
/obj/item/ammo_box/magazine/akm/civvie{
	pixel_x = 7
	},
/obj/item/ammo_box/magazine/akm/civvie{
	pixel_x = 7
	},
/obj/item/ammo_box/magazine/akm/civvie{
	pixel_x = 7
	},
/obj/item/ammo_box/magazine/plastikov9mm{
	pixel_x = -7
	},
/obj/item/ammo_box/magazine/plastikov9mm{
	pixel_x = -7
	},
/obj/item/ammo_box/magazine/plastikov9mm{
	pixel_x = -7
	},
/obj/item/ammo_box/magazine/plastikov9mm{
	pixel_x = -7
	},
/turf/open/floor/pod/light,
/area/shuttle/pirate/nri)
"xg" = (
/obj/machinery/door/airlock/survival_pod/glass,
/obj/structure/cable,
/obj/effect/mapping_helpers/airlock/access/all/syndicate/general,
/obj/effect/mapping_helpers/airlock/cutaiwire,
/turf/open/floor/catwalk_floor,
/area/shuttle/pirate/nri)
"xp" = (
/obj/machinery/door/airlock/survival_pod{
	dir = 8
	},
/obj/structure/cable,
/obj/effect/mapping_helpers/airlock/access/all/syndicate/general,
/obj/effect/mapping_helpers/airlock/cutaiwire,
/turf/open/floor/catwalk_floor,
/area/shuttle/pirate/nri)
"xX" = (
/obj/effect/turf_decal/stripes/line{
	dir = 10
	},
/turf/open/floor/pod,
/area/shuttle/pirate/nri)
"ze" = (
/obj/effect/turf_decal/stripes/line{
	dir = 5
	},
/turf/open/floor/engine/hull/reinforced,
/area/shuttle/pirate/nri)
"zy" = (
/obj/structure/table/reinforced,
/obj/machinery/recharger{
	pixel_y = 3
	},
/obj/effect/turf_decal/stripes/line,
/obj/machinery/light/small/red/dim/directional/north,
/turf/open/floor/pod/light,
/area/shuttle/pirate/nri)
"zJ" = (
/obj/structure/table/reinforced,
/obj/item/clothing/gloves/color/latex/nitrile{
	pixel_y = 3
	},
/obj/item/wrench/medical{
	pixel_x = 16;
	pixel_y = 4
	},
/obj/item/storage/backpack/duffelbag/med/surgery{
	pixel_y = 9
	},
/obj/item/healthanalyzer{
	pixel_x = 10;
	pixel_y = 9
	},
/obj/item/healthanalyzer{
	pixel_x = 10;
	pixel_y = 5
	},
/obj/effect/turf_decal/stripes/line{
	dir = 8
	},
/turf/open/floor/pod/dark,
/area/shuttle/pirate/nri)
"AX" = (
/obj/structure/rack/shelf,
/obj/effect/turf_decal/stripes/line,
/obj/item/ammo_box/advanced/s12gauge/buckshot,
/obj/item/ammo_box/advanced/s12gauge/buckshot,
/obj/item/ammo_box/advanced/s12gauge,
/obj/item/ammo_box/advanced/s12gauge,
/obj/machinery/light/small/red/dim/directional/north,
/turf/open/floor/pod/light,
/area/shuttle/pirate/nri)
"Be" = (
/obj/structure/fans/tiny/forcefield{
	dir = 4
	},
/obj/structure/cable,
/obj/effect/turf_decal/delivery,
/turf/open/floor/plating,
/area/shuttle/pirate/nri)
"Bj" = (
/obj/effect/turf_decal/stripes/line{
	dir = 8
	},
/obj/effect/turf_decal/stripes/corner,
/obj/machinery/porta_turret/syndicate/nri_raider{
	dir = 6
	},
/turf/open/floor/engine/hull/reinforced,
/area/shuttle/pirate/nri)
"Bk" = (
/obj/machinery/power/shieldwallgen/unlocked/anchored{
	req_access_txt = "syndicate";
	req_one_access_txt = "syndicate";
	max_integrity = 600;
	armor = list("melee"=30,"bullet"=30,"laser"=20,"energy"=20,"bomb"=10,"bio"=0,"fire"=80,"acid"=70);
	desc = "A heavy-duty reinforced shield generator designed for ship defense.";
	name = "defense shield generator"
	},
/obj/structure/cable,
/obj/structure/lattice/catwalk,
/turf/open/floor/plating/airless,
/area/shuttle/pirate/nri)
"Bm" = (
/obj/structure/cable,
/obj/effect/turf_decal/stripes/line{
	dir = 8
	},
/obj/machinery/suit_storage_unit/nri,
/turf/open/floor/pod/dark,
/area/shuttle/pirate/nri)
"Bw" = (
/obj/effect/turf_decal/caution/stand_clear{
	dir = 1
	},
/turf/open/floor/pod/dark,
/area/shuttle/pirate/nri)
"Bz" = (
/obj/effect/turf_decal/stripes/line{
	dir = 6
	},
/turf/open/floor/engine/hull/reinforced,
/area/shuttle/pirate/nri)
"Ci" = (
/obj/machinery/power/apc/auto_name/directional/east{
	req_access_txt = "syndicate";
	req_one_access_txt = "syndicate";
	cell_type = /obj/item/stock_parts/cell/super
	},
/obj/structure/cable,
/obj/effect/turf_decal/stripes/line,
/turf/open/floor/pod,
/area/shuttle/pirate/nri)
"Cy" = (
/obj/machinery/power/shuttle_engine/propulsion/burst{
	dir = 8
	},
/turf/open/floor/plating/airless,
/area/shuttle/pirate/nri)
"CC" = (
/obj/effect/mob_spawn/ghost_role/human/pirate/nri/gunner,
/turf/open/floor/pod,
/area/shuttle/pirate/nri)
"CP" = (
/obj/structure/table/reinforced,
/obj/machinery/fax{
	fax_name = "NRI Ship";
	name = "NRI ship fax machine"
	},
/obj/item/paper/fluff/nri_police,
/turf/open/floor/pod,
/area/shuttle/pirate/nri)
"DD" = (
/obj/effect/turf_decal/stripes/line{
	dir = 5
	},
/obj/effect/turf_decal/stripes/line{
	dir = 8
	},
/obj/machinery/light/floor,
/turf/open/floor/engine/hull/reinforced,
/area/shuttle/pirate/nri)
"Eh" = (
/obj/structure/window/reinforced/survival_pod{
	dir = 4
	},
/obj/machinery/power/smes/engineering,
/obj/structure/cable,
/obj/structure/window/reinforced/survival_pod,
/turf/open/floor/plating,
/area/shuttle/pirate/nri)
"EG" = (
/obj/effect/turf_decal/stripes/line{
	dir = 4
	},
/obj/effect/turf_decal/stripes/corner{
	dir = 8
	},
/obj/machinery/light/floor,
/turf/open/floor/engine/hull/reinforced,
/area/shuttle/pirate/nri)
"Fm" = (
/obj/effect/turf_decal/stripes/line{
	dir = 9
	},
/turf/open/floor/engine/hull/reinforced,
/area/shuttle/pirate/nri)
"GO" = (
/turf/open/floor/engine/hull,
/area/shuttle/pirate/nri)
"Hl" = (
/obj/effect/turf_decal/stripes/line{
	dir = 4
	},
/obj/effect/turf_decal/stripes/corner{
	dir = 1
	},
/obj/machinery/light/floor,
/turf/open/floor/engine/hull/reinforced,
/area/shuttle/pirate/nri)
"Hs" = (
/obj/structure/lattice,
/turf/open/floor/plating/airless,
/area/shuttle/pirate/nri)
"Hu" = (
/obj/structure/cable,
/obj/structure/window/reinforced/survival_pod{
	dir = 1
	},
/obj/structure/reagent_dispensers/fueltank/large{
	anchored = 1;
	desc = "A tank full of a high quantity of liquid hydrogen fuel. Keep away from open flames and 57mm mortar shells.";
	icon_state = "vat"
	},
/turf/open/floor/plating,
/area/shuttle/pirate/nri)
"Hz" = (
/turf/closed/wall/mineral/titanium/spaceship/nodiagonal,
/area/shuttle/pirate/nri)
"HD" = (
/obj/structure/cable,
/obj/machinery/holopad,
/turf/open/floor/pod/light,
/area/shuttle/pirate/nri)
"HV" = (
/obj/effect/turf_decal/stripes/line{
	dir = 8
	},
/turf/open/floor/pod/dark,
/area/shuttle/pirate/nri)
"Ib" = (
/obj/effect/turf_decal/stripes/line{
	dir = 6
	},
/obj/structure/closet/crate/secure/weapon{
	name = "footlocker";
	desc = "A secure crate to keep all your personal belongings in.";
	anchored = 1
	},
/turf/open/floor/pod/dark,
/area/shuttle/pirate/nri)
"Iv" = (
/obj/structure/grille,
/obj/structure/window/reinforced/shuttle/spaceship,
/turf/open/floor/plating,
/area/shuttle/pirate/nri)
"IJ" = (
/obj/effect/turf_decal/stripes/line{
	dir = 1
	},
/turf/open/floor/pod/dark,
/area/shuttle/pirate/nri)
"IT" = (
/obj/structure/cable,
/turf/open/floor/catwalk_floor,
/area/shuttle/pirate/nri)
"IY" = (
/turf/open/floor/engine/hull/reinforced,
/area/shuttle/pirate/nri)
"JS" = (
/obj/structure/cable,
/obj/structure/lattice/catwalk,
/turf/open/floor/plating/airless,
/area/shuttle/pirate/nri)
"Kc" = (
/obj/effect/turf_decal/stripes/line,
/obj/effect/turf_decal/stripes/line{
	dir = 9
	},
/turf/open/floor/engine/hull/reinforced,
/area/shuttle/pirate/nri)
"Kq" = (
/obj/machinery/light/warm/directional/south,
/turf/open/floor/pod/dark,
/area/shuttle/pirate/nri)
"Lp" = (
/obj/machinery/door/window/survival_pod{
	dir = 4
	},
/obj/structure/cable,
/turf/open/floor/plating,
/area/shuttle/pirate/nri)
"Lr" = (
/obj/structure/cable,
/obj/effect/turf_decal/stripes/line{
	dir = 8
	},
/obj/machinery/suit_storage_unit/open,
/turf/open/floor/pod/dark,
/area/shuttle/pirate/nri)
"Lx" = (
/obj/effect/turf_decal/stripes/line{
	dir = 6
	},
/obj/machinery/light/small/red/dim/directional/west,
/obj/structure/table/reinforced,
/obj/item/stock_parts/cell/high/empty,
/obj/item/stock_parts/cell/high/empty,
/obj/item/card/id/away/old/apc,
/turf/open/floor/pod,
/area/shuttle/pirate/nri)
"LA" = (
/obj/machinery/piratepad,
/obj/machinery/light/small/red/dim/directional/north,
/turf/open/floor/pod/dark,
/area/shuttle/pirate/nri)
"Mi" = (
/obj/machinery/door/airlock/external,
/obj/effect/mapping_helpers/airlock/access/all/syndicate/general,
/obj/effect/mapping_helpers/airlock/cutaiwire,
/obj/effect/mapping_helpers/airlock/cyclelink_helper,
/turf/open/floor/plating,
/area/shuttle/pirate/nri)
"Ms" = (
/obj/effect/turf_decal/stripes/line{
	dir = 6
	},
/obj/machinery/computer/shuttle/pirate/nri{
	dir = 8;
	name = "police shuttle console"
	},
/turf/open/floor/pod/light,
/area/shuttle/pirate/nri)
"Nu" = (
/obj/structure/closet/crate/secure/weapon{
	anchored = 1
	},
/obj/effect/turf_decal/stripes/line{
	dir = 5
	},
/obj/item/stack/sticky_tape,
/obj/item/stack/sticky_tape,
/turf/open/floor/pod,
/area/shuttle/pirate/nri)
"NE" = (
/obj/effect/turf_decal/stripes/line{
	dir = 10
	},
/turf/open/floor/engine/hull/reinforced,
/area/shuttle/pirate/nri)
"NO" = (
/obj/machinery/autolathe/hacked,
/obj/item/stack/sheet/glass/fifty,
/obj/item/stack/sheet/iron/fifty,
/obj/effect/turf_decal/stripes/line{
	dir = 5
	},
/obj/machinery/light/small/red/dim/directional/west,
/turf/open/floor/pod,
/area/shuttle/pirate/nri)
"NT" = (
/obj/effect/turf_decal/caution/stand_clear,
/turf/open/floor/pod/dark,
/area/shuttle/pirate/nri)
"NW" = (
/obj/structure/window/reinforced/survival_pod{
	dir = 1;
	name = "blast shield"
	},
/turf/open/floor/plating/airless,
/area/shuttle/pirate/nri)
"NY" = (
/obj/structure/window/reinforced/survival_pod,
/obj/structure/window/reinforced/survival_pod{
	dir = 1
	},
/turf/open/floor/plating/airless,
/area/shuttle/pirate/nri)
"Oc" = (
/obj/structure/cable,
/obj/machinery/light/small/red/directional/south,
/turf/open/floor/catwalk_floor,
/area/shuttle/pirate/nri)
"Pi" = (
/obj/structure/bed/pod{
	dir = 1
	},
/obj/effect/turf_decal/stripes/line{
	dir = 1
	},
/obj/item/bedsheet/random{
	dir = 4
	},
/turf/open/floor/pod/light,
/area/shuttle/pirate/nri)
"Pk" = (
/turf/open/floor/pod,
/area/shuttle/pirate/nri)
"Pp" = (
/obj/machinery/door/airlock/survival_pod{
	dir = 8
	},
/obj/effect/mapping_helpers/airlock/access/all/syndicate/general,
/obj/effect/mapping_helpers/airlock/cutaiwire,
/turf/open/floor/pod,
/area/shuttle/pirate/nri)
"PO" = (
/obj/effect/turf_decal/loading_area,
/turf/open/floor/plating,
/area/shuttle/pirate/nri)
"PV" = (
/obj/structure/girder/reinforced,
/obj/structure/grille,
/turf/open/floor/plating/airless,
/area/shuttle/pirate/nri)
"Qg" = (
/obj/machinery/computer/operating{
	dir = 1
	},
/obj/effect/turf_decal/stripes/line{
	dir = 8
	},
/turf/open/floor/pod/dark,
/area/shuttle/pirate/nri)
"Rb" = (
/obj/effect/turf_decal/stripes/line,
/obj/effect/turf_decal/stripes/corner{
	dir = 1
	},
/turf/open/floor/engine/hull/reinforced,
/area/shuttle/pirate/nri)
"SQ" = (
/obj/machinery/porta_turret/syndicate/nri_raider{
	dir = 6
	},
/turf/closed/wall/mineral/titanium/spaceship/nodiagonal,
/area/shuttle/pirate/nri)
"Tg" = (
/obj/structure/window/reinforced/survival_pod{
	dir = 4
	},
/obj/machinery/power/smes/engineering,
/obj/structure/cable,
/obj/structure/window/reinforced/survival_pod{
	dir = 1
	},
/turf/open/floor/plating,
/area/shuttle/pirate/nri)
"Tj" = (
/obj/machinery/door/airlock/external,
/obj/effect/mapping_helpers/airlock/access/all/syndicate/general,
/obj/effect/mapping_helpers/airlock/cyclelink_helper{
	dir = 1
	},
/obj/effect/mapping_helpers/airlock/cutaiwire,
/turf/open/floor/plating,
/area/shuttle/pirate/nri)
"TF" = (
/obj/effect/turf_decal/stripes/line{
	dir = 10
	},
/obj/structure/closet/crate/secure/weapon{
	name = "footlocker";
	desc = "A secure crate to keep all your personal belongings in.";
	anchored = 1
	},
/turf/open/floor/pod/dark,
/area/shuttle/pirate/nri)
"TR" = (
/obj/structure/window/reinforced/survival_pod{
	dir = 1
	},
/obj/structure/window/reinforced/survival_pod,
/obj/structure/window/reinforced/survival_pod{
	dir = 8
	},
/obj/machinery/power/shuttle_engine/heater{
	dir = 4
	},
/obj/machinery/power/shuttle_engine/heater{
	dir = 8
	},
/turf/open/floor/plating,
/area/shuttle/pirate/nri)
"UO" = (
/obj/structure/table/reinforced,
/obj/machinery/cell_charger_multi,
/obj/effect/turf_decal/stripes/line{
	dir = 4
	},
/turf/open/floor/pod,
/area/shuttle/pirate/nri)
"UP" = (
/obj/machinery/light/floor,
/turf/open/floor/engine/hull,
/area/shuttle/pirate/nri)
"UY" = (
/obj/structure/window/reinforced/survival_pod,
/obj/structure/window/reinforced/survival_pod{
	dir = 1
	},
/obj/machinery/power/shuttle_engine/propulsion/burst{
	dir = 8
	},
/turf/open/floor/plating/airless,
/area/shuttle/pirate/nri)
"Va" = (
/obj/structure/cable,
/obj/effect/turf_decal/stripes/line{
	dir = 10
	},
/obj/machinery/suit_storage_unit/nri,
/turf/open/floor/pod,
/area/shuttle/pirate/nri)
"VN" = (
/obj/structure/table/reinforced,
/obj/item/storage/box/nri_rations{
	pixel_x = -3
	},
/obj/item/storage/box/nri_rations{
	pixel_x = -3;
	pixel_y = 3
	},
/obj/item/storage/box/nri_rations{
	pixel_x = -3;
	pixel_y = 6
	},
/obj/item/storage/box/nri_rations{
	pixel_x = 7;
	pixel_y = -5
	},
/obj/item/storage/box/nri_rations{
	pixel_x = 7;
	pixel_y = -2
	},
/obj/item/storage/box/nri_rations{
	pixel_x = 7;
	pixel_y = 1
	},
/obj/effect/turf_decal/stripes/line{
	dir = 1
	},
/turf/open/floor/pod,
/area/shuttle/pirate/nri)
"Wa" = (
/obj/structure/cable,
/obj/effect/turf_decal/stripes/line{
	dir = 10
	},
/turf/open/floor/pod,
/area/shuttle/pirate/nri)
"Wr" = (
/obj/structure/window/reinforced/survival_pod{
	dir = 1
	},
/turf/open/floor/engine/hull/reinforced,
/area/shuttle/pirate/nri)
"Xe" = (
/obj/structure/cable,
/obj/machinery/door/airlock/survival_pod{
	dir = 8
	},
/obj/effect/mapping_helpers/airlock/access/all/syndicate/general,
/obj/effect/mapping_helpers/airlock/cutaiwire,
/turf/open/floor/catwalk_floor,
/area/shuttle/pirate/nri)
"Xh" = (
/obj/structure/cable,
/obj/machinery/power/shieldwallgen/unlocked/anchored{
	req_access_txt = "syndicate";
	req_one_access_txt = "syndicate";
	max_integrity = 600;
	armor = list("melee"=30,"bullet"=30,"laser"=20,"energy"=20,"bomb"=10,"bio"=0,"fire"=80,"acid"=70);
	desc = "A heavy-duty reinforced shield generator designed for ship defense.";
	name = "defense shield generator"
	},
/obj/structure/lattice/catwalk,
/turf/open/floor/plating/airless,
/area/shuttle/pirate/nri)
"XA" = (
/obj/effect/turf_decal/stripes/line{
	dir = 1
	},
/obj/structure/chair/comfy/shuttle{
	dir = 4
	},
/turf/open/floor/pod/dark,
/area/shuttle/pirate/nri)
"XY" = (
/obj/effect/turf_decal/stripes/line{
	dir = 10
	},
/obj/machinery/porta_turret/syndicate/nri_raider{
	dir = 9
	},
/turf/open/floor/engine/hull/reinforced,
/area/shuttle/pirate/nri)
"Yd" = (
/obj/machinery/power/shuttle_engine/large{
	dir = 8
	},
/turf/open/floor/engine/hull/reinforced,
/area/shuttle/pirate/nri)
"Ze" = (
/obj/structure/table/reinforced,
/obj/item/storage/belt/utility/full,
/obj/item/clothing/glasses/meson/engine,
/obj/effect/turf_decal/stripes/line{
	dir = 4
	},
/turf/open/floor/pod,
/area/shuttle/pirate/nri)

(1,1,1) = {"
ot
ot
ot
ot
ot
IY
nX
iC
nX
IY
ot
ot
ot
ot
ot
"}
(2,1,1) = {"
ot
ot
ot
ot
IY
IY
nD
iC
Wr
IY
IY
ot
ot
ot
ot
"}
(3,1,1) = {"
ot
ot
Fm
XY
IY
Yd
NY
iC
ap
IY
Yd
bQ
NE
ot
ot
"}
(4,1,1) = {"
ot
dy
Hl
Bz
IY
iC
UY
Cy
cZ
iC
IY
ze
EG
hH
ot
"}
(5,1,1) = {"
ot
iC
iC
iC
Hz
Hz
TR
sK
TR
Hz
Hz
iC
iC
iC
ot
"}
(6,1,1) = {"
ot
GO
GO
GO
Hz
vj
Hu
qQ
et
vj
Hz
GO
GO
GO
ot
"}
(7,1,1) = {"
ot
GO
GO
UP
Hz
tm
Tg
Lp
Eh
ty
Hz
UP
GO
GO
ot
"}
(8,1,1) = {"
NW
iC
lv
iC
Hz
HV
xX
rp
qz
HV
Hz
iC
NW
iC
lv
"}
(9,1,1) = {"
iC
iC
iC
IY
Hz
lV
lU
hU
od
Kq
Hz
IY
iC
iC
iC
"}
(10,1,1) = {"
iC
iC
iC
IY
Hz
Bm
Va
hU
uU
Lr
Hz
IY
iC
iC
iC
"}
(11,1,1) = {"
Hz
cc
Hz
IY
Hz
Iv
Iv
hn
Iv
Iv
Hz
IY
Hz
cc
Hz
"}
(12,1,1) = {"
Hz
ql
Hz
Hz
Hz
kb
rO
IT
Nu
tl
Hz
Hz
Hz
ql
Hz
"}
(13,1,1) = {"
ov
PO
Tj
NT
wM
tk
Pk
IT
Pk
tk
tN
Bw
Mi
vh
pt
"}
(14,1,1) = {"
Hz
Hz
Hz
Hz
Hz
zJ
xX
IT
qz
Qg
Hz
Hz
Hz
Hz
Hz
"}
(15,1,1) = {"
Hz
rg
Pk
aW
Hz
pQ
ui
IT
wh
hl
Hz
TF
ew
Pi
Hz
"}
(16,1,1) = {"
Hz
AX
Pk
rd
Hz
Hz
Hz
Xe
Hz
Hz
Hz
bg
CC
rk
Hz
"}
(17,1,1) = {"
Hz
wT
Pk
be
Hz
UO
Lx
IT
NO
Ze
Hz
Ib
CC
Pi
Hz
"}
(18,1,1) = {"
Hz
zy
Pk
IT
xg
IT
IT
HD
IT
IT
hK
IT
Pk
rk
Hz
"}
(19,1,1) = {"
pb
Hz
Hz
xp
Hz
ey
Wa
iG
qz
ie
Hz
xp
Hz
Hz
SQ
"}
(20,1,1) = {"
nX
Hz
lc
IT
Hz
LA
Ci
wb
VN
mJ
Hz
IT
Oc
Hz
nX
"}
(21,1,1) = {"
GO
Hz
Be
Iv
Hz
Hz
Hz
Pp
Hz
Hz
Hz
Iv
Be
Hz
GO
"}
(22,1,1) = {"
nX
Hz
Bk
GO
Hz
CP
IJ
tk
hP
iq
Hz
GO
Xh
Hz
nX
"}
(23,1,1) = {"
ot
Hz
JS
UP
Hz
uw
XA
tk
mG
bM
Hz
UP
JS
Hz
ot
"}
(24,1,1) = {"
ot
Hs
JS
Hs
Iv
Iv
qJ
jx
Ms
Iv
Iv
Hs
JS
Hs
ot
"}
(25,1,1) = {"
ot
Hs
JS
Hs
ot
Iv
Iv
Iv
Iv
Iv
ot
Hs
JS
Hs
ot
"}
(26,1,1) = {"
ot
IY
JS
nX
IY
Hs
Hs
Hs
Hs
Hs
IY
nX
JS
IY
ot
"}
(27,1,1) = {"
ot
PV
dS
JS
JS
JS
JS
JS
JS
JS
JS
JS
dS
PV
ot
"}
(28,1,1) = {"
ot
ot
PV
PV
Kc
Hs
Hs
Hs
Hs
Hs
kX
PV
PV
ot
ot
"}
(29,1,1) = {"
ot
ot
DD
ma
Rb
ot
ot
ot
ot
ot
gR
Bj
bG
ot
ot
"}
(30,1,1) = {"
ot
ot
ot
ze
Bz
ot
ot
ot
ot
ot
ze
Bz
ot
ot
ot
"}
