//MAP CONVERTED BY dmm2tgm.py THIS HEADER COMMENT PREVENTS RECONVERSION, DO NOT REMOVE
"a" = (
/obj/effect/turf_decal/siding/thinplating/dark/corner{
	dir = 1
	},
/obj/machinery/computer/shuttle/planetary_ferry{
	dir = 8
	},
/turf/open/floor/iron/smooth,
/area/shuttle/planetary_ferry)
"f" = (
/turf/open/floor/iron/smooth_large,
/area/shuttle/planetary_ferry)
"g" = (
/obj/machinery/power/shuttle_engine/propulsion{
	dir = 8
	},
/obj/effect/turf_decal/stripes/line{
	dir = 8
	},
/turf/open/floor/plating,
/area/shuttle/planetary_ferry)
"i" = (
/obj/structure/chair/comfy/shuttle{
	dir = 4
	},
/obj/effect/turf_decal/siding/thinplating/dark{
	dir = 1
	},
/turf/open/floor/iron/smooth,
/area/shuttle/planetary_ferry)
"k" = (
/obj/machinery/door/airlock/grunge{
	name = "Public Shuttle Airlock"
	},
/obj/structure/fans/tiny,
/obj/docking_port/mobile{
	dir = 4;
	shuttle_id = "planetary_ferry";
	launch_status = 0;
	name = "Planetary Ferry";
	port_direction = 2;
	preferred_direction = 4
	},
/turf/open/floor/catwalk_floor/iron_smooth,
/area/shuttle/planetary_ferry)
"v" = (
/obj/structure/marker_beacon/olive,
/turf/closed/wall/mineral/titanium/nodiagonal,
/area/shuttle/planetary_ferry)
"w" = (
/obj/structure/closet/crate/internals,
/obj/effect/turf_decal/siding/thinplating/dark{
	dir = 1
	},
/obj/machinery/light/small/directional/west,
/turf/open/floor/iron/smooth,
/area/shuttle/planetary_ferry)
"y" = (
/obj/machinery/power/shuttle_engine/heater{
	dir = 8
	},
/obj/structure/window/reinforced/plasma/spawner/directional/east,
/obj/structure/window/reinforced/plasma/spawner/directional/south,
/obj/effect/turf_decal/stripes/line{
	dir = 6
	},
/turf/open/floor/plating,
/area/shuttle/planetary_ferry)
"z" = (
/obj/structure/railing{
	dir = 1
	},
/obj/structure/railing,
/turf/open/floor/iron/stairs/medium{
	dir = 8
	},
/area/shuttle/planetary_ferry)
"D" = (
/obj/structure/marker_beacon/burgundy,
/turf/closed/wall/mineral/titanium/nodiagonal,
/area/shuttle/planetary_ferry)
"G" = (
/obj/effect/spawner/structure/window/reinforced/shuttle,
/turf/open/floor/plating,
/area/shuttle/planetary_ferry)
"H" = (
/obj/structure/chair/comfy/shuttle{
	dir = 1
	},
/obj/effect/turf_decal/siding/thinplating/dark{
	dir = 1
	},
/turf/open/floor/iron/smooth,
/area/shuttle/planetary_ferry)
"N" = (
/turf/closed/wall/mineral/titanium,
/area/shuttle/planetary_ferry)
"O" = (
/obj/structure/chair/comfy/shuttle{
	dir = 8
	},
/obj/effect/turf_decal/siding/thinplating/dark{
	dir = 8
	},
/turf/open/floor/iron/smooth,
/area/shuttle/planetary_ferry)
"Q" = (
/obj/machinery/power/shuttle_engine/heater{
	dir = 8
	},
/obj/structure/window/reinforced/plasma/spawner/directional/east,
/obj/structure/window/reinforced/plasma/spawner/directional/north,
/obj/effect/turf_decal/stripes/line{
	dir = 5
	},
/turf/open/floor/plating,
/area/shuttle/planetary_ferry)
"X" = (
/turf/closed/wall/mineral/titanium/nodiagonal,
/area/shuttle/planetary_ferry)
"Y" = (
/obj/effect/turf_decal/shuttle/exploration/hazardstripe{
	dir = 8
	},
/obj/structure/railing/corner/end{
	dir = 8
	},
/obj/structure/railing/corner/end/flip{
	dir = 8
	},
/turf/open/floor/iron/smooth_large,
/area/shuttle/planetary_ferry)

(1,1,1) = {"
g
k
X
g
"}
(2,1,1) = {"
y
z
w
Q
"}
(3,1,1) = {"
G
Y
H
G
"}
(4,1,1) = {"
G
f
i
G
"}
(5,1,1) = {"
D
O
a
v
"}
(6,1,1) = {"
N
G
G
N
"}
