//MAP CONVERTED BY dmm2tgm.py THIS HEADER COMMENT PREVENTS RECONVERSION, DO NOT REMOVE
"ab" = (
/obj/effect/turf_decal/caution,
/obj/machinery/door/poddoor/shutters/preopen{
	id = "prisontransportlockdown"
	},
/turf/open/floor/iron/smooth,
/area/shuttle/prison_transport)
"ay" = (
/turf/template_noop,
/area/template_noop)
"aD" = (
/obj/machinery/door/poddoor/shutters/preopen{
	id = "prisontransportlockdownc1"
	},
/obj/effect/turf_decal/vg_decals/numbers/one,
/turf/open/floor/iron/smooth_large,
/area/shuttle/prison_transport)
"aI" = (
/obj/machinery/light/cold/no_nightlight/directional/north,
/obj/item/gun/ballistic/automatic/cfa_wildcat/no_mag,
/obj/item/ammo_box/magazine/multi_sprite/cfa_wildcat/rubber,
/obj/item/ammo_box/magazine/multi_sprite/cfa_wildcat/rubber,
/obj/item/ammo_box/magazine/multi_sprite/cfa_wildcat/rubber,
/obj/structure/rack/shelf,
/turf/open/floor/iron/dark/blue/side{
	dir = 4
	},
/area/shuttle/prison_transport)
"bR" = (
/obj/machinery/door/airlock/command/glass{
	name = "Connecting Tube";
	req_access = list("cent_general")
	},
/turf/open/floor/iron/smooth_large,
/area/shuttle/prison_transport)
"cz" = (
/turf/open/floor/iron/dark/blue,
/area/shuttle/prison_transport)
"dz" = (
/obj/effect/turf_decal/trimline/brown/warning{
	dir = 1
	},
/obj/effect/turf_decal/vg_decals/numbers/five,
/turf/open/floor/iron/smooth_half,
/area/shuttle/prison_transport)
"dS" = (
/obj/structure/sign/nanotrasen,
/turf/closed/wall/mineral/titanium,
/area/shuttle/prison_transport)
"ew" = (
/obj/effect/turf_decal/trimline/brown/warning{
	dir = 1
	},
/obj/effect/turf_decal/vg_decals/numbers/six,
/turf/open/floor/iron/smooth_half,
/area/shuttle/prison_transport)
"fE" = (
/obj/effect/turf_decal/trimline/brown/warning,
/obj/machinery/button/door/directional/west{
	id = "prisontransportcell8";
	name = "Cell Lockdown";
	pixel_y = -10
	},
/obj/machinery/button/door/directional/west{
	id = "prisontransportcell7";
	name = "Cell Lockdown";
	pixel_y = 10
	},
/turf/open/floor/iron/smooth_half,
/area/shuttle/prison_transport)
"fK" = (
/obj/machinery/light/cold/no_nightlight/directional/west,
/obj/machinery/door/poddoor/shutters/preopen{
	id = "prisontransportlockdownc1"
	},
/obj/effect/turf_decal/trimline/brown/warning{
	dir = 4
	},
/turf/open/floor/iron/smooth_large,
/area/shuttle/prison_transport)
"gp" = (
/obj/structure/mirror/directional/south,
/obj/machinery/shower{
	dir = 1
	},
/obj/effect/turf_decal/weather/dirt,
/turf/open/floor/iron/shuttle/evac{
	icon_state = "floorsec2"
	},
/area/shuttle/prison_transport)
"hd" = (
/obj/machinery/door/poddoor/shutters/window/preopen{
	id = "prisontransportcell4";
	name = "Lockdown"
	},
/obj/effect/turf_decal/loading_area/red{
	dir = 8
	},
/turf/open/floor/iron/smooth,
/area/shuttle/prison_transport)
"ho" = (
/obj/structure/rack/shelf,
/obj/item/clothing/suit/armor/riot,
/obj/item/clothing/suit/armor/riot,
/obj/item/clothing/suit/armor/riot,
/obj/item/clothing/suit/armor/riot,
/obj/item/clothing/head/helmet/riot,
/obj/item/clothing/head/helmet/riot,
/obj/item/clothing/head/helmet/riot,
/obj/item/clothing/head/helmet/riot,
/turf/open/floor/iron/dark,
/area/shuttle/prison_transport)
"hC" = (
/obj/machinery/door/poddoor/shutters/window/preopen{
	id = "prisontransportcell11";
	name = "Lockdown"
	},
/obj/effect/turf_decal/loading_area/red{
	dir = 4
	},
/turf/open/floor/iron/smooth,
/area/shuttle/prison_transport)
"hD" = (
/obj/effect/turf_decal/trimline/brown/warning{
	dir = 1
	},
/obj/effect/turf_decal/vg_decals/numbers/nine,
/turf/open/floor/iron/smooth_half,
/area/shuttle/prison_transport)
"hE" = (
/obj/effect/turf_decal/trimline/brown/warning,
/turf/open/floor/iron/smooth_half,
/area/shuttle/prison_transport)
"iz" = (
/obj/structure/chair/greyscale,
/obj/effect/turf_decal/weather/dirt{
	dir = 9
	},
/obj/structure/sign/poster/official/no_erp{
	pixel_y = 32
	},
/turf/open/floor/iron/shuttle/evac{
	icon_state = "floorsec2"
	},
/area/shuttle/prison_transport)
"iH" = (
/obj/machinery/door/airlock/command/glass{
	name = "Connecting Tube";
	req_access = list("cent_general")
	},
/turf/open/floor/iron/smooth_half,
/area/shuttle/prison_transport)
"iL" = (
/obj/machinery/door/poddoor/shutters/window/preopen{
	id = "prisontransportcell13";
	name = "Lockdown"
	},
/obj/effect/turf_decal/loading_area/red{
	dir = 4
	},
/turf/open/floor/iron/smooth,
/area/shuttle/prison_transport)
"iX" = (
/obj/effect/turf_decal/trimline/brown/warning,
/obj/machinery/light/cold/no_nightlight/directional/east,
/obj/machinery/button/door/directional/east{
	id = "prisontransportcell11";
	name = "Cell Lockdown";
	pixel_y = -10
	},
/obj/machinery/button/door/directional/east{
	id = "prisontransportcell12";
	name = "Cell Lockdown";
	pixel_y = 10
	},
/turf/open/floor/iron/smooth_half,
/area/shuttle/prison_transport)
"jq" = (
/obj/structure/chair/greyscale,
/obj/effect/turf_decal/weather/dirt{
	dir = 5
	},
/turf/open/floor/iron/shuttle/evac{
	icon_state = "floorsec2"
	},
/area/shuttle/prison_transport)
"jI" = (
/obj/effect/turf_decal/trimline/brown/warning{
	dir = 1
	},
/obj/effect/turf_decal/vg_decals/numbers/two,
/turf/open/floor/iron/smooth_half,
/area/shuttle/prison_transport)
"jN" = (
/obj/machinery/door/poddoor/shutters/window/preopen{
	id = "prisontransportcell16";
	name = "Lockdown"
	},
/obj/effect/turf_decal/loading_area/red{
	dir = 4
	},
/turf/open/floor/iron/smooth,
/area/shuttle/prison_transport)
"jQ" = (
/obj/effect/turf_decal/trimline/brown/warning,
/obj/machinery/light/cold/no_nightlight/directional/east,
/obj/machinery/button/door/directional/east{
	id = "prisontransportcell15";
	name = "Cell Lockdown";
	pixel_y = -10
	},
/obj/machinery/button/door/directional/east{
	id = "prisontransportcell16";
	name = "Cell Lockdown";
	pixel_y = 10
	},
/turf/open/floor/iron/smooth_half,
/area/shuttle/prison_transport)
"jW" = (
/turf/open/floor/iron/shuttle/evac{
	icon_state = "floorsec2"
	},
/area/shuttle/prison_transport)
"kd" = (
/obj/machinery/suit_storage_unit/mining/eva,
/turf/open/floor/iron/smooth,
/area/shuttle/prison_transport)
"km" = (
/obj/machinery/door/airlock/command{
	name = "Cockpit";
	req_access = list("cent_general")
	},
/turf/open/floor/iron/dark/blue,
/area/shuttle/prison_transport)
"kW" = (
/obj/effect/turf_decal/trimline/brown/warning,
/obj/effect/turf_decal/skyrat_decals/departments/bridge,
/turf/open/floor/iron/smooth_half,
/area/shuttle/prison_transport)
"lu" = (
/obj/machinery/door/poddoor/shutters/window/preopen{
	id = "prisontransportcell14";
	name = "Lockdown"
	},
/obj/effect/turf_decal/loading_area/red{
	dir = 4
	},
/turf/open/floor/iron/smooth,
/area/shuttle/prison_transport)
"lF" = (
/obj/machinery/door/poddoor/shutters/window/preopen{
	id = "prisontransportcell3";
	name = "Lockdown"
	},
/obj/effect/turf_decal/loading_area/red{
	dir = 8
	},
/turf/open/floor/iron/smooth,
/area/shuttle/prison_transport)
"lW" = (
/obj/machinery/door/poddoor/shutters/preopen{
	id = "prisontransportlockdownc1"
	},
/obj/machinery/light/cold/no_nightlight/directional/east,
/obj/effect/turf_decal/trimline/brown/warning{
	dir = 8
	},
/turf/open/floor/iron/smooth_large,
/area/shuttle/prison_transport)
"mE" = (
/obj/effect/turf_decal/caution{
	dir = 1
	},
/turf/open/floor/iron/smooth,
/area/shuttle/prison_transport)
"mM" = (
/obj/effect/turf_decal/vg_decals/numbers/one,
/turf/open/floor/iron/smooth,
/area/shuttle/prison_transport)
"mU" = (
/obj/machinery/light/cold/no_nightlight/directional/west,
/obj/machinery/door/poddoor/shutters/preopen{
	id = "prisontransportlockdownc3"
	},
/obj/effect/turf_decal/trimline/brown/warning{
	dir = 4
	},
/turf/open/floor/iron/smooth_large,
/area/shuttle/prison_transport)
"oA" = (
/obj/machinery/door/airlock/external/glass{
	req_access = list("cent_general")
	},
/turf/open/floor/iron/smooth,
/area/shuttle/prison_transport)
"oD" = (
/obj/machinery/door/poddoor/shutters/window/preopen{
	id = "prisontransportcell1";
	name = "Lockdown"
	},
/obj/effect/turf_decal/loading_area/red{
	dir = 8
	},
/turf/open/floor/iron/smooth,
/area/shuttle/prison_transport)
"oQ" = (
/obj/structure/shuttle/engine/propulsion/left,
/obj/effect/turf_decal/stripes/full,
/turf/open/floor/plating,
/area/shuttle/prison_transport)
"py" = (
/obj/machinery/door/poddoor/shutters/window/preopen{
	id = "prisontransportcell7";
	name = "Lockdown"
	},
/obj/effect/turf_decal/loading_area/red{
	dir = 8
	},
/turf/open/floor/iron/smooth,
/area/shuttle/prison_transport)
"pQ" = (
/obj/structure/sign/warning/vacuum,
/turf/closed/wall/mineral/titanium,
/area/shuttle/prison_transport)
"pY" = (
/obj/machinery/light/cold/no_nightlight/directional/east,
/obj/structure/chair/comfy/shuttle,
/turf/open/floor/iron/dark/blue/side{
	dir = 8
	},
/area/shuttle/prison_transport)
"qf" = (
/obj/effect/turf_decal/caution/stand_clear/red{
	dir = 8
	},
/obj/effect/turf_decal/bot_red,
/turf/open/floor/iron/smooth,
/area/shuttle/prison_transport)
"sf" = (
/obj/effect/turf_decal/caution/stand_clear/red{
	dir = 4
	},
/obj/effect/turf_decal/bot_red,
/turf/open/floor/iron/smooth,
/area/shuttle/prison_transport)
"sk" = (
/obj/machinery/door/poddoor/shutters/preopen{
	id = "prisontransportlockdownc1"
	},
/turf/open/floor/iron/smooth,
/area/shuttle/prison_transport)
"sQ" = (
/obj/effect/turf_decal/trimline/brown/warning{
	dir = 1
	},
/obj/effect/turf_decal/vg_decals/numbers/seven,
/turf/open/floor/iron/smooth_half,
/area/shuttle/prison_transport)
"to" = (
/obj/machinery/button/door/directional/east{
	id = "prisontransportlockdownc3";
	req_access = list("cent_general")
	},
/obj/effect/turf_decal/trimline/brown/warning{
	dir = 8
	},
/turf/open/floor/iron/smooth_large,
/area/shuttle/prison_transport)
"tY" = (
/obj/machinery/light/red/directional/west,
/obj/structure/tank_dispenser/oxygen,
/turf/open/floor/iron/smooth,
/area/shuttle/prison_transport)
"ua" = (
/obj/structure/table/reinforced,
/obj/item/paper/carbon,
/obj/item/pen,
/obj/effect/turf_decal/weather/dirt{
	dir = 6
	},
/turf/open/floor/iron/shuttle/evac{
	icon_state = "floorsec2"
	},
/area/shuttle/prison_transport)
"un" = (
/obj/effect/turf_decal/trimline/brown/warning,
/obj/machinery/button/door/directional/west{
	id = "prisontransportcell2";
	name = "Cell Lockdown";
	pixel_y = -10
	},
/obj/machinery/button/door/directional/west{
	id = "prisontransportcell1";
	name = "Cell Lockdown";
	pixel_y = 10
	},
/turf/open/floor/iron/smooth_half,
/area/shuttle/prison_transport)
"uI" = (
/obj/machinery/light/cold/no_nightlight/directional/west,
/obj/structure/rack/shelf,
/obj/item/shield/riot,
/obj/item/shield/riot,
/obj/item/shield/riot,
/obj/item/shield/riot,
/obj/item/melee/baton,
/obj/item/melee/baton,
/obj/item/melee/baton,
/obj/item/melee/baton,
/turf/open/floor/iron/dark,
/area/shuttle/prison_transport)
"uQ" = (
/obj/structure/sign/poster/official/no_erp{
	pixel_y = 32
	},
/obj/structure/table/reinforced,
/obj/item/reagent_containers/spray/cleaner,
/obj/item/reagent_containers/spray/cleaner,
/obj/item/reagent_containers/spray/cleaner,
/turf/open/floor/iron/smooth,
/area/shuttle/prison_transport)
"vj" = (
/obj/machinery/door/poddoor/shutters/window/preopen{
	id = "prisontransportcell15";
	name = "Lockdown"
	},
/obj/effect/turf_decal/loading_area/red{
	dir = 4
	},
/turf/open/floor/iron/smooth,
/area/shuttle/prison_transport)
"vk" = (
/obj/machinery/door/poddoor/shutters/window/preopen{
	id = "prisontransportcell5";
	name = "Lockdown"
	},
/obj/effect/turf_decal/loading_area/red{
	dir = 8
	},
/turf/open/floor/iron/smooth,
/area/shuttle/prison_transport)
"vA" = (
/obj/machinery/door/poddoor/shutters/window/preopen{
	id = "prisontransportcell12";
	name = "Lockdown"
	},
/obj/effect/turf_decal/loading_area/red{
	dir = 4
	},
/turf/open/floor/iron/smooth,
/area/shuttle/prison_transport)
"vP" = (
/turf/open/floor/iron/smooth_large,
/area/shuttle/prison_transport)
"xc" = (
/obj/machinery/light/cold/no_nightlight/directional/west,
/obj/machinery/door/poddoor/shutters/preopen{
	id = "prisontransportlockdownc2"
	},
/obj/effect/turf_decal/trimline/brown/warning{
	dir = 4
	},
/turf/open/floor/iron/smooth_large,
/area/shuttle/prison_transport)
"xG" = (
/obj/structure/toilet{
	dir = 8
	},
/obj/effect/turf_decal/weather/dirt{
	dir = 6
	},
/turf/open/floor/iron/shuttle/evac{
	icon_state = "floorsec2"
	},
/area/shuttle/prison_transport)
"yi" = (
/obj/effect/turf_decal/trimline/brown/warning{
	dir = 1
	},
/obj/effect/turf_decal/vg_decals/numbers/three,
/turf/open/floor/iron/smooth_half,
/area/shuttle/prison_transport)
"ym" = (
/obj/effect/turf_decal/caution,
/turf/open/floor/iron/smooth,
/area/shuttle/prison_transport)
"zq" = (
/obj/machinery/door/poddoor/shutters/preopen{
	id = "prisontransportlockdownc2"
	},
/obj/machinery/light/cold/no_nightlight/directional/east,
/obj/effect/turf_decal/trimline/brown/warning{
	dir = 8
	},
/turf/open/floor/iron/smooth_large,
/area/shuttle/prison_transport)
"zF" = (
/obj/machinery/door/poddoor/shutters/window/preopen{
	id = "prisontransportcell9";
	name = "Lockdown"
	},
/obj/effect/turf_decal/loading_area/red{
	dir = 4
	},
/turf/open/floor/iron/smooth,
/area/shuttle/prison_transport)
"zK" = (
/obj/machinery/door/poddoor/shutters/preopen{
	id = "prisontransportlockdown"
	},
/turf/open/floor/iron/smooth,
/area/shuttle/prison_transport)
"Bf" = (
/obj/structure/sign/nanotrasen,
/turf/closed/wall/mineral/titanium/nodiagonal,
/area/shuttle/prison_transport)
"BN" = (
/obj/machinery/door/airlock/command/glass{
	name = "Connecting Tube";
	req_access = list("cent_general")
	},
/turf/open/floor/iron/smooth,
/area/shuttle/prison_transport)
"BQ" = (
/obj/machinery/door/poddoor/shutters/preopen{
	id = "prisontransportlockdownc3"
	},
/obj/effect/turf_decal/vg_decals/numbers/three,
/turf/open/floor/iron/smooth_large,
/area/shuttle/prison_transport)
"BX" = (
/obj/machinery/door/airlock/command{
	name = "Flight Deck";
	req_access = list("cent_general")
	},
/turf/open/floor/iron/dark/blue,
/area/shuttle/prison_transport)
"Ce" = (
/obj/machinery/door/poddoor/shutters/window/preopen{
	id = "prisontransportcell10";
	name = "Lockdown"
	},
/obj/effect/turf_decal/loading_area/red{
	dir = 4
	},
/turf/open/floor/iron/smooth,
/area/shuttle/prison_transport)
"CM" = (
/obj/machinery/button/door/directional/west{
	id = "prisontransportcell6";
	name = "Cell Lockdown";
	pixel_y = -10
	},
/obj/effect/turf_decal/trimline/brown/warning,
/obj/machinery/button/door/directional/west{
	id = "prisontransportcell5";
	name = "Cell Lockdown";
	pixel_y = 10
	},
/turf/open/floor/iron/smooth_half,
/area/shuttle/prison_transport)
"CS" = (
/obj/machinery/computer/shuttle/white_ship/bridge{
	name = "Flight Control"
	},
/turf/open/floor/iron/dark/blue/side,
/area/shuttle/prison_transport)
"Ds" = (
/obj/structure/chair/comfy/shuttle{
	dir = 1
	},
/turf/open/floor/iron/dark/blue,
/area/shuttle/prison_transport)
"DS" = (
/obj/effect/turf_decal/trimline/brown/warning,
/obj/machinery/light/cold/no_nightlight/directional/east,
/obj/machinery/button/door/directional/east{
	id = "prisontransportcell13";
	name = "Cell Lockdown";
	pixel_y = -10
	},
/obj/machinery/button/door/directional/east{
	id = "prisontransportcell14";
	name = "Cell Lockdown";
	pixel_y = 10
	},
/turf/open/floor/iron/smooth_half,
/area/shuttle/prison_transport)
"EZ" = (
/obj/machinery/door/poddoor/shutters/preopen{
	id = "prisontransportlockdownc2"
	},
/turf/open/floor/iron/smooth,
/area/shuttle/prison_transport)
"Fh" = (
/obj/machinery/door/airlock/external/glass{
	req_access = list("cent_general")
	},
/obj/machinery/door/poddoor/preopen{
	id = "prisontransportouter"
	},
/obj/docking_port/mobile{
	callTime = 250;
	dwidth = 10;
	height = 10;
	id = "prison_transport";
	launch_status = 0;
	movement_force = list("KNOCKDOWN" = 0, "THROW" = 0);
	name = "Prison Transporter NSS-74";
	preferred_direction = 4;
	width = 10
	},
/turf/open/floor/iron/dark/smooth_large,
/area/shuttle/prison_transport)
"Fj" = (
/obj/effect/spawner/structure/window/reinforced/shuttle,
/obj/machinery/door/poddoor/preopen{
	id = "prisontransportouter"
	},
/turf/open/floor/plating,
/area/shuttle/prison_transport)
"Fn" = (
/obj/machinery/computer/camera_advanced/shuttle_docker/whiteship{
	name = "Navigations"
	},
/turf/open/floor/iron/dark/blue/side,
/area/shuttle/prison_transport)
"Fv" = (
/obj/structure/chair/greyscale,
/obj/effect/turf_decal/weather/dirt{
	dir = 9
	},
/turf/open/floor/iron/shuttle/evac{
	icon_state = "floorsec2"
	},
/area/shuttle/prison_transport)
"Gf" = (
/obj/machinery/door/poddoor/shutters/window/preopen{
	id = "prisontransportcell6";
	name = "Lockdown"
	},
/obj/effect/turf_decal/loading_area/red{
	dir = 8
	},
/turf/open/floor/iron/smooth,
/area/shuttle/prison_transport)
"Gg" = (
/obj/machinery/light/red/directional/east,
/obj/machinery/suit_storage_unit/mining/eva,
/turf/open/floor/iron/smooth,
/area/shuttle/prison_transport)
"Gp" = (
/obj/machinery/light/cold/no_nightlight/directional/north,
/turf/open/floor/iron/smooth,
/area/shuttle/prison_transport)
"GF" = (
/obj/effect/turf_decal/trimline/brown/warning{
	dir = 1
	},
/obj/effect/turf_decal/vg_decals/numbers/eight,
/turf/open/floor/iron/smooth_half,
/area/shuttle/prison_transport)
"Hj" = (
/obj/structure/table/reinforced,
/obj/item/storage/box/handcuffs,
/obj/item/shield/riot,
/turf/open/floor/iron/smooth,
/area/shuttle/prison_transport)
"Ho" = (
/obj/machinery/door/poddoor/shutters/window/preopen{
	id = "prisontransportcell8";
	name = "Lockdown"
	},
/obj/effect/turf_decal/loading_area/red{
	dir = 8
	},
/turf/open/floor/iron/smooth,
/area/shuttle/prison_transport)
"HY" = (
/obj/structure/table/reinforced,
/obj/machinery/button/door{
	id = "prisontransportlockdown";
	name = "Interior Lockdown Shutters";
	pixel_x = -8;
	pixel_y = 8
	},
/obj/machinery/button/door{
	id = "prisontransportouter";
	name = "Exterior Blast Doors";
	pixel_x = 8;
	pixel_y = 8
	},
/turf/open/floor/iron/dark/blue/side,
/area/shuttle/prison_transport)
"IO" = (
/obj/effect/turf_decal/trimline/brown/warning{
	dir = 4
	},
/turf/open/floor/iron/smooth_large,
/area/shuttle/prison_transport)
"JK" = (
/obj/machinery/door/poddoor/shutters/window/preopen{
	id = "prisontransportcell2";
	name = "Lockdown"
	},
/obj/effect/turf_decal/loading_area/red{
	dir = 8
	},
/turf/open/floor/iron/smooth,
/area/shuttle/prison_transport)
"Kd" = (
/obj/structure/table/reinforced,
/obj/machinery/light/cold/no_nightlight/directional/north,
/obj/item/storage/box/handcuffs,
/turf/open/floor/iron/dark/blue/side{
	dir = 8
	},
/area/shuttle/prison_transport)
"Ke" = (
/obj/machinery/button/door/directional/east{
	id = "prisontransportlockdownc2";
	req_access = list("cent_general")
	},
/obj/effect/turf_decal/trimline/brown/warning{
	dir = 8
	},
/turf/open/floor/iron/smooth_large,
/area/shuttle/prison_transport)
"Nk" = (
/obj/effect/turf_decal/trimline/brown/warning{
	dir = 1
	},
/obj/effect/turf_decal/vg_decals/numbers/zero,
/turf/open/floor/iron/smooth_half,
/area/shuttle/prison_transport)
"NO" = (
/obj/effect/turf_decal/trimline/brown/warning,
/obj/machinery/light/cold/no_nightlight/directional/east,
/obj/machinery/button/door/directional/east{
	id = "prisontransportcell9";
	name = "Cell Lockdown";
	pixel_y = -10
	},
/obj/machinery/button/door/directional/east{
	id = "prisontransportcell10";
	name = "Cell Lockdown";
	pixel_y = 10
	},
/turf/open/floor/iron/smooth_half,
/area/shuttle/prison_transport)
"Or" = (
/obj/effect/turf_decal/trimline/brown/warning{
	dir = 1
	},
/obj/effect/turf_decal/vg_decals/numbers/four,
/turf/open/floor/iron/smooth_half,
/area/shuttle/prison_transport)
"Ot" = (
/obj/structure/tank_dispenser/oxygen,
/turf/open/floor/iron/smooth,
/area/shuttle/prison_transport)
"Pl" = (
/obj/effect/turf_decal/trimline/brown/warning{
	dir = 1
	},
/turf/open/floor/iron/smooth_half,
/area/shuttle/prison_transport)
"PP" = (
/obj/structure/bed/maint,
/obj/machinery/light/cold/no_nightlight/directional/north,
/turf/open/floor/iron/shuttle/evac{
	icon_state = "floorsec2"
	},
/area/shuttle/prison_transport)
"Qw" = (
/turf/closed/wall/mineral/titanium/nodiagonal,
/area/shuttle/prison_transport)
"Rb" = (
/obj/machinery/light/cold/no_nightlight/directional/south,
/obj/effect/turf_decal/trimline/brown/warning{
	dir = 1
	},
/turf/open/floor/iron/smooth_half,
/area/shuttle/prison_transport)
"Ri" = (
/obj/structure/table/reinforced,
/obj/item/paper/carbon,
/obj/item/pen,
/obj/effect/turf_decal/weather/dirt{
	dir = 10
	},
/turf/open/floor/iron/shuttle/evac{
	icon_state = "floorsec2"
	},
/area/shuttle/prison_transport)
"RA" = (
/obj/machinery/door/poddoor/shutters/preopen{
	id = "prisontransportlockdownc2"
	},
/obj/effect/turf_decal/vg_decals/numbers/two,
/turf/open/floor/iron/smooth_large,
/area/shuttle/prison_transport)
"RD" = (
/obj/machinery/light/cold/no_nightlight/directional/south,
/turf/open/floor/iron/smooth,
/area/shuttle/prison_transport)
"RP" = (
/obj/structure/mirror/directional/south,
/turf/open/floor/iron/smooth,
/area/shuttle/prison_transport)
"So" = (
/obj/structure/chair/comfy/shuttle,
/turf/open/floor/iron/smooth,
/area/shuttle/prison_transport)
"Sp" = (
/obj/structure/fence/door/opened{
	dir = 8
	},
/turf/open/floor/iron/dark/blue/side{
	dir = 4
	},
/area/shuttle/prison_transport)
"St" = (
/obj/effect/turf_decal/delivery,
/turf/open/floor/iron/smooth,
/area/shuttle/prison_transport)
"Su" = (
/obj/effect/turf_decal/trimline/brown/warning,
/obj/machinery/button/door/directional/west{
	id = "prisontransportcell4";
	name = "Cell Lockdown";
	pixel_y = -10
	},
/obj/machinery/button/door/directional/west{
	id = "prisontransportcell3";
	name = "Cell Lockdown";
	pixel_y = 10
	},
/turf/open/floor/iron/smooth_half,
/area/shuttle/prison_transport)
"SK" = (
/obj/structure/toilet{
	dir = 4
	},
/obj/effect/turf_decal/weather/dirt{
	dir = 10
	},
/turf/open/floor/iron/shuttle/evac{
	icon_state = "floorsec2"
	},
/area/shuttle/prison_transport)
"SQ" = (
/obj/effect/turf_decal/trimline/brown/warning{
	dir = 1
	},
/obj/effect/turf_decal/vg_decals/numbers/one,
/turf/open/floor/iron/smooth_half,
/area/shuttle/prison_transport)
"TH" = (
/obj/machinery/light/cold/no_nightlight/directional/north,
/obj/structure/chair/comfy/shuttle,
/turf/open/floor/iron/smooth,
/area/shuttle/prison_transport)
"Ut" = (
/obj/structure/table/reinforced,
/obj/machinery/button/door{
	id = "prisontransportlockdownc1";
	name = "Section 1 LOCKDOWN";
	pixel_y = -11
	},
/obj/machinery/button/door{
	id = "prisontransportlockdownc2";
	name = "Section 2 LOCKDOWN"
	},
/obj/machinery/button/door{
	id = "prisontransportlockdownc3";
	name = "Section 3 LOCKDOWN";
	pixel_y = 11
	},
/turf/open/floor/iron/dark/blue/side{
	dir = 8
	},
/area/shuttle/prison_transport)
"Uz" = (
/obj/structure/chair/comfy/shuttle,
/turf/open/floor/iron/dark/blue,
/area/shuttle/prison_transport)
"UC" = (
/obj/machinery/door/poddoor/preopen{
	id = "prisontransportouter"
	},
/obj/effect/spawner/structure/window/reinforced/shuttle,
/turf/open/floor/plating,
/area/shuttle/prison_transport)
"UG" = (
/obj/effect/spawner/structure/window/reinforced/shuttle,
/turf/open/floor/plating,
/area/shuttle/prison_transport)
"Ve" = (
/obj/machinery/door/poddoor/shutters/preopen{
	id = "prisontransportlockdownc3"
	},
/obj/machinery/light/cold/no_nightlight/directional/east,
/obj/effect/turf_decal/trimline/brown/warning{
	dir = 8
	},
/turf/open/floor/iron/smooth_large,
/area/shuttle/prison_transport)
"Wg" = (
/obj/machinery/shower{
	dir = 1
	},
/obj/structure/mirror/directional/south,
/obj/effect/turf_decal/weather/dirt,
/turf/open/floor/iron/shuttle/evac{
	icon_state = "floorsec2"
	},
/area/shuttle/prison_transport)
"Ws" = (
/obj/machinery/button/door/directional/east{
	id = "prisontransportlockdownc1";
	req_access = list("cent_general")
	},
/obj/effect/turf_decal/trimline/brown/warning{
	dir = 8
	},
/turf/open/floor/iron/smooth_large,
/area/shuttle/prison_transport)
"WA" = (
/obj/effect/turf_decal/trimline/brown/warning,
/obj/machinery/light/cold/no_nightlight/directional/west,
/turf/open/floor/iron/smooth_half,
/area/shuttle/prison_transport)
"Xk" = (
/obj/machinery/door/poddoor/shutters/preopen{
	id = "prisontransportlockdownc3"
	},
/turf/open/floor/iron/smooth,
/area/shuttle/prison_transport)
"Xm" = (
/obj/effect/turf_decal/stripes/full,
/obj/structure/shuttle/engine/propulsion/left,
/turf/open/floor/plating,
/area/shuttle/prison_transport)
"Xu" = (
/turf/open/floor/iron/smooth,
/area/shuttle/prison_transport)
"XB" = (
/turf/closed/wall/mineral/titanium,
/area/shuttle/prison_transport)
"Yw" = (
/obj/effect/turf_decal/trimline/brown/warning{
	dir = 1
	},
/obj/machinery/light/cold/no_nightlight/directional/south,
/turf/open/floor/iron/smooth_half,
/area/shuttle/prison_transport)
"ZT" = (
/obj/structure/sign/poster/official/report_crimes,
/turf/closed/wall/mineral/titanium,
/area/shuttle/prison_transport)

(1,1,1) = {"
ay
ay
ay
ay
ay
ay
ay
XB
Fj
Fj
dS
Fj
UC
XB
ay
ay
ay
XB
Fj
Fj
dS
Fj
Fj
XB
ay
ay
ay
XB
Fj
Fj
dS
Fj
Fj
XB
ay
ay
ay
XB
Fj
Fj
dS
Fj
Fj
XB
Fj
Fj
Qw
Xm
ay
ay
ay
"}
(2,1,1) = {"
ay
ay
ay
ay
ay
ay
ay
dS
Fv
Ri
XB
iz
Ri
Fj
ay
ay
ay
Fj
Fv
Ri
XB
Fv
Ri
Fj
ay
ay
ay
Fj
Fv
Ri
XB
Fv
Ri
Fj
ay
ay
ay
Fj
Fv
Ri
XB
Fv
Ri
XB
uQ
Xu
XB
oQ
ay
ay
ay
"}
(3,1,1) = {"
ay
ay
ay
ay
ay
ay
XB
XB
PP
gp
XB
PP
gp
XB
ay
ay
ay
XB
PP
gp
XB
PP
gp
XB
ay
ay
ay
XB
PP
gp
XB
PP
gp
XB
ay
ay
ay
XB
PP
gp
XB
PP
gp
XB
So
RP
XB
oQ
ay
ay
ay
"}
(4,1,1) = {"
ay
ay
ay
ay
ay
XB
Qw
XB
jW
xG
XB
jW
xG
XB
ay
ay
ay
XB
jW
xG
XB
jW
xG
XB
ay
ay
ay
XB
jW
xG
XB
jW
xG
XB
ay
ay
ay
XB
jW
xG
XB
jW
xG
XB
So
Xu
XB
Xm
ay
ay
ay
"}
(5,1,1) = {"
ay
XB
Fj
XB
Fj
Qw
Qw
Qw
oD
UG
Qw
JK
UG
Qw
XB
XB
XB
Qw
lF
UG
Qw
hd
UG
Qw
XB
XB
XB
Qw
vk
UG
Qw
Gf
UG
Qw
XB
XB
XB
Qw
py
UG
Qw
Ho
UG
Qw
XB
BN
Qw
XB
XB
XB
ay
"}
(6,1,1) = {"
XB
Qw
aI
XB
ho
uI
ZT
WA
sf
SQ
un
sf
jI
UG
IO
mU
IO
UG
sf
yi
Su
sf
Or
UG
IO
xc
IO
UG
sf
dz
CM
sf
ew
UG
IO
fK
IO
UG
sf
sQ
fE
sf
GF
UG
Xu
Pl
Qw
tY
Ot
Qw
Bf
"}
(7,1,1) = {"
UC
Fn
Ds
XB
Sp
Sp
XB
kW
Xu
Pl
hE
Xu
Pl
iH
Xu
Xk
Xu
iH
Xu
Xu
Xu
Xu
Xu
bR
Xu
EZ
Xu
bR
Xu
Xu
Xu
Xu
Xu
BN
Xu
sk
Xu
BN
Xu
Xu
Xu
Xu
Xu
iH
Xu
Pl
ZT
St
St
zK
pQ
"}
(8,1,1) = {"
Fj
HY
cz
km
cz
cz
BX
Xu
Xu
Xu
Xu
Xu
RD
XB
vP
BQ
vP
XB
Gp
Pl
hE
Xu
Rb
XB
vP
RA
vP
XB
Gp
Pl
hE
Xu
Rb
XB
vP
aD
vP
XB
Gp
Pl
hE
Xu
Yw
XB
Xu
ym
oA
mE
Xu
ab
Fh
"}
(9,1,1) = {"
Fj
CS
Ds
XB
Uz
Uz
XB
kW
Xu
SQ
hE
Xu
SQ
iH
Xu
Xk
Xu
iH
Xu
SQ
hE
Xu
SQ
bR
Xu
EZ
Xu
bR
Xu
mM
Xu
Xu
mM
BN
Xu
sk
Xu
BN
Xu
mM
Xu
Xu
Xu
iH
Xu
Pl
ZT
St
St
zK
XB
"}
(10,1,1) = {"
XB
Qw
Kd
XB
Ut
pY
ZT
hE
qf
ew
jQ
qf
dz
UG
to
Ve
to
UG
qf
Or
DS
qf
yi
UG
Ke
zq
Ke
UG
qf
jI
iX
qf
SQ
UG
Ws
lW
Ws
UG
qf
Nk
NO
qf
hD
UG
Xu
Pl
Qw
Gg
kd
Qw
Bf
"}
(11,1,1) = {"
ay
XB
Fj
XB
Fj
Qw
Qw
Qw
jN
UG
Qw
vj
UG
Qw
XB
XB
XB
Qw
lu
UG
Qw
iL
UG
Qw
XB
XB
XB
Qw
vA
UG
Qw
hC
UG
Qw
XB
XB
XB
Qw
Ce
UG
Qw
zF
UG
Qw
XB
BN
Qw
XB
XB
XB
ay
"}
(12,1,1) = {"
ay
ay
ay
ay
ay
XB
Qw
XB
jW
SK
XB
jW
SK
XB
ay
ay
ay
XB
jW
SK
XB
jW
SK
XB
ay
ay
ay
XB
jW
SK
XB
jW
SK
XB
ay
ay
ay
XB
jW
SK
XB
jW
SK
XB
So
Xu
XB
Xm
ay
ay
ay
"}
(13,1,1) = {"
ay
ay
ay
ay
ay
ay
XB
XB
PP
Wg
XB
PP
Wg
XB
ay
ay
ay
XB
PP
Wg
XB
PP
Wg
XB
ay
ay
ay
XB
PP
Wg
XB
PP
Wg
XB
ay
ay
ay
XB
PP
Wg
XB
PP
Wg
XB
TH
RP
XB
oQ
ay
ay
ay
"}
(14,1,1) = {"
ay
ay
ay
ay
ay
ay
ay
dS
jq
ua
XB
jq
ua
Fj
ay
ay
ay
Fj
jq
ua
XB
jq
ua
Fj
ay
ay
ay
Fj
jq
ua
XB
jq
ua
Fj
ay
ay
ay
Fj
jq
ua
XB
jq
ua
XB
Hj
Xu
XB
Xm
ay
ay
ay
"}
(15,1,1) = {"
ay
ay
ay
ay
ay
ay
ay
XB
Fj
Fj
dS
Fj
Fj
XB
ay
ay
ay
XB
Fj
Fj
dS
Fj
Fj
XB
ay
ay
ay
XB
Fj
Fj
dS
Fj
Fj
XB
ay
ay
ay
XB
Fj
Fj
dS
Fj
Fj
XB
Fj
Fj
Qw
Xm
ay
ay
ay
"}
