//MAP CONVERTED BY dmm2tgm.py THIS HEADER COMMENT PREVENTS RECONVERSION, DO NOT REMOVE
"aP" = (
/obj/machinery/atmospherics/components/unary/vent_scrubber/on/layer2{
	dir = 8
	},
/turf/open/floor/mineral/titanium,
/area/shuttle/tarkon_driver)
"bF" = (
/obj/machinery/light/dim/directional/east,
/obj/structure/table/reinforced,
/obj/effect/spawner/random/food_or_drink/snack,
/turf/open/floor/mineral/titanium,
/area/shuttle/tarkon_driver)
"cS" = (
/obj/machinery/door/airlock/titanium,
/obj/docking_port/mobile{
	name = "Tarkon Driver";
	port_direction = 2;
	preferred_direction = 8;
	shuttle_id = "tarkon_driver"
	},
/obj/structure/fans/tiny/invisible,
/obj/effect/mapping_helpers/airlock/access/all/tarkon/general,
/obj/structure/cable,
/turf/open/floor/mineral/titanium,
/area/shuttle/tarkon_driver)
"ef" = (
/turf/open/floor/iron/recharge_floor,
/area/shuttle/tarkon_driver)
"fg" = (
/obj/machinery/atmospherics/components/unary/vent_pump/on/layer4{
	dir = 4
	},
/turf/open/floor/mineral/titanium,
/area/shuttle/tarkon_driver)
"fy" = (
/obj/effect/spawner/structure/window/reinforced/shuttle,
/obj/machinery/door/poddoor{
	id = "driverwindows"
	},
/turf/open/floor/mineral/titanium,
/area/shuttle/tarkon_driver)
"fE" = (
/obj/machinery/light/dim/directional/west,
/obj/structure/table/reinforced,
/obj/item/clothing/mask/gas,
/turf/open/floor/mineral/titanium,
/area/shuttle/tarkon_driver)
"gu" = (
/obj/machinery/atmospherics/pipe/smart/manifold4w/supply/hidden/layer4,
/obj/machinery/atmospherics/pipe/smart/manifold4w/scrubbers/hidden/layer2,
/turf/open/floor/mineral/titanium,
/area/shuttle/tarkon_driver)
"hH" = (
/obj/machinery/atmospherics/pipe/smart/manifold4w/scrubbers/hidden/layer2,
/turf/closed/wall/mineral/titanium,
/area/shuttle/tarkon_driver)
"hW" = (
/obj/structure/chair/comfy/shuttle{
	dir = 8
	},
/turf/open/floor/mineral/titanium,
/area/shuttle/tarkon_driver)
"if" = (
/obj/machinery/door/airlock/titanium,
/obj/structure/fans/tiny/invisible,
/obj/effect/mapping_helpers/airlock/access/all/tarkon/general,
/obj/structure/cable,
/turf/open/floor/mineral/titanium,
/area/shuttle/tarkon_driver)
"ik" = (
/obj/structure/cable,
/obj/machinery/power/terminal{
	dir = 4
	},
/obj/machinery/portable_atmospherics/canister/air,
/obj/machinery/door/window/right/directional/south,
/obj/structure/window/reinforced/spawner/directional/east,
/turf/open/floor/mineral/titanium,
/area/shuttle/tarkon_driver)
"iF" = (
/obj/structure/cable,
/obj/machinery/atmospherics/pipe/smart/manifold4w/scrubbers/hidden/layer2,
/turf/open/floor/mineral/titanium,
/area/shuttle/tarkon_driver)
"jG" = (
/obj/structure/cable,
/obj/machinery/power/terminal{
	dir = 4
	},
/turf/open/floor/mineral/titanium,
/area/shuttle/tarkon_driver)
"nn" = (
/obj/structure/rack/shelf,
/obj/effect/spawner/random/medical/medkit,
/obj/effect/spawner/random/medical/medkit,
/obj/machinery/airalarm/directional/east,
/obj/effect/mapping_helpers/airalarm/all_access,
/turf/open/floor/mineral/titanium,
/area/shuttle/tarkon_driver)
"oz" = (
/obj/machinery/atmospherics/components/unary/vent_pump/on/layer4{
	dir = 1
	},
/obj/machinery/airalarm/directional/south,
/obj/effect/mapping_helpers/airalarm/all_access,
/turf/open/floor/mineral/titanium,
/area/shuttle/tarkon_driver)
"rr" = (
/obj/machinery/light/directional/north,
/obj/machinery/atmospherics/pipe/smart/manifold4w/supply/hidden/layer4,
/obj/machinery/atmospherics/pipe/smart/manifold4w/scrubbers/hidden/layer2,
/turf/open/floor/mineral/titanium,
/area/shuttle/tarkon_driver)
"st" = (
/obj/machinery/light/warm/directional/south,
/obj/machinery/atmospherics/components/unary/portables_connector/layer4{
	dir = 1
	},
/obj/machinery/portable_atmospherics/canister/air,
/turf/open/floor/mineral/titanium,
/area/shuttle/tarkon_driver)
"tx" = (
/obj/machinery/light/directional/west,
/turf/open/floor/mineral/titanium,
/area/shuttle/tarkon_driver)
"tV" = (
/turf/closed/wall/mineral/titanium/nodiagonal,
/area/shuttle/tarkon_driver)
"uk" = (
/obj/machinery/door/airlock/titanium,
/obj/effect/mapping_helpers/airlock/access/all/tarkon/general,
/obj/structure/fans/tiny/invisible,
/turf/open/floor/mineral/titanium,
/area/shuttle/tarkon_driver)
"zo" = (
/obj/machinery/atmospherics/pipe/smart/manifold4w/supply/hidden/layer4,
/turf/open/floor/mineral/titanium,
/area/shuttle/tarkon_driver)
"zL" = (
/obj/machinery/power/shuttle_engine/propulsion/burst,
/obj/machinery/atmospherics/components/unary/passive_vent/layer2{
	dir = 1
	},
/turf/open/floor/mineral/titanium,
/area/shuttle/tarkon_driver)
"Al" = (
/obj/machinery/computer/camera_advanced/shuttle_docker/tarkon_driver,
/turf/open/floor/mineral/titanium,
/area/shuttle/tarkon_driver)
"AX" = (
/obj/machinery/light/directional/north,
/obj/structure/tank_dispenser,
/turf/open/floor/mineral/titanium,
/area/shuttle/tarkon_driver)
"BH" = (
/obj/machinery/recharge_station,
/turf/open/floor/mineral/titanium,
/area/shuttle/tarkon_driver)
"Cf" = (
/obj/structure/rack/shelf,
/obj/item/flashlight/flare,
/obj/item/flashlight/flare,
/obj/item/flashlight/flare,
/obj/machinery/door/window/right/directional/west,
/turf/open/floor/mineral/titanium,
/area/shuttle/tarkon_driver)
"Cn" = (
/obj/structure/rack/shelf,
/obj/item/tank/internals/emergency_oxygen,
/obj/item/tank/internals/emergency_oxygen,
/obj/item/tank/internals/emergency_oxygen,
/obj/machinery/door/window/right/directional/west,
/turf/open/floor/mineral/titanium,
/area/shuttle/tarkon_driver)
"Cv" = (
/obj/machinery/power/shuttle_engine/propulsion/burst,
/turf/open/floor/mineral/titanium,
/area/shuttle/tarkon_driver)
"DF" = (
/obj/machinery/mech_bay_recharge_port{
	dir = 2
	},
/turf/open/floor/mineral/titanium,
/area/shuttle/tarkon_driver)
"Em" = (
/turf/template_noop,
/area/template_noop)
"Fi" = (
/obj/structure/window/reinforced/spawner/directional/south,
/obj/structure/table/reinforced,
/obj/item/tank/internals/emergency_oxygen/engi,
/obj/machinery/airalarm/directional/west,
/obj/effect/mapping_helpers/airalarm/all_access,
/turf/open/floor/mineral/titanium,
/area/shuttle/tarkon_driver)
"Fp" = (
/obj/structure/table/reinforced,
/obj/item/crowbar/red,
/turf/open/floor/mineral/titanium,
/area/shuttle/tarkon_driver)
"GN" = (
/obj/machinery/door/window/right/directional/south,
/obj/machinery/atmospherics/pipe/smart/manifold4w/supply/hidden/layer4,
/obj/machinery/atmospherics/components/unary/vent_scrubber/on/layer2,
/turf/open/floor/mineral/titanium,
/area/shuttle/tarkon_driver)
"GX" = (
/obj/machinery/light/directional/north,
/obj/structure/cable,
/obj/machinery/atmospherics/pipe/smart/manifold4w/supply/hidden/layer4,
/obj/machinery/portable_atmospherics/canister/air,
/obj/machinery/door/window/left/directional/south,
/obj/structure/window/reinforced/spawner/directional/west,
/turf/open/floor/mineral/titanium,
/area/shuttle/tarkon_driver)
"HI" = (
/obj/machinery/atmospherics/pipe/smart/manifold4w/scrubbers/hidden/layer2,
/obj/machinery/atmospherics/pipe/smart/manifold4w/supply/hidden/layer4,
/turf/open/floor/mineral/titanium,
/area/shuttle/tarkon_driver)
"HY" = (
/obj/machinery/door/airlock/titanium,
/obj/effect/mapping_helpers/airlock/access/all/tarkon/general,
/turf/open/floor/mineral/titanium,
/area/shuttle/tarkon_driver)
"Jo" = (
/obj/structure/table/reinforced,
/obj/machinery/light/warm/directional/south,
/obj/item/pickaxe/drill,
/turf/open/floor/mineral/titanium,
/area/shuttle/tarkon_driver)
"JF" = (
/turf/closed/wall/mineral/titanium,
/area/shuttle/tarkon_driver)
"JS" = (
/obj/structure/table/reinforced,
/obj/machinery/button/door{
	id = "driverwindows";
	name = "Blast Shield Control"
	},
/turf/open/floor/mineral/titanium,
/area/shuttle/tarkon_driver)
"JY" = (
/obj/machinery/computer/shuttle/tarkon_driver,
/turf/open/floor/mineral/titanium,
/area/shuttle/tarkon_driver)
"Kv" = (
/obj/machinery/atmospherics/components/unary/vent_scrubber/on/layer2,
/turf/open/floor/mineral/titanium,
/area/shuttle/tarkon_driver)
"LG" = (
/obj/machinery/atmospherics/components/unary/vent_scrubber/on/layer2{
	dir = 4
	},
/turf/open/floor/mineral/titanium,
/area/shuttle/tarkon_driver)
"Mh" = (
/obj/machinery/door/airlock/titanium,
/obj/effect/mapping_helpers/airlock/access/all/tarkon/general,
/obj/machinery/atmospherics/pipe/smart/manifold4w/supply/hidden/layer4,
/obj/machinery/atmospherics/pipe/smart/manifold4w/scrubbers/hidden/layer2,
/turf/open/floor/mineral/titanium,
/area/shuttle/tarkon_driver)
"Ow" = (
/obj/structure/cable,
/turf/open/floor/mineral/titanium,
/area/shuttle/tarkon_driver)
"OJ" = (
/obj/machinery/suit_storage_unit/industrial,
/turf/open/floor/mineral/titanium,
/area/shuttle/tarkon_driver)
"Pn" = (
/obj/machinery/power/smes/engineering,
/obj/structure/cable,
/turf/open/floor/mineral/titanium,
/area/shuttle/tarkon_driver)
"Qe" = (
/obj/structure/rack/shelf,
/obj/effect/spawner/random/engineering/material,
/obj/effect/spawner/random/engineering/material,
/turf/open/floor/mineral/titanium,
/area/shuttle/tarkon_driver)
"Rg" = (
/turf/open/floor/mineral/titanium,
/area/shuttle/tarkon_driver)
"Rn" = (
/obj/machinery/atmospherics/pipe/smart/manifold4w/supply/hidden/layer4,
/obj/machinery/atmospherics/pipe/smart/manifold4w/scrubbers/hidden/layer2,
/obj/machinery/airalarm/directional/north,
/obj/effect/mapping_helpers/airalarm/all_access,
/turf/open/floor/mineral/titanium,
/area/shuttle/tarkon_driver)
"Sd" = (
/obj/structure/cable,
/obj/machinery/atmospherics/components/unary/vent_pump/on/layer4{
	dir = 1
	},
/turf/open/floor/mineral/titanium,
/area/shuttle/tarkon_driver)
"St" = (
/obj/structure/closet/crate/internals,
/obj/item/clothing/head/helmet/space/eva,
/obj/item/clothing/mask/breath,
/obj/item/clothing/suit/space/eva,
/obj/item/tank/internals/oxygen,
/obj/item/tank/internals/oxygen,
/obj/item/clothing/suit/space/eva,
/obj/item/clothing/head/helmet/space/eva,
/obj/item/clothing/mask/breath,
/obj/machinery/door/window/right/directional/east,
/turf/open/floor/mineral/titanium,
/area/shuttle/tarkon_driver)
"Tp" = (
/obj/structure/rack/shelf,
/obj/item/oxygen_candle,
/obj/item/oxygen_candle,
/obj/item/oxygen_candle,
/obj/machinery/door/window/right/directional/west,
/turf/open/floor/mineral/titanium,
/area/shuttle/tarkon_driver)
"TS" = (
/obj/structure/chair/comfy/shuttle{
	dir = 4
	},
/turf/open/floor/mineral/titanium,
/area/shuttle/tarkon_driver)
"Ue" = (
/obj/structure/window/reinforced/spawner/directional/south,
/obj/structure/table/reinforced,
/obj/effect/spawner/random/food_or_drink/snack,
/turf/open/floor/mineral/titanium,
/area/shuttle/tarkon_driver)
"Ut" = (
/obj/machinery/light/directional/east,
/obj/machinery/airalarm/directional/east,
/obj/effect/mapping_helpers/airalarm/all_access,
/turf/open/floor/mineral/titanium,
/area/shuttle/tarkon_driver)
"Uu" = (
/obj/machinery/door/airlock/titanium/glass,
/obj/effect/mapping_helpers/airlock/access/all/tarkon/general,
/obj/machinery/atmospherics/pipe/smart/manifold4w/supply/hidden/layer4,
/obj/machinery/atmospherics/pipe/smart/manifold4w/scrubbers/hidden/layer2,
/turf/open/floor/mineral/titanium,
/area/shuttle/tarkon_driver)
"Vp" = (
/obj/machinery/atmospherics/pipe/smart/manifold4w/supply/hidden/layer4,
/obj/machinery/atmospherics/pipe/smart/manifold4w/scrubbers/hidden/layer2,
/obj/machinery/computer/mech_bay_power_console{
	dir = 4
	},
/turf/open/floor/mineral/titanium,
/area/shuttle/tarkon_driver)
"Vt" = (
/obj/machinery/power/apc/auto_name/directional/east,
/obj/structure/cable,
/obj/effect/mapping_helpers/apc/full_charge,
/obj/effect/mapping_helpers/apc/unlocked,
/obj/structure/table/reinforced,
/obj/item/storage/toolbox/emergency,
/turf/open/floor/mineral/titanium,
/area/shuttle/tarkon_driver)
"Ww" = (
/obj/structure/rack/shelf,
/obj/effect/spawner/random/maintenance/three,
/obj/machinery/light/directional/north,
/turf/open/floor/mineral/titanium,
/area/shuttle/tarkon_driver)
"Xb" = (
/obj/machinery/atmospherics/components/unary/vent_pump/on/layer4{
	dir = 1
	},
/turf/open/floor/mineral/titanium,
/area/shuttle/tarkon_driver)
"XN" = (
/obj/machinery/atmospherics/pipe/smart/manifold4w/scrubbers/hidden/layer2,
/turf/open/floor/mineral/titanium,
/area/shuttle/tarkon_driver)
"Ye" = (
/obj/machinery/door/window/left/directional/south,
/obj/machinery/atmospherics/components/unary/vent_pump/on/layer4{
	dir = 8
	},
/turf/open/floor/mineral/titanium,
/area/shuttle/tarkon_driver)
"Zm" = (
/obj/structure/chair/comfy/shuttle{
	dir = 1
	},
/turf/open/floor/mineral/titanium,
/area/shuttle/tarkon_driver)
"Zo" = (
/obj/machinery/power/shuttle_engine/propulsion/burst{
	dir = 1
	},
/turf/open/floor/mineral/titanium,
/area/shuttle/tarkon_driver)

(1,1,1) = {"
Zo
JF
JF
JF
JF
JF
JF
Em
Em
Zo
JF
JF
JF
JF
JF
JF
"}
(2,1,1) = {"
Em
Zo
JF
AX
OJ
OJ
JF
fy
fy
JF
tV
DF
ef
BH
JF
Cv
"}
(3,1,1) = {"
Em
Em
uk
Kv
gu
oz
JF
St
St
St
tV
Vp
gu
gu
hH
zL
"}
(4,1,1) = {"
JF
fy
tV
JF
Uu
JF
tV
TS
TS
TS
JF
rr
Xb
HI
tV
JF
"}
(5,1,1) = {"
fy
JS
fE
Fi
gu
LG
tx
Rg
fg
Rg
JF
Rn
Kv
gu
st
JF
"}
(6,1,1) = {"
fy
Al
Zm
GN
gu
gu
gu
gu
gu
gu
Mh
gu
Rg
XN
Rg
if
"}
(7,1,1) = {"
fy
JY
Zm
Ye
gu
Rg
Rg
Rg
XN
Rg
HY
zo
Rg
iF
Ow
cS
"}
(8,1,1) = {"
fy
Fp
bF
Ue
gu
Xb
Ut
Rg
aP
Rg
JF
zo
Kv
iF
Jo
JF
"}
(9,1,1) = {"
JF
fy
tV
JF
Uu
JF
tV
hW
hW
hW
JF
GX
Sd
Ow
tV
JF
"}
(10,1,1) = {"
Em
Em
uk
Kv
gu
Xb
JF
Tp
Cf
Cn
tV
ik
Rg
jG
JF
Cv
"}
(11,1,1) = {"
Em
Zo
JF
Ww
Qe
nn
JF
fy
fy
JF
tV
Pn
Vt
Pn
JF
Cv
"}
(12,1,1) = {"
Zo
JF
JF
JF
JF
JF
JF
Em
Em
Zo
JF
JF
JF
JF
JF
JF
"}
