//MAP CONVERTED BY dmm2tgm.py THIS HEADER COMMENT PREVENTS RECONVERSION, DO NOT REMOVE
"bY" = (
/obj/effect/spawner/random/trash/mess,
/turf/open/floor/mineral/titanium,
/area/shuttle/blackmarket_chevvy)
"eu" = (
/obj/structure/table,
/turf/open/floor/iron,
/area/shuttle/blackmarket_chevvy)
"fh" = (
/turf/open/floor/mineral/titanium,
/area/shuttle/blackmarket_chevvy)
"fp" = (
/turf/closed/wall/mineral/titanium,
/area/shuttle/blackmarket_chevvy)
"iG" = (
/obj/structure/chair/comfy/shuttle{
	dir = 4
	},
/turf/open/floor/plating,
/area/shuttle/blackmarket_chevvy)
"kT" = (
/obj/effect/turf_decal/siding/brown{
	dir = 1
	},
/obj/effect/decal/cleanable/dirt/dust,
/turf/open/floor/mineral/titanium,
/area/shuttle/blackmarket_chevvy)
"qx" = (
/obj/effect/decal/cleanable/dirt/dust,
/turf/open/floor/plating,
/area/shuttle/blackmarket_chevvy)
"rw" = (
/obj/machinery/door/window{
	req_access_txt = "208"
	},
/obj/effect/decal/cleanable/dirt/dust,
/turf/open/floor/plating,
/area/shuttle/blackmarket_chevvy)
"sU" = (
/obj/structure/chair/comfy/shuttle{
	dir = 4
	},
/obj/effect/decal/cleanable/dirt/dust,
/turf/open/floor/mineral/titanium,
/area/shuttle/blackmarket_chevvy)
"ts" = (
/obj/effect/decal/cleanable/dirt/dust,
/turf/open/floor/mineral/titanium,
/area/shuttle/blackmarket_chevvy)
"uW" = (
/obj/effect/turf_decal/siding/brown{
	dir = 1
	},
/turf/open/floor/mineral/titanium,
/area/shuttle/blackmarket_chevvy)
"vD" = (
/obj/structure/shuttle/engine/propulsion/burst{
	dir = 4
	},
/turf/closed/wall/mineral/titanium,
/area/shuttle/blackmarket_chevvy)
"vK" = (
/obj/structure/chair/comfy/shuttle{
	dir = 4
	},
/turf/open/floor/mineral/titanium,
/area/shuttle/blackmarket_chevvy)
"wV" = (
/obj/docking_port/mobile{
	callTime = 50;
	dir = 4;
	dwidth = 4;
	height = 5;
	id = "blackmarket_chevvy";
	ignitionTime = 25;
	name = "Chevvy";
	port_direction = 2;
	preferred_direction = 4;
	width = 9
	},
/obj/machinery/door/airlock/external,
/turf/open/floor/plating,
/area/shuttle/blackmarket_chevvy)
"Dx" = (
/turf/open/floor/plating,
/area/shuttle/blackmarket_chevvy)
"GO" = (
/obj/structure/window/reinforced/spawner,
/obj/machinery/computer/shuttle/caravan/blackmarket_chevvy{
	dir = 8
	},
/turf/open/floor/plating,
/area/shuttle/blackmarket_chevvy)
"Jv" = (
/obj/structure/shuttle/engine/propulsion/burst{
	dir = 8
	},
/turf/closed/wall/mineral/titanium,
/area/shuttle/blackmarket_chevvy)
"Ov" = (
/obj/structure/chair/comfy/shuttle{
	dir = 4
	},
/obj/structure/window/reinforced/spawner,
/obj/effect/decal/cleanable/dirt/dust,
/turf/open/floor/iron,
/area/shuttle/blackmarket_chevvy)
"OR" = (
/obj/structure/chair/comfy/shuttle{
	dir = 8
	},
/obj/effect/decal/cleanable/dirt/dust,
/turf/open/floor/mineral/titanium,
/area/shuttle/blackmarket_chevvy)
"Tk" = (
/obj/machinery/computer/camera_advanced/shuttle_docker/blackmarket_chevvy{
	dir = 8
	},
/turf/open/floor/iron,
/area/shuttle/blackmarket_chevvy)
"Vy" = (
/obj/machinery/light{
	dir = 4
	},
/obj/effect/decal/cleanable/dirt/dust,
/turf/open/floor/mineral/titanium,
/area/shuttle/blackmarket_chevvy)
"YP" = (
/obj/structure/table,
/obj/effect/decal/cleanable/dirt/dust,
/turf/open/floor/iron,
/area/shuttle/blackmarket_chevvy)
"YX" = (
/obj/effect/spawner/structure/window/reinforced/shuttle,
/turf/open/floor/plating,
/area/shuttle/blackmarket_chevvy)

(1,1,1) = {"
Jv
fp
fp
YX
wV
YX
fp
fp
Jv
"}
(2,1,1) = {"
fp
YP
rw
uW
fh
iG
vK
sU
fp
"}
(3,1,1) = {"
YX
eu
Ov
kT
qx
bY
Dx
ts
YX
"}
(4,1,1) = {"
fp
Tk
GO
uW
Vy
OR
OR
OR
fp
"}
(5,1,1) = {"
vD
YX
YX
YX
fp
YX
YX
YX
vD
"}
