//MAP CONVERTED BY dmm2tgm.py THIS HEADER COMMENT PREVENTS RECONVERSION, DO NOT REMOVE
"a" = (
/obj/effect/turf_decal/siding/dark/corner{
	dir = 1
	},
/turf/closed/wall/r_wall/syndicate/nodiagonal,
/area/shuttle/interdyne_cargo)
"d" = (
/turf/closed/wall/r_wall/syndicate/cruiser,
/area/shuttle/interdyne_cargo)
"e" = (
/obj/effect/turf_decal/loading_area,
/turf/open/floor/iron/dark/textured_large,
/area/shuttle/interdyne_cargo)
"f" = (
/obj/structure/frame/machine{
	anchored = 1;
	state = 2;
	icon_state = "box_1"
	},
/obj/item/circuitboard/machine/ore_redemption,
/obj/item/assembly/igniter,
/obj/effect/turf_decal/delivery,
/obj/machinery/light/red/directional/west,
/obj/machinery/button/door/directional/west{
	req_access = list("syndicate");
	id = "interdyneshuttle"
	},
/turf/open/floor/iron/dark/textured_large,
/area/shuttle/interdyne_cargo)
"g" = (
/obj/effect/spawner/structure/window/reinforced/plasma/plastitanium,
/turf/open/floor/plating,
/area/shuttle/interdyne_cargo)
"h" = (
/turf/open/floor/iron/dark/textured_large,
/area/shuttle/interdyne_cargo)
"i" = (
/obj/machinery/light/small/red/directional/south,
/obj/structure/frame/machine{
	anchored = 1;
	state = 2;
	icon_state = "box_1"
	},
/obj/item/circuitboard/machine/ore_silo,
/obj/effect/turf_decal/delivery,
/turf/open/floor/iron/dark/textured_large,
/area/shuttle/interdyne_cargo)
"k" = (
/obj/structure/fans/tiny/forcefield{
	dir = 4
	},
/obj/effect/turf_decal/stripes/line{
	dir = 8
	},
/obj/effect/turf_decal/stripes/line{
	dir = 4
	},
/obj/machinery/door/poddoor/preopen{
	id = "interdyneshuttle"
	},
/turf/open/floor/plating,
/area/shuttle/interdyne_cargo)
"v" = (
/obj/machinery/porta_turret/syndicate/energy{
	dir = 4
	},
/turf/closed/wall/r_wall/syndicate/cruiser,
/area/shuttle/interdyne_cargo)
"w" = (
/obj/machinery/power/shuttle_engine/heater{
	dir = 8
	},
/obj/effect/turf_decal/stripes/line{
	dir = 5
	},
/obj/structure/window/reinforced/survival_pod/spawner/directional/east,
/obj/structure/window/reinforced/survival_pod/spawner/directional/north,
/obj/structure/window/reinforced/survival_pod{
	dir = 5
	},
/turf/open/floor/plating/airless,
/area/shuttle/interdyne_cargo)
"y" = (
/turf/closed/wall/r_wall/syndicate/nodiagonal,
/area/shuttle/interdyne_cargo)
"z" = (
/turf/open/floor/catwalk_floor/iron_dark,
/area/shuttle/interdyne_cargo)
"B" = (
/obj/machinery/power/shuttle_engine/propulsion/right{
	dir = 8
	},
/obj/effect/turf_decal/stripes/line,
/obj/structure/fans/tiny,
/obj/structure/window/reinforced/survival_pod/spawner/directional/south,
/turf/open/floor/plating/airless,
/area/shuttle/interdyne_cargo)
"D" = (
/obj/machinery/power/shuttle_engine/heater{
	dir = 8
	},
/obj/structure/window/reinforced/survival_pod/spawner/directional/east,
/obj/effect/turf_decal/stripes/line{
	dir = 6
	},
/obj/structure/window/reinforced/survival_pod/spawner/directional/south,
/obj/structure/window/reinforced/survival_pod{
	dir = 6
	},
/turf/open/floor/plating/airless,
/area/shuttle/interdyne_cargo)
"G" = (
/obj/structure/fluff/metalpole/end{
	dir = 4;
	pixel_x = 32
	},
/obj/structure/fluff/metalpole/end{
	dir = 4;
	pixel_x = 12
	},
/turf/closed/wall/r_wall/syndicate/cruiser,
/area/shuttle/interdyne_cargo)
"H" = (
/obj/structure/closet/crate/eva,
/obj/effect/turf_decal/delivery,
/turf/open/floor/iron/dark/textured_large,
/area/shuttle/interdyne_cargo)
"L" = (
/obj/effect/turf_decal/stripes/line{
	dir = 8
	},
/obj/effect/turf_decal/stripes/line{
	dir = 4
	},
/obj/effect/mapping_helpers/airlock/access/all/syndicate/general,
/obj/effect/mapping_helpers/airlock/cutaiwire,
/obj/structure/fans/tiny,
/obj/machinery/door/airlock/external/glass{
	name = "External Access"
	},
/obj/docking_port/mobile{
	dir = 4;
	shuttle_id = "interdyne_cargo";
	launch_status = 0;
	name = "Interdyne Cargo Shuttle";
	port_direction = 2;
	preferred_direction = 4
	},
/turf/open/floor/catwalk_floor/iron_dark,
/area/shuttle/interdyne_cargo)
"M" = (
/obj/machinery/light/small/red/directional/north,
/obj/machinery/computer/shuttle/interdyne_cargo{
	icon_screen = "syndishuttle";
	icon_keyboard = "syndie_key";
	dir = 8
	},
/turf/open/floor/iron/dark/textured_large,
/area/shuttle/interdyne_cargo)
"N" = (
/turf/template_noop,
/area/template_noop)
"O" = (
/obj/structure/chair/comfy/shuttle{
	dir = 4
	},
/turf/open/floor/iron/dark/textured_large,
/area/shuttle/interdyne_cargo)
"Q" = (
/turf/closed/wall/mineral/titanium/spaceship/nodiagonal,
/area/shuttle/interdyne_cargo)
"V" = (
/obj/effect/spawner/structure/window/survival_pod,
/turf/open/floor/plating,
/area/shuttle/interdyne_cargo)
"X" = (
/obj/machinery/power/shuttle_engine/propulsion/left{
	dir = 8
	},
/obj/effect/turf_decal/stripes/line{
	dir = 1
	},
/obj/structure/fans/tiny,
/obj/structure/window/reinforced/survival_pod/spawner/directional/north,
/turf/open/floor/plating/airless,
/area/shuttle/interdyne_cargo)
"Y" = (
/obj/structure/chair/comfy/shuttle{
	dir = 8
	},
/turf/open/floor/iron/dark/textured_large,
/area/shuttle/interdyne_cargo)
"Z" = (
/obj/effect/turf_decal/siding/dark/corner{
	dir = 8
	},
/turf/closed/wall/r_wall/syndicate/nodiagonal,
/area/shuttle/interdyne_cargo)

(1,1,1) = {"
Q
B
L
V
Q
k
k
X
Q
"}
(2,1,1) = {"
Q
D
h
e
f
z
z
w
Q
"}
(3,1,1) = {"
y
O
h
z
z
z
z
H
y
"}
(4,1,1) = {"
y
M
h
z
z
z
z
i
y
"}
(5,1,1) = {"
d
Z
Y
Y
Y
z
z
a
d
"}
(6,1,1) = {"
N
G
g
g
v
g
g
G
N
"}
