//MAP CONVERTED BY dmm2tgm.py THIS HEADER COMMENT PREVENTS RECONVERSION, DO NOT REMOVE
"bu" = (
/obj/machinery/atmospherics/components/unary/vent_pump/on/layer4{
	dir = 8
	},
/turf/open/floor/iron/shuttle/cargo,
/area/shuttle/blackmarket_chevvy)
"cL" = (
/obj/effect/turf_decal/tile/neutral{
	dir = 1
	},
/obj/effect/turf_decal/tile/neutral{
	dir = 4
	},
/obj/effect/turf_decal/tile/neutral{
	dir = 8
	},
/obj/effect/turf_decal/tile/neutral,
/obj/effect/turf_decal/siding/thinplating/dark{
	dir = 4
	},
/turf/open/floor/iron/dark,
/area/shuttle/blackmarket_chevvy)
"en" = (
/obj/structure/chair/comfy/shuttle{
	dir = 4
	},
/turf/open/floor/iron/shuttle/cargo,
/area/shuttle/blackmarket_chevvy)
"eu" = (
/obj/effect/spawner/structure/window/reinforced/shuttle,
/turf/open/floor/plating,
/area/shuttle/blackmarket_chevvy)
"fp" = (
/turf/closed/wall/mineral/titanium,
/area/shuttle/blackmarket_chevvy)
"gt" = (
/obj/structure/chair/comfy/shuttle{
	dir = 8
	},
/obj/effect/turf_decal/bot_white,
/obj/structure/extinguisher_cabinet/directional/east,
/turf/open/floor/iron/dark/smooth_large,
/area/shuttle/blackmarket_chevvy)
"jD" = (
/obj/effect/turf_decal/bot_white,
/obj/structure/chair/comfy/shuttle{
	dir = 8
	},
/turf/open/floor/iron/dark/smooth_large,
/area/shuttle/blackmarket_chevvy)
"nB" = (
/obj/machinery/atmospherics/pipe/smart/manifold4w/supply/hidden/layer4,
/obj/machinery/airalarm/directional/north,
/obj/machinery/light/cold/directional/north,
/turf/open/floor/iron/shuttle/cargo,
/area/shuttle/blackmarket_chevvy)
"uW" = (
/turf/closed/wall/mineral/plastitanium/nodiagonal,
/area/shuttle/blackmarket_chevvy)
"vK" = (
/obj/structure/shuttle/engine/propulsion/burst{
	dir = 8
	},
/obj/effect/turf_decal/stripes/line{
	dir = 8
	},
/turf/open/floor/plating/airless,
/area/shuttle/blackmarket_chevvy)
"wE" = (
/obj/effect/turf_decal/tile/neutral{
	dir = 1
	},
/obj/effect/turf_decal/tile/neutral{
	dir = 4
	},
/obj/effect/turf_decal/tile/neutral{
	dir = 8
	},
/obj/effect/turf_decal/tile/neutral,
/obj/effect/turf_decal/siding/thinplating/dark{
	dir = 5
	},
/turf/open/floor/iron/dark,
/area/shuttle/blackmarket_chevvy)
"zH" = (
/obj/machinery/atmospherics/components/unary/vent_pump/on/layer4{
	dir = 1
	},
/turf/open/floor/iron/shuttle/cargo,
/area/shuttle/blackmarket_chevvy)
"Dx" = (
/obj/structure/shuttle/engine/heater{
	dir = 8
	},
/obj/effect/spawner/structure/window/reinforced/plasma/plastitanium,
/turf/open/floor/plating,
/area/shuttle/blackmarket_chevvy)
"Fr" = (
/obj/effect/turf_decal/tile/neutral{
	dir = 1
	},
/obj/effect/turf_decal/tile/neutral{
	dir = 4
	},
/obj/effect/turf_decal/tile/neutral{
	dir = 8
	},
/obj/effect/turf_decal/tile/neutral,
/obj/effect/turf_decal/siding/thinplating/dark{
	dir = 10
	},
/turf/open/floor/iron/dark,
/area/shuttle/blackmarket_chevvy)
"Fu" = (
/obj/machinery/computer/shuttle/caravan/blackmarket_chevvy,
/obj/effect/turf_decal/bot_white,
/turf/open/floor/iron/dark/smooth_large,
/area/shuttle/blackmarket_chevvy)
"GO" = (
/turf/closed/wall/mineral/titanium/spaceship/nodiagonal,
/area/shuttle/blackmarket_chevvy)
"Ii" = (
/obj/effect/turf_decal/bot_white,
/obj/machinery/button/door/directional/west{
	id = "skiffext";
	name = "External Airlock Bolt Control";
	normaldoorcontrol = 1;
	specialfunctions = 4
	},
/obj/machinery/light/cold/directional/south,
/obj/structure/tank_holder/oxygen/yellow,
/turf/open/floor/iron/dark/smooth_large,
/area/shuttle/blackmarket_chevvy)
"Ov" = (
/turf/template_noop,
/area/template_noop)
"OR" = (
/obj/effect/turf_decal/tile/neutral{
	dir = 1
	},
/obj/effect/turf_decal/tile/neutral{
	dir = 4
	},
/obj/effect/turf_decal/tile/neutral{
	dir = 8
	},
/obj/effect/turf_decal/tile/neutral,
/obj/effect/turf_decal/siding/thinplating/dark{
	dir = 8
	},
/turf/open/floor/iron/dark,
/area/shuttle/blackmarket_chevvy)
"PY" = (
/obj/machinery/modular_computer/console/preset/civilian{
	dir = 8
	},
/obj/effect/turf_decal/bot_white,
/turf/open/floor/iron/dark/smooth_large,
/area/shuttle/blackmarket_chevvy)
"Tk" = (
/obj/structure/rack/shelf,
/obj/item/storage/medkit/emergency,
/obj/item/crowbar/red,
/obj/effect/turf_decal/bot_white,
/turf/open/floor/iron/dark/smooth_large,
/area/shuttle/blackmarket_chevvy)
"Vy" = (
/obj/effect/turf_decal/tile/neutral{
	dir = 1
	},
/obj/effect/turf_decal/tile/neutral{
	dir = 4
	},
/obj/effect/turf_decal/tile/neutral{
	dir = 8
	},
/obj/effect/turf_decal/tile/neutral,
/obj/effect/turf_decal/siding/thinplating/dark{
	dir = 9
	},
/turf/open/floor/iron/dark,
/area/shuttle/blackmarket_chevvy)
"VX" = (
/obj/effect/turf_decal/tile/neutral{
	dir = 1
	},
/obj/effect/turf_decal/tile/neutral{
	dir = 4
	},
/obj/effect/turf_decal/tile/neutral{
	dir = 8
	},
/obj/effect/turf_decal/tile/neutral,
/obj/effect/turf_decal/siding/thinplating/dark{
	dir = 6
	},
/turf/open/floor/iron/dark,
/area/shuttle/blackmarket_chevvy)
"Yg" = (
/obj/machinery/atmospherics/pipe/smart/manifold4w/supply/hidden/layer4,
/turf/open/floor/iron/shuttle/cargo,
/area/shuttle/blackmarket_chevvy)
"YP" = (
/obj/machinery/atmospherics/components/unary/portables_connector/visible,
/obj/machinery/portable_atmospherics/canister/oxygen,
/obj/effect/turf_decal/bot_white,
/turf/open/floor/iron/dark/smooth_large,
/area/shuttle/blackmarket_chevvy)
"YX" = (
/turf/closed/wall/mineral/titanium/nodiagonal,
/area/shuttle/blackmarket_chevvy)
"ZC" = (
/obj/structure/chair/comfy/shuttle{
	dir = 8
	},
/obj/effect/turf_decal/bot_white,
/turf/open/floor/iron/dark/smooth_large,
/area/shuttle/blackmarket_chevvy)
"ZE" = (
/obj/machinery/computer/camera_advanced/shuttle_docker/blackmarket_chevvy,
/obj/effect/turf_decal/bot_white,
/turf/open/floor/iron/dark/smooth_large,
/area/shuttle/blackmarket_chevvy)
"ZW" = (
/obj/docking_port/mobile{
	dwidth = 5;
	height = 7;
	id = "blackmarket_chevvy";
	launch_status = 0;
	name = "Chevvy";
	port_direction = 8;
	preferred_direction = 4;
	width = 11
	},
/obj/machinery/door/airlock/external{
	id_tag = "skiffext"
	},
/obj/effect/turf_decal/delivery/white,
/turf/open/floor/iron/dark/textured_large,
/area/shuttle/blackmarket_chevvy)

(1,1,1) = {"
Ov
GO
Ov
Ov
Ov
GO
Ov
"}
(2,1,1) = {"
Ov
uW
vK
vK
vK
uW
Ov
"}
(3,1,1) = {"
Ov
uW
Dx
Dx
Dx
uW
Ov
"}
(4,1,1) = {"
fp
YX
Vy
OR
Fr
YX
fp
"}
(5,1,1) = {"
YX
Tk
wE
cL
VX
Ii
YX
"}
(6,1,1) = {"
YX
YP
Yg
Yg
Yg
zH
ZW
"}
(7,1,1) = {"
YX
YX
nB
ZC
gt
jD
YX
"}
(8,1,1) = {"
eu
ZE
bu
YX
YX
YX
YX
"}
(9,1,1) = {"
eu
Fu
en
eu
Ov
YX
fp
"}
(10,1,1) = {"
fp
YX
PY
eu
Ov
Ov
Ov
"}
(11,1,1) = {"
Ov
YX
eu
fp
Ov
Ov
Ov
"}
