//MAP CONVERTED BY dmm2tgm.py THIS HEADER COMMENT PREVENTS RECONVERSION, DO NOT REMOVE
"a" = (
/obj/structure/fluff/metalpole/end{
	pixel_y = -30
	},
/turf/closed/wall/mineral/titanium/spaceship/nodiagonal,
/area/shuttle/interdyne_cargo)
"b" = (
/obj/effect/turf_decal/tile/neutral/diagonal_centre,
/obj/effect/turf_decal/tile/neutral/diagonal_edge,
/obj/effect/decal/cleanable/dirt/dust,
/turf/open/floor/iron/shuttle/cargo,
/area/shuttle/interdyne_cargo)
"d" = (
/obj/effect/turf_decal/box/corners,
/obj/effect/turf_decal/trimline/yellow/filled/line{
	dir = 6
	},
/obj/effect/turf_decal/box/corners{
	dir = 1
	},
/obj/effect/spawner/random/structure/crate_loot,
/obj/effect/decal/cleanable/dirt/dust,
/turf/open/floor/iron/shuttle/exploration/tripleinvertcorner{
	dir = 1
	},
/area/shuttle/interdyne_cargo)
"f" = (
/turf/template_noop,
/area/template_noop)
"g" = (
/obj/effect/turf_decal/siding/dark{
	dir = 10
	},
/obj/structure/railing,
/obj/structure/chair/comfy/shuttle{
	dir = 1
	},
/obj/effect/turf_decal/tile/neutral/diagonal_centre,
/obj/effect/turf_decal/tile/dark_red/half{
	dir = 1
	},
/turf/open/floor/iron/shuttle/cargo,
/area/shuttle/interdyne_cargo)
"h" = (
/obj/effect/turf_decal/box/corners{
	dir = 8
	},
/obj/effect/turf_decal/trimline/yellow/filled/line{
	dir = 10
	},
/obj/effect/turf_decal/box/corners{
	dir = 4
	},
/obj/effect/decal/cleanable/dirt/dust,
/turf/open/floor/iron/shuttle/exploration/tripleinvertcorner,
/area/shuttle/interdyne_cargo)
"i" = (
/obj/structure/window/reinforced/plasma/spawner/north,
/obj/machinery/power/shuttle_engine/heater,
/obj/effect/turf_decal/stripes/line{
	dir = 1
	},
/turf/open/floor/iron/dark,
/area/shuttle/interdyne_cargo)
"j" = (
/turf/closed/wall/mineral/titanium/spaceship/nodiagonal,
/area/shuttle/interdyne_cargo)
"k" = (
/obj/effect/turf_decal/siding/dark{
	dir = 9
	},
/obj/structure/chair/comfy/shuttle,
/obj/effect/turf_decal/tile/neutral/diagonal_centre,
/obj/machinery/light/directional/north,
/obj/effect/turf_decal/tile/dark_red/half,
/turf/open/floor/iron/shuttle/cargo,
/area/shuttle/interdyne_cargo)
"l" = (
/obj/effect/turf_decal/box/white/corners{
	dir = 4
	},
/obj/effect/turf_decal/tile/dark_red/half,
/obj/effect/decal/cleanable/dirt/dust,
/turf/open/floor/iron/shuttle/exploration/corner_invcorner{
	dir = 8
	},
/area/shuttle/interdyne_cargo)
"m" = (
/obj/effect/turf_decal/siding/dark{
	dir = 8
	},
/obj/effect/turf_decal/tile/neutral/diagonal_centre,
/obj/effect/decal/cleanable/dirt/dust,
/turf/open/floor/iron/shuttle/cargo,
/area/shuttle/interdyne_cargo)
"n" = (
/obj/effect/turf_decal/bot/right,
/obj/effect/decal/cleanable/dirt/dust,
/obj/machinery/button/door{
	id = "burstcargo";
	req_access = list("syndicate");
	name = "Pilot Blastdoor Control";
	pixel_y = -32
	},
/turf/open/floor/iron/shuttle/exploration,
/area/shuttle/interdyne_cargo)
"o" = (
/obj/effect/turf_decal/box/corners,
/obj/effect/turf_decal/trimline/yellow/filled/line{
	dir = 6
	},
/obj/effect/turf_decal/box/corners{
	dir = 1
	},
/obj/effect/decal/cleanable/dirt/dust,
/turf/open/floor/iron/shuttle/exploration/tripleinvertcorner{
	dir = 1
	},
/area/shuttle/interdyne_cargo)
"r" = (
/obj/structure/fans/tiny/forcefield{
	dir = 4
	},
/obj/effect/turf_decal{
	dir = 8
	},
/obj/effect/turf_decal/loading_area{
	dir = 8
	},
/obj/machinery/door/poddoor{
	id = "burstcargo"
	},
/turf/open/floor/engine/n2,
/area/shuttle/interdyne_cargo)
"s" = (
/turf/closed/wall/mineral/titanium/nodiagonal,
/area/template_noop)
"t" = (
/obj/docking_port/mobile{
	dir = 4;
	dwidth = 6;
	height = 7;
	shuttle_id = "interdyne_burst";
	name = "Interdyne Burst Shuttle";
	port_direction = 8;
	preferred_direction = 8;
	width = 15
	},
/turf/closed/wall/mineral/titanium/nodiagonal,
/area/shuttle/interdyne_cargo)
"v" = (
/obj/structure/chair/comfy/shuttle{
	dir = 1
	},
/obj/effect/turf_decal/tile/neutral/diagonal_centre,
/obj/effect/turf_decal/tile/neutral/diagonal_edge,
/obj/effect/decal/cleanable/dirt/dust,
/obj/machinery/button/door/directional/south{
	name = "Window Shutter Control";
	id = "burstwind";
	pixel_y = 0;
	pixel_x = 32
	},
/turf/open/floor/iron/shuttle/cargo,
/area/shuttle/interdyne_cargo)
"w" = (
/obj/effect/spawner/structure/window/reinforced/shuttle,
/obj/effect/turf_decal/siding/dark/end{
	dir = 8
	},
/obj/machinery/door/poddoor/shutters/preopen{
	dir = 4;
	id = "burstwind"
	},
/turf/open/floor/iron/shuttle/cargo,
/area/shuttle/interdyne_cargo)
"y" = (
/obj/effect/decal/cleanable/dirt/dust,
/turf/open/floor/iron/shuttle/exploration/textured_flat,
/area/shuttle/interdyne_cargo)
"z" = (
/obj/structure/railing,
/obj/effect/turf_decal/box/white/corners{
	dir = 8
	},
/obj/effect/turf_decal/tile/dark_red/half{
	dir = 1
	},
/obj/structure/rack,
/obj/item/storage/toolbox/emergency{
	pixel_y = 8
	},
/obj/item/storage/medkit/emergency,
/obj/machinery/light/directional/west,
/turf/open/floor/iron/shuttle/exploration/corner_invcorner{
	dir = 4
	},
/area/shuttle/interdyne_cargo)
"B" = (
/obj/effect/turf_decal/siding/dark{
	dir = 5
	},
/obj/structure/railing{
	dir = 4
	},
/obj/structure/window/reinforced/survival_pod{
	dir = 4
	},
/obj/structure/chair/comfy/shuttle,
/obj/effect/turf_decal/tile/neutral/diagonal_centre,
/obj/effect/decal/cleanable/dirt/dust,
/obj/effect/turf_decal/tile/dark_red/half,
/turf/open/floor/iron/shuttle/cargo,
/area/shuttle/interdyne_cargo)
"F" = (
/obj/machinery/computer/shuttle/interdyne_burst,
/obj/effect/turf_decal/trimline/dark_red/line,
/turf/open/floor/iron/shuttle/exploration/uside,
/area/shuttle/interdyne_cargo)
"G" = (
/turf/closed/wall/mineral/titanium/nodiagonal,
/area/shuttle/interdyne_cargo)
"H" = (
/obj/structure/closet/crate/secure/gear{
	req_access_txt = "150"
	},
/obj/item/clothing/glasses/night,
/obj/item/clothing/glasses/night,
/obj/item/clothing/glasses/night,
/obj/item/storage/belt/military,
/obj/item/storage/belt/military,
/obj/item/clothing/mask/gas/syndicate,
/obj/item/clothing/mask/gas/syndicate,
/obj/item/clothing/shoes/combat,
/obj/item/clothing/shoes/combat,
/obj/item/clothing/under/syndicate/combat,
/obj/item/clothing/under/syndicate/combat,
/obj/item/clothing/gloves/combat,
/obj/item/clothing/gloves/combat,
/obj/effect/turf_decal/bot/left,
/turf/open/floor/iron/shuttle/exploration,
/area/shuttle/interdyne_cargo)
"I" = (
/obj/effect/turf_decal/siding/dark{
	dir = 4
	},
/obj/machinery/door/window/brigdoor{
	dir = 4
	},
/obj/effect/turf_decal/tile/neutral/diagonal_centre,
/turf/open/floor/iron/shuttle/cargo,
/area/shuttle/interdyne_cargo)
"J" = (
/obj/effect/turf_decal/box/corners{
	dir = 1
	},
/obj/effect/turf_decal/trimline/yellow/filled/line{
	dir = 9
	},
/obj/effect/turf_decal/box/corners,
/turf/open/floor/iron/shuttle/exploration/tripleinvertcorner{
	dir = 8
	},
/area/shuttle/interdyne_cargo)
"M" = (
/obj/effect/turf_decal/box/corners{
	dir = 4
	},
/obj/effect/turf_decal/trimline/yellow/filled/line{
	dir = 5
	},
/obj/effect/turf_decal/box/corners{
	dir = 8
	},
/obj/effect/decal/cleanable/dirt/dust,
/turf/open/floor/iron/shuttle/exploration/tripleinvertcorner{
	dir = 4
	},
/area/shuttle/interdyne_cargo)
"N" = (
/obj/effect/turf_decal/siding/dark{
	dir = 6
	},
/obj/structure/railing{
	dir = 6
	},
/obj/structure/window/reinforced/survival_pod{
	dir = 4
	},
/obj/structure/chair/comfy/shuttle{
	dir = 1
	},
/obj/effect/turf_decal/tile/neutral/diagonal_centre,
/obj/effect/turf_decal/tile/dark_red/half{
	dir = 1
	},
/turf/open/floor/iron/shuttle/cargo,
/area/shuttle/interdyne_cargo)
"O" = (
/obj/effect/turf_decal/box/corners{
	dir = 4
	},
/obj/effect/turf_decal/trimline/yellow/filled/line{
	dir = 5
	},
/obj/effect/turf_decal/box/corners{
	dir = 8
	},
/obj/effect/decal/cleanable/dirt/dust,
/obj/structure/closet/crate,
/obj/item/card/id/advanced/chameleon,
/obj/item/card/id/advanced/chameleon,
/obj/item/card/id/advanced/chameleon,
/obj/item/modular_computer/laptop/preset/syndicate,
/obj/item/modular_computer/laptop/preset/syndicate,
/obj/item/modular_computer/laptop/preset/syndicate,
/obj/item/modular_computer/laptop/preset/syndicate,
/turf/open/floor/iron/shuttle/exploration/tripleinvertcorner{
	dir = 4
	},
/area/shuttle/interdyne_cargo)
"P" = (
/obj/machinery/door/airlock/shuttle/glass{
	name = "External Airlock"
	},
/obj/effect/mapping_helpers/airlock/access/all/syndicate/general,
/obj/effect/turf_decal/shuttle{
	dir = 8
	},
/obj/effect/turf_decal/shuttle{
	dir = 4
	},
/turf/open/floor/iron/shuttle/exploration/hazard,
/area/shuttle/interdyne_cargo)
"R" = (
/obj/effect/turf_decal/tile/neutral/diagonal_centre,
/obj/effect/turf_decal/tile/neutral/diagonal_edge,
/obj/machinery/light/directional/east,
/obj/effect/decal/cleanable/dirt/dust,
/obj/effect/turf_decal/siding/thinplating_new/dark,
/turf/open/floor/iron/shuttle/cargo,
/area/shuttle/interdyne_cargo)
"T" = (
/obj/effect/turf_decal/box/corners{
	dir = 1
	},
/obj/effect/turf_decal/trimline/yellow/filled/line{
	dir = 9
	},
/obj/effect/turf_decal/box/corners,
/obj/effect/spawner/random/structure/crate_loot,
/obj/effect/decal/cleanable/dirt/dust,
/turf/open/floor/iron/shuttle/exploration/tripleinvertcorner{
	dir = 8
	},
/area/shuttle/interdyne_cargo)
"U" = (
/obj/effect/turf_decal/box/white/corners{
	dir = 1
	},
/obj/effect/turf_decal/tile/dark_red/half,
/obj/structure/closet/emcloset/wall{
	pixel_y = 30
	},
/obj/effect/decal/cleanable/dirt/dust,
/turf/open/floor/iron/shuttle/exploration/corner_invcorner,
/area/shuttle/interdyne_cargo)
"V" = (
/obj/effect/spawner/structure/window/reinforced/shuttle,
/obj/machinery/door/poddoor/shutters/preopen{
	id = "burstwind"
	},
/turf/open/space/basic,
/area/shuttle/interdyne_cargo)
"W" = (
/obj/structure/railing,
/obj/effect/turf_decal/box/white/corners,
/obj/effect/turf_decal/tile/dark_red/half{
	dir = 1
	},
/obj/structure/rack,
/obj/item/storage/toolbox/electrical{
	pixel_y = 4
	},
/obj/item/storage/toolbox/syndicate,
/turf/open/floor/iron/shuttle/exploration/corner_invcorner{
	dir = 1
	},
/area/shuttle/interdyne_cargo)
"X" = (
/obj/structure/fluff/metalpole/end{
	dir = 1;
	pixel_y = 32
	},
/turf/closed/wall/mineral/titanium/nodiagonal,
/area/shuttle/interdyne_cargo)
"Y" = (
/obj/machinery/power/shuttle_engine/propulsion/burst/left,
/turf/open/floor/iron/dark,
/area/shuttle/interdyne_cargo)

(1,1,1) = {"
f
X
P
w
t
r
r
j
a
"}
(2,1,1) = {"
f
G
U
y
z
J
h
i
Y
"}
(3,1,1) = {"
f
G
l
y
W
O
o
i
Y
"}
(4,1,1) = {"
s
G
k
m
g
H
n
j
a
"}
(5,1,1) = {"
X
G
B
I
N
T
h
i
Y
"}
(6,1,1) = {"
V
F
v
b
R
M
d
i
Y
"}
(7,1,1) = {"
X
G
G
G
G
G
G
j
a
"}
