//MAP CONVERTED BY dmm2tgm.py THIS HEADER COMMENT PREVENTS RECONVERSION, DO NOT REMOVE
"a" = (
/turf/closed/mineral/volcanic/lava_land_surface,
/area/lavaland/surface/outdoors)
"b" = (
/turf/open/floor/plating/asteroid/basalt/lava_land_surface,
/area/lavaland/surface/outdoors)
"c" = (
/turf/open/lava/smooth/lava_land_surface,
/area/lavaland/surface/outdoors)
"d" = (
/turf/closed/indestructible/necropolis,
/area/ruin/powered/wrath)
"e" = (
/turf/open/chasm/magic,
/area/ruin/powered/wrath)
"f" = (
/obj/item/banhammer,
/obj/item/katana/goldbrand,
/turf/open/indestructible/necropolis/air,
/area/ruin/powered/wrath)
"g" = (
/obj/effect/wrath,
/turf/open/indestructible/necropolis/air,
/area/ruin/powered/wrath)
"h" = (
/turf/open/indestructible/necropolis/air,
/area/ruin/powered/wrath)
"i" = (
/obj/machinery/door/airlock/cult/unruned/friendly,
/turf/open/indestructible/necropolis/air,
/area/ruin/powered/wrath)
"j" = (
/obj/machinery/door/airlock/cult/friendly,
/turf/open/indestructible/necropolis/air,
/area/ruin/powered/wrath)

(1,1,1) = {"
a
a
a
b
b
a
a
b
a
b
b
b
b
b
b
b
a
a
a
a
"}
(2,1,1) = {"
a
a
a
b
b
b
b
b
b
b
b
b
b
b
b
b
a
a
a
a
"}
(3,1,1) = {"
b
a
a
a
b
b
b
c
c
c
b
c
c
c
b
b
a
a
a
a
"}
(4,1,1) = {"
b
a
a
a
b
b
b
c
d
d
i
d
d
c
b
a
a
a
a
a
"}
(5,1,1) = {"
b
b
a
a
a
b
b
c
d
h
h
h
d
c
b
a
a
a
a
a
"}
(6,1,1) = {"
a
a
a
a
a
b
b
c
d
h
h
h
d
c
b
b
b
b
b
a
"}
(7,1,1) = {"
a
b
b
b
b
b
b
c
d
h
h
h
d
c
b
b
b
b
b
a
"}
(8,1,1) = {"
a
b
c
c
c
c
c
c
d
h
h
h
d
c
c
c
c
c
c
b
"}
(9,1,1) = {"
b
b
c
d
d
d
d
d
d
h
h
h
d
d
d
d
d
d
c
b
"}
(10,1,1) = {"
a
b
c
d
e
d
g
h
h
h
h
h
h
h
h
h
h
d
c
b
"}
(11,1,1) = {"
a
b
c
d
f
h
g
h
h
h
h
h
h
h
h
h
h
j
b
b
"}
(12,1,1) = {"
a
b
c
d
e
d
g
h
h
h
h
h
h
h
h
h
h
d
c
b
"}
(13,1,1) = {"
a
b
c
d
d
d
d
d
d
h
h
h
d
d
d
d
d
d
c
b
"}
(14,1,1) = {"
a
b
c
c
c
c
c
c
d
h
h
h
d
c
c
c
c
c
c
b
"}
(15,1,1) = {"
a
b
b
b
b
b
b
c
d
h
h
h
d
c
b
b
b
b
b
b
"}
(16,1,1) = {"
b
b
b
a
b
b
b
c
d
h
h
h
d
c
b
b
b
a
a
a
"}
(17,1,1) = {"
b
b
b
a
b
b
b
c
d
h
h
h
d
c
b
b
b
a
a
a
"}
(18,1,1) = {"
a
a
a
a
b
b
b
c
d
d
i
d
d
c
b
b
b
a
a
a
"}
(19,1,1) = {"
a
a
a
a
a
a
a
c
c
c
b
c
c
c
b
b
a
a
a
a
"}
(20,1,1) = {"
a
a
a
a
a
a
a
b
b
b
b
b
b
b
a
a
b
a
a
a
"}
