//MAP CONVERTED BY dmm2tgm.py THIS HEADER COMMENT PREVENTS RECONVERSION, DO NOT REMOVE
"a" = (
/turf/template_noop,
/area/template_noop)
"b" = (
/turf/open/floor/plating/asteroid/basalt/lava_land_surface,
/area/lavaland/surface/outdoors)
"c" = (
/turf/open/lava/smooth/lava_land_surface,
/area/lavaland/surface/outdoors)
"d" = (
/obj/structure/sword/sif,
/turf/open/floor/plating/asteroid/basalt/lava_land_surface,
/area/lavaland/surface/outdoors)
"e" = (
/turf/closed/mineral/volcanic/lava_land_surface,
/area/lavaland/surface/outdoors)
"f" = (
/obj/item/storage/bag/easterbasket,
/turf/open/floor/plating/asteroid/basalt/lava_land_surface,
/area/lavaland/surface/sif)
"g" = (
/turf/open/floor/plating/asteroid/basalt/lava_land_surface,
/area/lavaland/surface/sif)

(1,1,1) = {"
a
a
a
a
a
a
a
a
a
a
a
a
a
a
b
b
b
a
a
a
a
a
a
a
a
a
a
a
a
a
"}
(2,1,1) = {"
a
a
a
c
c
c
a
a
a
c
c
c
c
a
b
b
b
a
c
c
c
c
a
a
a
a
c
c
a
a
"}
(3,1,1) = {"
a
a
c
c
c
c
a
a
c
c
c
c
c
c
b
b
b
c
c
c
c
c
c
c
c
c
c
c
c
a
"}
(4,1,1) = {"
a
a
c
c
c
c
c
c
c
c
c
c
c
c
b
b
b
c
c
c
c
c
c
c
c
c
c
c
c
a
"}
(5,1,1) = {"
a
a
c
c
c
c
c
c
c
c
c
c
c
c
b
b
b
c
c
c
c
c
c
c
c
c
c
c
a
a
"}
(6,1,1) = {"
a
a
c
c
c
c
c
c
c
c
c
c
c
c
b
b
b
c
c
c
c
c
c
c
c
c
c
c
c
a
"}
(7,1,1) = {"
a
c
c
c
c
c
c
c
c
c
c
c
c
c
b
b
b
c
c
c
c
c
c
c
c
c
c
c
c
a
"}
(8,1,1) = {"
a
c
c
c
c
c
c
c
c
c
c
c
c
b
b
b
b
b
c
c
c
c
c
c
c
c
c
c
c
a
"}
(9,1,1) = {"
a
a
c
c
c
c
c
c
c
c
c
c
b
b
b
b
b
b
b
c
c
c
c
c
c
c
c
c
a
a
"}
(10,1,1) = {"
a
c
c
c
c
c
c
c
c
c
c
c
c
b
b
b
b
b
b
c
c
c
c
c
c
c
c
c
a
a
"}
(11,1,1) = {"
a
c
c
c
c
c
c
c
c
c
c
c
c
c
b
b
b
b
b
c
c
c
c
c
c
c
c
c
a
a
"}
(12,1,1) = {"
a
c
c
c
c
c
c
c
c
c
b
c
c
c
b
b
b
c
c
c
c
c
c
e
c
c
c
c
c
a
"}
(13,1,1) = {"
a
c
c
c
c
c
b
c
c
c
b
c
c
b
b
b
b
b
c
c
c
c
b
b
b
c
c
a
a
a
"}
(14,1,1) = {"
b
b
b
b
b
b
b
b
b
b
b
b
b
b
b
b
d
b
b
b
b
b
b
b
b
b
b
b
b
b
"}
(15,1,1) = {"
b
b
b
b
b
b
b
b
b
b
b
b
b
b
b
b
b
b
b
b
b
b
b
b
b
b
b
b
b
b
"}
(16,1,1) = {"
b
b
b
b
b
b
b
b
b
b
b
b
b
b
b
b
b
b
b
b
b
b
b
b
b
b
b
b
b
b
"}
(17,1,1) = {"
a
a
c
c
c
c
c
b
b
b
c
c
c
b
b
b
b
b
c
c
b
b
b
c
c
c
c
c
c
a
"}
(18,1,1) = {"
a
a
c
c
c
c
c
c
c
c
c
c
c
c
b
b
b
c
c
c
c
c
c
c
c
c
c
c
a
a
"}
(19,1,1) = {"
a
a
c
c
c
c
c
c
c
c
c
c
c
c
b
b
b
c
c
c
c
c
c
c
c
c
c
c
a
a
"}
(20,1,1) = {"
a
c
c
c
c
c
b
b
c
c
c
c
c
b
b
b
b
b
c
c
c
c
c
c
c
c
c
c
a
a
"}
(21,1,1) = {"
c
c
c
c
c
b
e
b
c
c
c
b
b
b
b
b
b
b
b
b
c
c
c
c
c
c
c
c
c
a
"}
(22,1,1) = {"
c
c
c
c
b
e
e
e
b
c
b
b
b
b
b
b
b
b
b
c
c
c
c
c
c
c
c
c
c
a
"}
(23,1,1) = {"
a
c
c
c
e
e
g
e
b
c
c
c
b
c
b
b
b
b
b
b
c
c
c
c
c
c
c
c
a
a
"}
(24,1,1) = {"
a
c
c
c
b
e
f
e
e
c
c
c
c
c
b
b
b
b
b
c
c
c
c
c
c
c
c
c
a
a
"}
(25,1,1) = {"
a
c
c
c
e
e
e
e
b
c
c
c
c
c
b
b
b
b
c
c
c
c
c
c
c
c
c
c
a
a
"}
(26,1,1) = {"
a
a
c
c
c
c
e
b
c
c
c
c
c
c
b
b
b
c
c
c
c
c
c
c
c
c
c
c
a
a
"}
(27,1,1) = {"
a
c
c
c
c
c
c
c
c
c
c
c
c
c
b
b
b
c
c
c
c
c
c
c
c
c
c
c
c
a
"}
(28,1,1) = {"
a
c
c
c
c
c
c
c
c
c
c
c
c
c
b
b
b
c
c
c
c
c
c
c
c
c
c
c
c
a
"}
(29,1,1) = {"
a
a
c
c
c
c
c
c
c
c
c
c
c
c
b
b
b
c
c
a
c
c
c
a
a
a
a
a
a
a
"}
(30,1,1) = {"
a
a
a
a
a
a
c
a
a
a
a
c
c
a
b
b
b
a
a
a
a
c
a
a
a
a
a
a
a
a
"}
