//MAP CONVERTED BY dmm2tgm.py THIS HEADER COMMENT PREVENTS RECONVERSION, DO NOT REMOVE
"a" = (
/turf/template_noop,
/area/template_noop)
"b" = (
/obj/structure/table/glass,
/obj/item/hairbrush,
/obj/effect/turf_decal/tile/purple{
	dir = 1
	},
/obj/effect/turf_decal/tile/purple,
/obj/item/lipstick/random,
/obj/machinery/camera/directional/east{
	c_tag = "Salon - Massage Parlour"
	},
/turf/open/floor/iron,
/area/station/service/barber)
"c" = (
/obj/machinery/camera/directional/north{
	c_tag = "Salon"
	},
/obj/effect/turf_decal/tile/purple{
	dir = 1
	},
/obj/effect/turf_decal/tile/purple,
/obj/structure/chair/sofa/bench/right,
/obj/machinery/button/curtain{
	id = "barbershopcurtains";
	pixel_y = 24;
	pixel_x = -4
	},
/turf/open/floor/iron,
/area/station/service/barber)
"d" = (
/obj/structure/extinguisher_cabinet/directional/west,
/obj/structure/chair/office/light{
	dir = 4
	},
/obj/effect/turf_decal/tile/purple{
	dir = 1
	},
/obj/effect/turf_decal/tile/purple,
/turf/open/floor/iron,
/area/station/service/barber)
"e" = (
/obj/effect/turf_decal/tile/purple{
	dir = 1
	},
/obj/effect/turf_decal/tile/purple,
/obj/structure/cable,
/obj/machinery/power/apc/auto_name/directional/north,
/turf/open/floor/iron,
/area/station/service/barber)
"f" = (
/obj/structure/bed/pod,
/obj/machinery/light/warm/directional/north,
/obj/effect/turf_decal/tile/purple{
	dir = 1
	},
/obj/effect/turf_decal/tile/purple,
/obj/effect/landmark/start/hangover,
/turf/open/floor/iron,
/area/station/service/barber)
"g" = (
/obj/effect/turf_decal/tile/purple{
	dir = 1
	},
/obj/effect/turf_decal/tile/purple,
/turf/open/floor/iron,
/area/station/service/barber)
"h" = (
/obj/structure/table/glass,
/obj/effect/turf_decal/tile/purple{
	dir = 1
	},
/obj/effect/turf_decal/tile/purple,
/obj/structure/mirror/directional/east,
/obj/item/reagent_containers/spray/barbers_aid{
	pixel_x = 6
	},
/obj/item/razor{
	pixel_x = -6
	},
/turf/open/floor/iron,
/area/station/service/barber)
"i" = (
/obj/structure/chair/office/light{
	dir = 4
	},
/obj/effect/turf_decal/tile/purple{
	dir = 1
	},
/obj/effect/turf_decal/tile/purple,
/obj/machinery/button/curtain{
	id = "barbershopcurtains1";
	pixel_x = -25;
	pixel_y = 6
	},
/turf/open/floor/iron,
/area/station/service/barber)
"j" = (
/obj/effect/turf_decal/tile/purple{
	dir = 1
	},
/obj/effect/turf_decal/tile/purple,
/obj/machinery/dryer{
	dir = 4;
	pixel_x = -6;
	pixel_y = -6
	},
/turf/open/floor/iron,
/area/station/service/barber)
"k" = (
/obj/structure/cable,
/obj/effect/turf_decal/tile/purple{
	dir = 1
	},
/obj/effect/turf_decal/tile/purple,
/obj/machinery/atmospherics/pipe/smart/manifold4w/scrubbers/hidden/layer2,
/turf/open/floor/iron,
/area/station/service/barber)
"l" = (
/obj/structure/curtain/cloth/fancy/mechanical{
	id = "barbershopcurtains1"
	},
/obj/effect/spawner/structure/window,
/turf/open/floor/plating,
/area/station/service/barber)
"m" = (
/obj/effect/turf_decal/tile/purple{
	dir = 1
	},
/obj/effect/turf_decal/tile/purple,
/obj/structure/cable,
/obj/machinery/atmospherics/pipe/smart/manifold4w/supply/hidden/layer4,
/obj/machinery/atmospherics/pipe/smart/manifold4w/scrubbers/hidden/layer2,
/obj/machinery/light_switch/directional/south,
/turf/open/floor/iron,
/area/station/service/barber)
"o" = (
/obj/effect/turf_decal/tile/purple{
	dir = 1
	},
/obj/effect/turf_decal/tile/purple,
/obj/structure/closet/secure_closet/barber,
/obj/machinery/light/warm/directional/west,
/turf/open/floor/iron,
/area/station/service/barber)
"p" = (
/obj/machinery/atmospherics/pipe/smart/manifold4w/scrubbers/hidden/layer2,
/obj/machinery/atmospherics/pipe/smart/manifold4w/supply/hidden/layer4,
/obj/effect/turf_decal/tile/purple,
/obj/effect/turf_decal/tile/purple{
	dir = 1
	},
/obj/machinery/door/firedoor,
/obj/machinery/door/airlock/public/glass{
	name = "Massage Parlour"
	},
/turf/open/floor/iron,
/area/station/service/barber)
"q" = (
/obj/machinery/light/small/directional/east,
/obj/structure/table/glass,
/obj/effect/turf_decal/tile/purple{
	dir = 1
	},
/obj/effect/turf_decal/tile/purple,
/obj/item/lipstick/random,
/obj/item/reagent_containers/spray/quantum_hair_dye{
	pixel_x = 6
	},
/turf/open/floor/iron,
/area/station/service/barber)
"s" = (
/obj/machinery/holopad,
/obj/effect/turf_decal/tile/purple{
	dir = 1
	},
/obj/effect/turf_decal/tile/purple,
/turf/open/floor/iron,
/area/station/service/barber)
"t" = (
/obj/structure/bed/pod,
/obj/effect/turf_decal/tile/purple{
	dir = 1
	},
/obj/effect/turf_decal/tile/purple,
/turf/open/floor/iron,
/area/station/service/barber)
"u" = (
/obj/structure/table/glass,
/obj/effect/turf_decal/tile/purple{
	dir = 1
	},
/obj/effect/turf_decal/tile/purple,
/obj/structure/mirror/directional/east,
/obj/item/reagent_containers/dropper,
/obj/item/hairbrush/comb{
	pixel_y = 10
	},
/turf/open/floor/iron,
/area/station/service/barber)
"v" = (
/obj/effect/turf_decal/tile/purple{
	dir = 1
	},
/obj/effect/turf_decal/tile/purple,
/obj/effect/landmark/start/barber,
/obj/machinery/atmospherics/components/unary/vent_scrubber/on/layer2{
	dir = 8
	},
/turf/open/floor/iron,
/area/station/service/barber)
"w" = (
/obj/effect/turf_decal/tile/purple{
	dir = 1
	},
/obj/effect/turf_decal/tile/purple,
/obj/machinery/atmospherics/components/unary/vent_pump/on/layer4{
	dir = 1
	},
/obj/machinery/button/curtain{
	id = "barbershopcurtains";
	pixel_y = -24;
	pixel_x = -4
	},
/turf/open/floor/iron,
/area/station/service/barber)
"x" = (
/obj/effect/turf_decal/tile/purple{
	dir = 1
	},
/obj/effect/turf_decal/tile/purple,
/obj/machinery/atmospherics/components/unary/vent_pump/on/layer4,
/obj/effect/landmark/start/barber,
/turf/open/floor/iron,
/area/station/service/barber)
"y" = (
/obj/structure/table/glass,
/obj/item/hairbrush,
/obj/effect/turf_decal/tile/purple{
	dir = 1
	},
/obj/effect/turf_decal/tile/purple,
/obj/item/lipstick/random,
/turf/open/floor/iron,
/area/station/service/barber)
"z" = (
/obj/effect/turf_decal/tile/purple{
	dir = 1
	},
/obj/effect/turf_decal/tile/purple,
/obj/machinery/atmospherics/pipe/smart/manifold4w/scrubbers/hidden/layer2,
/obj/structure/cable,
/turf/open/floor/iron,
/area/station/service/barber)
"A" = (
/obj/effect/turf_decal/tile/purple{
	dir = 1
	},
/obj/effect/turf_decal/tile/purple,
/obj/structure/cable,
/obj/machinery/atmospherics/pipe/smart/manifold4w/supply/hidden/layer4,
/obj/machinery/atmospherics/pipe/smart/manifold4w/scrubbers/hidden/layer2,
/turf/open/floor/iron,
/area/station/service/barber)
"B" = (
/obj/effect/turf_decal/tile/purple{
	dir = 1
	},
/obj/effect/turf_decal/tile/purple,
/obj/structure/chair/sofa/bench/right{
	dir = 1
	},
/obj/effect/landmark/start/hangover,
/turf/open/floor/iron,
/area/station/service/barber)
"C" = (
/obj/effect/turf_decal/tile/purple{
	dir = 1
	},
/obj/effect/turf_decal/tile/purple,
/obj/machinery/atmospherics/pipe/smart/manifold4w/scrubbers/hidden/layer2,
/obj/machinery/atmospherics/pipe/smart/manifold4w/supply/hidden/layer4,
/turf/open/floor/iron,
/area/station/service/barber)
"D" = (
/obj/effect/turf_decal/tile/purple{
	dir = 1
	},
/obj/effect/turf_decal/tile/purple,
/obj/structure/chair/sofa/bench/left{
	dir = 1
	},
/turf/open/floor/iron,
/area/station/service/barber)
"H" = (
/obj/effect/turf_decal/tile/purple{
	dir = 1
	},
/obj/effect/turf_decal/tile/purple,
/obj/structure/sink/directional/east,
/obj/structure/mirror/directional/west,
/obj/machinery/atmospherics/components/unary/vent_scrubber/on/layer2{
	dir = 4
	},
/turf/open/floor/iron,
/area/station/service/barber)
"I" = (
/obj/effect/turf_decal/tile/purple{
	dir = 1
	},
/obj/effect/turf_decal/tile/purple,
/obj/machinery/light_switch/directional/west,
/obj/machinery/atmospherics/pipe/smart/manifold4w/supply/hidden/layer4,
/obj/machinery/atmospherics/pipe/smart/manifold4w/scrubbers/hidden/layer2,
/obj/structure/cable,
/turf/open/floor/iron,
/area/station/service/barber)
"K" = (
/obj/effect/turf_decal/tile/purple{
	dir = 1
	},
/obj/effect/turf_decal/tile/purple,
/obj/effect/landmark/event_spawn,
/obj/machinery/atmospherics/pipe/smart/manifold4w/scrubbers/hidden/layer2,
/obj/machinery/atmospherics/pipe/smart/manifold4w/supply/hidden/layer4,
/turf/open/floor/iron,
/area/station/service/barber)
"M" = (
/obj/effect/turf_decal/tile/purple{
	dir = 1
	},
/obj/effect/turf_decal/tile/purple,
/obj/item/lipstick/random,
/obj/structure/table/wood,
/turf/open/floor/iron,
/area/station/service/barber)
"N" = (
/obj/machinery/firealarm/directional/east,
/obj/effect/turf_decal/tile/purple{
	dir = 1
	},
/obj/effect/turf_decal/tile/purple,
/obj/item/kirbyplants/random,
/turf/open/floor/iron,
/area/station/service/barber)
"O" = (
/obj/effect/turf_decal/tile/purple{
	dir = 1
	},
/obj/effect/turf_decal/tile/purple,
/obj/structure/chair/comfy/barber_chair{
	dir = 4
	},
/turf/open/floor/iron,
/area/station/service/barber)
"P" = (
/turf/closed/wall,
/area/station/service/barber)
"Q" = (
/obj/effect/turf_decal/tile/purple{
	dir = 1
	},
/obj/effect/turf_decal/tile/purple,
/obj/item/kirbyplants/random,
/turf/open/floor/iron,
/area/station/service/barber)
"S" = (
/obj/effect/turf_decal/tile/purple{
	dir = 1
	},
/obj/effect/turf_decal/tile/purple,
/obj/machinery/atmospherics/pipe/smart/manifold4w/supply/hidden/layer4,
/obj/machinery/atmospherics/pipe/smart/manifold4w/scrubbers/hidden/layer2,
/obj/structure/cable,
/turf/open/floor/iron,
/area/station/service/barber)
"T" = (
/obj/effect/turf_decal/tile/purple,
/obj/effect/turf_decal/tile/purple{
	dir = 1
	},
/obj/machinery/door/airlock/public/glass{
	name = "Barbershop"
	},
/obj/machinery/atmospherics/pipe/smart/manifold4w/scrubbers/hidden/layer2,
/obj/machinery/atmospherics/pipe/smart/manifold4w/supply/hidden/layer4,
/obj/machinery/door/firedoor,
/obj/structure/cable,
/turf/open/floor/iron,
/area/station/service/barber)
"U" = (
/obj/effect/turf_decal/tile/purple{
	dir = 1
	},
/obj/effect/turf_decal/tile/purple,
/obj/structure/chair/sofa/bench/left,
/obj/machinery/airalarm/directional/north,
/turf/open/floor/iron,
/area/station/service/barber)
"V" = (
/obj/effect/turf_decal/tile/purple{
	dir = 1
	},
/obj/effect/turf_decal/tile/purple,
/obj/item/book/manual/fish_catalog,
/obj/structure/table/wood,
/turf/open/floor/iron,
/area/station/service/barber)
"X" = (
/obj/item/radio/intercom/directional/north,
/obj/effect/turf_decal/tile/purple{
	dir = 1
	},
/obj/effect/turf_decal/tile/purple,
/obj/machinery/vending/barbervend,
/turf/open/floor/iron,
/area/station/service/barber)
"Y" = (
/obj/effect/spawner/structure/window,
/obj/structure/curtain/cloth/fancy/mechanical{
	id = "barbershopcurtains"
	},
/turf/open/floor/plating,
/area/station/service/barber)
"Z" = (
/obj/machinery/light/warm/directional/north,
/obj/effect/turf_decal/tile/purple{
	dir = 1
	},
/obj/effect/turf_decal/tile/purple,
/obj/structure/chair/comfy/barber_chair{
	dir = 4
	},
/turf/open/floor/iron,
/area/station/service/barber)

(1,1,1) = {"
a
a
a
a
a
a
a
"}
(2,1,1) = {"
P
i
j
H
d
l
a
"}
(3,1,1) = {"
P
f
x
K
t
l
a
"}
(4,1,1) = {"
P
b
Q
C
y
P
a
"}
(5,1,1) = {"
P
P
P
p
P
P
a
"}
(6,1,1) = {"
P
X
o
C
I
T
a
"}
(7,1,1) = {"
P
Q
g
s
A
P
a
"}
(8,1,1) = {"
P
c
V
D
m
P
a
"}
(9,1,1) = {"
P
U
M
B
A
Y
a
"}
(10,1,1) = {"
P
e
k
z
S
Y
a
"}
(11,1,1) = {"
P
Z
v
O
w
P
a
"}
(12,1,1) = {"
P
u
q
h
N
P
a
"}
(13,1,1) = {"
P
P
P
P
P
P
a
"}
