//MAP CONVERTED BY dmm2tgm.py THIS HEADER COMMENT PREVENTS RECONVERSION, DO NOT REMOVE
"a" = (
/turf/template_noop,
/area/template_noop)
"t" = (
/obj/structure/cable,
/obj/effect/turf_decal/stripes/red/box,
/turf/open/floor/engine,
/area/station/engineering/supermatter/room)
"z" = (
/obj/machinery/button/delam_scram,
/turf/closed/wall/r_wall,
/area/station/engineering/supermatter/room)
"H" = (
/obj/effect/turf_decal/stripes/red/box,
/turf/open/floor/iron,
/area/station/engineering/main)
"N" = (
/obj/machinery/atmospherics/components/unary/delam_scram/directional/east,
/turf/template_noop,
/area/template_noop)
"Y" = (
/obj/structure/sign/delam_procedure,
/turf/closed/wall/r_wall,
/area/station/engineering/supermatter/room)

(1,1,1) = {"
H
a
a
a
a
a
a
"}
(2,1,1) = {"
z
a
a
a
a
a
Y
"}
(3,1,1) = {"
t
a
a
a
a
a
a
"}
(4,1,1) = {"
a
a
a
a
a
a
a
"}
(5,1,1) = {"
a
a
a
a
a
a
a
"}
(6,1,1) = {"
a
a
a
a
a
a
a
"}
(7,1,1) = {"
a
a
a
a
a
a
a
"}
(8,1,1) = {"
a
a
a
a
a
a
a
"}
(9,1,1) = {"
a
a
a
a
a
a
a
"}
(10,1,1) = {"
a
a
a
a
a
a
a
"}
(11,1,1) = {"
a
a
a
N
a
a
a
"}
(12,1,1) = {"
a
a
a
a
a
a
a
"}
