//MAP CONVERTED BY dmm2tgm.py THIS HEADER COMMENT PREVENTS RECONVERSION, DO NOT REMOVE
"al" = (
/obj/effect/turf_decal/stripes/line{
	dir = 1
	},
/obj/machinery/light/dim/directional/west,
/turf/open/floor/engine,
/area/station/hallway/secondary/entry)
"aD" = (
/obj/structure/closet/l3closet/janitor,
/obj/structure/disposalpipe/segment,
/turf/open/floor/iron,
/area/station/service/janitor)
"aI" = (
/obj/effect/turf_decal/trimline/green/filled/line,
/turf/open/floor/iron/white,
/area/station/hallway/secondary/entry)
"bn" = (
/obj/effect/turf_decal/trimline/green/filled/line{
	dir = 1
	},
/obj/effect/spawner/random/vending/colavend,
/obj/effect/turf_decal/siding{
	dir = 8
	},
/turf/open/floor/iron/white,
/area/station/hallway/secondary/entry)
"bN" = (
/obj/effect/turf_decal/siding,
/obj/effect/turf_decal/trimline/green/filled/line{
	dir = 4
	},
/obj/machinery/atmospherics/pipe/smart/manifold4w/supply/hidden/layer4,
/obj/item/kirbyplants/random,
/turf/open/floor/iron/white,
/area/station/hallway/secondary/entry)
"cl" = (
/obj/effect/turf_decal/stripes/line,
/turf/open/floor/engine,
/area/station/hallway/secondary/entry)
"cE" = (
/obj/structure/table,
/obj/item/grenade/chem_grenade/cleaner{
	pixel_x = -7;
	pixel_y = 12
	},
/obj/item/grenade/chem_grenade/cleaner{
	pixel_x = -7;
	pixel_y = 12
	},
/obj/item/grenade/chem_grenade/cleaner{
	pixel_x = -7;
	pixel_y = 12
	},
/obj/item/reagent_containers/spray/cleaner,
/obj/item/storage/box/lights/mixed{
	pixel_x = 6;
	pixel_y = 8
	},
/obj/item/storage/box/lights/mixed{
	pixel_x = 6;
	pixel_y = 8
	},
/obj/effect/decal/cleanable/dirt,
/obj/machinery/light/directional/west,
/obj/item/storage/box/mousetraps{
	pixel_x = -3;
	pixel_y = 8
	},
/obj/structure/disposalpipe/segment{
	dir = 5
	},
/turf/open/floor/iron,
/area/station/service/janitor)
"dD" = (
/obj/effect/turf_decal/stripes/line,
/obj/machinery/light/dim/directional/west,
/turf/open/floor/engine,
/area/station/hallway/secondary/entry)
"eA" = (
/obj/effect/landmark/navigate_destination{
	location = "Public Mining Dock"
	},
/obj/machinery/door/airlock/external{
	name = "Common Mining Dock"
	},
/turf/open/floor/iron,
/area/station/hallway/secondary/entry)
"fb" = (
/obj/effect/mapping_helpers/airlock/access/all/service/janitor,
/obj/machinery/door/airlock{
	name = "Custodial Closet"
	},
/obj/machinery/atmospherics/pipe/smart/manifold4w/scrubbers/hidden/layer2,
/obj/structure/cable,
/obj/machinery/atmospherics/pipe/smart/manifold4w/supply/hidden/layer4,
/obj/machinery/door/firedoor,
/obj/structure/disposalpipe/segment{
	dir = 4
	},
/turf/open/floor/plating,
/area/station/service/janitor)
"fh" = (
/obj/machinery/atmospherics/pipe/smart/manifold4w/supply/hidden/layer4,
/obj/machinery/atmospherics/pipe/smart/manifold4w/scrubbers/hidden/layer2,
/obj/structure/cable,
/turf/open/floor/wood/tile,
/area/station/service/bar)
"fD" = (
/obj/effect/turf_decal/stripes/line,
/obj/machinery/light/dim/directional/east,
/turf/open/floor/engine,
/area/station/hallway/secondary/entry)
"ge" = (
/obj/structure/table/wood,
/turf/open/floor/iron/grimy,
/area/station/hallway/secondary/entry)
"gm" = (
/turf/open/misc/asteroid,
/area/station/asteroid)
"gw" = (
/obj/machinery/door/firedoor,
/turf/open/floor/iron/white,
/area/station/hallway/secondary/entry)
"gV" = (
/turf/open/floor/engine,
/area/station/hallway/secondary/entry)
"gX" = (
/obj/effect/turf_decal/stripes/full,
/turf/open/floor/engine,
/area/station/hallway/secondary/entry)
"iv" = (
/obj/effect/turf_decal/siding/corner,
/turf/open/floor/iron/white,
/area/station/hallway/secondary/entry)
"iB" = (
/turf/closed/wall,
/area/station/hallway/secondary/entry)
"iV" = (
/obj/effect/turf_decal/trimline/green/filled/line{
	dir = 1
	},
/turf/open/floor/iron/white,
/area/station/hallway/secondary/entry)
"jM" = (
/obj/effect/turf_decal/siding,
/obj/machinery/atmospherics/pipe/smart/manifold4w/supply/hidden/layer4,
/turf/open/floor/iron/white,
/area/station/hallway/secondary/entry)
"jQ" = (
/obj/effect/turf_decal/sand/plating,
/obj/machinery/atmospherics/pipe/smart/manifold4w/supply/hidden/layer4,
/turf/open/floor/plating,
/area/station/asteroid)
"km" = (
/obj/structure/table/wood,
/obj/effect/spawner/random/entertainment/deck{
	pixel_x = -2;
	pixel_y = 15
	},
/obj/effect/spawner/random/food_or_drink/snack{
	pixel_x = 5;
	pixel_y = 6
	},
/turf/open/floor/iron/grimy,
/area/station/hallway/secondary/entry)
"kv" = (
/turf/closed/wall,
/area/station/service/bar)
"kJ" = (
/obj/structure/cable,
/obj/machinery/atmospherics/pipe/smart/manifold4w/supply/hidden/layer4,
/obj/machinery/atmospherics/pipe/smart/manifold4w/scrubbers/hidden/layer2,
/obj/machinery/firealarm/directional/south,
/turf/open/floor/catwalk_floor/iron_white,
/area/station/hallway/secondary/entry)
"lj" = (
/obj/effect/turf_decal/siding{
	dir = 1
	},
/turf/open/floor/iron/white,
/area/station/hallway/secondary/entry)
"lG" = (
/obj/effect/turf_decal/trimline/green/filled/corner,
/obj/structure/disposalpipe/segment{
	dir = 4
	},
/turf/open/floor/iron/white,
/area/station/hallway/secondary/entry)
"lN" = (
/obj/effect/turf_decal/siding,
/turf/open/floor/iron/white,
/area/station/hallway/secondary/entry)
"mr" = (
/obj/machinery/atmospherics/components/unary/vent_scrubber/on/layer2,
/turf/open/floor/iron/white,
/area/station/hallway/secondary/entry)
"mL" = (
/obj/structure/cable,
/obj/machinery/atmospherics/pipe/smart/manifold4w/scrubbers/hidden/layer2,
/obj/machinery/atmospherics/pipe/smart/manifold4w/supply/hidden/layer4,
/obj/effect/turf_decal/trimline/green/filled/line{
	dir = 1
	},
/obj/structure/disposalpipe/segment{
	dir = 4
	},
/turf/open/floor/iron/white,
/area/station/hallway/secondary/entry)
"nf" = (
/obj/effect/spawner/structure/window,
/turf/open/floor/plating,
/area/station/hallway/secondary/entry)
"np" = (
/turf/open/floor/iron/grimy,
/area/station/hallway/secondary/entry)
"nz" = (
/obj/structure/cable,
/obj/machinery/atmospherics/pipe/smart/manifold4w/supply/hidden/layer4,
/obj/machinery/atmospherics/pipe/smart/manifold4w/scrubbers/hidden/layer2,
/obj/effect/landmark/navigate_destination{
	location = "Arrival Shuttle"
	},
/turf/open/floor/catwalk_floor/iron_white,
/area/station/hallway/secondary/entry)
"nL" = (
/obj/effect/spawner/structure/window/reinforced,
/turf/open/floor/plating,
/area/station/hallway/secondary/entry)
"oQ" = (
/obj/structure/cable,
/obj/machinery/atmospherics/pipe/smart/manifold4w/supply/hidden/layer4,
/obj/machinery/atmospherics/pipe/smart/manifold4w/scrubbers/hidden/layer2,
/obj/machinery/light/directional/north,
/obj/structure/extinguisher_cabinet/directional/north,
/turf/open/floor/catwalk_floor/iron_white,
/area/station/hallway/secondary/entry)
"pk" = (
/obj/machinery/computer/shuttle/arrivals/recall,
/turf/open/floor/iron/dark/textured_large,
/area/station/hallway/secondary/entry)
"pp" = (
/obj/machinery/atmospherics/pipe/smart/manifold4w/scrubbers/hidden/layer2,
/obj/machinery/atmospherics/pipe/smart/manifold4w/supply/hidden/layer4,
/obj/structure/cable,
/obj/effect/turf_decal/trimline/green/filled/line{
	dir = 1
	},
/obj/structure/closet/emcloset,
/obj/machinery/incident_display/delam/directional/north,
/turf/open/floor/iron/white,
/area/station/hallway/secondary/entry)
"qi" = (
/obj/effect/decal/cleanable/dirt,
/obj/vehicle/ridden/janicart,
/obj/item/key/janitor,
/obj/machinery/camera/autoname/directional/west,
/obj/structure/disposalpipe/segment,
/turf/open/floor/iron,
/area/station/service/janitor)
"qu" = (
/obj/structure/cable,
/obj/machinery/atmospherics/pipe/smart/manifold4w/scrubbers/hidden/layer2,
/obj/machinery/atmospherics/pipe/smart/manifold4w/supply/hidden/layer4,
/obj/machinery/airalarm/directional/north,
/obj/effect/turf_decal/trimline/green/filled/line{
	dir = 1
	},
/obj/structure/disposalpipe/segment{
	dir = 4
	},
/turf/open/floor/iron/white,
/area/station/hallway/secondary/entry)
"qx" = (
/obj/effect/turf_decal/trimline/green/filled/line{
	dir = 10
	},
/obj/structure/closet/emcloset,
/turf/open/floor/iron/white,
/area/station/hallway/secondary/entry)
"qC" = (
/obj/machinery/door/airlock{
	name = "Custodial Closet"
	},
/obj/effect/mapping_helpers/airlock/access/all/service/janitor,
/obj/structure/cable,
/obj/machinery/door/firedoor,
/obj/machinery/atmospherics/pipe/smart/manifold4w/scrubbers/hidden/layer2,
/obj/machinery/atmospherics/pipe/smart/manifold4w/supply/hidden/layer4,
/turf/open/floor/plating,
/area/station/service/bar)
"qK" = (
/obj/structure/cable,
/obj/machinery/atmospherics/pipe/smart/manifold4w/supply/hidden/layer4,
/obj/machinery/atmospherics/pipe/smart/manifold4w/scrubbers/hidden/layer2,
/obj/machinery/light/directional/south,
/turf/open/floor/catwalk_floor/iron_white,
/area/station/hallway/secondary/entry)
"qP" = (
/obj/machinery/atmospherics/pipe/smart/manifold4w/scrubbers/hidden/layer2,
/obj/machinery/atmospherics/pipe/smart/manifold4w/supply/hidden/layer4,
/obj/structure/cable,
/obj/effect/turf_decal/trimline/green/filled/line{
	dir = 1
	},
/obj/machinery/light/directional/north,
/turf/open/floor/iron/white,
/area/station/hallway/secondary/entry)
"rp" = (
/obj/effect/turf_decal/siding{
	dir = 4
	},
/obj/machinery/light/directional/east,
/obj/machinery/door/firedoor,
/turf/open/floor/iron/white,
/area/station/hallway/secondary/entry)
"rx" = (
/obj/machinery/door/airlock/maintenance/external/glass,
/obj/effect/mapping_helpers/airlock/access/all/engineering/maintenance,
/obj/effect/mapping_helpers/airlock/unres{
	dir = 8
	},
/obj/machinery/door/firedoor,
/turf/open/floor/engine,
/area/station/hallway/secondary/entry)
"tu" = (
/obj/effect/landmark/event_spawn,
/turf/open/floor/iron/white,
/area/station/hallway/secondary/entry)
"tY" = (
/obj/effect/turf_decal/trimline/green/filled/corner{
	dir = 1
	},
/obj/effect/turf_decal/siding{
	dir = 1
	},
/turf/open/floor/iron/white,
/area/station/hallway/secondary/entry)
"ub" = (
/obj/effect/turf_decal/sand/plating,
/obj/effect/spawner/random/structure/crate,
/turf/open/floor/plating,
/area/station/asteroid)
"ul" = (
/obj/machinery/door/airlock/maintenance,
/obj/effect/mapping_helpers/airlock/unres{
	dir = 1
	},
/obj/effect/mapping_helpers/airlock/access/all/engineering/maintenance,
/obj/machinery/atmospherics/pipe/smart/manifold4w/scrubbers/hidden/layer2,
/obj/structure/cable,
/obj/machinery/atmospherics/pipe/smart/manifold4w/supply/hidden/layer4,
/turf/open/floor/plating,
/area/station/hallway/secondary/entry)
"uU" = (
/obj/machinery/atmospherics/components/unary/vent_scrubber/on/layer2{
	dir = 8
	},
/turf/open/floor/iron/white,
/area/station/hallway/secondary/entry)
"vt" = (
/obj/structure/chair/comfy/beige{
	dir = 8
	},
/obj/machinery/newscaster/directional/east,
/turf/open/floor/iron/grimy,
/area/station/hallway/secondary/entry)
"wM" = (
/obj/effect/turf_decal/trimline/green/filled/corner{
	dir = 8
	},
/obj/structure/disposalpipe/segment{
	dir = 4
	},
/turf/open/floor/iron/white,
/area/station/hallway/secondary/entry)
"xY" = (
/obj/structure/cable,
/obj/machinery/atmospherics/pipe/smart/manifold4w/supply/hidden/layer4,
/obj/machinery/atmospherics/pipe/smart/manifold4w/scrubbers/hidden/layer2,
/obj/machinery/status_display/shuttle/directional/south{
	shuttle_id = "arrivals_shuttle";
	name = "Interlink shuttle display"
	},
/turf/open/floor/catwalk_floor/iron_white,
/area/station/hallway/secondary/entry)
"yD" = (
/obj/effect/turf_decal/stripes/line{
	dir = 1
	},
/turf/open/floor/engine,
/area/station/hallway/secondary/entry)
"zU" = (
/obj/effect/turf_decal/stripes/line{
	dir = 1
	},
/obj/machinery/light/dim/directional/east,
/turf/open/floor/engine,
/area/station/hallway/secondary/entry)
"zW" = (
/obj/structure/cable,
/obj/machinery/atmospherics/pipe/smart/manifold4w/supply/hidden/layer4,
/obj/machinery/atmospherics/pipe/smart/manifold4w/scrubbers/hidden/layer2,
/obj/item/radio/intercom/directional/north,
/turf/open/floor/catwalk_floor/iron_white,
/area/station/hallway/secondary/entry)
"Au" = (
/obj/structure/cable,
/obj/machinery/atmospherics/pipe/smart/manifold4w/supply/hidden/layer4,
/obj/machinery/atmospherics/pipe/smart/manifold4w/scrubbers/hidden/layer2,
/obj/machinery/door/firedoor,
/turf/open/floor/catwalk_floor/iron_white,
/area/station/hallway/secondary/entry)
"AJ" = (
/obj/machinery/atmospherics/pipe/smart/manifold4w/scrubbers/hidden/layer2,
/obj/machinery/atmospherics/pipe/smart/manifold4w/supply/hidden/layer4,
/obj/structure/cable,
/obj/effect/turf_decal/trimline/green/filled/line{
	dir = 1
	},
/obj/structure/closet/firecloset,
/turf/open/floor/iron/white,
/area/station/hallway/secondary/entry)
"AZ" = (
/obj/effect/turf_decal/trimline/green/filled/line{
	dir = 4
	},
/obj/machinery/atmospherics/components/unary/vent_pump/on/layer4,
/obj/machinery/light/directional/east,
/turf/open/floor/iron/white,
/area/station/hallway/secondary/entry)
"Bj" = (
/obj/machinery/atmospherics/pipe/smart/manifold4w/scrubbers/hidden/layer2,
/obj/machinery/atmospherics/pipe/smart/manifold4w/supply/hidden/layer4,
/obj/machinery/door/airlock/maintenance/external,
/obj/effect/mapping_helpers/airlock/unres{
	dir = 8
	},
/obj/effect/turf_decal/sand/plating,
/obj/effect/mapping_helpers/airlock/access/all/engineering/maintenance,
/obj/structure/cable,
/turf/open/floor/plating,
/area/station/hallway/secondary/entry)
"BS" = (
/obj/machinery/atmospherics/pipe/smart/manifold4w/supply/hidden/layer4,
/turf/open/floor/iron/white,
/area/station/hallway/secondary/entry)
"CB" = (
/obj/effect/spawner/random/vending/snackvend,
/turf/open/floor/iron/dark/textured_large,
/area/station/hallway/secondary/entry)
"CI" = (
/obj/effect/turf_decal/sand/plating,
/obj/machinery/atmospherics/components/unary/vent_pump/on/layer4{
	dir = 8
	},
/obj/effect/landmark/generic_maintenance_landmark,
/turf/open/floor/plating,
/area/station/asteroid)
"Da" = (
/obj/effect/turf_decal/trimline/green/filled/line{
	dir = 4
	},
/obj/effect/turf_decal/siding,
/obj/structure/closet/emcloset/wall{
	pixel_x = 32
	},
/turf/open/floor/iron/white,
/area/station/hallway/secondary/entry)
"Dm" = (
/obj/machinery/door/airlock/maintenance/external/glass,
/obj/effect/mapping_helpers/airlock/access/all/engineering/maintenance,
/obj/effect/mapping_helpers/airlock/unres{
	dir = 4
	},
/turf/open/floor/engine,
/area/station/hallway/secondary/entry)
"DH" = (
/obj/machinery/power/apc/auto_name/directional/north,
/obj/structure/cable,
/obj/machinery/atmospherics/pipe/smart/manifold4w/scrubbers/hidden/layer2,
/obj/machinery/atmospherics/pipe/smart/manifold4w/supply/hidden/layer4,
/obj/effect/turf_decal/trimline/green/filled/line{
	dir = 1
	},
/obj/structure/disposalpipe/segment{
	dir = 4
	},
/turf/open/floor/iron/white,
/area/station/hallway/secondary/entry)
"DN" = (
/obj/structure/disposalpipe/segment{
	dir = 4
	},
/turf/template_noop,
/area/station/service/janitor)
"Es" = (
/obj/effect/turf_decal/trimline/green/filled/line,
/obj/structure/disposalpipe/segment{
	dir = 4
	},
/turf/open/floor/iron/white,
/area/station/hallway/secondary/entry)
"EF" = (
/obj/structure/cable,
/obj/machinery/atmospherics/pipe/smart/manifold4w/scrubbers/hidden/layer2,
/obj/machinery/atmospherics/pipe/smart/manifold4w/supply/hidden/layer4,
/obj/effect/turf_decal/trimline/green/filled/corner,
/obj/effect/turf_decal/trimline/green/filled/line{
	dir = 1
	},
/obj/structure/disposalpipe/segment{
	dir = 4
	},
/turf/open/floor/iron/white,
/area/station/hallway/secondary/entry)
"EQ" = (
/obj/effect/turf_decal/siding{
	dir = 1
	},
/obj/effect/landmark/start/hangover,
/turf/open/floor/iron/white,
/area/station/hallway/secondary/entry)
"EW" = (
/obj/structure/chair/comfy/beige{
	dir = 4
	},
/turf/open/floor/iron/grimy,
/area/station/hallway/secondary/entry)
"Fe" = (
/obj/structure/cable,
/obj/machinery/atmospherics/pipe/smart/manifold4w/supply/hidden/layer4,
/obj/machinery/atmospherics/pipe/smart/manifold4w/scrubbers/hidden/layer2,
/obj/structure/extinguisher_cabinet/directional/west,
/turf/open/floor/catwalk_floor/iron_white,
/area/station/hallway/secondary/entry)
"Hf" = (
/obj/effect/turf_decal/trimline/green/filled/line{
	dir = 1
	},
/obj/effect/turf_decal/siding/corner{
	dir = 4
	},
/turf/open/floor/iron/white,
/area/station/hallway/secondary/entry)
"Hx" = (
/obj/structure/cable,
/obj/machinery/atmospherics/pipe/smart/manifold4w/scrubbers/hidden/layer2,
/obj/machinery/atmospherics/pipe/smart/manifold4w/supply/hidden/layer4,
/obj/effect/turf_decal/trimline/green/filled/corner{
	dir = 4
	},
/obj/structure/disposalpipe/segment{
	dir = 5
	},
/turf/open/floor/iron/white,
/area/station/hallway/secondary/entry)
"HB" = (
/obj/structure/cable,
/obj/machinery/atmospherics/pipe/smart/manifold4w/supply/hidden/layer4,
/obj/machinery/atmospherics/pipe/smart/manifold4w/scrubbers/hidden/layer2,
/obj/machinery/light/directional/west,
/obj/machinery/door/firedoor,
/turf/open/floor/catwalk_floor/iron_white,
/area/station/hallway/secondary/entry)
"HJ" = (
/obj/effect/turf_decal/siding/corner{
	dir = 1
	},
/turf/open/floor/iron/white,
/area/station/hallway/secondary/entry)
"HK" = (
/obj/effect/turf_decal/trimline/green/filled/line{
	dir = 5
	},
/obj/machinery/button/transport/tram/directional/east{
	id = 1
	},
/obj/machinery/transport/destination_sign/indicator/directional/east,
/turf/open/floor/iron/white,
/area/station/hallway/secondary/entry)
"HN" = (
/obj/structure/sign/directions/cryo{
	pixel_y = 8;
	dir = 4
	},
/obj/structure/sign/directions/dorms{
	dir = 4
	},
/obj/structure/sign/directions/evac{
	pixel_y = -8
	},
/turf/closed/wall,
/area/station/hallway/secondary/entry)
"HV" = (
/obj/machinery/atmospherics/components/unary/vent_pump/on/layer4{
	dir = 8
	},
/turf/open/floor/iron/white,
/area/station/hallway/secondary/entry)
"Ih" = (
/obj/structure/window/reinforced/spawner/directional/west,
/obj/structure/window/reinforced/spawner/directional/north,
/obj/machinery/computer/shuttle/mining/common{
	pixel_x = 2
	},
/turf/open/floor/plating,
/area/station/hallway/secondary/entry)
"IF" = (
/obj/structure/cable,
/obj/machinery/atmospherics/pipe/smart/manifold4w/supply/hidden/layer4,
/obj/machinery/atmospherics/pipe/smart/manifold4w/scrubbers/hidden/layer2,
/obj/machinery/status_display/shuttle/directional/north{
	name = "Interlink shuttle display";
	shuttle_id = "arrivals_shuttle"
	},
/turf/open/floor/catwalk_floor/iron_white,
/area/station/hallway/secondary/entry)
"IQ" = (
/obj/structure/cable,
/obj/machinery/power/apc/auto_name/directional/north,
/turf/open/floor/iron,
/area/station/service/janitor)
"IU" = (
/obj/effect/landmark/start/hangover,
/turf/open/floor/iron/white,
/area/station/hallway/secondary/entry)
"Jp" = (
/obj/effect/turf_decal/trimline/green/filled/line,
/obj/effect/turf_decal/siding{
	dir = 4
	},
/turf/open/floor/iron/white,
/area/station/hallway/secondary/entry)
"Ju" = (
/obj/machinery/atmospherics/pipe/smart/manifold4w/supply/hidden/layer4,
/obj/machinery/atmospherics/pipe/smart/manifold4w/scrubbers/hidden/layer2,
/turf/open/floor/iron/white,
/area/station/hallway/secondary/entry)
"Jy" = (
/obj/structure/cable,
/obj/machinery/atmospherics/pipe/smart/manifold4w/supply/hidden/layer4,
/obj/machinery/atmospherics/pipe/smart/manifold4w/scrubbers/hidden/layer2,
/obj/item/radio/intercom/directional/south,
/turf/open/floor/catwalk_floor/iron_white,
/area/station/hallway/secondary/entry)
"JJ" = (
/obj/machinery/atmospherics/pipe/smart/manifold4w/supply/hidden/layer4,
/obj/machinery/atmospherics/pipe/smart/manifold4w/scrubbers/hidden/layer2,
/turf/open/misc/asteroid,
/area/station/asteroid)
"Ko" = (
/obj/effect/turf_decal/trimline/green/filled/line{
	dir = 4
	},
/obj/machinery/door/firedoor,
/obj/structure/disposalpipe/segment,
/turf/open/floor/iron/white,
/area/station/hallway/secondary/entry)
"Lt" = (
/obj/docking_port/stationary/mining_home/common,
/turf/open/floor/engine,
/area/station/hallway/secondary/entry)
"Mk" = (
/obj/structure/table/wood,
/obj/effect/spawner/random/decoration/ornament,
/obj/machinery/newscaster/directional/east,
/turf/open/floor/iron/grimy,
/area/station/hallway/secondary/entry)
"Mo" = (
/obj/effect/landmark/start/hangover,
/turf/open/floor/iron/grimy,
/area/station/hallway/secondary/entry)
"Mr" = (
/obj/effect/decal/cleanable/dirt,
/obj/structure/cable,
/obj/machinery/atmospherics/pipe/smart/manifold4w/scrubbers/hidden/layer2,
/obj/machinery/atmospherics/pipe/smart/manifold4w/supply/hidden/layer4,
/obj/effect/landmark/blobstart,
/obj/structure/disposalpipe/segment{
	dir = 10
	},
/turf/open/floor/iron,
/area/station/service/janitor)
"Mu" = (
/obj/structure/table/wood,
/obj/effect/spawner/random/decoration/ornament,
/turf/open/floor/iron/grimy,
/area/station/hallway/secondary/entry)
"MQ" = (
/obj/machinery/door/airlock/external{
	name = "Port Docking Bay 1"
	},
/turf/open/floor/plating,
/area/station/hallway/secondary/entry)
"Nk" = (
/obj/machinery/status_display/evac,
/turf/closed/wall,
/area/station/hallway/secondary/entry)
"Nl" = (
/obj/effect/decal/cleanable/dirt,
/obj/structure/cable,
/obj/structure/disposalpipe/junction{
	dir = 4
	},
/obj/machinery/atmospherics/pipe/smart/manifold4w/scrubbers/hidden/layer2,
/obj/machinery/atmospherics/pipe/smart/manifold4w/supply/hidden/layer4,
/turf/open/floor/iron,
/area/station/service/janitor)
"Nt" = (
/obj/machinery/atmospherics/pipe/smart/manifold4w/scrubbers/hidden/layer2,
/obj/structure/cable,
/obj/machinery/atmospherics/pipe/smart/manifold4w/supply/hidden/layer4,
/obj/effect/turf_decal/trimline/green/filled/corner{
	dir = 1
	},
/obj/effect/turf_decal/trimline/green/filled/corner{
	dir = 4
	},
/turf/open/floor/iron/white,
/area/station/hallway/secondary/entry)
"Nv" = (
/obj/effect/turf_decal/trimline/green/filled/corner,
/obj/structure/disposalpipe/segment{
	dir = 6
	},
/turf/open/floor/iron/white,
/area/station/hallway/secondary/entry)
"NL" = (
/obj/effect/turf_decal/trimline/green/filled/line{
	dir = 4
	},
/obj/structure/disposalpipe/segment,
/turf/open/floor/iron/white,
/area/station/hallway/secondary/entry)
"NU" = (
/obj/machinery/holopad,
/turf/open/floor/iron/white,
/area/station/hallway/secondary/entry)
"Pf" = (
/obj/effect/turf_decal/trimline/green/filled/line{
	dir = 4
	},
/obj/effect/turf_decal/siding{
	dir = 1
	},
/turf/open/floor/iron/white,
/area/station/hallway/secondary/entry)
"Pt" = (
/obj/machinery/atmospherics/pipe/smart/manifold4w/scrubbers/hidden/layer2,
/obj/machinery/atmospherics/pipe/smart/manifold4w/supply/hidden/layer4,
/obj/structure/cable,
/turf/open/floor/iron/white,
/area/station/hallway/secondary/entry)
"QZ" = (
/obj/machinery/atmospherics/pipe/smart/manifold4w/scrubbers/hidden/layer2,
/turf/open/floor/iron/white,
/area/station/hallway/secondary/entry)
"Rg" = (
/obj/effect/turf_decal/sand/plating,
/obj/machinery/atmospherics/pipe/smart/manifold4w/supply/hidden/layer4,
/obj/machinery/door/airlock/maintenance,
/obj/effect/mapping_helpers/airlock/access/all/engineering/maintenance,
/obj/effect/mapping_helpers/airlock/welded,
/turf/open/floor/plating,
/area/station/asteroid)
"Rk" = (
/obj/effect/turf_decal/siding,
/obj/machinery/atmospherics/pipe/smart/manifold4w/supply/hidden/layer4,
/obj/machinery/atmospherics/pipe/smart/manifold4w/scrubbers/hidden/layer2,
/turf/open/floor/iron/white,
/area/station/hallway/secondary/entry)
"Ry" = (
/obj/structure/chair/comfy/beige{
	dir = 8
	},
/turf/open/floor/iron/grimy,
/area/station/hallway/secondary/entry)
"Sd" = (
/obj/effect/turf_decal/siding/corner,
/obj/machinery/atmospherics/pipe/smart/manifold4w/supply/hidden/layer4,
/obj/machinery/atmospherics/pipe/smart/manifold4w/scrubbers/hidden/layer2,
/turf/open/floor/iron/white,
/area/station/hallway/secondary/entry)
"Sy" = (
/obj/docking_port/stationary{
	dir = 4;
	dwidth = 1;
	height = 13;
	shuttle_id = "arrivals_stationary";
	name = "arrivals";
	width = 5
	},
/turf/open/floor/engine,
/area/station/hallway/secondary/entry)
"SE" = (
/turf/open/floor/iron/white,
/area/station/hallway/secondary/entry)
"Tp" = (
/turf/closed/wall,
/area/station/asteroid)
"TC" = (
/obj/structure/cable,
/obj/machinery/atmospherics/pipe/smart/manifold4w/supply/hidden/layer4,
/obj/machinery/atmospherics/pipe/smart/manifold4w/scrubbers/hidden/layer2,
/turf/open/floor/catwalk_floor/iron_white,
/area/station/hallway/secondary/entry)
"Vc" = (
/obj/effect/turf_decal/trimline/green/filled/line{
	dir = 6
	},
/obj/machinery/status_display/evac/directional/south,
/obj/machinery/disposal/bin,
/obj/structure/disposalpipe/trunk{
	dir = 8
	},
/turf/open/floor/iron/white,
/area/station/hallway/secondary/entry)
"Vt" = (
/turf/template_noop,
/area/template_noop)
"Wr" = (
/turf/closed/wall,
/area/station/service/janitor)
"Wv" = (
/obj/effect/turf_decal/siding/corner{
	dir = 4
	},
/turf/open/floor/iron/white,
/area/station/hallway/secondary/entry)
"Wy" = (
/obj/structure/cable,
/obj/structure/disposalpipe/segment,
/turf/open/floor/iron,
/area/station/service/janitor)
"WD" = (
/obj/structure/cable,
/obj/machinery/atmospherics/pipe/smart/manifold4w/supply/hidden/layer4,
/obj/machinery/atmospherics/pipe/smart/manifold4w/scrubbers/hidden/layer2,
/obj/machinery/light/directional/west,
/turf/open/floor/catwalk_floor/iron_white,
/area/station/hallway/secondary/entry)
"Xj" = (
/turf/open/floor/iron/dark/textured_large,
/area/station/hallway/secondary/entry)
"XH" = (
/obj/effect/turf_decal/sand/plating,
/obj/machinery/atmospherics/pipe/smart/manifold4w/supply/hidden/layer4,
/obj/machinery/light/small/dim/directional/west,
/obj/structure/extinguisher_cabinet/directional/north,
/turf/open/floor/plating,
/area/station/asteroid)
"XY" = (
/obj/structure/cable,
/obj/machinery/atmospherics/pipe/smart/manifold4w/supply/hidden/layer4,
/obj/machinery/atmospherics/pipe/smart/manifold4w/scrubbers/hidden/layer2,
/obj/machinery/light/directional/north,
/obj/machinery/firealarm/directional/north,
/turf/open/floor/catwalk_floor/iron_white,
/area/station/hallway/secondary/entry)
"YC" = (
/obj/effect/turf_decal/sand/plating,
/obj/item/rack_parts,
/turf/open/floor/plating,
/area/station/asteroid)
"Zx" = (
/obj/effect/turf_decal/siding{
	dir = 4
	},
/turf/open/floor/iron/white,
/area/station/hallway/secondary/entry)
"ZQ" = (
/obj/machinery/vending/coffee,
/turf/open/floor/iron/dark/textured_large,
/area/station/hallway/secondary/entry)

(1,1,1) = {"
Vt
Vt
Vt
Vt
Tp
ub
XH
jQ
Rg
Vt
Vt
Vt
Vt
Vt
Vt
Vt
Vt
Vt
Vt
Vt
Vt
"}
(2,1,1) = {"
Vt
Vt
Vt
Vt
Tp
ub
CI
YC
Tp
Vt
Vt
Vt
Vt
Vt
Vt
Vt
Vt
Vt
Vt
Vt
Vt
"}
(3,1,1) = {"
Vt
Vt
Vt
Vt
Tp
Tp
Tp
Tp
Tp
iB
iB
Vt
Vt
Vt
Vt
Vt
Vt
Vt
Vt
Vt
Vt
"}
(4,1,1) = {"
Vt
Vt
Vt
Vt
iB
gV
Sy
gV
gV
gV
iB
Vt
Vt
Vt
Vt
Vt
Vt
Vt
Vt
Vt
Vt
"}
(5,1,1) = {"
Vt
iB
iB
iB
iB
gV
gV
gV
gV
gV
iB
gm
gm
Vt
Vt
Vt
Vt
Vt
Vt
Vt
Vt
"}
(6,1,1) = {"
Vt
pp
Pt
TC
MQ
gV
gV
gV
gV
gV
iB
Vt
Vt
Vt
Vt
Vt
Vt
Vt
Vt
Vt
Vt
"}
(7,1,1) = {"
Vt
AJ
SE
xY
iB
gV
gV
gV
gV
gV
iB
Vt
gm
Vt
Vt
Vt
Vt
Vt
Vt
Vt
Vt
"}
(8,1,1) = {"
Vt
qP
SE
TC
nf
gV
gV
gV
gV
gV
iB
gm
gm
Vt
Vt
Vt
gm
gm
gm
gm
Vt
"}
(9,1,1) = {"
ul
Nt
SE
TC
nf
gV
gV
gV
gV
gV
iB
Dm
iB
iB
iB
iB
iB
iB
iB
JJ
Vt
"}
(10,1,1) = {"
Vt
Hf
SE
TC
nf
gV
gV
gV
gV
gV
dD
gX
al
gV
gV
gV
gV
gV
iB
Bj
Vt
"}
(11,1,1) = {"
pk
tY
SE
TC
nf
gV
gV
gV
gV
gV
cl
gX
yD
gV
gV
gV
gV
gV
iB
oQ
qx
"}
(12,1,1) = {"
HN
lj
SE
TC
nf
gV
gV
gV
gV
gV
cl
gX
yD
gV
gV
gV
gV
gV
nL
TC
aI
"}
(13,1,1) = {"
bn
HJ
SE
xY
iB
gV
gV
gV
gV
gV
cl
gX
yD
gV
gV
gV
gV
Lt
eA
TC
aI
"}
(14,1,1) = {"
iV
SE
IU
nz
MQ
gV
gV
gV
gV
gV
cl
gX
yD
gV
gV
gV
gV
gV
Ih
TC
aI
"}
(15,1,1) = {"
iV
tu
SE
Jy
iB
gV
gV
gV
gV
gV
cl
gX
yD
gV
gV
gV
gV
gV
iB
zW
aI
"}
(16,1,1) = {"
iV
SE
SE
kJ
iB
gV
gV
gV
gV
gV
fD
gX
zU
gV
gV
gV
gV
gV
iB
XY
aI
"}
(17,1,1) = {"
iV
SE
SE
qK
Nk
iB
iB
iB
iB
iB
iB
rx
iB
nf
nf
nf
nf
nf
iB
IF
aI
"}
(18,1,1) = {"
iV
SE
Ju
TC
WD
Fe
TC
TC
TC
TC
Au
TC
WD
TC
TC
TC
TC
TC
HB
TC
aI
"}
(19,1,1) = {"
iV
SE
Ju
SE
SE
SE
SE
Nv
NL
NL
Ko
NL
NL
Hx
SE
BS
QZ
SE
gw
SE
aI
"}
(20,1,1) = {"
iV
SE
Sd
Zx
Zx
Zx
Wv
Es
SE
SE
SE
SE
SE
mL
SE
HV
uU
SE
gw
SE
aI
"}
(21,1,1) = {"
iV
mr
Rk
EW
EW
EW
lj
wM
SE
SE
SE
SE
SE
DH
iv
Zx
Zx
Zx
rp
Zx
Jp
"}
(22,1,1) = {"
iV
NU
jM
Mu
km
ge
EQ
lG
SE
SE
SE
SE
SE
qu
lN
np
Mo
np
Nk
Xj
Xj
"}
(23,1,1) = {"
HK
AZ
bN
Ry
vt
Ry
Pf
Vc
SE
SE
SE
SE
SE
EF
Da
Ry
Mk
Ry
iB
ZQ
CB
"}
(24,1,1) = {"
Vt
Vt
Vt
Vt
Vt
Vt
Vt
Vt
SE
SE
SE
SE
SE
fb
Wr
Vt
Vt
Vt
Vt
Vt
Vt
"}
(25,1,1) = {"
Vt
Vt
Vt
Vt
Vt
Vt
Vt
Vt
Vt
Vt
Vt
fh
qC
Mr
Wy
aD
qi
cE
Vt
Vt
Vt
"}
(26,1,1) = {"
Vt
Vt
Vt
Vt
Vt
Vt
Vt
Vt
Vt
Vt
Vt
Vt
kv
Wr
IQ
Vt
Vt
DN
Vt
Vt
Vt
"}
(27,1,1) = {"
Vt
Vt
Vt
Vt
Vt
Vt
Vt
Vt
Vt
Vt
Vt
Vt
Vt
Vt
Vt
Vt
Vt
Nl
Vt
Vt
Vt
"}
(28,1,1) = {"
Vt
Vt
Vt
Vt
Vt
Vt
Vt
Vt
Vt
Vt
Vt
Vt
Vt
Vt
Vt
Vt
Vt
Vt
Vt
Vt
Vt
"}
