//MAP CONVERTED BY dmm2tgm.py THIS HEADER COMMENT PREVENTS RECONVERSION, DO NOT REMOVE
"a" = (
/turf/open/openspace,
/area/station/hallway/secondary/entry)
"c" = (
/obj/structure/sign/directions/cryo{
	dir = 10;
	pixel_y = 4
	},
/obj/structure/sign/directions/evac{
	pixel_y = -4;
	dir = 8
	},
/turf/closed/wall,
/area/station/maintenance/central/lesser)
"e" = (
/obj/structure/transport/linear/public,
/obj/effect/abstract/elevator_music_zone{
	linked_elevator_id = "transport_centre"
	},
/obj/effect/landmark/transport/transport_id{
	specific_transport_id = "transport_centre"
	},
/turf/open/floor/plating/elevatorshaft,
/area/station/maintenance/central/lesser)
"f" = (
/obj/machinery/door/window/elevator/right/directional/east{
	elevator_mode = 1;
	transport_linked_id = "transport_centre"
	},
/obj/effect/turf_decal/tile/neutral,
/turf/open/floor/iron,
/area/station/maintenance/central/lesser)
"i" = (
/obj/structure/cable,
/turf/closed/wall,
/area/station/hallway/secondary/entry)
"l" = (
/obj/structure/transport/linear/public,
/turf/open/floor/plating/elevatorshaft,
/area/station/maintenance/central/lesser)
"n" = (
/turf/closed/wall,
/area/station/hallway/secondary/entry)
"t" = (
/obj/machinery/lift_indicator{
	linked_elevator_id = "transport_centre"
	},
/obj/machinery/button/elevator{
	id = "transport_centre"
	},
/turf/closed/wall,
/area/station/hallway/secondary/entry)
"u" = (
/obj/structure/cable,
/obj/effect/spawner/random/maintenance,
/obj/machinery/light/small/dim/directional/east,
/obj/machinery/power/apc/auto_name/directional/west,
/obj/machinery/airalarm/directional/east,
/turf/open/floor/plating,
/area/station/maintenance/central/lesser)
"w" = (
/obj/structure/transport/linear/public,
/obj/machinery/elevator_control_panel/directional/east{
	linked_elevator_id = "transport_centre"
	},
/turf/open/floor/plating/elevatorshaft,
/area/station/maintenance/central/lesser)
"y" = (
/obj/machinery/button/elevator{
	id = "transport_centre"
	},
/obj/machinery/lift_indicator{
	linked_elevator_id = "transport_centre"
	},
/turf/closed/wall,
/area/station/maintenance/central/lesser)
"z" = (
/turf/closed/wall,
/area/station/maintenance/central/lesser)
"D" = (
/obj/effect/turf_decal/tile/neutral,
/obj/machinery/door/window/elevator/left/directional/east{
	transport_linked_id = "transport_centre";
	elevator_mode = 1
	},
/turf/open/floor/iron,
/area/station/maintenance/central/lesser)
"L" = (
/obj/machinery/light/cold/dim/directional/east,
/turf/open/openspace,
/area/station/hallway/secondary/entry)
"N" = (
/obj/effect/turf_decal/tile/neutral,
/obj/machinery/camera/autoname/directional/north,
/obj/machinery/status_display/evac/directional/north,
/turf/open/floor/iron,
/area/station/hallway/primary/central)
"O" = (
/obj/machinery/door/window/elevator/right/directional/south{
	transport_linked_id = "transport_centre";
	elevator_mode = 1
	},
/obj/effect/turf_decal/trimline/green/filled/corner{
	dir = 4
	},
/turf/open/floor/iron/white,
/area/station/hallway/secondary/entry)
"Q" = (
/obj/machinery/door/window/elevator/left/directional/south{
	transport_linked_id = "transport_centre";
	elevator_mode = 1
	},
/obj/effect/turf_decal/trimline/green/filled/corner{
	dir = 1
	},
/turf/open/floor/iron/white,
/area/station/hallway/secondary/entry)
"R" = (
/turf/template_noop,
/area/template_noop)
"S" = (
/obj/structure/cable,
/turf/template_noop,
/area/station/hallway/primary/central)
"X" = (
/obj/effect/turf_decal/tile/neutral,
/turf/open/floor/iron,
/area/station/hallway/primary/central)

(1,1,1) = {"
S
S
S
S
S
R
R
"}
(2,1,1) = {"
R
R
R
N
X
X
R
"}
(3,1,1) = {"
R
R
c
y
D
f
R
"}
(4,1,1) = {"
R
R
z
l
l
l
R
"}
(5,1,1) = {"
R
z
z
l
e
l
R
"}
(6,1,1) = {"
R
u
z
l
w
l
R
"}
(7,1,1) = {"
R
z
z
z
z
z
R
"}

(1,1,2) = {"
R
R
R
R
R
R
R
"}
(2,1,2) = {"
R
R
R
R
R
R
R
"}
(3,1,2) = {"
R
R
t
n
n
n
n
"}
(4,1,2) = {"
R
R
Q
a
a
a
n
"}
(5,1,2) = {"
R
R
O
a
a
a
n
"}
(6,1,2) = {"
R
R
n
a
L
a
n
"}
(7,1,2) = {"
R
R
n
n
n
i
i
"}
