//MAP CONVERTED BY dmm2tgm.py THIS HEADER COMMENT PREVENTS RECONVERSION, DO NOT REMOVE
"a" = (
/turf/template_noop,
/area/template_noop)
"b" = (
/turf/closed/mineral/random/stationside/asteroid/porus{
	mineralChance = 20
	},
/area/station/commons/kiosk)
"c" = (
/turf/open/misc/asteroid,
/area/station/commons/kiosk)
"f" = (
/obj/structure/disposalpipe/segment,
/turf/open/floor/iron/dark,
/area/station/commons/kiosk)
"l" = (
/turf/open/floor/iron/dark,
/area/station/commons/kiosk)
"n" = (
/obj/structure/table,
/obj/item/storage/box/drinkingglasses{
	pixel_x = 3;
	pixel_y = 3
	},
/obj/item/clothing/head/soft/green{
	color = "#00a62e";
	desc = "It's a baseball hat in a tastefull green colour."
	},
/obj/item/clothing/suit/apron/chef{
	name = "Jim Norton's Quebecois Coffee apron"
	},
/obj/item/pickaxe/mini,
/turf/open/floor/iron/dark,
/area/station/commons/kiosk)
"o" = (
/obj/structure/table,
/obj/machinery/coffeemaker/impressa,
/obj/item/reagent_containers/cup/glass/mug{
	pixel_x = -7;
	pixel_y = 20
	},
/obj/item/reagent_containers/cup/glass/mug{
	pixel_x = 1;
	pixel_y = 20
	},
/obj/item/reagent_containers/cup/glass/mug{
	pixel_x = 9;
	pixel_y = 20
	},
/turf/open/floor/iron/dark,
/area/station/commons/kiosk)
"p" = (
/obj/structure/table,
/obj/item/reagent_containers/cup/bottle/syrup_bottle/liqueur{
	pixel_x = 13;
	pixel_y = 16
	},
/obj/item/reagent_containers/cup/bottle/syrup_bottle/caramel{
	pixel_y = 16;
	pixel_x = 3
	},
/obj/item/reagent_containers/cup/bottle/syrup_bottle/korta_nectar{
	pixel_y = 16;
	pixel_x = -7
	},
/obj/item/storage/fancy/coffee_condi_display{
	pixel_x = -6;
	pixel_y = 3
	},
/obj/item/storage/box/coffeepack{
	pixel_x = 9;
	pixel_y = 8
	},
/obj/item/reagent_containers/cup/glass/bottle/juice/cream{
	pixel_x = 8;
	pixel_y = 1
	},
/turf/open/floor/iron/dark,
/area/station/commons/kiosk)
"q" = (
/obj/structure/cable,
/obj/machinery/light/directional/north,
/turf/open/floor/iron/dark,
/area/station/commons/kiosk)
"s" = (
/obj/machinery/atmospherics/pipe/smart/manifold4w/supply/hidden/layer4,
/obj/machinery/atmospherics/pipe/smart/manifold4w/scrubbers/hidden/layer2,
/obj/structure/cable,
/obj/structure/disposalpipe/segment{
	dir = 4
	},
/turf/open/floor/iron/dark,
/area/station/commons/kiosk)
"v" = (
/obj/structure/closet/generic/wall/empty{
	pixel_x = -32
	},
/obj/effect/landmark/start/hangover,
/turf/open/floor/iron/dark,
/area/station/commons/kiosk)
"w" = (
/obj/structure/closet/secure_closet/freezer/fridge,
/obj/item/reagent_containers/condiment/soymilk,
/obj/item/reagent_containers/condiment/soymilk,
/obj/item/reagent_containers/condiment/milk,
/obj/item/reagent_containers/condiment/milk,
/obj/item/reagent_containers/cup/glass/bottle/juice/cream,
/obj/item/reagent_containers/cup/glass/bottle/juice/cream,
/obj/item/reagent_containers/cup/glass/ice,
/obj/item/reagent_containers/cup/glass/ice,
/obj/item/reagent_containers/condiment/sugar,
/obj/item/reagent_containers/condiment/sugar,
/obj/effect/turf_decal/bot_white,
/obj/item/storage/pill_bottle/happinesspsych{
	pixel_x = -4;
	pixel_y = -1
	},
/turf/open/floor/iron/dark,
/area/station/commons/kiosk)
"x" = (
/obj/structure/barricade/wooden,
/turf/open/misc/asteroid,
/area/station/commons/kiosk)
"y" = (
/obj/effect/landmark/start/assistant,
/turf/open/floor/iron/dark,
/area/station/commons/kiosk)
"B" = (
/obj/machinery/atmospherics/components/unary/vent_scrubber/on/layer2{
	dir = 1
	},
/obj/structure/disposalpipe/segment,
/turf/open/floor/iron/dark,
/area/station/commons/kiosk)
"G" = (
/obj/structure/cable,
/obj/machinery/atmospherics/pipe/smart/manifold4w/supply/hidden/layer4,
/obj/machinery/atmospherics/pipe/smart/manifold4w/scrubbers/hidden/layer2,
/obj/structure/disposalpipe/segment{
	dir = 10
	},
/turf/open/floor/iron/dark,
/area/station/commons/kiosk)
"H" = (
/obj/machinery/power/apc/auto_name/directional/north,
/obj/structure/table,
/obj/structure/cable,
/obj/item/food/donut/berry{
	pixel_y = 14;
	pixel_x = -6
	},
/obj/item/food/donut/berry{
	pixel_y = 11;
	pixel_x = -6
	},
/obj/item/food/donut/berry{
	pixel_y = 8;
	pixel_x = -6
	},
/obj/item/food/donut/jelly/choco{
	name = "boston cream donut";
	pixel_x = 8;
	pixel_y = 14
	},
/obj/item/food/donut/jelly/choco{
	name = "boston cream donut";
	pixel_x = 8;
	pixel_y = 11
	},
/obj/item/food/donut/jelly/choco{
	name = "boston cream donut";
	pixel_x = 8;
	pixel_y = 8
	},
/obj/item/food/cakeslice/pound_cake_slice{
	pixel_x = -7
	},
/obj/item/food/cakeslice/pound_cake_slice{
	pixel_x = -7;
	pixel_y = -3
	},
/obj/item/food/cakeslice/pound_cake_slice{
	pixel_x = -7;
	pixel_y = -6
	},
/obj/item/food/cakeslice/hardware_cake_slice{
	name = "synth cake slice";
	pixel_x = 7
	},
/obj/item/food/cakeslice/hardware_cake_slice{
	name = "synth cake slice";
	pixel_x = 7;
	pixel_y = -3
	},
/obj/item/food/cakeslice/hardware_cake_slice{
	name = "synth cake slice";
	pixel_x = 7;
	pixel_y = -6
	},
/obj/machinery/button/door/directional/north{
	id = "L2_Kiosk_Door";
	name = "Kiosk Door";
	pixel_y = 37;
	pixel_x = 4;
	normaldoorcontrol = 1;
	specialfunctions = 4
	},
/obj/machinery/button/door/directional/north{
	id = "L2_Kiosk_Shutters";
	name = "Kiosk Shutters";
	pixel_y = 37;
	pixel_x = -5
	},
/turf/open/floor/iron/dark,
/area/station/commons/kiosk)
"I" = (
/obj/structure/sink/kitchen/directional/east,
/turf/open/floor/iron/dark,
/area/station/commons/kiosk)
"J" = (
/turf/closed/wall,
/area/station/commons/kiosk)
"K" = (
/turf/template_noop,
/area/station/commons/kiosk)
"P" = (
/obj/machinery/door/airlock/maintenance/external,
/obj/structure/barricade/wooden,
/turf/open/misc/asteroid,
/area/station/commons/kiosk)
"R" = (
/obj/structure/sign/chalkboard_menu{
	pixel_y = 32
	},
/obj/effect/landmark/start/assistant,
/turf/open/floor/iron/dark,
/area/station/commons/kiosk)
"T" = (
/obj/machinery/disposal/bin,
/obj/structure/disposalpipe/trunk{
	dir = 1
	},
/obj/machinery/airalarm/directional/south,
/obj/machinery/light/directional/south,
/turf/open/floor/iron/dark,
/area/station/commons/kiosk)
"U" = (
/obj/machinery/atmospherics/components/unary/vent_pump/on/layer4,
/obj/structure/cable,
/turf/open/floor/iron/dark,
/area/station/commons/kiosk)
"W" = (
/obj/structure/table,
/obj/machinery/reagentgrinder{
	pixel_x = 7;
	pixel_y = 6
	},
/obj/item/reagent_containers/cup/glass/shaker{
	pixel_y = 15;
	pixel_x = 6
	},
/obj/item/reagent_containers/cup/rag{
	pixel_x = -7;
	pixel_y = 9
	},
/turf/open/floor/iron/dark,
/area/station/commons/kiosk)

(1,1,1) = {"
a
K
K
K
K
K
K
K
a
"}
(2,1,1) = {"
J
R
y
s
I
v
w
J
a
"}
(3,1,1) = {"
J
q
U
G
B
f
T
J
a
"}
(4,1,1) = {"
J
H
o
p
W
l
n
J
a
"}
(5,1,1) = {"
J
K
K
K
b
x
K
J
a
"}
(6,1,1) = {"
J
K
K
K
K
c
K
P
a
"}
(7,1,1) = {"
J
K
K
K
K
K
K
J
a
"}
(8,1,1) = {"
a
a
a
a
a
a
a
a
a
"}
(9,1,1) = {"
a
a
a
a
a
a
a
a
a
"}
