//MAP CONVERTED BY dmm2tgm.py THIS HEADER COMMENT PREVENTS RECONVERSION, DO NOT REMOVE
"a" = (
/obj/structure/disposalpipe/segment{
	dir = 9
	},
/obj/structure/stairs/west,
/turf/open/floor/plating,
/area/station/commons/locker)
"b" = (
/obj/machinery/shower/directional/south,
/obj/structure/drain,
/turf/open/floor/iron/freezer,
/area/station/commons/toilet/restrooms)
"c" = (
/turf/template_noop,
/area/template_noop)
"d" = (
/obj/effect/turf_decal/tile/neutral{
	dir = 1
	},
/obj/machinery/atmospherics/pipe/smart/manifold4w/supply/hidden/layer4,
/obj/machinery/atmospherics/pipe/smart/manifold4w/scrubbers/hidden/layer2,
/turf/open/floor/iron,
/area/station/hallway/primary/central)
"e" = (
/obj/machinery/shower/directional/south,
/obj/effect/spawner/random/trash/soap,
/turf/open/floor/iron/freezer,
/area/station/commons/toilet/restrooms)
"f" = (
/obj/machinery/vending/autodrobe/all_access,
/obj/effect/turf_decal/delivery,
/obj/structure/window/spawner/directional/east,
/turf/open/floor/iron,
/area/station/commons/locker)
"g" = (
/turf/closed/wall,
/area/station/maintenance/central/lesser)
"h" = (
/obj/effect/spawner/structure/window,
/turf/open/floor/plating,
/area/station/commons/locker)
"i" = (
/turf/closed/wall,
/area/station/commons/locker)
"j" = (
/obj/machinery/light/directional/west,
/turf/template_noop,
/area/template_noop)
"k" = (
/obj/structure/disposalpipe/segment{
	dir = 10
	},
/turf/open/floor/iron,
/area/station/commons/locker)
"l" = (
/turf/open/floor/iron/stairs/left{
	dir = 8
	},
/area/station/commons/locker)
"m" = (
/obj/structure/extinguisher_cabinet/directional/south,
/turf/template_noop,
/area/station/commons/locker)
"n" = (
/turf/closed/wall,
/area/station/hallway/primary/central)
"o" = (
/obj/effect/turf_decal/tile/neutral{
	dir = 4
	},
/obj/machinery/atmospherics/pipe/smart/manifold4w/scrubbers/hidden/layer2,
/turf/open/floor/iron,
/area/station/commons/locker)
"p" = (
/obj/structure/disposalpipe/segment{
	dir = 5
	},
/turf/open/floor/iron,
/area/station/commons/locker)
"q" = (
/obj/machinery/atmospherics/pipe/smart/manifold4w/scrubbers/hidden/layer2,
/obj/machinery/atmospherics/pipe/smart/manifold4w/supply/hidden/layer4,
/obj/structure/cable,
/obj/structure/sink/directional/west,
/obj/structure/mirror/directional/east,
/turf/open/floor/iron/freezer,
/area/station/commons/toilet/restrooms)
"r" = (
/obj/machinery/atmospherics/pipe/smart/manifold4w/supply/hidden/layer4,
/obj/machinery/atmospherics/pipe/smart/manifold4w/scrubbers/hidden/layer2,
/turf/open/floor/plating,
/area/station/maintenance/central/lesser)
"s" = (
/obj/machinery/atmospherics/components/unary/vent_scrubber/on/layer2{
	dir = 4
	},
/turf/template_noop,
/area/station/commons/locker)
"v" = (
/turf/open/floor/plating,
/area/station/maintenance/central/lesser)
"w" = (
/obj/structure/table,
/obj/structure/bedsheetbin,
/obj/effect/turf_decal/tile/blue/opposingcorners{
	dir = 1
	},
/turf/open/floor/iron/cafeteria,
/area/station/commons/locker)
"x" = (
/obj/machinery/atmospherics/components/unary/vent_pump/on/layer4{
	dir = 8
	},
/obj/structure/railing{
	dir = 1
	},
/turf/open/floor/iron,
/area/station/commons/locker)
"y" = (
/obj/machinery/vending/clothing,
/obj/effect/turf_decal/delivery,
/obj/structure/window/spawner/directional/east,
/turf/open/floor/iron,
/area/station/commons/locker)
"z" = (
/obj/machinery/atmospherics/components/unary/vent_pump/on/layer4{
	dir = 1
	},
/obj/machinery/duct,
/turf/open/floor/iron/freezer,
/area/station/commons/toilet/restrooms)
"A" = (
/obj/machinery/door/airlock/freezer{
	name = "Showers"
	},
/obj/machinery/duct,
/turf/open/floor/iron/freezer,
/area/station/commons/toilet/restrooms)
"C" = (
/turf/open/floor/iron/stairs/right{
	dir = 8
	},
/area/station/commons/locker)
"D" = (
/obj/machinery/atmospherics/pipe/smart/manifold4w/scrubbers/hidden/layer2,
/turf/template_noop,
/area/station/commons/locker)
"E" = (
/obj/structure/stairs/west,
/turf/open/floor/plating,
/area/station/hallway/primary/central)
"G" = (
/obj/effect/turf_decal/tile/neutral{
	dir = 8
	},
/obj/machinery/atmospherics/pipe/smart/manifold4w/scrubbers/hidden/layer2,
/obj/machinery/atmospherics/pipe/smart/manifold4w/supply/hidden/layer4,
/obj/structure/railing{
	dir = 1
	},
/turf/open/floor/iron,
/area/station/commons/locker)
"H" = (
/obj/structure/sign/directions/dorms{
	dir = 8
	},
/obj/structure/sign/directions/cryo{
	pixel_y = 8;
	dir = 10
	},
/obj/structure/sign/directions/evac{
	pixel_y = -8
	},
/turf/closed/wall,
/area/station/hallway/primary/central)
"I" = (
/obj/machinery/disposal/bin,
/obj/structure/disposalpipe/trunk{
	dir = 4
	},
/obj/structure/railing,
/obj/structure/sign/directions/cryo/directional/west{
	dir = 6;
	pixel_y = 5
	},
/obj/structure/sign/directions/dorms/directional/west{
	pixel_y = -3;
	dir = 4
	},
/turf/open/floor/iron,
/area/station/commons/locker)
"J" = (
/turf/open/floor/iron/stairs/left{
	dir = 8
	},
/area/station/hallway/primary/central)
"K" = (
/obj/effect/turf_decal/tile/neutral{
	dir = 1
	},
/obj/machinery/atmospherics/pipe/smart/manifold4w/supply/hidden/layer4,
/obj/machinery/atmospherics/pipe/smart/manifold4w/scrubbers/hidden/layer2,
/obj/structure/sign/poster/timeclock_psa/directional/west,
/turf/open/floor/iron,
/area/station/hallway/primary/central)
"L" = (
/obj/effect/turf_decal/tile/neutral{
	dir = 4
	},
/obj/machinery/airalarm/directional/west,
/turf/open/floor/iron,
/area/station/commons/locker)
"M" = (
/obj/machinery/shower/directional/north,
/turf/open/floor/iron/freezer,
/area/station/commons/toilet/restrooms)
"N" = (
/obj/effect/turf_decal/tile/neutral{
	dir = 4
	},
/turf/open/floor/iron,
/area/station/commons/locker)
"O" = (
/turf/closed/wall,
/area/station/commons/toilet/restrooms)
"P" = (
/obj/effect/turf_decal/tile/neutral{
	dir = 8
	},
/obj/structure/stairs/west,
/turf/open/floor/plating,
/area/station/commons/locker)
"Q" = (
/obj/machinery/duct,
/turf/open/floor/iron/freezer,
/area/station/commons/toilet/restrooms)
"R" = (
/turf/open/floor/iron/stairs/right{
	dir = 8
	},
/area/station/hallway/primary/central)
"S" = (
/obj/structure/extinguisher_cabinet/directional/east,
/obj/machinery/atmospherics/pipe/smart/manifold4w/supply/hidden/layer4,
/obj/machinery/atmospherics/pipe/smart/manifold4w/scrubbers/hidden/layer2,
/turf/open/floor/plating,
/area/station/maintenance/central/lesser)
"T" = (
/obj/machinery/door/airlock/maintenance_hatch,
/obj/effect/mapping_helpers/airlock/access/all/engineering/maintenance,
/obj/effect/mapping_helpers/airlock/unres{
	dir = 8
	},
/obj/machinery/atmospherics/pipe/smart/manifold4w/scrubbers/hidden/layer2,
/obj/machinery/atmospherics/pipe/smart/manifold4w/supply/hidden/layer4,
/turf/open/floor/iron,
/area/station/maintenance/central/lesser)
"U" = (
/obj/machinery/shower/directional/north,
/obj/effect/landmark/start/hangover,
/turf/open/floor/iron/freezer,
/area/station/commons/toilet/restrooms)
"V" = (
/obj/structure/disposalpipe/segment{
	dir = 8
	},
/obj/structure/railing,
/turf/open/floor/iron,
/area/station/commons/locker)
"W" = (
/obj/machinery/duct,
/obj/machinery/light/small/directional/west,
/turf/open/floor/iron/freezer,
/area/station/commons/toilet/restrooms)
"X" = (
/obj/effect/turf_decal/tile/neutral{
	dir = 8
	},
/turf/closed/wall,
/area/station/maintenance/central/lesser)
"Y" = (
/obj/structure/table,
/obj/effect/turf_decal/tile/blue/opposingcorners{
	dir = 1
	},
/turf/open/floor/iron/cafeteria,
/area/station/commons/locker)
"Z" = (
/obj/item/radio/intercom/directional/south,
/turf/template_noop,
/area/station/commons/locker)

(1,1,1) = {"
c
v
v
v
S
r
g
c
c
c
c
"}
(2,1,1) = {"
c
g
g
g
X
T
g
c
c
c
c
"}
(3,1,1) = {"
c
L
I
a
P
G
i
c
c
c
c
"}
(4,1,1) = {"
c
s
V
l
C
x
c
c
c
c
c
"}
(5,1,1) = {"
c
D
k
p
c
c
c
c
c
c
c
"}
(6,1,1) = {"
N
o
c
c
c
c
c
c
c
c
c
"}
(7,1,1) = {"
f
y
c
c
c
c
c
c
c
Z
c
"}
(8,1,1) = {"
c
c
c
c
c
c
h
w
Y
Y
c
"}
(9,1,1) = {"
c
c
c
c
c
c
O
O
O
O
c
"}
(10,1,1) = {"
c
c
c
c
c
c
c
e
W
U
c
"}
(11,1,1) = {"
c
c
c
c
c
c
c
b
Q
M
c
"}
(12,1,1) = {"
c
c
c
c
c
c
c
O
A
O
c
"}
(13,1,1) = {"
c
c
c
c
c
c
c
c
z
j
c
"}
(14,1,1) = {"
c
c
c
c
c
c
c
q
c
c
c
"}
(15,1,1) = {"
c
c
c
c
m
c
c
O
c
c
c
"}
(16,1,1) = {"
c
c
c
c
c
n
n
n
n
c
c
"}
(17,1,1) = {"
c
c
c
c
c
n
E
E
n
c
c
"}
(18,1,1) = {"
c
c
c
c
c
H
J
R
n
c
c
"}
(19,1,1) = {"
c
K
c
c
c
c
d
c
c
c
c
"}
