//MAP CONVERTED BY dmm2tgm.py THIS HEADER COMMENT PREVENTS RECONVERSION, DO NOT REMOVE
"br" = (
/obj/structure/fluff/tram_rail/electric{
	dir = 1
	},
/obj/structure/transport/linear/tram,
/obj/structure/thermoplastic,
/obj/structure/chair/sofa/bench/tram/left{
	dir = 1
	},
/obj/machinery/computer/tram_controls/split/directional/south,
/turf/open/floor/tram/guideway,
/area/station/maintenance/central/greater)
"cB" = (
/obj/structure/fluff/tram_rail/electric{
	dir = 1
	},
/obj/structure/transport/linear/tram,
/obj/structure/tram,
/turf/open/floor/tram/guideway,
/area/station/maintenance/central/greater)
"cX" = (
/obj/structure/fluff/tram_rail/electric{
	dir = 1
	},
/obj/structure/holosign/barrier/atmos/tram,
/turf/open/floor/tram/guideway,
/area/station/maintenance/central/greater)
"dd" = (
/obj/structure/fluff/tram_rail/electric{
	dir = 1
	},
/obj/structure/cable/multilayer/multiz,
/obj/effect/turf_decal/stripes/white/line{
	dir = 6
	},
/turf/open/floor/engine{
	liquid_height = -30;
	turf_height = -30
	},
/area/station/maintenance/central/greater)
"dT" = (
/obj/structure/fluff/tram_rail/electric{
	dir = 1
	},
/obj/machinery/atmospherics/pipe/smart/manifold4w/scrubbers/hidden/layer2,
/obj/machinery/atmospherics/pipe/smart/manifold4w/supply/hidden/layer4,
/obj/structure/cable,
/turf/open/floor/catwalk_floor/iron_dark,
/area/station/maintenance/central/greater)
"eq" = (
/obj/structure/cable,
/obj/machinery/atmospherics/pipe/smart/manifold4w/scrubbers/hidden/layer2,
/obj/machinery/atmospherics/pipe/smart/manifold4w/supply/hidden/layer4,
/obj/machinery/door/airlock/maintenance_hatch{
	name = "Tram Guideway";
	desc = "There's always a light at the end of the tunnel. It may seem hard to get to it, but you can do it! Just keep working towards it and you'll find the positive side of things. Alternatively, you'll find a tram to the face."
	},
/obj/effect/mapping_helpers/airlock/access/all/engineering/maintenance,
/obj/effect/mapping_helpers/airlock/unres{
	dir = 4
	},
/obj/effect/decal/cleanable/dirt,
/turf/open/floor/iron/dark,
/area/station/maintenance/central/greater)
"er" = (
/obj/effect/turf_decal/sand/plating,
/obj/machinery/atmospherics/pipe/smart/manifold4w/supply/hidden/layer4,
/obj/effect/spawner/random/entertainment/arcade{
	dir = 4
	},
/turf/open/floor/plating,
/area/station/maintenance/central/greater)
"eV" = (
/obj/structure/fluff/tram_rail/electric,
/obj/structure/transport/linear/tram,
/obj/structure/thermoplastic,
/obj/structure/chair/sofa/bench/tram/left,
/turf/open/floor/tram/guideway,
/area/station/maintenance/central/greater)
"fb" = (
/obj/machinery/atmospherics/pipe/smart/manifold4w/scrubbers/hidden/layer2,
/obj/machinery/atmospherics/pipe/smart/manifold4w/supply/hidden/layer4,
/obj/structure/cable,
/turf/open/floor/catwalk_floor/iron_dark,
/area/station/maintenance/central/greater)
"fi" = (
/obj/structure/transport/linear/tram,
/obj/structure/thermoplastic,
/obj/structure/chair/sofa/bench/tram{
	dir = 1
	},
/obj/structure/fluff/tram_rail/electric{
	dir = 1
	},
/turf/open/floor/tram/guideway,
/area/station/maintenance/central/greater)
"fk" = (
/obj/structure/transport/linear/tram,
/obj/structure/thermoplastic/light,
/obj/machinery/door/airlock/tram,
/turf/open/floor/tram/guideway,
/area/station/maintenance/central/greater)
"fw" = (
/obj/structure/fluff/tram_rail/electric,
/obj/structure/transport/linear/tram,
/obj/structure/thermoplastic/light,
/turf/open/floor/tram/guideway,
/area/station/maintenance/central/greater)
"fy" = (
/obj/structure/transport/linear/tram,
/obj/structure/tram/alt/titanium,
/turf/open/floor/tram/guideway,
/area/station/maintenance/central/greater)
"hB" = (
/obj/machinery/transport/destination_sign/indicator/directional,
/obj/machinery/button/transport/tram/directional{
	id = 1
	},
/turf/closed/wall,
/area/station/hallway/secondary/entry)
"ma" = (
/obj/structure/fluff/tram_rail/electric,
/obj/structure/transport/linear/tram,
/obj/structure/thermoplastic,
/obj/structure/chair/sofa/bench/tram/right,
/turf/open/floor/tram/guideway,
/area/station/maintenance/central/greater)
"me" = (
/obj/machinery/light/small/directional/east,
/turf/template_noop,
/area/station/maintenance/central/greater)
"nf" = (
/obj/structure/cable,
/obj/machinery/atmospherics/pipe/smart/manifold4w/scrubbers/hidden/layer2,
/obj/machinery/atmospherics/pipe/smart/manifold4w/supply/hidden/layer4,
/obj/effect/decal/cleanable/dirt,
/turf/open/floor/catwalk_floor/iron_dark,
/area/station/maintenance/central/greater)
"nk" = (
/obj/structure/transport/linear/tram,
/obj/structure/tram,
/obj/machinery/transport/tram_controller,
/turf/open/floor/tram/guideway,
/area/station/maintenance/central/greater)
"nH" = (
/turf/closed/wall,
/area/station/maintenance/central/greater)
"nV" = (
/obj/structure/transport/linear/tram,
/obj/structure/tram,
/turf/open/floor/tram/guideway,
/area/station/maintenance/central/greater)
"om" = (
/obj/structure/cable,
/obj/machinery/atmospherics/pipe/smart/manifold4w/supply/hidden/layer4,
/obj/machinery/atmospherics/pipe/smart/manifold4w/scrubbers/hidden/layer2,
/turf/open/floor/plating,
/area/station/maintenance/central/greater)
"oy" = (
/obj/structure/cable,
/obj/machinery/atmospherics/pipe/smart/manifold4w/scrubbers/hidden/layer2,
/obj/machinery/atmospherics/pipe/smart/manifold4w/supply/hidden/layer4,
/turf/open/floor/catwalk_floor/iron_dark,
/area/station/maintenance/central/greater)
"ph" = (
/obj/structure/fluff/tram_rail/electric{
	dir = 1
	},
/obj/machinery/atmospherics/pipe/multiz/scrubbers/hidden/layer2,
/obj/machinery/atmospherics/pipe/multiz/supply/hidden/layer4,
/obj/effect/turf_decal/stripes/white/line{
	dir = 10
	},
/turf/open/floor/engine{
	liquid_height = -30;
	turf_height = -30
	},
/area/station/maintenance/central/greater)
"pr" = (
/obj/structure/transport/linear/tram,
/obj/structure/tram/split,
/obj/machinery/transport/destination_sign/split/south,
/turf/open/floor/tram/guideway,
/area/station/maintenance/central/greater)
"pG" = (
/obj/structure/fluff/tram_rail/electric,
/obj/structure/transport/linear/tram,
/obj/structure/thermoplastic,
/obj/effect/landmark/start/hangover,
/turf/open/floor/tram/guideway,
/area/station/maintenance/central/greater)
"qj" = (
/obj/structure/fluff/tram_rail,
/obj/structure/transport/linear/tram,
/obj/structure/thermoplastic,
/obj/structure/chair/sofa/bench/tram/right,
/turf/open/floor/tram/guideway,
/area/station/maintenance/central/greater)
"qD" = (
/obj/structure/cable,
/obj/machinery/atmospherics/pipe/smart/manifold4w/scrubbers/hidden/layer2,
/obj/machinery/atmospherics/pipe/smart/manifold4w/supply/hidden/layer4,
/obj/machinery/door/airlock/maintenance_hatch{
	name = "Tram Guideway";
	desc = "There's always a light at the end of the tunnel. It may seem hard to get to it, but you can do it! Just keep working towards it and you'll find the positive side of things. Alternatively, you'll find a tram to the face."
	},
/obj/effect/decal/cleanable/dirt,
/turf/open/floor/catwalk_floor/iron_dark,
/area/station/maintenance/central/greater)
"rw" = (
/obj/machinery/atmospherics/pipe/smart/manifold4w/scrubbers/hidden/layer2,
/obj/machinery/atmospherics/pipe/smart/manifold4w/supply/hidden/layer4,
/obj/structure/cable,
/obj/effect/turf_decal/stripes/white/line,
/obj/effect/turf_decal/stripes/white/line{
	dir = 1
	},
/obj/effect/turf_decal/tile/neutral/tram,
/turf/open/floor/tram/plate/energized,
/area/station/maintenance/central/greater)
"rY" = (
/obj/structure/railing,
/obj/structure/lattice,
/obj/effect/landmark/start/hangover,
/turf/open/openspace,
/area/station/maintenance/central/greater)
"sa" = (
/turf/open/floor/noslip/tram,
/area/station/hallway/secondary/entry)
"se" = (
/obj/structure/transport/linear/tram,
/obj/structure/tram,
/obj/structure/plaque/static_plaque/tram,
/turf/open/floor/tram/guideway,
/area/station/maintenance/central/greater)
"sU" = (
/obj/effect/turf_decal/sand/plating,
/obj/effect/mapping_helpers/broken_floor,
/turf/open/floor/plating,
/area/station/maintenance/central/greater)
"to" = (
/obj/structure/holosign/barrier/atmos/tram,
/obj/effect/turf_decal/tile/neutral/tram,
/turf/open/floor/tram/plate,
/area/station/maintenance/central/greater)
"ts" = (
/obj/structure/transport/linear/tram,
/obj/structure/thermoplastic/light,
/turf/open/floor/tram/guideway,
/area/station/maintenance/central/greater)
"tK" = (
/turf/open/floor/tram/guideway,
/area/station/maintenance/central/greater)
"tX" = (
/obj/machinery/light/directional/west,
/turf/open/floor/noslip/tram,
/area/station/hallway/secondary/entry)
"ub" = (
/obj/machinery/atmospherics/pipe/smart/manifold4w/supply/hidden/layer4,
/turf/template_noop,
/area/station/maintenance/central/greater)
"vX" = (
/obj/structure/cable,
/obj/effect/turf_decal/stripes/white/line{
	dir = 5
	},
/turf/open/floor/engine{
	liquid_height = -30;
	turf_height = -30
	},
/area/station/maintenance/central/greater)
"yu" = (
/obj/effect/turf_decal/tile/neutral/tram,
/obj/structure/transport/linear/tram,
/obj/structure/thermoplastic,
/obj/structure/chair/sofa/bench/tram/right{
	dir = 8
	},
/turf/open/floor/tram/plate,
/area/station/maintenance/central/greater)
"yX" = (
/obj/structure/transport/linear/tram,
/obj/structure/tram/split,
/turf/open/floor/tram/guideway,
/area/station/maintenance/central/greater)
"zv" = (
/obj/structure/fluff/tram_rail/electric{
	dir = 1
	},
/obj/effect/turf_decal/stripes/white/line{
	dir = 1
	},
/turf/open/floor/engine{
	liquid_height = -30;
	turf_height = -30
	},
/area/station/maintenance/central/greater)
"AP" = (
/obj/effect/turf_decal/tile/neutral/tram,
/obj/structure/transport/linear/tram,
/obj/structure/tram,
/turf/open/floor/tram/plate,
/area/station/maintenance/central/greater)
"AW" = (
/obj/structure/lattice,
/obj/machinery/atmospherics/pipe/smart/manifold4w/scrubbers/hidden/layer2,
/obj/structure/cable,
/obj/machinery/atmospherics/pipe/smart/manifold4w/supply/hidden/layer4,
/turf/open/openspace,
/area/station/maintenance/central/greater)
"Bo" = (
/obj/structure/fluff/tram_rail/end{
	dir = 4
	},
/obj/structure/transport/linear/tram,
/obj/structure/tram,
/turf/open/floor/tram/guideway,
/area/station/maintenance/central/greater)
"Bt" = (
/obj/structure/cable,
/obj/machinery/atmospherics/pipe/smart/manifold4w/scrubbers/hidden/layer2,
/obj/machinery/atmospherics/pipe/smart/manifold4w/supply/hidden/layer4,
/obj/structure/railing{
	dir = 1
	},
/obj/effect/decal/cleanable/dirt,
/turf/open/floor/catwalk_floor/iron_dark,
/area/station/maintenance/central/greater)
"BL" = (
/obj/effect/turf_decal/tile/neutral/tram,
/obj/structure/transport/linear/tram,
/obj/structure/thermoplastic/light,
/turf/open/floor/tram/plate,
/area/station/maintenance/central/greater)
"Cj" = (
/obj/machinery/atmospherics/pipe/smart/manifold4w/scrubbers/hidden/layer2,
/obj/machinery/atmospherics/pipe/smart/manifold4w/supply/hidden/layer4,
/obj/structure/cable,
/turf/open/floor/plating,
/area/station/maintenance/central/greater)
"CO" = (
/obj/machinery/light/blacklight/directional/south{
	brightness = 9;
	nightshift_brightness = 9;
	bulb_power = 0.4;
	light_angle = 180
	},
/turf/template_noop,
/area/station/maintenance/central/greater)
"Dy" = (
/obj/structure/transport/linear/tram/corner/northeast,
/obj/structure/tram/spoiler{
	dir = 1
	},
/turf/open/floor/tram/guideway,
/area/station/maintenance/central/greater)
"DM" = (
/obj/machinery/atmospherics/pipe/smart/manifold4w/supply/hidden/layer4,
/obj/machinery/atmospherics/pipe/smart/manifold4w/scrubbers/hidden/layer2,
/obj/effect/turf_decal/stripes/white/line{
	dir = 9
	},
/turf/open/floor/engine{
	liquid_height = -30;
	turf_height = -30
	},
/area/station/maintenance/central/greater)
"Ev" = (
/obj/machinery/door/airlock/maintenance_hatch{
	name = "Utilities Access Hatch"
	},
/obj/effect/mapping_helpers/airlock/access/all/engineering/maintenance,
/turf/open/floor/plating,
/area/station/maintenance/central/greater)
"Fo" = (
/obj/structure/transport/linear/tram/corner/southeast,
/obj/structure/tram/spoiler{
	dir = 4
	},
/turf/open/floor/tram/guideway,
/area/station/maintenance/central/greater)
"FJ" = (
/obj/structure/fluff/tram_rail/electric{
	dir = 1
	},
/obj/structure/transport/linear/tram,
/obj/structure/thermoplastic,
/obj/structure/chair/sofa/bench/tram/right{
	dir = 1
	},
/turf/open/floor/tram/guideway,
/area/station/maintenance/central/greater)
"GJ" = (
/obj/structure/transport/linear/tram/corner/southwest,
/obj/structure/tram/spoiler,
/turf/open/floor/tram/guideway,
/area/station/maintenance/central/greater)
"GR" = (
/obj/structure/railing,
/obj/structure/lattice,
/turf/open/openspace,
/area/station/maintenance/central/greater)
"Hs" = (
/obj/machinery/transport/guideway_sensor{
	dir = 1
	},
/obj/structure/railing{
	dir = 10
	},
/obj/effect/turf_decal/bot_white,
/turf/open/floor/plating,
/area/station/maintenance/central/greater)
"HM" = (
/obj/structure/cable,
/obj/machinery/atmospherics/pipe/smart/manifold4w/scrubbers/hidden/layer2,
/obj/machinery/atmospherics/pipe/smart/manifold4w/supply/hidden/layer4,
/turf/open/floor/plating,
/area/station/maintenance/central/greater)
"HZ" = (
/obj/structure/holosign/barrier/atmos/tram,
/turf/open/floor/tram/guideway,
/area/station/maintenance/central/greater)
"Im" = (
/obj/structure/transport/linear/tram/corner/northwest,
/obj/structure/tram/spoiler{
	dir = 8
	},
/turf/open/floor/tram/guideway,
/area/station/maintenance/central/greater)
"KL" = (
/obj/machinery/door/airlock/maintenance_hatch{
	name = "Utilities Access Hatch"
	},
/obj/machinery/atmospherics/pipe/smart/manifold4w/supply/hidden/layer4,
/obj/effect/mapping_helpers/airlock/access/all/engineering/maintenance,
/turf/open/floor/plating,
/area/station/maintenance/central/greater)
"Li" = (
/obj/structure/fluff/tram_rail/electric,
/obj/structure/holosign/barrier/atmos/tram,
/turf/open/floor/tram/guideway,
/area/station/maintenance/central/greater)
"Mf" = (
/obj/effect/landmark/start/hangover,
/turf/open/floor/noslip/tram,
/area/station/hallway/secondary/entry)
"Mu" = (
/obj/effect/turf_decal/tile/neutral/tram,
/obj/structure/transport/linear/tram,
/obj/structure/thermoplastic,
/obj/structure/chair/sofa/bench/tram/left{
	dir = 4
	},
/turf/open/floor/tram/plate,
/area/station/maintenance/central/greater)
"Np" = (
/obj/effect/landmark/start/hangover,
/turf/open/floor/plating,
/area/station/maintenance/central/greater)
"Nq" = (
/obj/structure/fluff/tram_rail/electric{
	dir = 1
	},
/obj/structure/transport/linear/tram,
/obj/structure/thermoplastic,
/obj/structure/chair/sofa/bench/tram/right{
	dir = 4
	},
/turf/open/floor/tram/guideway,
/area/station/maintenance/central/greater)
"Of" = (
/obj/machinery/light/cold/directional/north,
/obj/structure/lattice,
/obj/machinery/atmospherics/pipe/smart/manifold4w/scrubbers/hidden/layer2,
/obj/structure/cable,
/obj/machinery/atmospherics/pipe/smart/manifold4w/supply/hidden/layer4,
/turf/open/openspace,
/area/station/maintenance/central/greater)
"Ok" = (
/turf/template_noop,
/area/template_noop)
"Ol" = (
/obj/structure/fluff/tram_rail/electric{
	dir = 1
	},
/turf/open/floor/tram/guideway,
/area/station/maintenance/central/greater)
"Oo" = (
/obj/structure/fluff/tram_rail/end{
	dir = 8
	},
/obj/structure/transport/linear/tram,
/obj/structure/tram,
/turf/open/floor/tram/guideway,
/area/station/maintenance/central/greater)
"Or" = (
/obj/effect/turf_decal/sand/plating,
/turf/open/floor/plating,
/area/station/maintenance/central/greater)
"OL" = (
/obj/effect/turf_decal/tile/neutral/tram,
/obj/structure/transport/linear/tram,
/obj/effect/landmark/transport/nav_beacon/tram/platform/tramstation/west,
/obj/structure/thermoplastic/light,
/obj/effect/landmark/transport/nav_beacon/tram/nav/tramstation/main,
/turf/open/floor/tram/plate,
/area/station/maintenance/central/greater)
"OY" = (
/obj/structure/falsewall,
/turf/open/floor/plating,
/area/station/maintenance/central/greater)
"Pm" = (
/obj/structure/fluff/tram_rail/electric,
/turf/open/floor/tram/guideway,
/area/station/maintenance/central/greater)
"Qa" = (
/obj/structure/cable,
/obj/machinery/atmospherics/pipe/smart/manifold4w/supply/hidden/layer4,
/obj/machinery/atmospherics/pipe/smart/manifold4w/scrubbers/hidden/layer2,
/obj/structure/lattice,
/turf/open/openspace,
/area/station/maintenance/central/greater)
"Qk" = (
/obj/structure/transport/linear/tram,
/obj/structure/thermoplastic/light,
/obj/structure/fluff/tram_rail/electric,
/turf/open/floor/tram/guideway,
/area/station/maintenance/central/greater)
"QP" = (
/obj/machinery/transport/power_rectifier{
	pixel_y = 0
	},
/turf/closed/wall,
/area/station/maintenance/central/greater)
"RJ" = (
/turf/open/floor/plating,
/area/station/maintenance/central/greater)
"TI" = (
/obj/machinery/transport/guideway_sensor,
/obj/structure/railing{
	dir = 1
	},
/obj/effect/turf_decal/bot_white,
/turf/open/floor/plating,
/area/station/maintenance/central/greater)
"Va" = (
/obj/effect/turf_decal/loading_area/white{
	dir = 1
	},
/turf/open/floor/engine{
	liquid_height = -30;
	turf_height = -30
	},
/area/station/maintenance/central/greater)
"Vb" = (
/obj/effect/spawner/random/trash/graffiti{
	pixel_x = -32;
	spawn_loot_chance = 50
	},
/turf/template_noop,
/area/station/maintenance/central/greater)
"VV" = (
/obj/effect/turf_decal/tile/neutral/tram,
/turf/open/floor/tram/plate,
/area/station/maintenance/central/greater)
"Wl" = (
/obj/structure/fluff/tram_rail/electric,
/obj/machinery/atmospherics/pipe/smart/manifold4w/scrubbers/hidden/layer2,
/obj/machinery/atmospherics/pipe/smart/manifold4w/supply/hidden/layer4,
/obj/structure/cable,
/turf/open/floor/catwalk_floor/iron_dark,
/area/station/maintenance/central/greater)
"WO" = (
/obj/effect/mapping_helpers/airlock/access/all/command/general,
/obj/machinery/door/airlock/command{
	name = "Corporate Private Dock"
	},
/obj/effect/mapping_helpers/airlock/unres{
	dir = 1
	},
/turf/open/floor/plating,
/area/station/maintenance/central/greater)
"Xd" = (
/obj/structure/fluff/tram_rail/electric{
	dir = 1
	},
/obj/structure/transport/linear/tram,
/obj/structure/thermoplastic,
/obj/structure/chair/sofa/bench/tram/left{
	dir = 8
	},
/turf/open/floor/tram/guideway,
/area/station/maintenance/central/greater)
"XH" = (
/obj/machinery/light/small/blacklight/directional/east,
/turf/open/floor/plating,
/area/station/maintenance/central/greater)
"XW" = (
/obj/structure/fluff/tram_rail/electric,
/obj/structure/transport/linear/tram,
/obj/structure/thermoplastic/light,
/obj/machinery/computer/tram_controls/split/directional/north,
/turf/open/floor/tram/guideway,
/area/station/maintenance/central/greater)
"Yk" = (
/obj/effect/turf_decal/sand/plating,
/obj/machinery/atmospherics/pipe/smart/manifold4w/supply/hidden/layer4,
/turf/open/floor/plating,
/area/station/maintenance/central/greater)
"Yt" = (
/obj/effect/turf_decal/tile/neutral/tram,
/obj/effect/landmark/transport/transport_id/tramstation/line_1,
/obj/structure/transport/linear/tram,
/obj/structure/thermoplastic/light,
/turf/open/floor/tram/plate,
/area/station/maintenance/central/greater)
"Zc" = (
/obj/structure/fluff/tram_rail/electric,
/obj/structure/transport/linear/tram,
/obj/structure/tram,
/turf/open/floor/tram/guideway,
/area/station/maintenance/central/greater)
"Zi" = (
/obj/machinery/atmospherics/pipe/smart/manifold4w/scrubbers/hidden/layer2,
/obj/machinery/atmospherics/pipe/smart/manifold4w/supply/hidden/layer4,
/obj/structure/cable,
/obj/machinery/door/airlock/maintenance_hatch{
	name = "Tram Guideway";
	desc = "There's always a light at the end of the tunnel. It may seem hard to get to it, but you can do it! Just keep working towards it and you'll find the positive side of things. Alternatively, you'll find a tram to the face."
	},
/obj/effect/mapping_helpers/airlock/unres,
/obj/effect/mapping_helpers/airlock/access/all/engineering/maintenance,
/turf/open/floor/catwalk_floor/titanium,
/area/station/maintenance/central/greater)
"ZI" = (
/obj/structure/transport/linear/tram,
/obj/structure/tram/split,
/obj/machinery/transport/destination_sign/split/north,
/turf/open/floor/tram/guideway,
/area/station/maintenance/central/greater)
"ZR" = (
/obj/structure/fluff/tram_rail/electric{
	dir = 1
	},
/obj/structure/transport/linear/tram,
/obj/structure/thermoplastic/light,
/turf/open/floor/tram/guideway,
/area/station/maintenance/central/greater)

(1,1,1) = {"
Ok
Ok
RJ
nH
Ok
Ok
Ok
Ok
Ok
Ok
Ok
Ok
Ok
"}
(2,1,1) = {"
Ok
Ok
RJ
nH
HM
nH
Im
Oo
AP
Bo
GJ
hB
Ok
"}
(3,1,1) = {"
Ok
Ok
RJ
nH
AW
GR
nk
pG
Mu
Nq
nV
tX
Ok
"}
(4,1,1) = {"
Ok
Ok
OY
nH
AW
GR
fy
ma
BL
ZR
fk
sa
Ok
"}
(5,1,1) = {"
Ok
Ok
Vb
Ok
AW
GR
fy
eV
BL
ZR
ts
sa
Ok
"}
(6,1,1) = {"
Ok
Ok
Ok
Ok
AW
rY
yX
fw
Yt
br
pr
Mf
Ok
"}
(7,1,1) = {"
Ok
Ok
Ok
Ok
Of
GR
yX
Qk
OL
fi
yX
sa
Ok
"}
(8,1,1) = {"
Ok
Ok
Ok
Ok
AW
rY
ZI
XW
BL
FJ
yX
Mf
Ok
"}
(9,1,1) = {"
Ok
Ok
Ok
Ok
AW
GR
fy
qj
BL
ZR
fk
sa
Ok
"}
(10,1,1) = {"
Ok
Ok
Ok
Ok
AW
GR
fy
eV
BL
ZR
ts
sa
Ok
"}
(11,1,1) = {"
Ok
Ok
Ok
Ok
Qa
GR
se
pG
yu
Xd
nV
sa
Ok
"}
(12,1,1) = {"
Ok
Ok
Ok
Ok
om
nH
Dy
Zc
AP
cB
Fo
eq
Ok
"}
(13,1,1) = {"
Ok
Ok
Or
Ok
Cj
Zi
fb
Wl
rw
dT
fb
oy
Ok
"}
(14,1,1) = {"
Ok
Ok
Or
nH
KL
nH
HZ
Li
to
cX
HZ
qD
Ok
"}
(15,1,1) = {"
Ok
ub
Yk
er
Yk
nH
tK
Pm
VV
Ol
tK
Bt
Ok
"}
(16,1,1) = {"
Ok
ub
Or
Or
Or
nH
tK
Pm
VV
dd
vX
Bt
Ok
"}
(17,1,1) = {"
Ok
ub
Ok
Ok
Ok
nH
tK
Pm
VV
zv
Va
nf
Ok
"}
(18,1,1) = {"
Ok
Ok
Ok
Ok
Ok
nH
tK
Pm
VV
ph
DM
Bt
Ok
"}
(19,1,1) = {"
Ok
Ok
Ok
Ok
Ok
nH
tK
Pm
VV
Ol
tK
Np
Ok
"}
(20,1,1) = {"
Ok
Ok
Ok
Ok
Ok
nH
tK
Pm
VV
Ol
tK
RJ
Ok
"}
(21,1,1) = {"
Ok
Ok
Ok
Ok
Ok
nH
tK
Pm
VV
Ol
tK
RJ
CO
"}
(22,1,1) = {"
Ok
Ok
Ok
Ok
Ok
nH
tK
Pm
VV
Ol
tK
RJ
Ok
"}
(23,1,1) = {"
Ok
Ok
Ok
Ok
Ok
nH
tK
Pm
VV
Ol
tK
RJ
Cj
"}
(24,1,1) = {"
Ok
Ok
Ok
Ok
Ok
nH
tK
Pm
VV
Ol
tK
Np
Ok
"}
(25,1,1) = {"
Ok
Ok
Ok
Ok
Ok
nH
tK
Pm
VV
Ol
tK
RJ
Ok
"}
(26,1,1) = {"
Ok
Ok
me
sU
Ok
nH
tK
Pm
VV
Ol
tK
RJ
Ok
"}
(27,1,1) = {"
Ok
Ok
nH
Ev
nH
QP
tK
Pm
VV
Ol
tK
RJ
Ok
"}
(28,1,1) = {"
Ok
WO
RJ
RJ
XH
TI
tK
Pm
VV
Ol
tK
Hs
Ok
"}
