//MAP CONVERTED BY dmm2tgm.py THIS HEADER COMMENT PREVENTS RECONVERSION, DO NOT REMOVE
"ae" = (
/obj/structure/bed/pod,
/obj/structure/curtain/bounty,
/obj/effect/turf_decal/bot_white,
/obj/machinery/atmospherics/components/unary/vent_scrubber/on/layer2,
/turf/open/floor/iron/dark/smooth_large,
/area/shuttle/personally_bought/private_liner)
"am" = (
/obj/machinery/power/shuttle_engine/heater{
	dir = 8
	},
/obj/structure/window/reinforced/plasma/spawner/directional/east,
/obj/effect/turf_decal/stripes/line{
	dir = 6
	},
/obj/machinery/atmospherics/pipe/smart/manifold4w/scrubbers/hidden/layer2,
/turf/open/floor/plating/airless,
/area/shuttle/personally_bought/private_liner)
"bf" = (
/obj/machinery/modular_computer/preset/engineering{
	dir = 4
	},
/obj/effect/turf_decal/bot_white,
/obj/structure/extinguisher_cabinet/directional/west,
/turf/open/floor/iron/dark/smooth_large,
/area/shuttle/personally_bought/private_liner)
"bg" = (
/obj/structure/rack/shelf,
/obj/item/storage/medkit/combat_surgeon/stocked,
/obj/item/storage/medkit/frontier/stocked,
/obj/effect/turf_decal/bot_white,
/obj/structure/extinguisher_cabinet/directional/south,
/turf/open/floor/iron/dark/smooth_large,
/area/shuttle/personally_bought/private_liner)
"bl" = (
/obj/structure/marker_beacon/olive,
/turf/closed/wall/mineral/titanium/nodiagonal,
/area/shuttle/personally_bought/private_liner)
"bQ" = (
/obj/machinery/suit_storage_unit/industrial,
/obj/machinery/atmospherics/components/unary/vent_pump/on/layer4,
/turf/open/floor/iron/dark/smooth_large,
/area/shuttle/personally_bought/private_liner)
"bU" = (
/obj/structure/chair/comfy/shuttle{
	dir = 8
	},
/obj/machinery/atmospherics/pipe/smart/manifold4w/supply/hidden/layer4,
/obj/machinery/atmospherics/pipe/smart/manifold4w/scrubbers/hidden/layer2,
/turf/open/floor/carpet/green,
/area/shuttle/personally_bought/private_liner)
"cG" = (
/obj/machinery/vending/wallmed/directional/north,
/obj/machinery/light/warm/directional/north,
/obj/machinery/atmospherics/pipe/smart/manifold4w/supply/hidden/layer4,
/obj/machinery/atmospherics/pipe/smart/manifold4w/scrubbers/hidden/layer2,
/turf/open/floor/iron/smooth_large,
/area/shuttle/personally_bought/private_liner)
"cH" = (
/obj/effect/turf_decal/bot_white,
/obj/machinery/portable_atmospherics/canister/oxygen,
/obj/machinery/light/red/dim/directional/east,
/obj/machinery/atmospherics/components/unary/vent_pump/on/layer4{
	dir = 8
	},
/turf/open/floor/iron/dark/smooth_large,
/area/shuttle/personally_bought/private_liner)
"cP" = (
/obj/effect/spawner/structure/window/reinforced/shuttle,
/obj/structure/fluff/metalpole/end{
	dir = 4;
	pixel_x = 32
	},
/obj/machinery/door/poddoor/preopen/personal_shuttle_windows,
/turf/open/floor/plating,
/area/shuttle/personally_bought/private_liner)
"dc" = (
/obj/effect/spawner/structure/window/reinforced/shuttle,
/obj/machinery/door/poddoor/preopen/personal_shuttle_windows,
/turf/open/floor/plating,
/area/shuttle/personally_bought/private_liner)
"dP" = (
/obj/structure/table/reinforced,
/obj/machinery/button/door/personal_shuttle_windows/directional/west,
/turf/open/floor/iron/dark/smooth_large,
/area/shuttle/personally_bought/private_liner)
"ea" = (
/obj/structure/marker_beacon/burgundy,
/turf/closed/wall/mineral/plastitanium,
/area/shuttle/personally_bought/private_liner)
"eb" = (
/obj/effect/spawner/random/structure/tank_holder,
/obj/effect/turf_decal/bot_white,
/obj/machinery/atmospherics/components/unary/vent_pump/on/layer4,
/obj/machinery/atmospherics/pipe/smart/manifold4w/scrubbers/hidden/layer2,
/turf/open/floor/iron/dark/smooth_large,
/area/shuttle/personally_bought/private_liner)
"fb" = (
/obj/machinery/atmospherics/pipe/smart/manifold4w/supply/hidden/layer4,
/obj/machinery/atmospherics/components/unary/vent_scrubber/on/layer2{
	dir = 1
	},
/turf/open/floor/iron/smooth_large,
/area/shuttle/personally_bought/private_liner)
"fh" = (
/obj/structure/sign/poster/contraband/mothic_rations/directional/west,
/obj/structure/closet/crate/cardboard/mothic,
/obj/item/storage/box/mothic_rations,
/obj/item/coffee_cartridge/fancy,
/obj/item/coffee_cartridge/fancy,
/obj/item/coffee_cartridge/fancy,
/obj/effect/turf_decal/bot_white,
/turf/open/floor/iron/dark/smooth_large,
/area/shuttle/personally_bought/private_liner)
"fG" = (
/obj/effect/turf_decal/delivery/white,
/obj/machinery/door/airlock/external,
/obj/effect/mapping_helpers/airlock/cyclelink_helper{
	dir = 1
	},
/obj/machinery/atmospherics/pipe/smart/manifold4w/supply/hidden/layer4,
/obj/machinery/atmospherics/pipe/smart/manifold4w/scrubbers/hidden/layer2,
/turf/open/floor/iron/dark/smooth_large,
/area/shuttle/personally_bought/private_liner)
"hy" = (
/obj/structure/marker_beacon/burgundy,
/turf/closed/wall/mineral/titanium,
/area/shuttle/personally_bought/private_liner)
"ic" = (
/obj/effect/turf_decal/delivery/white,
/obj/machinery/door/airlock/captain,
/obj/machinery/atmospherics/pipe/smart/manifold4w/supply/hidden/layer4,
/obj/machinery/atmospherics/pipe/smart/manifold4w/scrubbers/hidden/layer2,
/turf/open/floor/iron/dark/smooth_large,
/area/shuttle/personally_bought/private_liner)
"ig" = (
/obj/machinery/power/shuttle_engine/propulsion{
	dir = 8
	},
/obj/effect/turf_decal/stripes/line{
	dir = 8
	},
/obj/structure/fluff/metalpole/end{
	dir = 8;
	pixel_x = -32
	},
/turf/open/floor/plating/airless,
/area/shuttle/personally_bought/private_liner)
"iB" = (
/obj/machinery/atmospherics/components/unary/vent_scrubber/on/layer2,
/turf/open/floor/iron/smooth_large,
/area/shuttle/personally_bought/private_liner)
"jj" = (
/obj/machinery/computer/camera_advanced/shuttle_docker/personally_bought,
/obj/effect/turf_decal/bot_white,
/obj/machinery/button/door/personal_shuttle_windows/directional/north,
/turf/open/floor/iron/dark/smooth_large,
/area/shuttle/personally_bought/private_liner)
"km" = (
/obj/machinery/power/shuttle_engine/propulsion{
	dir = 8
	},
/obj/effect/turf_decal/stripes/line{
	dir = 8
	},
/obj/effect/turf_decal/stripes/corner,
/obj/machinery/atmospherics/components/unary/passive_vent/layer2{
	dir = 4
	},
/turf/open/floor/plating/airless,
/area/shuttle/personally_bought/private_liner)
"kS" = (
/obj/machinery/power/shuttle_engine/propulsion{
	dir = 8
	},
/obj/effect/turf_decal/stripes/line{
	dir = 9
	},
/turf/open/floor/plating/airless,
/area/shuttle/personally_bought/private_liner)
"mh" = (
/obj/structure/fluff/metalpole/end{
	dir = 4;
	pixel_x = 32
	},
/obj/structure/marker_beacon/burgundy,
/turf/closed/wall/mineral/titanium/nodiagonal,
/area/shuttle/personally_bought/private_liner)
"mP" = (
/obj/machinery/light/warm/directional/east,
/obj/item/radio/intercom/directional/east,
/obj/machinery/atmospherics/components/unary/vent_pump/on/layer4,
/turf/open/floor/iron/smooth_large,
/area/shuttle/personally_bought/private_liner)
"nC" = (
/obj/machinery/light_switch/directional/north,
/obj/machinery/atmospherics/pipe/smart/manifold4w/supply/hidden/layer4,
/obj/machinery/atmospherics/pipe/smart/manifold4w/scrubbers/hidden/layer2,
/turf/open/floor/iron/smooth_large,
/area/shuttle/personally_bought/private_liner)
"oO" = (
/obj/machinery/light/cold/directional/east,
/obj/machinery/atmospherics/components/unary/vent_scrubber/on/layer2{
	dir = 8
	},
/turf/open/floor/iron/smooth_large,
/area/shuttle/personally_bought/private_liner)
"pn" = (
/obj/machinery/atmospherics/components/unary/vent_pump/on/layer4{
	dir = 1
	},
/turf/open/floor/iron/smooth_large,
/area/shuttle/personally_bought/private_liner)
"qV" = (
/obj/structure/cable,
/obj/structure/closet/firecloset/wall/personal_shuttle/directional/east,
/obj/effect/turf_decal/bot,
/obj/machinery/light/warm/directional/east,
/obj/machinery/atmospherics/pipe/smart/manifold4w/supply/hidden/layer4,
/obj/machinery/atmospherics/components/unary/vent_scrubber/on/layer2{
	dir = 1
	},
/turf/open/floor/iron/dark/smooth_large,
/area/shuttle/personally_bought/private_liner)
"rx" = (
/obj/machinery/airalarm/directional/north,
/obj/effect/mapping_helpers/airalarm/all_access,
/obj/machinery/atmospherics/pipe/smart/manifold4w/supply/hidden/layer4,
/obj/machinery/atmospherics/pipe/smart/manifold4w/scrubbers/hidden/layer2,
/turf/open/floor/iron/smooth_large,
/area/shuttle/personally_bought/private_liner)
"rS" = (
/obj/machinery/power/shuttle_engine/heater{
	dir = 8
	},
/obj/effect/turf_decal/stripes/line{
	dir = 4
	},
/obj/effect/turf_decal/stripes/corner{
	dir = 8
	},
/turf/open/floor/plating/airless,
/area/shuttle/personally_bought/private_liner)
"st" = (
/obj/effect/turf_decal/delivery/white,
/obj/machinery/door/airlock/external,
/obj/effect/mapping_helpers/airlock/cyclelink_helper,
/obj/machinery/atmospherics/pipe/smart/manifold4w/supply/hidden/layer4,
/obj/machinery/atmospherics/pipe/smart/manifold4w/scrubbers/hidden/layer2,
/turf/open/floor/iron/dark/smooth_large,
/area/shuttle/personally_bought/private_liner)
"sF" = (
/obj/machinery/atmospherics/pipe/smart/manifold4w/supply/hidden/layer4,
/obj/machinery/atmospherics/components/unary/vent_scrubber/on/layer2{
	dir = 1
	},
/turf/open/floor/catwalk_floor/iron_dark,
/area/shuttle/personally_bought/private_liner)
"sZ" = (
/obj/machinery/atmospherics/components/unary/portables_connector/visible/layer2,
/obj/machinery/portable_atmospherics/canister,
/obj/effect/turf_decal/bot_white,
/obj/structure/extinguisher_cabinet/directional/east,
/turf/open/floor/iron/dark/smooth_large,
/area/shuttle/personally_bought/private_liner)
"tf" = (
/obj/machinery/computer/crew{
	dir = 4
	},
/obj/effect/turf_decal/bot_white,
/obj/machinery/atmospherics/pipe/smart/manifold4w/scrubbers/hidden/layer2,
/turf/open/floor/iron/dark/smooth_large,
/area/shuttle/personally_bought/private_liner)
"tm" = (
/obj/effect/turf_decal/delivery/white,
/obj/machinery/door/airlock/external,
/obj/effect/mapping_helpers/airlock/cyclelink_helper,
/turf/open/floor/iron/dark/smooth_large,
/area/shuttle/personally_bought/private_liner)
"tN" = (
/obj/structure/marker_beacon/olive,
/turf/closed/wall/mineral/titanium,
/area/shuttle/personally_bought/private_liner)
"tZ" = (
/obj/machinery/atmospherics/pipe/smart/manifold4w/supply/hidden/layer4,
/obj/machinery/atmospherics/pipe/smart/manifold4w/scrubbers/hidden/layer2,
/turf/open/floor/iron/smooth_large,
/area/shuttle/personally_bought/private_liner)
"ul" = (
/obj/machinery/modular_computer/preset/civilian{
	dir = 4
	},
/obj/effect/turf_decal/bot_white,
/turf/open/floor/iron/dark/smooth_large,
/area/shuttle/personally_bought/private_liner)
"vf" = (
/obj/structure/chair/plastic{
	dir = 8
	},
/obj/machinery/atmospherics/components/unary/vent_pump/on/layer4,
/turf/open/floor/iron/smooth_large,
/area/shuttle/personally_bought/private_liner)
"vh" = (
/obj/machinery/atmospherics/pipe/smart/manifold4w/supply/hidden/layer4,
/obj/machinery/atmospherics/pipe/smart/manifold4w/scrubbers/hidden/layer2,
/turf/open/floor/carpet/green,
/area/shuttle/personally_bought/private_liner)
"vq" = (
/obj/machinery/atmospherics/pipe/smart/manifold4w/supply/hidden/layer4,
/obj/machinery/atmospherics/components/unary/vent_scrubber/on/layer2,
/turf/open/floor/catwalk_floor/iron_dark,
/area/shuttle/personally_bought/private_liner)
"vJ" = (
/obj/machinery/power/terminal{
	dir = 4
	},
/obj/structure/closet/crate/large/import,
/obj/structure/cable,
/obj/item/flatpacked_machine/fuel_generator,
/turf/open/floor/plating,
/area/shuttle/personally_bought/private_liner)
"vM" = (
/obj/effect/turf_decal/delivery/white,
/obj/structure/cable,
/obj/machinery/door/airlock/hatch,
/obj/machinery/atmospherics/pipe/smart/manifold4w/supply/hidden/layer4,
/obj/machinery/atmospherics/pipe/smart/manifold4w/scrubbers/hidden/layer2,
/turf/open/floor/iron/dark/smooth_large,
/area/shuttle/personally_bought/private_liner)
"vN" = (
/turf/closed/wall/mineral/titanium,
/area/shuttle/personally_bought/private_liner)
"wn" = (
/obj/structure/chair/comfy/shuttle{
	dir = 8
	},
/obj/machinery/atmospherics/pipe/smart/manifold4w/supply/hidden/layer4,
/obj/machinery/atmospherics/pipe/smart/manifold4w/scrubbers/hidden/layer2,
/turf/open/floor/iron/smooth_large,
/area/shuttle/personally_bought/private_liner)
"wI" = (
/obj/structure/closet/emcloset/wall/personal_shuttle/directional/north,
/obj/effect/turf_decal/bot,
/obj/machinery/airalarm/directional/west,
/obj/effect/mapping_helpers/airalarm/all_access,
/turf/open/floor/iron/dark/smooth_large,
/area/shuttle/personally_bought/private_liner)
"yv" = (
/obj/structure/fluff/metalpole/end{
	pixel_y = -32
	},
/turf/closed/wall/mineral/titanium/nodiagonal,
/area/shuttle/personally_bought/private_liner)
"zu" = (
/obj/structure/table/reinforced,
/obj/machinery/coffeemaker,
/obj/structure/extinguisher_cabinet/directional/south,
/turf/open/floor/iron/dark/smooth_large,
/area/shuttle/personally_bought/private_liner)
"zT" = (
/obj/structure/toilet{
	pixel_y = 8
	},
/obj/effect/turf_decal/bot_red,
/obj/machinery/light/warm/directional/east,
/obj/machinery/atmospherics/components/unary/vent_pump/on/layer4,
/turf/open/floor/iron/freezer,
/area/shuttle/personally_bought/private_liner)
"Aq" = (
/obj/structure/toilet{
	dir = 8
	},
/obj/structure/curtain,
/obj/effect/turf_decal/bot_red,
/turf/open/floor/iron/freezer,
/area/shuttle/personally_bought/private_liner)
"AG" = (
/obj/machinery/shower/directional/north,
/obj/structure/sink/kitchen/directional/east,
/obj/structure/curtain,
/obj/structure/drain,
/obj/effect/turf_decal/bot_white,
/turf/open/floor/iron/dark/smooth_large,
/area/shuttle/personally_bought/private_liner)
"BU" = (
/obj/machinery/atmospherics/pipe/smart/manifold4w/scrubbers/hidden/layer2,
/obj/machinery/atmospherics/pipe/smart/manifold4w/supply/hidden/layer4,
/obj/machinery/meter/layer2,
/turf/open/floor/iron/smooth_large,
/area/shuttle/personally_bought/private_liner)
"Ct" = (
/obj/structure/fluff/metalpole/end{
	pixel_y = -32
	},
/turf/open/floor/engine/hull/shuttle_white_plate,
/area/shuttle/personally_bought/private_liner)
"CR" = (
/obj/structure/chair/plastic{
	dir = 1
	},
/obj/structure/extinguisher_cabinet/directional/south,
/obj/machinery/atmospherics/pipe/smart/manifold4w/supply/hidden/layer4,
/obj/machinery/atmospherics/pipe/smart/manifold4w/scrubbers/hidden/layer2,
/turf/open/floor/iron/smooth_large,
/area/shuttle/personally_bought/private_liner)
"DH" = (
/obj/structure/cable,
/obj/machinery/power/apc/auto_name/directional/east,
/obj/effect/mapping_helpers/apc/unlocked,
/obj/machinery/atmospherics/pipe/smart/manifold4w/supply/hidden/layer4,
/obj/machinery/atmospherics/pipe/smart/manifold4w/scrubbers/hidden/layer2,
/obj/effect/mapping_helpers/apc/cell_5k,
/turf/open/floor/iron/smooth_large,
/area/shuttle/personally_bought/private_liner)
"DI" = (
/obj/machinery/portable_atmospherics/canister/air,
/obj/machinery/atmospherics/components/unary/portables_connector/visible/layer4{
	dir = 8
	},
/obj/effect/turf_decal/bot_white,
/obj/machinery/light/cold/directional/east,
/turf/open/floor/iron/dark/smooth_large,
/area/shuttle/personally_bought/private_liner)
"DN" = (
/obj/structure/marker_beacon/burgundy,
/turf/closed/wall/mineral/titanium/nodiagonal,
/area/shuttle/personally_bought/private_liner)
"FD" = (
/obj/effect/turf_decal/delivery/white,
/obj/machinery/door/airlock/corporate,
/obj/structure/cable,
/obj/machinery/atmospherics/pipe/smart/manifold4w/supply/hidden/layer4,
/obj/machinery/atmospherics/pipe/smart/manifold4w/scrubbers/hidden/layer2,
/turf/open/floor/iron/dark/smooth_large,
/area/shuttle/personally_bought/private_liner)
"GB" = (
/obj/machinery/power/shuttle_engine/propulsion{
	dir = 8
	},
/obj/effect/turf_decal/stripes/line{
	dir = 10
	},
/turf/open/floor/plating/airless,
/area/shuttle/personally_bought/private_liner)
"GR" = (
/obj/machinery/power/shuttle_engine/heater{
	dir = 8
	},
/obj/effect/turf_decal/stripes/line{
	dir = 4
	},
/obj/effect/turf_decal/stripes/corner{
	dir = 1
	},
/turf/open/floor/plating/airless,
/area/shuttle/personally_bought/private_liner)
"HV" = (
/obj/machinery/power/shuttle_engine/heater{
	dir = 8
	},
/obj/effect/turf_decal/stripes/line{
	dir = 4
	},
/obj/structure/window/reinforced/plasma/spawner/directional/east,
/turf/open/floor/plating/airless,
/area/shuttle/personally_bought/private_liner)
"If" = (
/obj/structure/tank_dispenser,
/obj/machinery/light/cold/directional/north,
/obj/machinery/atmospherics/components/unary/vent_scrubber/on/layer2,
/turf/open/floor/iron/dark/smooth_large,
/area/shuttle/personally_bought/private_liner)
"Ir" = (
/obj/effect/turf_decal/bot_red,
/obj/machinery/holopad,
/turf/open/floor/iron/dark/smooth_large,
/area/shuttle/personally_bought/private_liner)
"Jw" = (
/obj/structure/sink/kitchen/directional/west,
/obj/effect/turf_decal/bot_white,
/obj/machinery/atmospherics/pipe/smart/manifold4w/supply/hidden/layer4,
/obj/machinery/atmospherics/components/unary/vent_scrubber/on/layer2{
	dir = 8
	},
/turf/open/floor/iron/dark/smooth_large,
/area/shuttle/personally_bought/private_liner)
"JA" = (
/obj/structure/railing/eva_handhold/directional/south,
/turf/closed/wall/mineral/titanium/nodiagonal,
/area/shuttle/personally_bought/private_liner)
"JC" = (
/obj/machinery/vending/cigarette,
/obj/effect/turf_decal/bot_white,
/turf/open/floor/iron/dark/smooth_large,
/area/shuttle/personally_bought/private_liner)
"JH" = (
/obj/structure/chair/comfy/shuttle,
/turf/open/floor/iron/smooth_large,
/area/shuttle/personally_bought/private_liner)
"Kc" = (
/obj/structure/bed/pod,
/obj/structure/curtain/bounty,
/obj/structure/secure_safe/directional/east,
/obj/effect/turf_decal/bot_white,
/turf/open/floor/iron/dark/smooth_large,
/area/shuttle/personally_bought/private_liner)
"Kk" = (
/turf/closed/wall/mineral/titanium/nodiagonal,
/area/shuttle/personally_bought/private_liner)
"KF" = (
/turf/template_noop,
/area/template_noop)
"KG" = (
/obj/effect/turf_decal/delivery/white,
/obj/machinery/atmospherics/pipe/smart/manifold4w/supply/hidden/layer4,
/obj/machinery/atmospherics/pipe/smart/manifold4w/scrubbers/hidden/layer2,
/obj/machinery/door/airlock/hatch,
/turf/open/floor/iron/dark/smooth_large,
/area/shuttle/personally_bought/private_liner)
"KM" = (
/obj/structure/fluff/metalpole/end{
	dir = 4;
	pixel_x = 32
	},
/turf/closed/wall/mineral/titanium/nodiagonal,
/area/shuttle/personally_bought/private_liner)
"KO" = (
/obj/structure/closet/crate/cardboard,
/obj/item/storage/box/colonial_rations,
/obj/item/storage/box/colonial_rations,
/obj/item/plate,
/obj/item/plate,
/obj/item/storage/box/utensils,
/obj/item/storage/box/utensils,
/obj/item/storage/box/utensils,
/obj/item/storage/box/utensils,
/obj/effect/turf_decal/bot_white,
/turf/open/floor/iron/dark/smooth_large,
/area/shuttle/personally_bought/private_liner)
"KY" = (
/obj/structure/rack/shelf,
/obj/item/storage/toolbox/emergency,
/obj/item/binoculars,
/obj/item/trench_tool,
/obj/effect/turf_decal/bot_white,
/obj/structure/secure_safe/directional/north,
/turf/open/floor/iron/dark/smooth_large,
/area/shuttle/personally_bought/private_liner)
"LQ" = (
/obj/structure/table/reinforced,
/obj/machinery/microwave,
/turf/open/floor/iron/dark/smooth_large,
/area/shuttle/personally_bought/private_liner)
"LV" = (
/obj/machinery/vending/cola/black,
/obj/effect/turf_decal/bot_white,
/turf/open/floor/iron/dark/smooth_large,
/area/shuttle/personally_bought/private_liner)
"Mx" = (
/obj/structure/table/reinforced,
/obj/item/toy/cards/deck,
/turf/open/floor/iron/dark/smooth_large,
/area/shuttle/personally_bought/private_liner)
"MM" = (
/obj/structure/chair/comfy/shuttle{
	dir = 1
	},
/turf/open/floor/iron/smooth_large,
/area/shuttle/personally_bought/private_liner)
"NC" = (
/obj/structure/fluff/metalpole/end{
	dir = 1;
	pixel_y = 32
	},
/turf/open/floor/engine/hull/shuttle_white_plate,
/area/shuttle/personally_bought/private_liner)
"Oi" = (
/obj/structure/railing/eva_handhold/directional/north,
/turf/closed/wall/mineral/titanium/nodiagonal,
/area/shuttle/personally_bought/private_liner)
"Os" = (
/obj/structure/table/reinforced,
/obj/machinery/recharger,
/turf/open/floor/iron/dark/smooth_large,
/area/shuttle/personally_bought/private_liner)
"Ov" = (
/obj/machinery/power/shuttle_engine/propulsion{
	dir = 8
	},
/obj/effect/turf_decal/stripes/line{
	dir = 8
	},
/obj/effect/turf_decal/stripes/corner{
	dir = 4
	},
/turf/open/floor/plating/airless,
/area/shuttle/personally_bought/private_liner)
"OC" = (
/obj/structure/marker_beacon/olive,
/turf/closed/wall/mineral/plastitanium,
/area/shuttle/personally_bought/private_liner)
"OH" = (
/obj/structure/table/reinforced,
/obj/item/paper_bin/carbon,
/obj/item/pen/fourcolor,
/obj/machinery/light/warm/directional/north,
/obj/machinery/button/door/personal_shuttle_windows/directional/north,
/turf/open/floor/iron/dark/smooth_large,
/area/shuttle/personally_bought/private_liner)
"OX" = (
/obj/structure/fluff/metalpole/end{
	dir = 1;
	pixel_y = 32
	},
/turf/closed/wall/mineral/titanium/nodiagonal,
/area/shuttle/personally_bought/private_liner)
"Po" = (
/obj/structure/closet/crate/engineering/electrical,
/obj/item/stack/sheet/mineral/plasma/thirty,
/obj/item/flatpacked_machine/rtg,
/obj/item/flatpacked_machine/rtg,
/obj/effect/turf_decal/bot_white,
/obj/machinery/airalarm/directional/north,
/obj/effect/mapping_helpers/airalarm/all_access,
/obj/machinery/light/cold/directional/north,
/obj/machinery/atmospherics/components/unary/vent_pump/on/layer4,
/obj/machinery/atmospherics/pipe/smart/manifold4w/scrubbers/hidden/layer2,
/turf/open/floor/iron/dark/smooth_large,
/area/shuttle/personally_bought/private_liner)
"Py" = (
/obj/effect/turf_decal/delivery/white,
/obj/machinery/door/airlock/hatch,
/obj/machinery/atmospherics/pipe/smart/manifold4w/supply/hidden/layer4,
/obj/machinery/atmospherics/pipe/smart/manifold4w/scrubbers/hidden/layer2,
/turf/open/floor/iron/dark/smooth_large,
/area/shuttle/personally_bought/private_liner)
"PT" = (
/obj/machinery/atmospherics/pipe/smart/manifold4w/scrubbers/hidden/layer2,
/obj/machinery/atmospherics/pipe/smart/manifold4w/supply/hidden/layer4,
/obj/machinery/meter/layer4,
/obj/structure/closet/secure_closet/wall/personal_shuttle/directional/west,
/obj/effect/turf_decal/bot,
/turf/open/floor/iron/dark/smooth_large,
/area/shuttle/personally_bought/private_liner)
"QV" = (
/obj/structure/fluff/metalpole/end{
	dir = 1;
	pixel_y = 32
	},
/turf/closed/wall/mineral/plastitanium/nodiagonal,
/area/shuttle/personally_bought/private_liner)
"RH" = (
/obj/machinery/power/shuttle_engine/heater{
	dir = 8
	},
/obj/structure/window/reinforced/plasma/spawner/directional/east,
/obj/effect/turf_decal/stripes/line{
	dir = 5
	},
/turf/open/floor/plating/airless,
/area/shuttle/personally_bought/private_liner)
"RQ" = (
/obj/machinery/computer/shuttle/personally_bought,
/obj/effect/turf_decal/bot_white,
/turf/open/floor/iron/dark/smooth_large,
/area/shuttle/personally_bought/private_liner)
"Ti" = (
/turf/closed/wall/mineral/plastitanium/nodiagonal,
/area/shuttle/personally_bought/private_liner)
"TL" = (
/obj/effect/turf_decal/bot_white,
/obj/effect/spawner/random/structure/tank_holder,
/obj/structure/railing{
	dir = 8
	},
/obj/machinery/light/red/dim/directional/east,
/obj/machinery/atmospherics/components/unary/vent_pump/on/layer4{
	dir = 8
	},
/turf/open/floor/iron/dark/smooth_large,
/area/shuttle/personally_bought/private_liner)
"VJ" = (
/obj/effect/turf_decal/delivery/white,
/obj/machinery/door/airlock/external,
/obj/effect/mapping_helpers/airlock/cyclelink_helper{
	dir = 1
	},
/obj/docking_port/mobile/personally_bought,
/turf/open/floor/iron/dark/smooth_large,
/area/shuttle/personally_bought/private_liner)
"WW" = (
/obj/structure/fluff/metalpole/end{
	pixel_y = -32
	},
/turf/closed/wall/mineral/plastitanium/nodiagonal,
/area/shuttle/personally_bought/private_liner)
"Xf" = (
/obj/machinery/atmospherics/components/unary/vent_scrubber/on/layer2{
	dir = 1
	},
/turf/open/floor/iron/smooth_large,
/area/shuttle/personally_bought/private_liner)
"Xu" = (
/obj/machinery/power/smes/battery_pack/large/precharged,
/obj/structure/cable,
/obj/effect/turf_decal/bot_white,
/turf/open/floor/iron/dark/smooth_large,
/area/shuttle/personally_bought/private_liner)
"Xy" = (
/obj/machinery/atmospherics/pipe/smart/manifold4w/scrubbers/hidden/layer2,
/obj/machinery/atmospherics/pipe/smart/manifold4w/supply/hidden/layer4,
/obj/effect/turf_decal/delivery/white,
/obj/machinery/door/airlock/atmos,
/turf/open/floor/iron/dark/smooth_large,
/area/shuttle/personally_bought/private_liner)
"YJ" = (
/obj/structure/closet/emcloset/wall/personal_shuttle/directional/north,
/obj/effect/turf_decal/bot,
/obj/machinery/atmospherics/pipe/smart/manifold4w/supply/hidden/layer4,
/obj/machinery/atmospherics/pipe/smart/manifold4w/scrubbers/hidden/layer2,
/turf/open/floor/iron/dark/smooth_large,
/area/shuttle/personally_bought/private_liner)
"YM" = (
/obj/structure/closet/secure_closet/personal,
/obj/effect/turf_decal/bot_white,
/obj/machinery/atmospherics/components/unary/vent_pump/on/layer4,
/turf/open/floor/iron/dark/smooth_large,
/area/shuttle/personally_bought/private_liner)
"ZM" = (
/obj/structure/cable,
/obj/machinery/atmospherics/pipe/smart/manifold4w/supply/hidden/layer4,
/obj/machinery/atmospherics/pipe/smart/manifold4w/scrubbers/hidden/layer2,
/turf/open/floor/iron/smooth_large,
/area/shuttle/personally_bought/private_liner)

(1,1,1) = {"
KF
KF
KF
KF
KF
KF
kS
GB
KF
KF
KF
"}
(2,1,1) = {"
KF
KF
KF
ea
ig
km
GR
rS
Ov
ig
OC
"}
(3,1,1) = {"
KF
KF
KF
QV
HV
am
Ti
Ti
RH
HV
WW
"}
(4,1,1) = {"
KF
KF
KF
Ti
sZ
BU
Xy
PT
fb
vJ
Ti
"}
(5,1,1) = {"
KF
vN
Kk
Kk
Kk
DI
Kk
Po
ZM
Xu
Kk
"}
(6,1,1) = {"
hy
Kk
KY
Os
Kk
Kk
Kk
Kk
vM
Kk
Kk
"}
(7,1,1) = {"
Oi
jj
MM
iB
tf
bf
dc
eb
ZM
KO
JA
"}
(8,1,1) = {"
dc
RQ
Ir
mP
wn
DH
FD
ZM
qV
bg
Kk
"}
(9,1,1) = {"
mh
dc
cP
Kk
Kk
Kk
Kk
Py
Kk
Kk
Kk
"}
(10,1,1) = {"
KF
KF
KF
Kk
OH
ul
Kk
nC
JH
dP
dc
"}
(11,1,1) = {"
KF
KF
KF
dc
ae
bU
ic
tZ
pn
JC
dc
"}
(12,1,1) = {"
KF
KF
KF
dc
YM
vh
Kk
cG
LV
Kk
bl
"}
(13,1,1) = {"
KF
KF
KF
DN
Kk
KG
Kk
YJ
Xf
fh
dc
"}
(14,1,1) = {"
KF
KF
KF
Oi
zT
Jw
Kk
rx
LQ
zu
JA
"}
(15,1,1) = {"
KF
KF
KF
OX
Kk
Kk
Kk
Py
Kk
Kk
yv
"}
(16,1,1) = {"
KF
KF
KF
tm
vq
fG
tZ
tZ
st
sF
VJ
"}
(17,1,1) = {"
KF
KF
KF
Oi
cH
dc
bQ
tZ
dc
TL
JA
"}
(18,1,1) = {"
KF
KF
KF
hy
Kk
Kk
If
tZ
Kk
Kk
tN
"}
(19,1,1) = {"
KF
KF
KF
KF
NC
Kk
Kk
Py
Kk
Ct
KF
"}
(20,1,1) = {"
KF
KF
KF
Kk
Kk
Kk
Mx
CR
Kk
Kk
Kk
"}
(21,1,1) = {"
KF
KF
KF
hy
Kk
wI
vf
tZ
AG
Kk
tN
"}
(22,1,1) = {"
KF
KF
KF
KF
Oi
Kc
Kc
oO
Aq
JA
KF
"}
(23,1,1) = {"
KF
KF
KF
KF
vN
KM
Kk
Kk
KM
vN
KF
"}
