//MAP CONVERTED BY dmm2tgm.py THIS HEADER COMMENT PREVENTS RECONVERSION, DO NOT REMOVE
"ae" = (
/obj/structure/chair/comfy/shuttle{
	dir = 8
	},
/obj/effect/turf_decal/bot_white,
/turf/open/floor/iron/dark/smooth_large,
/area/shuttle/personally_bought/people_mover)
"ai" = (
/obj/structure/chair/comfy/shuttle{
	dir = 8
	},
/obj/machinery/atmospherics/components/unary/vent_scrubber/on/layer2{
	dir = 8
	},
/obj/effect/turf_decal/bot_white,
/turf/open/floor/iron/dark/smooth_large,
/area/shuttle/personally_bought/people_mover)
"aL" = (
/obj/machinery/portable_atmospherics/canister/air,
/obj/machinery/atmospherics/components/unary/portables_connector/visible/layer4,
/obj/effect/turf_decal/bot_white,
/obj/structure/extinguisher_cabinet/directional/north,
/obj/machinery/light/cold/directional/north,
/turf/open/floor/iron/dark/smooth_large,
/area/shuttle/personally_bought/people_mover)
"co" = (
/obj/structure/fluff/metalpole/end{
	dir = 4;
	pixel_x = 32
	},
/obj/machinery/porta_turret/centcom_shuttle/weak{
	dir = 4
	},
/turf/closed/wall/mineral/titanium/nodiagonal,
/area/shuttle/personally_bought/people_mover)
"dh" = (
/obj/machinery/atmospherics/pipe/smart/manifold4w/supply/hidden/layer4,
/obj/machinery/atmospherics/pipe/smart/manifold4w/scrubbers/hidden/layer2,
/turf/open/floor/catwalk_floor/iron_dark,
/area/shuttle/personally_bought/people_mover)
"dR" = (
/obj/machinery/atmospherics/pipe/smart/manifold4w/supply/hidden/layer4,
/obj/machinery/atmospherics/components/unary/vent_scrubber/on/layer2{
	dir = 1
	},
/turf/open/floor/iron/smooth_large,
/area/shuttle/personally_bought/people_mover)
"hR" = (
/obj/structure/railing/eva_handhold/directional/south,
/turf/closed/wall/mineral/plastitanium/nodiagonal,
/area/shuttle/personally_bought/people_mover)
"ie" = (
/obj/machinery/power/shuttle_engine/heater{
	dir = 8
	},
/obj/structure/window/reinforced/plasma/spawner/directional/east,
/obj/effect/turf_decal/stripes/line{
	dir = 5
	},
/turf/open/floor/plating/airless,
/area/shuttle/personally_bought/people_mover)
"iJ" = (
/obj/machinery/atmospherics/components/unary/vent_pump/on/layer4,
/obj/machinery/light_switch/directional/north,
/turf/open/floor/iron/smooth_large,
/area/shuttle/personally_bought/people_mover)
"iX" = (
/obj/machinery/portable_atmospherics/canister,
/obj/machinery/atmospherics/components/unary/portables_connector/visible/layer2,
/obj/effect/turf_decal/bot_white,
/turf/open/floor/iron/dark/smooth_large,
/area/shuttle/personally_bought/people_mover)
"jx" = (
/obj/structure/marker_beacon/olive,
/turf/closed/wall/mineral/titanium,
/area/shuttle/personally_bought/people_mover)
"jM" = (
/obj/item/radio/intercom/directional/south,
/obj/structure/chair/comfy/shuttle{
	dir = 1
	},
/obj/structure/cable,
/turf/open/floor/iron/smooth_large,
/area/shuttle/personally_bought/people_mover)
"mf" = (
/obj/structure/marker_beacon/burgundy,
/turf/closed/wall/mineral/plastitanium,
/area/shuttle/personally_bought/people_mover)
"mr" = (
/obj/effect/turf_decal/bot,
/obj/structure/closet/firecloset/wall/personal_shuttle/directional/west,
/turf/open/floor/iron/dark/smooth_large,
/area/shuttle/personally_bought/people_mover)
"np" = (
/obj/structure/marker_beacon/burgundy,
/turf/closed/wall/mineral/titanium,
/area/shuttle/personally_bought/people_mover)
"nC" = (
/obj/machinery/power/shuttle_engine/heater{
	dir = 8
	},
/obj/effect/turf_decal/stripes/corner{
	dir = 1
	},
/obj/effect/turf_decal/stripes/line{
	dir = 4
	},
/turf/open/floor/plating/airless,
/area/shuttle/personally_bought/people_mover)
"or" = (
/obj/machinery/power/terminal{
	dir = 4
	},
/obj/structure/cable,
/turf/open/floor/iron/smooth_large,
/area/shuttle/personally_bought/people_mover)
"ow" = (
/obj/structure/cable,
/obj/effect/turf_decal/bot_white,
/obj/structure/extinguisher_cabinet/directional/east,
/obj/machinery/power/smes/battery_pack/large/precharged,
/turf/open/floor/iron/dark/smooth_large,
/area/shuttle/personally_bought/people_mover)
"oI" = (
/obj/structure/fluff/metalpole/end{
	dir = 8;
	pixel_x = -32
	},
/turf/closed/wall/mineral/plastitanium/nodiagonal,
/area/shuttle/personally_bought/people_mover)
"pf" = (
/obj/effect/turf_decal/delivery/white,
/obj/machinery/door/airlock/external,
/obj/effect/mapping_helpers/airlock/cyclelink_helper{
	dir = 1
	},
/obj/docking_port/mobile/personally_bought,
/turf/open/floor/iron/dark/smooth_large,
/area/shuttle/personally_bought/people_mover)
"pg" = (
/obj/machinery/power/shuttle_engine/propulsion{
	dir = 8
	},
/obj/effect/turf_decal/stripes/line{
	dir = 9
	},
/turf/open/floor/plating/airless,
/area/shuttle/personally_bought/people_mover)
"pl" = (
/obj/structure/table/reinforced,
/obj/machinery/recharger,
/obj/machinery/light/warm/directional/south,
/turf/open/floor/iron/dark/smooth_large,
/area/shuttle/personally_bought/people_mover)
"qy" = (
/obj/structure/cable,
/obj/machinery/atmospherics/pipe/smart/manifold4w/supply/hidden/layer4,
/obj/machinery/atmospherics/pipe/smart/manifold4w/scrubbers/hidden/layer2,
/turf/open/floor/iron/smooth_large,
/area/shuttle/personally_bought/people_mover)
"sa" = (
/obj/structure/cable,
/obj/machinery/atmospherics/components/unary/vent_scrubber/on/layer2{
	dir = 8
	},
/turf/open/floor/iron/smooth_large,
/area/shuttle/personally_bought/people_mover)
"us" = (
/obj/machinery/atmospherics/pipe/smart/manifold4w/supply/hidden/layer4,
/obj/machinery/atmospherics/pipe/smart/manifold4w/scrubbers/hidden/layer2,
/obj/effect/turf_decal/delivery/white,
/obj/machinery/door/airlock/external,
/obj/effect/mapping_helpers/airlock/cyclelink_helper,
/turf/open/floor/iron/dark/smooth_large,
/area/shuttle/personally_bought/people_mover)
"ux" = (
/obj/machinery/power/shuttle_engine/propulsion{
	dir = 8
	},
/obj/effect/turf_decal/stripes/line{
	dir = 8
	},
/obj/effect/turf_decal/stripes/corner{
	dir = 4
	},
/turf/open/floor/plating/airless,
/area/shuttle/personally_bought/people_mover)
"uy" = (
/obj/structure/marker_beacon/olive,
/turf/closed/wall/mineral/plastitanium,
/area/shuttle/personally_bought/people_mover)
"uI" = (
/obj/machinery/portable_atmospherics/canister/air,
/obj/machinery/atmospherics/components/unary/portables_connector/visible/layer4,
/obj/effect/turf_decal/bot_white,
/turf/open/floor/iron/dark/smooth_large,
/area/shuttle/personally_bought/people_mover)
"vv" = (
/obj/machinery/power/shuttle_engine/heater{
	dir = 8
	},
/obj/effect/turf_decal/stripes/corner{
	dir = 8
	},
/obj/effect/turf_decal/stripes/line{
	dir = 4
	},
/turf/open/floor/plating/airless,
/area/shuttle/personally_bought/people_mover)
"vU" = (
/obj/machinery/power/shuttle_engine/propulsion{
	dir = 8
	},
/obj/effect/turf_decal/stripes/line{
	dir = 8
	},
/obj/structure/fluff/metalpole/end{
	dir = 8;
	pixel_x = -32
	},
/turf/open/floor/plating/airless,
/area/shuttle/personally_bought/people_mover)
"xe" = (
/obj/machinery/power/shuttle_engine/heater{
	dir = 8
	},
/obj/effect/turf_decal/stripes/line{
	dir = 4
	},
/obj/structure/window/reinforced/plasma/spawner/directional/east,
/turf/open/floor/plating/airless,
/area/shuttle/personally_bought/people_mover)
"xj" = (
/obj/structure/chair/comfy/shuttle{
	dir = 8
	},
/obj/machinery/atmospherics/components/unary/vent_pump/on/layer4{
	dir = 8
	},
/obj/effect/turf_decal/bot_white,
/obj/structure/extinguisher_cabinet/directional/east,
/obj/machinery/light/warm/directional/east,
/turf/open/floor/iron/dark/smooth_large,
/area/shuttle/personally_bought/people_mover)
"xz" = (
/obj/machinery/power/terminal{
	dir = 4
	},
/obj/structure/cable,
/obj/machinery/light/cold/directional/south,
/turf/open/floor/iron/smooth_large,
/area/shuttle/personally_bought/people_mover)
"xN" = (
/obj/effect/spawner/structure/window/reinforced/shuttle,
/obj/structure/cable,
/obj/machinery/door/poddoor/preopen/personal_shuttle_windows,
/turf/open/floor/plating,
/area/shuttle/personally_bought/people_mover)
"zg" = (
/obj/structure/chair/comfy/shuttle{
	dir = 4
	},
/obj/effect/turf_decal/bot_white,
/turf/open/floor/iron/dark/smooth_large,
/area/shuttle/personally_bought/people_mover)
"Bq" = (
/obj/structure/cable,
/obj/machinery/atmospherics/pipe/smart/manifold4w/supply/hidden/layer4,
/obj/machinery/atmospherics/pipe/smart/manifold4w/scrubbers/hidden/layer2,
/obj/machinery/meter/layer4,
/obj/machinery/button/door/personal_shuttle_windows/directional/east,
/turf/open/floor/iron/smooth_large,
/area/shuttle/personally_bought/people_mover)
"BK" = (
/obj/structure/railing/eva_handhold/directional/north,
/turf/closed/wall/mineral/plastitanium/nodiagonal,
/area/shuttle/personally_bought/people_mover)
"Db" = (
/obj/machinery/computer/shuttle/personally_bought,
/obj/effect/turf_decal/bot_white,
/turf/open/floor/iron/dark/smooth_large,
/area/shuttle/personally_bought/people_mover)
"DE" = (
/obj/machinery/atmospherics/pipe/smart/manifold4w/supply/hidden/layer4,
/obj/machinery/atmospherics/pipe/smart/manifold4w/scrubbers/hidden/layer2,
/turf/open/floor/iron/smooth_large,
/area/shuttle/personally_bought/people_mover)
"Es" = (
/obj/structure/cable,
/obj/effect/turf_decal/bot_white,
/obj/machinery/power/smes/battery_pack/large/precharged,
/turf/open/floor/iron/dark/smooth_large,
/area/shuttle/personally_bought/people_mover)
"EW" = (
/obj/machinery/power/shuttle_engine/heater{
	dir = 8
	},
/obj/structure/window/reinforced/plasma/spawner/directional/east,
/obj/effect/turf_decal/stripes/line{
	dir = 6
	},
/obj/machinery/atmospherics/pipe/smart/manifold4w/scrubbers/hidden/layer2,
/turf/open/floor/plating/airless,
/area/shuttle/personally_bought/people_mover)
"Fl" = (
/obj/structure/rack/shelf,
/obj/item/storage/toolbox/emergency,
/obj/item/binoculars,
/obj/item/trench_tool,
/obj/effect/turf_decal/bot_white,
/obj/structure/secure_safe/directional/north,
/obj/structure/extinguisher_cabinet/directional/west,
/turf/open/floor/iron/dark/smooth_large,
/area/shuttle/personally_bought/people_mover)
"Fw" = (
/turf/closed/wall/mineral/titanium/nodiagonal,
/area/shuttle/personally_bought/people_mover)
"FC" = (
/turf/closed/wall/mineral/plastitanium/nodiagonal,
/area/shuttle/personally_bought/people_mover)
"Gc" = (
/obj/structure/closet/crate/engineering/electrical,
/obj/effect/turf_decal/bot_white,
/obj/item/stack/sheet/mineral/plasma/thirty,
/obj/item/flatpacked_machine/rtg,
/obj/item/flatpacked_machine/rtg,
/turf/open/floor/iron/dark/smooth_large,
/area/shuttle/personally_bought/people_mover)
"Gg" = (
/obj/structure/marker_beacon/bronze,
/turf/closed/wall/mineral/titanium,
/area/shuttle/personally_bought/people_mover)
"GF" = (
/obj/machinery/suit_storage_unit/industrial,
/obj/machinery/atmospherics/pipe/smart/manifold4w/scrubbers/hidden/layer2,
/obj/effect/turf_decal/bot_white,
/turf/open/floor/iron/dark/smooth_large,
/area/shuttle/personally_bought/people_mover)
"GK" = (
/obj/machinery/autolathe,
/obj/effect/turf_decal/bot_white,
/obj/machinery/light_switch/directional/west,
/turf/open/floor/iron/dark/smooth_large,
/area/shuttle/personally_bought/people_mover)
"HJ" = (
/obj/effect/turf_decal/bot_red,
/obj/machinery/holopad,
/obj/structure/cable,
/obj/machinery/button/door/personal_shuttle_windows/directional/north,
/turf/open/floor/iron/dark/smooth_large,
/area/shuttle/personally_bought/people_mover)
"HL" = (
/obj/effect/spawner/random/structure/tank_holder,
/obj/machinery/atmospherics/components/unary/vent_pump/on/layer4{
	dir = 8
	},
/obj/effect/turf_decal/bot_white,
/obj/structure/extinguisher_cabinet/directional/north,
/obj/structure/railing{
	dir = 8
	},
/turf/open/floor/iron/dark/smooth_large,
/area/shuttle/personally_bought/people_mover)
"HN" = (
/obj/structure/cable,
/obj/machinery/atmospherics/pipe/smart/manifold4w/supply/hidden/layer4,
/obj/machinery/atmospherics/pipe/smart/manifold4w/scrubbers/hidden/layer2,
/obj/effect/turf_decal/delivery/white,
/obj/machinery/door/airlock/hatch,
/turf/open/floor/iron/dark/smooth_large,
/area/shuttle/personally_bought/people_mover)
"Ix" = (
/obj/machinery/atmospherics/pipe/smart/manifold4w/scrubbers/hidden/layer2,
/obj/machinery/meter/layer2,
/turf/open/floor/iron/smooth_large,
/area/shuttle/personally_bought/people_mover)
"IA" = (
/obj/machinery/modular_computer/preset/engineering{
	dir = 1
	},
/obj/structure/cable,
/obj/effect/turf_decal/bot_white,
/obj/machinery/digital_clock/directional/south,
/turf/open/floor/iron/dark/smooth_large,
/area/shuttle/personally_bought/people_mover)
"Lj" = (
/obj/machinery/atmospherics/pipe/smart/manifold4w/supply/hidden/layer4,
/obj/effect/turf_decal/bot,
/obj/structure/closet/secure_closet/wall/personal_shuttle/directional/east,
/turf/open/floor/iron/dark/smooth_large,
/area/shuttle/personally_bought/people_mover)
"Lt" = (
/obj/structure/railing/eva_handhold/directional/north,
/turf/closed/wall/mineral/titanium/nodiagonal,
/area/shuttle/personally_bought/people_mover)
"LJ" = (
/obj/structure/fluff/metalpole/end{
	dir = 4;
	pixel_x = 32
	},
/turf/closed/wall/mineral/titanium/nodiagonal,
/area/shuttle/personally_bought/people_mover)
"MF" = (
/turf/closed/wall/mineral/titanium,
/area/shuttle/personally_bought/people_mover)
"MT" = (
/obj/structure/chair/comfy/shuttle{
	dir = 4
	},
/obj/machinery/atmospherics/components/unary/vent_scrubber/on/layer2{
	dir = 4
	},
/obj/effect/turf_decal/bot_white,
/obj/machinery/digital_clock/directional/west,
/obj/machinery/light/warm/directional/west,
/turf/open/floor/iron/dark/smooth_large,
/area/shuttle/personally_bought/people_mover)
"NL" = (
/obj/structure/cable,
/obj/structure/closet/crate/large/import,
/obj/item/flatpacked_machine/fuel_generator,
/turf/open/floor/plating,
/area/shuttle/personally_bought/people_mover)
"Ok" = (
/obj/machinery/power/shuttle_engine/propulsion{
	dir = 8
	},
/obj/effect/turf_decal/stripes/line{
	dir = 10
	},
/turf/open/floor/plating/airless,
/area/shuttle/personally_bought/people_mover)
"Qc" = (
/obj/structure/cable,
/obj/machinery/power/apc/auto_name/directional/west,
/obj/machinery/atmospherics/pipe/smart/manifold4w/supply/hidden/layer4,
/obj/machinery/atmospherics/pipe/smart/manifold4w/scrubbers/hidden/layer2,
/obj/machinery/airalarm/directional/east,
/obj/effect/mapping_helpers/apc/cell_5k,
/obj/effect/mapping_helpers/apc/unlocked,
/obj/effect/mapping_helpers/airalarm/all_access,
/turf/open/floor/iron/smooth_large,
/area/shuttle/personally_bought/people_mover)
"Qw" = (
/obj/effect/turf_decal/bot,
/obj/structure/closet/emcloset/wall/personal_shuttle/directional/west,
/turf/open/floor/iron/dark/smooth_large,
/area/shuttle/personally_bought/people_mover)
"QF" = (
/obj/structure/railing/eva_handhold/directional/south,
/turf/closed/wall/mineral/titanium/nodiagonal,
/area/shuttle/personally_bought/people_mover)
"RY" = (
/obj/structure/cable,
/obj/machinery/atmospherics/pipe/smart/manifold4w/scrubbers/hidden/layer2,
/obj/machinery/atmospherics/components/unary/vent_pump/on/layer4{
	dir = 8
	},
/turf/open/floor/iron/smooth_large,
/area/shuttle/personally_bought/people_mover)
"Sd" = (
/obj/machinery/computer/camera_advanced/shuttle_docker/personally_bought,
/obj/effect/turf_decal/bot_white,
/turf/open/floor/iron/dark/smooth_large,
/area/shuttle/personally_bought/people_mover)
"Tw" = (
/turf/template_noop,
/area/template_noop)
"TM" = (
/obj/structure/closet/crate/cargo,
/obj/machinery/atmospherics/components/unary/vent_pump/on/layer4{
	dir = 4
	},
/obj/effect/turf_decal/bot_white,
/obj/machinery/airalarm/directional/west,
/obj/item/stack/sheet/glass/fifty,
/obj/item/stack/sheet/iron/fifty,
/obj/effect/mapping_helpers/airalarm/all_access,
/turf/open/floor/iron/dark/smooth_large,
/area/shuttle/personally_bought/people_mover)
"Wc" = (
/obj/machinery/power/shuttle_engine/propulsion{
	dir = 8
	},
/obj/effect/turf_decal/stripes/line{
	dir = 8
	},
/obj/effect/turf_decal/stripes/corner,
/obj/machinery/atmospherics/components/unary/passive_vent/layer2{
	dir = 4
	},
/turf/open/floor/plating/airless,
/area/shuttle/personally_bought/people_mover)
"WP" = (
/obj/machinery/atmospherics/pipe/smart/manifold4w/supply/hidden/layer4,
/obj/machinery/atmospherics/pipe/smart/manifold4w/scrubbers/hidden/layer2,
/obj/machinery/meter/layer4,
/turf/open/floor/iron/smooth_large,
/area/shuttle/personally_bought/people_mover)
"WY" = (
/obj/machinery/atmospherics/pipe/smart/manifold4w/supply/hidden/layer4,
/obj/machinery/atmospherics/pipe/smart/manifold4w/scrubbers/hidden/layer2,
/obj/effect/turf_decal/delivery/white,
/obj/machinery/door/airlock/hatch,
/turf/open/floor/iron/dark/smooth_large,
/area/shuttle/personally_bought/people_mover)
"ZI" = (
/obj/machinery/portable_atmospherics/canister/oxygen,
/obj/machinery/atmospherics/components/unary/vent_scrubber/on/layer2{
	dir = 4
	},
/obj/effect/turf_decal/bot_white,
/obj/machinery/light/red/dim/directional/west,
/turf/open/floor/iron/dark/smooth_large,
/area/shuttle/personally_bought/people_mover)

(1,1,1) = {"
Tw
Tw
Tw
Tw
pg
oI
Ok
Tw
Tw
Tw
Tw
"}
(2,1,1) = {"
Tw
mf
vU
Wc
nC
FC
vv
ux
vU
uy
Tw
"}
(3,1,1) = {"
Tw
FC
xe
EW
FC
FC
FC
ie
xe
FC
Tw
"}
(4,1,1) = {"
Tw
BK
iX
Ix
FC
GK
TM
Gc
NL
hR
Tw
"}
(5,1,1) = {"
Tw
FC
aL
WP
WY
DE
dR
or
xz
FC
Tw
"}
(6,1,1) = {"
Tw
Fw
uI
Lj
Fw
GF
qy
Es
ow
Fw
Tw
"}
(7,1,1) = {"
np
Fw
Fw
Fw
Fw
Fw
HN
Fw
Fw
Fw
jx
"}
(8,1,1) = {"
Lt
zg
MT
zg
Fw
mr
qy
Qw
Fw
ZI
QF
"}
(9,1,1) = {"
Fw
iJ
qy
Bq
Qc
qy
qy
DE
us
dh
pf
"}
(10,1,1) = {"
Lt
Fw
HN
Fw
Fw
ae
xj
ai
Fw
HL
QF
"}
(11,1,1) = {"
Fw
Fl
RY
IA
Fw
Fw
LJ
Fw
Fw
Fw
jx
"}
(12,1,1) = {"
xN
Sd
sa
pl
Fw
Tw
Tw
Tw
Fw
Fw
Tw
"}
(13,1,1) = {"
xN
Db
jM
Fw
MF
Tw
Tw
Tw
Gg
co
Tw
"}
(14,1,1) = {"
np
Fw
HJ
xN
Tw
Tw
Tw
Tw
Tw
Tw
Tw
"}
(15,1,1) = {"
Tw
MF
xN
LJ
Tw
Tw
Tw
Tw
Tw
Tw
Tw
"}
