//MAP CONVERTED BY dmm2tgm.py THIS HEADER COMMENT PREVENTS RECONVERSION, DO NOT REMOVE
"aC" = (
/obj/machinery/power/smes/battery_pack/large/precharged,
/obj/structure/cable,
/obj/effect/turf_decal/bot_white,
/turf/open/floor/iron/dark/smooth_large,
/area/shuttle/personally_bought/private_liner)
"aM" = (
/obj/structure/rack/shelf,
/obj/item/storage/toolbox/emergency,
/obj/item/binoculars,
/obj/item/trench_tool,
/obj/effect/turf_decal/bot_white,
/obj/structure/secure_safe/directional/north,
/turf/open/floor/iron/dark/smooth_large,
/area/shuttle/personally_bought/private_liner)
"cx" = (
/obj/machinery/atmospherics/components/unary/vent_scrubber/on/layer2,
/turf/open/floor/iron/smooth_large,
/area/shuttle/personally_bought/private_liner)
"cH" = (
/obj/structure/marker_beacon/burgundy,
/turf/closed/wall/mineral/plastitanium,
/area/shuttle/personally_bought/private_liner)
"dy" = (
/obj/machinery/atmospherics/pipe/smart/manifold4w/scrubbers/hidden/layer2,
/obj/machinery/atmospherics/pipe/smart/manifold4w/supply/hidden/layer4,
/obj/effect/turf_decal/delivery/white,
/obj/machinery/door/airlock/atmos,
/turf/open/floor/iron/dark/smooth_large,
/area/shuttle/personally_bought/private_liner)
"ed" = (
/obj/machinery/power/shuttle_engine/propulsion{
	dir = 8
	},
/obj/effect/turf_decal/stripes/line{
	dir = 8
	},
/obj/effect/turf_decal/stripes/corner{
	dir = 4
	},
/turf/open/floor/plating/airless,
/area/shuttle/personally_bought/private_liner)
"ez" = (
/obj/machinery/atmospherics/pipe/smart/manifold4w/scrubbers/hidden/layer2,
/obj/machinery/atmospherics/pipe/smart/manifold4w/supply/hidden/layer4,
/obj/machinery/meter/layer4,
/obj/structure/closet/secure_closet/wall/personal_shuttle/directional/west,
/obj/effect/turf_decal/bot,
/turf/open/floor/iron/dark/smooth_large,
/area/shuttle/personally_bought/private_liner)
"fQ" = (
/obj/machinery/modular_computer/preset/civilian{
	dir = 4
	},
/obj/effect/turf_decal/bot_white,
/turf/open/floor/iron/dark/smooth_large,
/area/shuttle/personally_bought/private_liner)
"fR" = (
/obj/effect/turf_decal/delivery/white,
/obj/structure/cable,
/obj/machinery/door/airlock/hatch,
/obj/machinery/atmospherics/pipe/smart/manifold4w/supply/hidden/layer4,
/obj/machinery/atmospherics/pipe/smart/manifold4w/scrubbers/hidden/layer2,
/turf/open/floor/iron/dark/smooth_large,
/area/shuttle/personally_bought/private_liner)
"gb" = (
/obj/structure/fluff/metalpole/end{
	dir = 1;
	pixel_y = 32
	},
/turf/open/floor/engine/hull/shuttle_white_plate,
/area/shuttle/personally_bought/private_liner)
"gA" = (
/obj/machinery/light/warm/directional/east,
/obj/item/radio/intercom/directional/east,
/obj/machinery/atmospherics/components/unary/vent_pump/on/layer4,
/turf/open/floor/iron/smooth_large,
/area/shuttle/personally_bought/private_liner)
"hj" = (
/obj/effect/turf_decal/delivery/white,
/obj/machinery/door/airlock/corporate,
/obj/structure/cable,
/obj/machinery/atmospherics/pipe/smart/manifold4w/supply/hidden/layer4,
/obj/machinery/atmospherics/pipe/smart/manifold4w/scrubbers/hidden/layer2,
/turf/open/floor/iron/dark/smooth_large,
/area/shuttle/personally_bought/private_liner)
"hN" = (
/obj/machinery/power/shuttle_engine/heater{
	dir = 8
	},
/obj/structure/window/reinforced/plasma/spawner/directional/east,
/obj/effect/turf_decal/stripes/line{
	dir = 5
	},
/turf/open/floor/plating/airless,
/area/shuttle/personally_bought/private_liner)
"ii" = (
/obj/structure/closet/emcloset/wall/personal_shuttle/directional/north,
/obj/effect/turf_decal/bot,
/obj/machinery/airalarm/directional/west,
/obj/effect/mapping_helpers/airalarm/all_access,
/turf/open/floor/iron/dark/smooth_large,
/area/shuttle/personally_bought/private_liner)
"iW" = (
/obj/machinery/shower/directional/north,
/obj/structure/sink/kitchen/directional/east,
/obj/structure/curtain,
/obj/structure/drain,
/obj/effect/turf_decal/bot_white,
/turf/open/floor/iron/dark/smooth_large,
/area/shuttle/personally_bought/private_liner)
"kk" = (
/obj/structure/closet/secure_closet/personal,
/obj/effect/turf_decal/bot_white,
/obj/machinery/atmospherics/components/unary/vent_pump/on/layer4,
/turf/open/floor/iron/dark/smooth_large,
/area/shuttle/personally_bought/private_liner)
"kC" = (
/obj/effect/spawner/structure/window/reinforced/shuttle,
/obj/structure/fluff/metalpole/end{
	dir = 4;
	pixel_x = 32
	},
/obj/machinery/door/poddoor/preopen/personal_shuttle_windows,
/turf/open/floor/plating,
/area/shuttle/personally_bought/private_liner)
"kH" = (
/obj/machinery/airalarm/directional/north,
/obj/effect/mapping_helpers/airalarm/all_access,
/obj/machinery/atmospherics/pipe/smart/manifold4w/supply/hidden/layer4,
/obj/machinery/atmospherics/pipe/smart/manifold4w/scrubbers/hidden/layer2,
/turf/open/floor/iron/smooth_large,
/area/shuttle/personally_bought/private_liner)
"kP" = (
/obj/machinery/vending/cigarette,
/obj/effect/turf_decal/bot_white,
/turf/open/floor/iron/dark/smooth_large,
/area/shuttle/personally_bought/private_liner)
"lD" = (
/obj/machinery/power/shuttle_engine/propulsion{
	dir = 8
	},
/obj/effect/turf_decal/stripes/line{
	dir = 9
	},
/turf/open/floor/plating/airless,
/area/shuttle/personally_bought/private_liner)
"lJ" = (
/obj/structure/closet/emcloset/wall/personal_shuttle/directional/north,
/obj/effect/turf_decal/bot,
/obj/machinery/atmospherics/pipe/smart/manifold4w/supply/hidden/layer4,
/obj/machinery/atmospherics/pipe/smart/manifold4w/scrubbers/hidden/layer2,
/turf/open/floor/iron/dark/smooth_large,
/area/shuttle/personally_bought/private_liner)
"lN" = (
/obj/machinery/power/terminal{
	dir = 4
	},
/obj/structure/closet/crate/large/import,
/obj/structure/cable,
/obj/item/flatpacked_machine/fuel_generator,
/turf/open/floor/plating,
/area/shuttle/personally_bought/private_liner)
"mi" = (
/obj/machinery/computer/crew{
	dir = 4
	},
/obj/effect/turf_decal/bot_white,
/obj/machinery/atmospherics/pipe/smart/manifold4w/scrubbers/hidden/layer2,
/turf/open/floor/iron/dark/smooth_large,
/area/shuttle/personally_bought/private_liner)
"mN" = (
/obj/effect/turf_decal/bot_red,
/obj/machinery/holopad,
/turf/open/floor/iron/dark/smooth_large,
/area/shuttle/personally_bought/private_liner)
"mW" = (
/turf/closed/wall/mineral/titanium/nodiagonal,
/area/shuttle/personally_bought/private_liner)
"na" = (
/obj/effect/turf_decal/bot_white,
/obj/effect/spawner/random/structure/tank_holder,
/obj/structure/railing{
	dir = 8
	},
/obj/machinery/light/red/dim/directional/east,
/obj/machinery/atmospherics/components/unary/vent_pump/on/layer4{
	dir = 8
	},
/turf/open/floor/iron/dark/smooth_large,
/area/shuttle/personally_bought/private_liner)
"oa" = (
/obj/effect/turf_decal/delivery/white,
/obj/machinery/door/airlock/external,
/obj/effect/mapping_helpers/airlock/cyclelink_helper{
	dir = 1
	},
/obj/machinery/atmospherics/pipe/smart/manifold4w/supply/hidden/layer4,
/obj/machinery/atmospherics/pipe/smart/manifold4w/scrubbers/hidden/layer2,
/turf/open/floor/iron/dark/smooth_large,
/area/shuttle/personally_bought/private_liner)
"oq" = (
/obj/machinery/computer/camera_advanced/shuttle_docker/personally_bought,
/obj/effect/turf_decal/bot_white,
/obj/machinery/button/door/personal_shuttle_windows/directional/north,
/turf/open/floor/iron/dark/smooth_large,
/area/shuttle/personally_bought/private_liner)
"oL" = (
/obj/machinery/light_switch/directional/north,
/obj/machinery/atmospherics/pipe/smart/manifold4w/supply/hidden/layer4,
/obj/machinery/atmospherics/pipe/smart/manifold4w/scrubbers/hidden/layer2,
/turf/open/floor/iron/smooth_large,
/area/shuttle/personally_bought/private_liner)
"oV" = (
/obj/machinery/power/shuttle_engine/heater{
	dir = 8
	},
/obj/structure/window/reinforced/plasma/spawner/directional/east,
/obj/effect/turf_decal/stripes/line{
	dir = 6
	},
/obj/machinery/atmospherics/pipe/smart/manifold4w/scrubbers/hidden/layer2,
/turf/open/floor/plating/airless,
/area/shuttle/personally_bought/private_liner)
"oW" = (
/obj/machinery/atmospherics/components/unary/vent_pump/on/layer4{
	dir = 1
	},
/turf/open/floor/iron/smooth_large,
/area/shuttle/personally_bought/private_liner)
"oZ" = (
/obj/structure/sink/kitchen/directional/west,
/obj/effect/turf_decal/bot_white,
/obj/machinery/atmospherics/pipe/smart/manifold4w/supply/hidden/layer4,
/obj/machinery/atmospherics/components/unary/vent_scrubber/on/layer2{
	dir = 8
	},
/turf/open/floor/iron/dark/smooth_large,
/area/shuttle/personally_bought/private_liner)
"pt" = (
/obj/structure/rack/shelf,
/obj/item/storage/medkit/combat_surgeon/stocked,
/obj/item/storage/medkit/frontier/stocked,
/obj/effect/turf_decal/bot_white,
/obj/structure/extinguisher_cabinet/directional/south,
/turf/open/floor/iron/dark/smooth_large,
/area/shuttle/personally_bought/private_liner)
"pN" = (
/obj/structure/marker_beacon/olive,
/turf/closed/wall/mineral/titanium,
/area/shuttle/personally_bought/private_liner)
"pU" = (
/obj/structure/chair/plastic{
	dir = 8
	},
/obj/machinery/atmospherics/components/unary/vent_pump/on/layer4,
/turf/open/floor/iron/smooth_large,
/area/shuttle/personally_bought/private_liner)
"qZ" = (
/obj/machinery/atmospherics/components/unary/portables_connector/visible/layer2,
/obj/machinery/portable_atmospherics/canister,
/obj/effect/turf_decal/bot_white,
/obj/structure/extinguisher_cabinet/directional/east,
/turf/open/floor/iron/dark/smooth_large,
/area/shuttle/personally_bought/private_liner)
"rF" = (
/obj/structure/fluff/metalpole/end{
	dir = 1;
	pixel_y = 32
	},
/turf/closed/wall/mineral/plastitanium/nodiagonal,
/area/shuttle/personally_bought/private_liner)
"sk" = (
/obj/machinery/light/cold/directional/east,
/obj/machinery/atmospherics/components/unary/vent_scrubber/on/layer2{
	dir = 8
	},
/turf/open/floor/iron/smooth_large,
/area/shuttle/personally_bought/private_liner)
"sn" = (
/obj/effect/turf_decal/delivery/white,
/obj/machinery/door/airlock/hatch,
/obj/machinery/atmospherics/pipe/smart/manifold4w/supply/hidden/layer4,
/obj/machinery/atmospherics/pipe/smart/manifold4w/scrubbers/hidden/layer2,
/turf/open/floor/iron/dark/smooth_large,
/area/shuttle/personally_bought/private_liner)
"sC" = (
/obj/structure/fluff/metalpole/end{
	pixel_y = -32
	},
/turf/closed/wall/mineral/titanium/nodiagonal,
/area/shuttle/personally_bought/private_liner)
"sH" = (
/obj/machinery/atmospherics/pipe/smart/manifold4w/supply/hidden/layer4,
/obj/machinery/atmospherics/components/unary/vent_scrubber/on/layer2{
	dir = 1
	},
/turf/open/floor/iron/smooth_large,
/area/shuttle/personally_bought/private_liner)
"tk" = (
/obj/machinery/vending/wallmed/directional/north,
/obj/machinery/light/warm/directional/north,
/obj/machinery/atmospherics/pipe/smart/manifold4w/supply/hidden/layer4,
/obj/machinery/atmospherics/pipe/smart/manifold4w/scrubbers/hidden/layer2,
/turf/open/floor/iron/smooth_large,
/area/shuttle/personally_bought/private_liner)
"tz" = (
/obj/structure/chair/comfy/shuttle{
	dir = 8
	},
/obj/machinery/atmospherics/pipe/smart/manifold4w/supply/hidden/layer4,
/obj/machinery/atmospherics/pipe/smart/manifold4w/scrubbers/hidden/layer2,
/turf/open/floor/iron/smooth_large,
/area/shuttle/personally_bought/private_liner)
"ug" = (
/obj/structure/marker_beacon/olive,
/turf/closed/wall/mineral/plastitanium,
/area/shuttle/personally_bought/private_liner)
"un" = (
/obj/structure/tank_dispenser,
/obj/machinery/light/cold/directional/north,
/obj/machinery/atmospherics/components/unary/vent_scrubber/on/layer2,
/turf/open/floor/iron/dark/smooth_large,
/area/shuttle/personally_bought/private_liner)
"vI" = (
/obj/machinery/power/shuttle_engine/heater{
	dir = 8
	},
/obj/effect/turf_decal/stripes/line{
	dir = 4
	},
/obj/structure/window/reinforced/plasma/spawner/directional/east,
/turf/open/floor/plating/airless,
/area/shuttle/personally_bought/private_liner)
"wX" = (
/obj/machinery/atmospherics/pipe/smart/manifold4w/supply/hidden/layer4,
/obj/machinery/atmospherics/pipe/smart/manifold4w/scrubbers/hidden/layer2,
/turf/open/floor/iron/smooth_large,
/area/shuttle/personally_bought/private_liner)
"xs" = (
/obj/machinery/power/shuttle_engine/heater{
	dir = 8
	},
/obj/effect/turf_decal/stripes/line{
	dir = 4
	},
/obj/effect/turf_decal/stripes/corner{
	dir = 8
	},
/turf/open/floor/plating/airless,
/area/shuttle/personally_bought/private_liner)
"xX" = (
/obj/machinery/power/shuttle_engine/propulsion{
	dir = 8
	},
/obj/effect/turf_decal/stripes/line{
	dir = 10
	},
/turf/open/floor/plating/airless,
/area/shuttle/personally_bought/private_liner)
"yo" = (
/obj/effect/spawner/random/structure/tank_holder,
/obj/effect/turf_decal/bot_white,
/obj/machinery/atmospherics/components/unary/vent_pump/on/layer4,
/obj/machinery/atmospherics/pipe/smart/manifold4w/scrubbers/hidden/layer2,
/turf/open/floor/iron/dark/smooth_large,
/area/shuttle/personally_bought/private_liner)
"yK" = (
/obj/structure/toilet{
	pixel_y = 8
	},
/obj/effect/turf_decal/bot_red,
/obj/machinery/light/warm/directional/east,
/obj/machinery/atmospherics/components/unary/vent_pump/on/layer4,
/turf/open/floor/iron/freezer,
/area/shuttle/personally_bought/private_liner)
"yW" = (
/obj/machinery/modular_computer/preset/engineering{
	dir = 4
	},
/obj/effect/turf_decal/bot_white,
/obj/structure/extinguisher_cabinet/directional/west,
/turf/open/floor/iron/dark/smooth_large,
/area/shuttle/personally_bought/private_liner)
"Aa" = (
/obj/structure/sign/poster/contraband/mothic_rations/directional/west,
/obj/structure/closet/crate/cardboard/mothic,
/obj/item/storage/box/mothic_rations,
/obj/item/coffee_cartridge/fancy,
/obj/item/coffee_cartridge/fancy,
/obj/item/coffee_cartridge/fancy,
/obj/effect/turf_decal/bot_white,
/turf/open/floor/iron/dark/smooth_large,
/area/shuttle/personally_bought/private_liner)
"Ae" = (
/obj/machinery/power/shuttle_engine/heater{
	dir = 8
	},
/obj/effect/turf_decal/stripes/line{
	dir = 4
	},
/obj/effect/turf_decal/stripes/corner{
	dir = 1
	},
/turf/open/floor/plating/airless,
/area/shuttle/personally_bought/private_liner)
"Bv" = (
/obj/effect/spawner/structure/window/reinforced/shuttle,
/obj/machinery/door/poddoor/preopen/personal_shuttle_windows,
/turf/open/floor/plating,
/area/shuttle/personally_bought/private_liner)
"BT" = (
/obj/structure/chair/plastic{
	dir = 1
	},
/obj/structure/extinguisher_cabinet/directional/south,
/obj/machinery/atmospherics/pipe/smart/manifold4w/supply/hidden/layer4,
/obj/machinery/atmospherics/pipe/smart/manifold4w/scrubbers/hidden/layer2,
/turf/open/floor/iron/smooth_large,
/area/shuttle/personally_bought/private_liner)
"Cd" = (
/obj/structure/marker_beacon/olive,
/turf/closed/wall/mineral/titanium/nodiagonal,
/area/shuttle/personally_bought/private_liner)
"CU" = (
/obj/structure/marker_beacon/burgundy,
/turf/closed/wall/mineral/titanium,
/area/shuttle/personally_bought/private_liner)
"EH" = (
/obj/structure/chair/comfy/shuttle{
	dir = 8
	},
/obj/machinery/atmospherics/pipe/smart/manifold4w/supply/hidden/layer4,
/obj/machinery/atmospherics/pipe/smart/manifold4w/scrubbers/hidden/layer2,
/turf/open/floor/carpet/green,
/area/shuttle/personally_bought/private_liner)
"Ga" = (
/obj/effect/turf_decal/delivery/white,
/obj/machinery/door/airlock/external,
/obj/effect/mapping_helpers/airlock/cyclelink_helper,
/turf/open/floor/iron/dark/smooth_large,
/area/shuttle/personally_bought/private_liner)
"GP" = (
/obj/effect/turf_decal/delivery/white,
/obj/machinery/door/airlock/captain,
/obj/machinery/atmospherics/pipe/smart/manifold4w/supply/hidden/layer4,
/obj/machinery/atmospherics/pipe/smart/manifold4w/scrubbers/hidden/layer2,
/turf/open/floor/iron/dark/smooth_large,
/area/shuttle/personally_bought/private_liner)
"Hb" = (
/obj/structure/table/reinforced,
/obj/machinery/coffeemaker,
/obj/structure/extinguisher_cabinet/directional/south,
/turf/open/floor/iron/dark/smooth_large,
/area/shuttle/personally_bought/private_liner)
"Hz" = (
/obj/structure/bed/pod,
/obj/structure/curtain/bounty,
/obj/structure/secure_safe/directional/east,
/obj/effect/turf_decal/bot_white,
/turf/open/floor/iron/dark/smooth_large,
/area/shuttle/personally_bought/private_liner)
"HM" = (
/obj/structure/railing/eva_handhold/directional/north,
/turf/closed/wall/mineral/titanium/nodiagonal,
/area/shuttle/personally_bought/private_liner)
"IM" = (
/obj/structure/table/reinforced,
/obj/item/paper_bin/carbon,
/obj/item/pen/fourcolor,
/obj/machinery/light/warm/directional/north,
/obj/machinery/button/door/personal_shuttle_windows/directional/north,
/turf/open/floor/iron/dark/smooth_large,
/area/shuttle/personally_bought/private_liner)
"IR" = (
/obj/machinery/atmospherics/pipe/smart/manifold4w/supply/hidden/layer4,
/obj/machinery/atmospherics/components/unary/vent_scrubber/on/layer2{
	dir = 1
	},
/turf/open/floor/catwalk_floor/iron_dark,
/area/shuttle/personally_bought/private_liner)
"Jd" = (
/obj/structure/bed/pod,
/obj/structure/curtain/bounty,
/obj/effect/turf_decal/bot_white,
/obj/machinery/atmospherics/components/unary/vent_scrubber/on/layer2,
/turf/open/floor/iron/dark/smooth_large,
/area/shuttle/personally_bought/private_liner)
"Jg" = (
/obj/machinery/power/shuttle_engine/propulsion{
	dir = 8
	},
/obj/effect/turf_decal/stripes/line{
	dir = 8
	},
/obj/structure/fluff/metalpole/end{
	dir = 8;
	pixel_x = -32
	},
/turf/open/floor/plating/airless,
/area/shuttle/personally_bought/private_liner)
"Li" = (
/obj/structure/fluff/metalpole/end{
	pixel_y = -32
	},
/turf/closed/wall/mineral/plastitanium/nodiagonal,
/area/shuttle/personally_bought/private_liner)
"LD" = (
/obj/effect/turf_decal/delivery/white,
/obj/machinery/door/airlock/external,
/obj/effect/mapping_helpers/airlock/cyclelink_helper{
	dir = 1
	},
/obj/docking_port/mobile/personally_bought,
/turf/open/floor/iron/dark/smooth_large,
/area/shuttle/personally_bought/private_liner)
"LI" = (
/obj/structure/table/reinforced,
/obj/item/toy/cards/deck,
/turf/open/floor/iron/dark/smooth_large,
/area/shuttle/personally_bought/private_liner)
"MN" = (
/obj/structure/toilet{
	dir = 8
	},
/obj/structure/curtain,
/obj/effect/turf_decal/bot_red,
/turf/open/floor/iron/freezer,
/area/shuttle/personally_bought/private_liner)
"Nx" = (
/obj/machinery/atmospherics/pipe/smart/manifold4w/scrubbers/hidden/layer2,
/obj/machinery/atmospherics/pipe/smart/manifold4w/supply/hidden/layer4,
/obj/machinery/meter/layer2,
/turf/open/floor/iron/smooth_large,
/area/shuttle/personally_bought/private_liner)
"NV" = (
/obj/machinery/power/shuttle_engine/propulsion{
	dir = 8
	},
/obj/effect/turf_decal/stripes/line{
	dir = 8
	},
/obj/effect/turf_decal/stripes/corner,
/obj/machinery/atmospherics/components/unary/passive_vent/layer2{
	dir = 4
	},
/turf/open/floor/plating/airless,
/area/shuttle/personally_bought/private_liner)
"OP" = (
/obj/machinery/atmospherics/pipe/smart/manifold4w/supply/hidden/layer4,
/obj/machinery/atmospherics/pipe/smart/manifold4w/scrubbers/hidden/layer2,
/turf/open/floor/carpet/green,
/area/shuttle/personally_bought/private_liner)
"Pw" = (
/obj/effect/turf_decal/delivery/white,
/obj/machinery/atmospherics/pipe/smart/manifold4w/supply/hidden/layer4,
/obj/machinery/atmospherics/pipe/smart/manifold4w/scrubbers/hidden/layer2,
/turf/open/floor/iron/dark/smooth_large,
/area/shuttle/personally_bought/private_liner)
"Rr" = (
/obj/machinery/atmospherics/pipe/smart/manifold4w/supply/hidden/layer4,
/obj/machinery/atmospherics/components/unary/vent_scrubber/on/layer2,
/turf/open/floor/catwalk_floor/iron_dark,
/area/shuttle/personally_bought/private_liner)
"Ru" = (
/obj/effect/turf_decal/delivery/white,
/obj/machinery/door/airlock/external,
/obj/effect/mapping_helpers/airlock/cyclelink_helper,
/obj/machinery/atmospherics/pipe/smart/manifold4w/supply/hidden/layer4,
/obj/machinery/atmospherics/pipe/smart/manifold4w/scrubbers/hidden/layer2,
/turf/open/floor/iron/dark/smooth_large,
/area/shuttle/personally_bought/private_liner)
"SC" = (
/obj/structure/railing/eva_handhold/directional/south,
/turf/closed/wall/mineral/titanium/nodiagonal,
/area/shuttle/personally_bought/private_liner)
"SI" = (
/obj/structure/cable,
/obj/machinery/atmospherics/pipe/smart/manifold4w/supply/hidden/layer4,
/obj/machinery/atmospherics/pipe/smart/manifold4w/scrubbers/hidden/layer2,
/turf/open/floor/iron/smooth_large,
/area/shuttle/personally_bought/private_liner)
"Tm" = (
/obj/structure/closet/crate/cardboard,
/obj/item/storage/box/colonial_rations,
/obj/item/storage/box/colonial_rations,
/obj/item/plate,
/obj/item/plate,
/obj/item/storage/box/utensils,
/obj/item/storage/box/utensils,
/obj/item/storage/box/utensils,
/obj/item/storage/box/utensils,
/obj/effect/turf_decal/bot_white,
/turf/open/floor/iron/dark/smooth_large,
/area/shuttle/personally_bought/private_liner)
"Tw" = (
/turf/closed/wall/mineral/titanium,
/area/shuttle/personally_bought/private_liner)
"TI" = (
/obj/structure/table/reinforced,
/obj/machinery/recharger,
/turf/open/floor/iron/dark/smooth_large,
/area/shuttle/personally_bought/private_liner)
"TT" = (
/turf/closed/wall/mineral/plastitanium/nodiagonal,
/area/shuttle/personally_bought/private_liner)
"TX" = (
/obj/structure/marker_beacon/burgundy,
/turf/closed/wall/mineral/titanium/nodiagonal,
/area/shuttle/personally_bought/private_liner)
"Us" = (
/obj/machinery/portable_atmospherics/canister/air,
/obj/machinery/atmospherics/components/unary/portables_connector/visible/layer4{
	dir = 8
	},
/obj/effect/turf_decal/bot_white,
/obj/machinery/light/cold/directional/east,
/turf/open/floor/iron/dark/smooth_large,
/area/shuttle/personally_bought/private_liner)
"UH" = (
/obj/machinery/atmospherics/components/unary/vent_scrubber/on/layer2{
	dir = 1
	},
/turf/open/floor/iron/smooth_large,
/area/shuttle/personally_bought/private_liner)
"US" = (
/obj/structure/chair/comfy/shuttle,
/turf/open/floor/iron/smooth_large,
/area/shuttle/personally_bought/private_liner)
"UY" = (
/obj/machinery/computer/shuttle/personally_bought,
/obj/effect/turf_decal/bot_white,
/turf/open/floor/iron/dark/smooth_large,
/area/shuttle/personally_bought/private_liner)
"Vh" = (
/obj/machinery/suit_storage_unit/industrial,
/obj/machinery/atmospherics/components/unary/vent_pump/on/layer4,
/turf/open/floor/iron/dark/smooth_large,
/area/shuttle/personally_bought/private_liner)
"Vt" = (
/obj/machinery/vending/cola/black,
/obj/effect/turf_decal/bot_white,
/turf/open/floor/iron/dark/smooth_large,
/area/shuttle/personally_bought/private_liner)
"VN" = (
/obj/structure/fluff/metalpole/end{
	dir = 4;
	pixel_x = 32
	},
/turf/closed/wall/mineral/titanium/nodiagonal,
/area/shuttle/personally_bought/private_liner)
"VX" = (
/obj/structure/fluff/metalpole/end{
	dir = 4;
	pixel_x = 32
	},
/obj/structure/marker_beacon/burgundy,
/turf/closed/wall/mineral/titanium/nodiagonal,
/area/shuttle/personally_bought/private_liner)
"WH" = (
/obj/structure/table/reinforced,
/obj/machinery/button/door/personal_shuttle_windows/directional/west,
/turf/open/floor/iron/dark/smooth_large,
/area/shuttle/personally_bought/private_liner)
"Xg" = (
/obj/structure/chair/comfy/shuttle{
	dir = 1
	},
/turf/open/floor/iron/smooth_large,
/area/shuttle/personally_bought/private_liner)
"XC" = (
/obj/structure/fluff/metalpole/end{
	dir = 1;
	pixel_y = 32
	},
/turf/closed/wall/mineral/titanium/nodiagonal,
/area/shuttle/personally_bought/private_liner)
"XK" = (
/obj/effect/turf_decal/bot_white,
/obj/machinery/portable_atmospherics/canister/oxygen,
/obj/machinery/light/red/dim/directional/east,
/obj/machinery/atmospherics/components/unary/vent_pump/on/layer4{
	dir = 8
	},
/turf/open/floor/iron/dark/smooth_large,
/area/shuttle/personally_bought/private_liner)
"XL" = (
/obj/structure/cable,
/obj/machinery/power/apc/auto_name/directional/east,
/obj/effect/mapping_helpers/apc/unlocked,
/obj/machinery/atmospherics/pipe/smart/manifold4w/supply/hidden/layer4,
/obj/machinery/atmospherics/pipe/smart/manifold4w/scrubbers/hidden/layer2,
/obj/effect/mapping_helpers/apc/cell_5k,
/turf/open/floor/iron/smooth_large,
/area/shuttle/personally_bought/private_liner)
"Yf" = (
/turf/template_noop,
/area/template_noop)
"Zu" = (
/obj/structure/table/reinforced,
/obj/machinery/microwave,
/turf/open/floor/iron/dark/smooth_large,
/area/shuttle/personally_bought/private_liner)
"ZA" = (
/obj/structure/closet/crate/engineering/electrical,
/obj/item/stack/sheet/mineral/plasma/thirty,
/obj/item/flatpacked_machine/rtg,
/obj/item/flatpacked_machine/rtg,
/obj/effect/turf_decal/bot_white,
/obj/machinery/airalarm/directional/north,
/obj/effect/mapping_helpers/airalarm/all_access,
/obj/machinery/light/cold/directional/north,
/obj/machinery/atmospherics/components/unary/vent_pump/on/layer4,
/obj/machinery/atmospherics/pipe/smart/manifold4w/scrubbers/hidden/layer2,
/turf/open/floor/iron/dark/smooth_large,
/area/shuttle/personally_bought/private_liner)
"ZW" = (
/obj/structure/cable,
/obj/structure/closet/firecloset/wall/personal_shuttle/directional/east,
/obj/effect/turf_decal/bot,
/obj/machinery/light/warm/directional/east,
/obj/machinery/atmospherics/pipe/smart/manifold4w/supply/hidden/layer4,
/obj/machinery/atmospherics/components/unary/vent_scrubber/on/layer2{
	dir = 1
	},
/turf/open/floor/iron/dark/smooth_large,
/area/shuttle/personally_bought/private_liner)
"ZY" = (
/obj/structure/fluff/metalpole/end{
	pixel_y = -32
	},
/turf/open/floor/engine/hull/shuttle_white_plate,
/area/shuttle/personally_bought/private_liner)

(1,1,1) = {"
Yf
Yf
Yf
Yf
Yf
Yf
lD
xX
Yf
Yf
Yf
"}
(2,1,1) = {"
Yf
Yf
Yf
cH
Jg
NV
Ae
xs
ed
Jg
ug
"}
(3,1,1) = {"
Yf
Yf
Yf
rF
vI
oV
TT
TT
hN
vI
Li
"}
(4,1,1) = {"
Yf
Yf
Yf
TT
qZ
Nx
dy
ez
sH
lN
TT
"}
(5,1,1) = {"
Yf
Tw
mW
mW
mW
Us
mW
ZA
SI
aC
mW
"}
(6,1,1) = {"
CU
mW
aM
TI
mW
mW
mW
mW
fR
mW
mW
"}
(7,1,1) = {"
HM
oq
Xg
cx
mi
yW
Bv
yo
SI
Tm
SC
"}
(8,1,1) = {"
Bv
UY
mN
gA
tz
XL
hj
SI
ZW
pt
mW
"}
(9,1,1) = {"
VX
Bv
kC
mW
mW
mW
mW
sn
mW
mW
mW
"}
(10,1,1) = {"
Yf
Yf
Yf
mW
IM
fQ
mW
oL
US
WH
Bv
"}
(11,1,1) = {"
Yf
Yf
Yf
Bv
Jd
EH
GP
wX
oW
kP
Bv
"}
(12,1,1) = {"
Yf
Yf
Yf
Bv
kk
OP
mW
tk
Vt
mW
Cd
"}
(13,1,1) = {"
Yf
Yf
Yf
TX
mW
Pw
mW
lJ
UH
Aa
Bv
"}
(14,1,1) = {"
Yf
Yf
Yf
HM
yK
oZ
mW
kH
Zu
Hb
SC
"}
(15,1,1) = {"
Yf
Yf
Yf
XC
mW
mW
mW
sn
mW
mW
sC
"}
(16,1,1) = {"
Yf
Yf
Yf
Ga
Rr
oa
wX
wX
Ru
IR
LD
"}
(17,1,1) = {"
Yf
Yf
Yf
HM
XK
Bv
Vh
wX
Bv
na
SC
"}
(18,1,1) = {"
Yf
Yf
Yf
CU
mW
mW
un
wX
mW
mW
pN
"}
(19,1,1) = {"
Yf
Yf
Yf
Yf
gb
mW
mW
sn
mW
ZY
Yf
"}
(20,1,1) = {"
Yf
Yf
Yf
mW
mW
mW
LI
BT
mW
mW
mW
"}
(21,1,1) = {"
Yf
Yf
Yf
CU
mW
ii
pU
wX
iW
mW
pN
"}
(22,1,1) = {"
Yf
Yf
Yf
Yf
HM
Hz
Hz
sk
MN
SC
Yf
"}
(23,1,1) = {"
Yf
Yf
Yf
Yf
Tw
VN
mW
mW
VN
Tw
Yf
"}
