//MAP CONVERTED BY dmm2tgm.py THIS HEADER COMMENT PREVENTS RECONVERSION, DO NOT REMOVE
"a" = (
/turf/open/misc/asteroid/basalt/lava_land_surface/no_ruins,
/area/lavaland/surface/outdoors/virtual_domain)
"c" = (
/turf/template_noop,
/area/virtual_domain/safehouse)
"e" = (
/obj/structure/marker_beacon/cerulean,
/turf/open/misc/asteroid/basalt/lava_land_surface/no_ruins,
/area/lavaland/surface/outdoors/virtual_domain)
"f" = (
/obj/effect/baseturf_helper/virtual_domain,
/turf/template_noop,
/area/virtual_domain/safehouse)
"g" = (
/obj/structure/marker_beacon/lime,
/turf/open/misc/asteroid/basalt/lava_land_surface/no_ruins,
/area/lavaland/surface/outdoors/virtual_domain)
"h" = (
/obj/machinery/light/small/blacklight/directional/south,
/obj/effect/baseturf_helper/virtual_domain,
/turf/open/misc/asteroid/basalt/lava_land_surface/no_ruins,
/area/virtual_domain)
"i" = (
/obj/structure/marker_beacon/jade,
/turf/open/misc/asteroid/basalt/lava_land_surface/no_ruins,
/area/lavaland/surface/outdoors/virtual_domain)
"j" = (
/obj/structure/marker_beacon/teal,
/turf/open/misc/asteroid/basalt/lava_land_surface/no_ruins,
/area/lavaland/surface/outdoors/virtual_domain)
"l" = (
/obj/structure/marker_beacon/bronze,
/turf/open/misc/asteroid/basalt/lava_land_surface/no_ruins,
/area/lavaland/surface/outdoors/virtual_domain)
"q" = (
/mob/living/simple_animal/hostile/megafauna/dragon,
/turf/open/misc/asteroid/basalt/lava_land_surface/no_ruins,
/area/lavaland/surface/outdoors/virtual_domain)
"s" = (
/turf/closed/mineral/volcanic/lava_land_surface,
/area/lavaland/surface/outdoors/virtual_domain)
"B" = (
/obj/effect/baseturf_helper/virtual_domain,
/turf/closed/mineral/volcanic/lava_land_surface,
/area/lavaland/surface/outdoors/virtual_domain)
"G" = (
/obj/structure/marker_beacon/purple,
/turf/open/misc/asteroid/basalt/lava_land_surface/no_ruins,
/area/lavaland/surface/outdoors/virtual_domain)
"J" = (
/turf/open/lava/smooth/lava_land_surface,
/area/lavaland/surface/outdoors/virtual_domain)
"L" = (
/obj/modular_map_root/safehouse{
	key = "lavaland_boss"
	},
/turf/template_noop,
/area/virtual_domain/safehouse)
"P" = (
/obj/structure/marker_beacon/fuchsia,
/turf/open/misc/asteroid/basalt/lava_land_surface/no_ruins,
/area/lavaland/surface/outdoors/virtual_domain)
"R" = (
/turf/closed/indestructible/binary,
/area/virtual_domain/fullbright)
"Z" = (
/obj/effect/mob_spawn/corpse/human/miner,
/turf/open/misc/asteroid/basalt/lava_land_surface/no_ruins,
/area/lavaland/surface/outdoors/virtual_domain)

(1,1,1) = {"
R
R
R
R
R
R
R
R
R
R
R
R
R
R
R
R
R
R
R
R
R
R
R
R
R
R
R
R
R
R
R
R
R
R
R
R
R
R
R
R
R
R
R
R
R
R
"}
(2,1,1) = {"
R
s
s
s
s
s
s
s
s
s
s
s
s
s
s
s
s
s
s
s
s
s
s
s
s
s
s
s
s
s
s
s
s
s
s
s
s
s
s
s
s
s
s
s
B
R
"}
(3,1,1) = {"
R
s
s
s
s
J
J
s
s
J
J
s
s
J
J
J
J
s
s
s
J
J
J
s
s
s
s
s
s
s
s
s
s
J
J
s
s
s
J
J
s
s
J
J
s
R
"}
(4,1,1) = {"
R
s
s
J
J
J
J
J
J
J
J
J
J
J
J
J
J
J
J
J
J
J
J
J
J
J
a
J
J
J
J
J
J
J
J
J
J
J
J
J
J
J
J
J
s
R
"}
(5,1,1) = {"
R
s
s
J
a
J
J
J
J
a
J
J
J
J
a
a
J
J
J
J
J
a
a
J
J
J
J
J
J
J
J
J
J
J
J
J
J
J
J
J
J
J
J
s
s
R
"}
(6,1,1) = {"
R
s
s
J
a
J
J
a
a
a
a
a
a
a
a
a
a
a
a
J
a
a
a
a
a
J
J
J
a
a
J
J
J
a
a
J
a
J
a
a
J
J
J
s
s
R
"}
(7,1,1) = {"
R
s
s
J
J
J
a
a
a
a
a
a
a
a
a
a
a
a
a
a
a
a
a
a
a
a
a
a
a
a
a
a
a
a
a
a
a
a
a
a
a
J
J
J
s
R
"}
(8,1,1) = {"
R
s
s
J
J
J
a
a
a
a
a
a
a
a
a
a
a
a
a
a
a
a
a
a
a
a
a
a
a
a
a
a
a
a
a
a
a
a
a
a
a
J
J
s
s
R
"}
(9,1,1) = {"
R
s
J
J
J
a
a
a
a
a
a
a
a
a
a
a
a
a
a
a
a
a
a
a
a
i
a
a
a
a
a
Z
a
a
a
a
a
a
a
a
a
a
J
J
s
R
"}
(10,1,1) = {"
R
s
J
J
J
a
a
a
a
a
a
G
a
a
a
a
a
a
a
a
a
a
a
a
a
a
a
a
a
a
a
a
a
a
a
a
a
a
a
a
a
a
J
J
s
R
"}
(11,1,1) = {"
R
s
s
J
J
J
a
a
a
a
a
a
a
a
a
a
a
a
a
a
a
a
a
a
a
a
a
a
a
a
a
a
a
a
a
a
a
a
a
a
a
a
J
J
s
R
"}
(12,1,1) = {"
R
s
s
J
J
J
a
a
a
a
a
a
a
a
a
a
a
a
a
a
a
a
a
a
a
a
a
a
a
a
a
a
a
a
a
a
a
a
a
a
a
J
J
J
s
R
"}
(13,1,1) = {"
R
s
s
J
J
a
a
a
a
a
a
a
a
a
a
a
a
g
a
a
a
a
a
a
a
a
a
a
a
a
a
a
a
a
a
a
a
a
a
a
a
a
J
J
s
R
"}
(14,1,1) = {"
R
s
s
J
J
a
a
a
a
a
a
a
a
a
a
a
a
a
a
a
a
a
a
a
a
a
a
a
a
a
a
a
a
a
a
a
a
a
a
a
a
a
J
J
s
R
"}
(15,1,1) = {"
R
s
J
J
J
a
a
a
a
a
a
a
a
a
a
a
a
a
a
a
a
a
a
a
a
a
a
a
a
a
a
a
a
h
c
c
c
c
c
L
a
a
J
J
s
R
"}
(16,1,1) = {"
R
s
J
J
J
J
a
a
a
a
a
a
a
a
a
a
a
a
a
a
a
a
a
a
a
a
a
a
a
a
a
a
a
a
c
c
c
c
c
c
a
a
J
J
s
R
"}
(17,1,1) = {"
R
s
s
J
J
J
a
a
a
a
a
a
a
a
a
a
a
a
a
a
a
a
a
a
a
a
a
a
a
a
a
l
a
a
c
c
c
c
c
c
a
a
J
J
s
R
"}
(18,1,1) = {"
R
s
s
J
J
a
a
a
a
a
a
a
a
q
a
a
a
a
a
a
a
a
a
a
a
a
a
a
a
a
a
a
a
a
c
c
c
c
c
c
a
J
J
s
s
R
"}
(19,1,1) = {"
R
s
J
J
J
a
a
a
a
a
a
a
a
a
a
a
a
a
a
a
a
a
a
a
a
a
a
a
a
a
a
a
a
a
c
c
c
c
c
c
a
a
J
J
s
R
"}
(20,1,1) = {"
R
s
J
J
J
J
a
a
a
a
a
a
a
a
a
a
a
a
a
a
a
a
a
a
a
a
a
a
a
a
a
a
a
a
c
c
c
c
c
c
a
a
J
J
s
R
"}
(21,1,1) = {"
R
s
s
J
J
a
a
a
a
a
a
a
a
a
a
a
a
a
a
a
e
a
a
a
a
a
a
a
a
a
a
a
a
h
c
c
c
c
c
f
a
a
J
s
s
R
"}
(22,1,1) = {"
R
s
s
J
J
a
a
a
a
a
a
a
a
a
a
a
a
a
a
a
a
a
a
a
a
a
a
a
a
a
a
a
a
a
a
a
a
a
a
a
a
a
J
s
s
R
"}
(23,1,1) = {"
R
s
J
J
a
a
a
a
a
a
a
a
a
a
a
a
a
a
a
a
a
a
a
a
a
a
a
a
a
a
a
a
a
a
a
a
a
a
a
a
a
a
J
s
s
R
"}
(24,1,1) = {"
R
s
J
J
a
a
a
a
j
a
a
a
a
a
P
a
a
a
a
a
a
a
a
a
a
a
a
a
a
a
a
a
a
a
a
a
a
a
a
a
a
a
J
J
s
R
"}
(25,1,1) = {"
R
s
s
J
J
a
a
a
a
a
a
a
a
a
a
a
a
a
a
a
a
a
a
a
a
a
a
a
a
a
a
a
a
a
a
a
a
a
a
a
a
J
J
J
s
R
"}
(26,1,1) = {"
R
s
s
J
J
a
a
a
a
a
a
a
a
a
a
a
a
a
a
a
a
a
a
a
a
a
a
a
a
a
a
a
a
a
a
a
a
a
a
a
a
a
J
J
s
R
"}
(27,1,1) = {"
R
s
s
J
J
J
a
a
a
Z
a
a
a
a
a
a
a
a
a
a
a
a
a
a
a
a
a
a
a
a
a
a
a
a
j
a
a
a
a
a
a
a
J
J
s
R
"}
(28,1,1) = {"
R
s
J
J
J
J
a
a
a
a
a
a
a
a
a
a
a
a
a
a
a
a
a
a
a
a
a
a
a
a
a
a
a
a
a
a
a
a
a
a
a
J
J
J
s
R
"}
(29,1,1) = {"
R
s
J
J
J
J
a
a
a
a
a
a
a
a
a
a
a
a
a
a
a
a
a
a
a
a
a
a
a
a
a
a
a
a
a
a
a
a
a
a
a
J
J
s
s
R
"}
(30,1,1) = {"
R
s
s
J
J
J
J
a
a
J
J
J
a
a
a
a
J
J
J
a
a
a
J
J
J
a
a
a
J
J
a
a
a
a
a
a
J
J
a
a
a
J
J
s
s
R
"}
(31,1,1) = {"
R
s
s
a
J
J
J
J
J
J
J
J
J
a
a
J
J
J
J
J
J
J
J
J
J
J
J
J
J
J
J
J
a
a
a
J
J
J
J
J
J
J
J
J
s
R
"}
(32,1,1) = {"
R
s
s
a
J
J
J
J
J
J
J
J
J
J
J
J
J
a
J
J
J
J
J
J
J
J
J
J
J
J
J
J
J
J
J
J
J
J
J
J
J
J
J
J
s
R
"}
(33,1,1) = {"
R
s
s
s
s
s
J
J
s
s
s
s
J
J
s
s
s
s
s
s
J
J
s
s
s
s
J
J
s
s
s
s
J
J
J
s
s
s
s
s
s
J
J
J
s
R
"}
(34,1,1) = {"
R
s
s
s
s
s
s
s
s
s
s
s
s
s
s
s
s
s
s
s
s
s
s
s
s
s
s
s
s
s
s
s
s
s
s
s
s
s
s
s
s
s
s
s
s
R
"}
(35,1,1) = {"
R
R
R
R
R
R
R
R
R
R
R
R
R
R
R
R
R
R
R
R
R
R
R
R
R
R
R
R
R
R
R
R
R
R
R
R
R
R
R
R
R
R
R
R
R
R
"}
