//MAP CONVERTED BY dmm2tgm.py THIS HEADER COMMENT PREVENTS RECONVERSION, DO NOT REMOVE
"a" = (
/turf/open/misc/asteroid/basalt/lava_land_surface/no_ruins,
/area/lavaland/surface/outdoors/virtual_domain)
"c" = (
/obj/effect/mob_spawn/corpse/human/miner,
/turf/open/misc/asteroid/basalt/lava_land_surface/no_ruins,
/area/lavaland/surface/outdoors/virtual_domain)
"d" = (
/obj/structure/marker_beacon/jade,
/turf/open/misc/asteroid/basalt/lava_land_surface/no_ruins,
/area/lavaland/surface/outdoors/virtual_domain)
"f" = (
/obj/structure/marker_beacon/burgundy,
/turf/open/misc/asteroid/basalt/lava_land_surface/no_ruins,
/area/lavaland/surface/outdoors/virtual_domain)
"g" = (
/obj/structure/marker_beacon/teal,
/turf/open/misc/asteroid/basalt/lava_land_surface/no_ruins,
/area/lavaland/surface/outdoors/virtual_domain)
"p" = (
/turf/open/lava/smooth/lava_land_surface,
/area/lavaland/surface/outdoors/virtual_domain)
"r" = (
/obj/structure/marker_beacon/fuchsia,
/turf/open/misc/asteroid/basalt/lava_land_surface/no_ruins,
/area/lavaland/surface/outdoors/virtual_domain)
"s" = (
/turf/open/indestructible/binary,
/area/virtual_domain)
"w" = (
/obj/machinery/light/small/blacklight/directional/south,
/obj/effect/baseturf_helper/virtual_domain,
/turf/open/misc/asteroid/basalt/lava_land_surface/no_ruins,
/area/virtual_domain)
"x" = (
/obj/structure/marker_beacon/olive,
/turf/open/misc/asteroid/basalt/lava_land_surface/no_ruins,
/area/lavaland/surface/outdoors/virtual_domain)
"z" = (
/obj/structure/marker_beacon/purple,
/turf/open/misc/asteroid/basalt/lava_land_surface/no_ruins,
/area/lavaland/surface/outdoors/virtual_domain)
"A" = (
/obj/effect/baseturf_helper/virtual_domain,
/turf/template_noop,
/area/virtual_domain/safehouse)
"C" = (
/mob/living/simple_animal/hostile/megafauna/bubblegum,
/turf/open/misc/asteroid/basalt/lava_land_surface/no_ruins,
/area/lavaland/surface/outdoors/virtual_domain)
"G" = (
/obj/structure/marker_beacon/violet,
/turf/open/misc/asteroid/basalt/lava_land_surface/no_ruins,
/area/lavaland/surface/outdoors/virtual_domain)
"I" = (
/obj/structure/marker_beacon/bronze,
/turf/open/misc/asteroid/basalt/lava_land_surface/no_ruins,
/area/lavaland/surface/outdoors/virtual_domain)
"M" = (
/obj/structure/marker_beacon/indigo,
/turf/open/misc/asteroid/basalt/lava_land_surface/no_ruins,
/area/lavaland/surface/outdoors/virtual_domain)
"O" = (
/obj/effect/baseturf_helper/virtual_domain,
/turf/closed/mineral/volcanic/lava_land_surface,
/area/lavaland/surface/outdoors/virtual_domain)
"S" = (
/turf/template_noop,
/area/virtual_domain/safehouse)
"T" = (
/obj/modular_map_root/safehouse{
	key = "lavaland_boss"
	},
/turf/template_noop,
/area/virtual_domain/safehouse)
"W" = (
/obj/structure/marker_beacon/cerulean,
/turf/open/misc/asteroid/basalt/lava_land_surface/no_ruins,
/area/lavaland/surface/outdoors/virtual_domain)
"X" = (
/obj/structure/marker_beacon/lime,
/turf/open/misc/asteroid/basalt/lava_land_surface/no_ruins,
/area/lavaland/surface/outdoors/virtual_domain)
"Y" = (
/obj/structure/marker_beacon/yellow,
/turf/open/misc/asteroid/basalt/lava_land_surface/no_ruins,
/area/lavaland/surface/outdoors/virtual_domain)
"Z" = (
/turf/closed/mineral/volcanic/lava_land_surface,
/area/lavaland/surface/outdoors/virtual_domain)

(1,1,1) = {"
s
s
s
s
s
s
s
s
s
s
s
s
s
s
s
s
s
s
s
s
s
s
s
s
s
s
s
s
s
s
s
s
s
s
s
s
s
s
s
s
s
s
s
s
s
s
s
s
s
s
s
s
s
s
s
s
"}
(2,1,1) = {"
s
Z
Z
Z
Z
Z
Z
Z
Z
Z
Z
Z
Z
Z
Z
Z
Z
Z
Z
Z
Z
Z
Z
Z
Z
Z
Z
Z
Z
Z
Z
Z
Z
Z
Z
Z
Z
Z
Z
Z
Z
Z
Z
Z
Z
Z
Z
Z
Z
Z
Z
Z
Z
Z
O
s
"}
(3,1,1) = {"
s
Z
Z
Z
Z
Z
Z
Z
Z
Z
Z
Z
Z
Z
Z
Z
Z
Z
Z
Z
Z
Z
Z
Z
Z
Z
Z
Z
Z
Z
Z
Z
Z
Z
Z
Z
Z
Z
Z
Z
Z
Z
Z
Z
Z
Z
Z
Z
Z
Z
Z
Z
Z
Z
Z
s
"}
(4,1,1) = {"
s
Z
Z
Z
Z
Z
Z
Z
Z
Z
Z
Z
Z
Z
Z
Z
Z
Z
Z
Z
Z
Z
s
Z
Z
Z
Z
Z
Z
Z
Z
Z
Z
Z
Z
Z
Z
Z
s
Z
Z
Z
Z
Z
Z
Z
Z
Z
Z
Z
Z
Z
Z
Z
Z
s
"}
(5,1,1) = {"
s
Z
Z
Z
Z
Z
Z
Z
Z
Z
Z
Z
Z
Z
Z
Z
Z
Z
Z
Z
Z
Z
Z
Z
Z
Z
Z
Z
Z
Z
Z
Z
Z
Z
Z
Z
Z
Z
Z
Z
Z
Z
Z
Z
Z
Z
Z
Z
Z
Z
Z
Z
Z
Z
Z
s
"}
(6,1,1) = {"
s
Z
Z
Z
Z
Z
Z
Z
Z
Z
Z
Z
Z
Z
Z
Z
Z
Z
Z
Z
Z
Z
Z
Z
Z
Z
Z
Z
Z
Z
Z
Z
Z
Z
Z
Z
Z
Z
Z
Z
Z
Z
Z
Z
Z
Z
Z
Z
Z
Z
Z
Z
Z
Z
Z
s
"}
(7,1,1) = {"
s
Z
Z
s
Z
Z
Z
Z
Z
Z
Z
Z
Z
Z
Z
Z
Z
Z
Z
Z
Z
Z
Z
Z
Z
Z
Z
Z
Z
Z
Z
Z
Z
Z
Z
Z
Z
Z
Z
Z
Z
Z
Z
Z
Z
Z
Z
Z
Z
Z
Z
Z
Z
Z
Z
s
"}
(8,1,1) = {"
s
Z
Z
s
Z
Z
Z
a
a
Z
Z
Z
a
a
a
a
a
a
a
a
a
a
a
a
a
a
a
a
Z
Z
Z
a
a
a
a
a
a
a
a
Z
Z
a
a
a
a
a
a
Z
Z
Z
Z
Z
Z
Z
Z
s
"}
(9,1,1) = {"
s
Z
Z
s
Z
Z
Z
a
a
a
a
a
a
a
a
a
a
a
a
a
a
a
a
a
a
a
a
a
a
a
a
a
a
a
a
a
a
a
a
a
a
a
a
a
a
a
a
a
a
Z
Z
Z
Z
Z
Z
s
"}
(10,1,1) = {"
s
Z
Z
Z
Z
Z
Z
a
a
a
a
a
a
a
a
a
a
a
a
a
a
a
a
a
a
a
a
a
a
a
a
a
a
a
a
a
a
a
a
a
a
a
a
a
a
a
a
a
p
Z
Z
Z
Z
s
Z
s
"}
(11,1,1) = {"
s
Z
Z
Z
Z
Z
Z
a
a
a
a
a
a
a
a
a
a
a
a
a
a
a
a
a
a
a
a
a
a
a
a
a
a
a
G
a
a
a
a
a
a
a
a
a
a
a
a
p
p
Z
Z
Z
Z
s
Z
s
"}
(12,1,1) = {"
s
Z
Z
Z
Z
Z
Z
a
a
a
a
a
a
a
a
a
a
a
a
a
a
x
a
a
a
a
a
a
a
a
a
a
a
a
a
a
a
a
a
a
a
a
a
Z
a
a
a
a
p
Z
Z
Z
Z
Z
Z
s
"}
(13,1,1) = {"
s
Z
Z
Z
Z
Z
Z
a
a
a
a
a
a
a
a
a
a
a
a
a
a
a
a
a
a
a
a
a
a
a
a
a
a
a
a
a
a
a
a
a
a
a
a
Z
Z
a
a
a
Z
Z
Z
Z
Z
Z
Z
s
"}
(14,1,1) = {"
s
Z
Z
Z
Z
Z
Z
a
a
a
a
a
a
p
p
p
p
a
a
a
a
a
a
a
a
a
a
a
a
a
a
a
a
a
a
a
a
a
a
a
a
a
a
a
a
a
a
a
Z
Z
Z
Z
Z
Z
Z
s
"}
(15,1,1) = {"
s
Z
Z
Z
Z
Z
Z
Z
a
a
a
a
a
Z
Z
Z
p
a
a
a
a
a
a
a
a
a
a
a
a
a
a
a
a
a
a
a
a
a
a
a
a
a
a
a
a
a
a
a
Z
Z
Z
Z
Z
Z
Z
s
"}
(16,1,1) = {"
s
Z
Z
Z
Z
Z
Z
Z
a
a
a
a
a
Z
Z
Z
p
a
a
a
a
a
a
a
a
a
a
a
a
a
a
a
Z
Z
a
a
a
a
a
a
a
a
p
p
a
a
a
a
a
Z
Z
Z
Z
Z
Z
s
"}
(17,1,1) = {"
s
Z
Z
Z
Z
Z
Z
Z
a
a
a
a
a
p
Z
p
p
a
a
a
a
a
a
a
a
a
a
a
a
a
a
a
a
a
Z
Z
a
a
a
a
a
a
a
p
a
a
a
a
a
Z
Z
Z
Z
Z
Z
s
"}
(18,1,1) = {"
s
Z
Z
Z
Z
Z
Z
Z
a
a
a
a
a
a
a
a
a
a
a
a
a
a
a
a
a
a
a
a
a
a
a
a
a
Z
Z
Z
a
a
a
a
a
M
a
a
a
a
a
a
a
Z
Z
Z
Z
Z
Z
s
"}
(19,1,1) = {"
s
Z
Z
Z
Z
Z
Z
a
a
a
a
a
a
a
a
a
a
a
a
a
a
a
a
a
a
a
a
a
a
a
a
a
a
Z
Z
Z
a
a
a
a
a
a
a
a
a
a
a
a
a
Z
Z
Z
Z
Z
Z
s
"}
(20,1,1) = {"
s
Z
Z
Z
Z
Z
Z
a
a
a
a
a
a
a
a
a
a
a
a
a
a
a
a
a
a
a
a
a
a
a
a
a
a
a
a
a
a
a
a
a
a
a
c
a
a
a
a
a
a
Z
Z
Z
Z
Z
Z
s
"}
(21,1,1) = {"
s
Z
Z
Z
Z
Z
Z
a
a
a
a
a
a
a
a
a
a
a
a
a
a
a
a
a
a
a
a
a
I
a
a
a
a
a
a
a
a
a
a
a
a
a
a
a
a
a
a
a
a
Z
Z
Z
Z
Z
Z
s
"}
(22,1,1) = {"
s
Z
Z
Z
Z
Z
Z
a
a
a
a
a
a
a
a
a
a
a
W
a
a
a
a
a
a
a
a
a
a
a
a
a
a
a
a
a
a
a
a
a
a
a
a
a
a
a
a
a
a
Z
Z
Z
Z
Z
Z
s
"}
(23,1,1) = {"
s
Z
Z
Z
Z
Z
Z
a
a
a
a
a
a
a
a
a
a
a
a
a
a
a
a
a
a
a
a
a
a
a
a
a
a
a
a
a
a
a
a
a
a
a
a
a
a
a
a
a
a
Z
Z
Z
Z
Z
Z
s
"}
(24,1,1) = {"
s
Z
Z
Z
Z
Z
Z
a
a
a
a
a
a
a
a
a
a
a
a
a
a
a
a
a
a
a
a
a
a
a
a
a
a
a
a
a
a
a
a
a
a
a
a
a
a
a
a
a
a
Z
Z
Z
Z
Z
Z
s
"}
(25,1,1) = {"
s
Z
Z
s
Z
Z
Z
a
a
a
a
a
z
a
a
a
a
a
a
a
a
a
a
a
a
a
a
a
a
a
a
a
a
a
a
a
a
a
a
a
a
a
a
a
a
a
a
a
a
Z
Z
Z
Z
Z
Z
s
"}
(26,1,1) = {"
s
Z
Z
Z
Z
Z
Z
a
a
a
a
a
a
a
a
a
a
a
a
a
a
a
a
a
a
a
a
a
a
a
a
a
a
a
a
a
a
a
a
a
a
w
S
S
S
S
S
T
a
Z
Z
Z
Z
Z
s
s
"}
(27,1,1) = {"
s
Z
Z
Z
Z
Z
Z
a
a
a
a
a
a
a
a
a
a
a
a
a
a
a
a
a
a
a
a
a
a
a
a
a
a
a
a
a
a
a
a
a
a
a
S
S
S
S
S
S
a
Z
Z
Z
Z
Z
Z
s
"}
(28,1,1) = {"
s
Z
Z
Z
Z
Z
Z
a
a
a
a
a
a
a
a
a
a
a
a
a
a
a
a
a
a
a
C
a
a
a
a
a
a
a
a
a
a
a
a
a
a
a
S
S
S
S
S
S
a
Z
Z
Z
Z
Z
Z
s
"}
(29,1,1) = {"
s
Z
Z
Z
Z
Z
Z
a
a
a
a
a
a
a
a
a
a
a
a
a
a
a
a
a
a
a
a
a
a
a
a
a
a
a
a
a
a
a
a
X
a
a
S
S
S
S
S
S
a
Z
Z
Z
Z
Z
Z
s
"}
(30,1,1) = {"
s
Z
Z
Z
Z
Z
Z
a
a
a
a
a
a
a
a
a
a
a
a
a
a
a
a
a
a
a
a
a
a
a
a
a
a
a
a
a
a
a
a
a
a
a
S
S
S
S
S
S
a
Z
Z
Z
Z
Z
Z
s
"}
(31,1,1) = {"
s
Z
Z
Z
Z
Z
Z
a
a
a
a
a
a
a
a
a
a
a
a
a
a
a
a
a
a
a
a
a
a
a
a
a
a
a
a
a
a
a
a
a
a
a
S
S
S
S
S
S
a
Z
Z
Z
Z
Z
Z
s
"}
(32,1,1) = {"
s
Z
Z
Z
Z
Z
Z
a
a
a
a
a
a
a
a
a
a
a
a
a
a
a
a
a
a
a
a
a
a
a
a
a
a
a
a
a
a
a
a
a
a
w
S
S
S
S
S
A
a
Z
Z
Z
Z
Z
Z
s
"}
(33,1,1) = {"
s
Z
Z
Z
Z
Z
Z
a
a
a
a
a
a
a
a
a
a
a
a
f
a
a
a
a
a
a
a
a
a
a
a
a
a
a
a
a
a
a
a
a
a
a
a
a
a
a
a
a
a
Z
Z
Z
Z
Z
Z
s
"}
(34,1,1) = {"
s
Z
Z
Z
Z
Z
Z
a
a
a
a
a
a
Z
a
a
a
a
a
a
a
a
a
a
a
a
a
a
a
r
a
a
a
a
a
a
a
a
a
a
a
a
a
a
a
a
a
a
a
Z
Z
Z
Z
Z
Z
s
"}
(35,1,1) = {"
s
Z
Z
Z
Z
Z
Z
a
a
a
a
a
a
Z
Z
Z
a
a
a
a
a
a
a
a
a
a
a
a
a
a
a
a
a
a
a
a
a
a
a
a
a
a
a
a
a
a
a
a
a
Z
Z
Z
Z
Z
Z
s
"}
(36,1,1) = {"
s
Z
Z
Z
Z
Z
Z
a
a
a
a
a
a
Z
Z
Z
a
a
a
a
a
a
a
a
a
a
a
a
a
a
a
a
a
a
a
a
a
a
a
a
a
a
a
a
a
a
a
a
a
Z
Z
Z
Z
Z
Z
s
"}
(37,1,1) = {"
s
Z
Z
Z
Z
Z
Z
a
a
a
a
a
a
a
Z
a
a
a
a
a
a
a
a
a
a
a
a
a
a
a
a
a
a
a
a
a
a
a
a
a
a
a
a
a
a
a
a
a
a
Z
Z
Z
Z
Z
Z
s
"}
(38,1,1) = {"
s
Z
Z
Z
Z
Z
Z
a
a
a
a
a
Z
a
a
a
a
a
a
a
a
a
a
a
a
a
a
a
a
a
a
a
a
a
a
a
a
a
a
a
a
d
a
a
a
a
a
a
a
Z
Z
Z
Z
Z
Z
s
"}
(39,1,1) = {"
s
Z
Z
Z
Z
Z
Z
Z
a
a
a
a
Z
a
a
a
a
a
a
a
a
a
a
a
a
a
a
a
a
a
a
a
a
a
a
Z
a
a
a
a
a
a
a
a
a
a
a
a
a
Z
Z
Z
Z
Z
Z
s
"}
(40,1,1) = {"
s
Z
Z
Z
Z
Z
Z
Z
a
a
a
a
a
a
a
a
a
a
a
a
a
a
a
a
a
X
a
a
a
a
a
a
a
a
Z
Z
Z
a
a
a
a
a
a
a
a
a
a
a
a
Z
Z
Z
Z
Z
Z
s
"}
(41,1,1) = {"
s
Z
Z
Z
Z
Z
Z
Z
a
a
a
a
a
a
a
a
a
a
a
a
a
a
a
a
a
a
a
a
a
a
a
a
a
a
Z
Z
Z
a
a
a
a
a
a
a
a
a
a
a
a
Z
Z
Z
Z
Z
Z
s
"}
(42,1,1) = {"
s
Z
Z
s
Z
Z
Z
Z
a
a
a
a
a
a
a
a
a
a
a
a
a
a
a
a
a
a
a
a
a
a
a
a
a
a
a
a
a
a
a
a
a
a
a
a
a
a
a
a
Z
Z
Z
Z
Z
Z
Z
s
"}
(43,1,1) = {"
s
Z
Z
Z
Z
Z
Z
a
a
a
p
p
a
a
a
a
a
g
a
a
a
a
Z
a
a
a
a
a
a
p
a
a
a
a
a
a
a
a
a
a
a
a
a
a
a
a
a
a
Z
Z
Z
Z
Z
Z
Z
s
"}
(44,1,1) = {"
s
Z
Z
Z
Z
Z
Z
a
a
a
p
p
a
a
a
a
a
a
a
a
a
Z
Z
Z
a
a
a
a
a
p
p
a
a
a
a
a
a
a
a
a
a
a
a
a
a
a
a
a
a
Z
Z
Z
Z
Z
Z
s
"}
(45,1,1) = {"
s
Z
Z
Z
Z
Z
Z
a
c
a
a
a
a
a
a
a
a
a
a
a
a
a
a
a
a
a
a
a
a
a
a
a
a
a
a
a
a
a
a
a
a
a
a
a
a
a
a
a
a
Z
Z
Z
Z
Z
Z
s
"}
(46,1,1) = {"
s
Z
Z
Z
Z
Z
Z
a
a
a
a
a
a
a
a
a
a
a
a
a
a
a
a
a
a
a
a
a
a
a
a
a
a
a
a
a
a
a
a
a
a
Y
a
a
a
a
a
a
a
Z
Z
Z
Z
Z
Z
s
"}
(47,1,1) = {"
s
Z
Z
Z
Z
Z
Z
a
a
a
a
a
a
a
a
a
a
a
a
a
a
a
a
a
a
a
a
a
a
a
a
a
a
a
a
a
a
a
a
a
a
a
a
a
a
a
a
a
a
Z
Z
Z
Z
Z
Z
s
"}
(48,1,1) = {"
s
Z
Z
Z
Z
Z
Z
a
Z
Z
Z
Z
a
a
a
a
a
Z
Z
Z
Z
a
a
a
Z
Z
Z
Z
Z
a
a
a
a
a
a
Z
Z
Z
Z
a
a
a
a
a
a
Z
Z
a
a
Z
Z
Z
Z
Z
Z
s
"}
(49,1,1) = {"
s
Z
Z
Z
Z
Z
Z
Z
Z
Z
Z
Z
Z
Z
Z
Z
Z
Z
Z
Z
Z
Z
Z
Z
Z
Z
Z
Z
Z
Z
Z
Z
Z
Z
Z
Z
Z
Z
Z
Z
Z
Z
Z
Z
Z
Z
Z
Z
Z
Z
s
Z
Z
Z
Z
s
"}
(50,1,1) = {"
s
Z
Z
Z
Z
Z
Z
Z
Z
Z
Z
Z
Z
Z
Z
Z
Z
Z
Z
Z
Z
Z
Z
Z
Z
Z
Z
Z
Z
Z
Z
Z
Z
Z
Z
Z
Z
Z
Z
Z
Z
Z
Z
Z
Z
Z
Z
Z
Z
Z
Z
Z
Z
Z
Z
s
"}
(51,1,1) = {"
s
Z
Z
Z
Z
Z
Z
Z
Z
Z
Z
Z
Z
Z
Z
Z
Z
Z
Z
Z
Z
Z
Z
Z
Z
Z
Z
Z
Z
Z
Z
Z
Z
Z
Z
Z
Z
Z
Z
Z
Z
Z
Z
Z
Z
Z
Z
Z
Z
Z
Z
Z
Z
Z
Z
s
"}
(52,1,1) = {"
s
Z
Z
Z
Z
Z
Z
s
s
Z
Z
Z
Z
Z
Z
Z
Z
Z
Z
Z
Z
s
Z
Z
Z
Z
Z
Z
Z
Z
Z
Z
Z
Z
Z
Z
Z
Z
Z
Z
Z
Z
Z
Z
s
Z
Z
Z
Z
Z
Z
Z
Z
Z
Z
s
"}
(53,1,1) = {"
s
Z
Z
Z
Z
Z
Z
Z
Z
Z
Z
Z
Z
Z
Z
Z
Z
Z
Z
Z
Z
Z
Z
Z
Z
Z
Z
Z
Z
Z
Z
Z
Z
Z
Z
Z
s
Z
Z
Z
Z
Z
Z
Z
Z
Z
Z
Z
Z
Z
Z
Z
Z
Z
Z
s
"}
(54,1,1) = {"
s
Z
Z
Z
Z
Z
Z
Z
Z
Z
Z
Z
Z
Z
Z
Z
Z
Z
Z
Z
Z
Z
Z
Z
Z
Z
Z
Z
Z
Z
Z
Z
Z
Z
Z
Z
Z
Z
s
Z
Z
Z
Z
Z
Z
Z
Z
Z
Z
Z
s
Z
Z
Z
Z
s
"}
(55,1,1) = {"
s
s
s
s
s
s
s
s
s
s
s
s
s
s
s
s
s
s
s
s
s
s
s
s
s
s
s
s
s
s
s
s
s
s
s
s
s
s
s
s
s
s
s
s
s
s
s
s
s
s
s
s
s
s
s
s
"}
