//MAP CONVERTED BY dmm2tgm.py THIS HEADER COMMENT PREVENTS RECONVERSION, DO NOT REMOVE
"b" = (
/obj/structure/closet/crate/secure/bitrunning/encrypted/gondola,
/turf/open/floor/grass,
/area/virtual_domain)
"d" = (
/obj/structure/flora/bush/sparsegrass/style_random,
/turf/open/floor/grass,
/area/virtual_domain)
"f" = (
/obj/structure/flora/bush/stalky/style_random,
/turf/open/floor/grass,
/area/virtual_domain)
"i" = (
/obj/structure/flora/coconuts,
/turf/open/floor/grass,
/area/virtual_domain)
"j" = (
/obj/effect/baseturf_helper/virtual_domain,
/turf/closed/mineral/random,
/area/virtual_domain)
"k" = (
/obj/structure/flora/bush/fullgrass/style_random,
/turf/open/floor/grass,
/area/virtual_domain)
"l" = (
/turf/open/floor/grass,
/area/virtual_domain)
"o" = (
/turf/template_noop,
/area/template_noop)
"p" = (
/mob/living/basic/pet/gondola/virtual_domain,
/turf/open/floor/grass,
/area/virtual_domain)
"r" = (
/obj/effect/baseturf_helper/virtual_domain,
/turf/template_noop,
/area/virtual_domain/safehouse)
"t" = (
/turf/template_noop,
/area/virtual_domain/safehouse)
"u" = (
/turf/open/space/basic,
/area/space/virtual_domain)
"v" = (
/turf/closed/indestructible/binary,
/area/virtual_domain/fullbright)
"x" = (
/obj/structure/water_source/puddle,
/turf/open/floor/grass,
/area/virtual_domain)
"A" = (
/obj/structure/chair/wood{
	dir = 8
	},
/turf/template_noop,
/area/virtual_domain/safehouse)
"B" = (
/obj/structure/flora/bush/sunny/style_random,
/turf/open/floor/grass,
/area/virtual_domain)
"E" = (
/turf/closed/mineral/random,
/area/virtual_domain)
"G" = (
/obj/structure/flora/bush/large/style_random,
/turf/open/floor/grass,
/area/virtual_domain)
"H" = (
/obj/structure/flora/bush/reed/style_random,
/turf/open/floor/grass,
/area/virtual_domain)
"L" = (
/obj/structure/flora/tree/palm,
/turf/open/floor/grass,
/area/virtual_domain)
"M" = (
/obj/structure/table/wood,
/obj/item/storage/bag/tray,
/obj/item/kitchen/fork,
/obj/item/knife/kitchen,
/turf/template_noop,
/area/virtual_domain/safehouse)
"O" = (
/obj/modular_map_root/safehouse{
	key = "shuttle_space"
	},
/turf/template_noop,
/area/virtual_domain/safehouse)
"P" = (
/turf/open/misc/asteroid/airless,
/area/virtual_domain)
"R" = (
/obj/structure/marker_beacon{
	light_color = "#FFE8AA";
	light_range = 20
	},
/turf/open/floor/grass,
/area/virtual_domain)
"S" = (
/obj/structure/flora/bush/flowers_br/style_random,
/turf/open/floor/grass,
/area/virtual_domain)
"U" = (
/obj/structure/flora/bush/ferny/style_random,
/turf/open/floor/grass,
/area/virtual_domain)
"X" = (
/obj/structure/flora/bush/grassy/style_random,
/turf/open/floor/grass,
/area/virtual_domain)
"Y" = (
/obj/structure/flora/bush/flowers_yw/style_random,
/turf/open/floor/grass,
/area/virtual_domain)
"Z" = (
/obj/structure/flora/bush/lavendergrass/style_random,
/turf/open/floor/grass,
/area/virtual_domain)

(1,1,1) = {"
o
o
o
o
o
o
o
o
o
o
o
o
o
o
o
o
o
o
o
o
o
o
o
o
o
v
v
v
v
v
v
v
v
o
o
o
o
o
o
o
o
o
o
"}
(2,1,1) = {"
o
o
o
o
o
o
o
o
o
o
o
o
o
o
o
o
o
o
o
o
o
o
o
v
v
v
E
E
E
E
E
E
v
v
o
o
o
o
o
o
o
o
o
"}
(3,1,1) = {"
o
o
o
o
o
o
o
o
o
o
o
o
o
o
o
o
o
o
o
v
v
v
v
v
E
E
E
E
E
E
E
E
E
v
v
v
o
o
o
o
o
o
o
"}
(4,1,1) = {"
o
o
o
o
o
o
o
o
o
o
o
o
o
o
v
v
v
v
v
v
v
E
E
E
E
E
E
E
E
E
E
E
E
E
j
v
o
o
o
o
o
o
o
"}
(5,1,1) = {"
o
o
o
o
o
o
o
o
o
o
o
o
o
v
v
E
E
E
E
E
E
E
E
E
E
E
E
E
E
l
E
E
E
E
E
v
o
o
o
o
o
o
o
"}
(6,1,1) = {"
o
o
o
o
o
o
o
o
v
v
v
v
v
v
E
E
E
E
E
E
E
E
E
E
E
l
l
l
l
l
l
l
E
E
E
v
o
o
o
o
o
o
o
"}
(7,1,1) = {"
o
o
o
o
o
o
o
v
v
E
E
E
E
E
E
E
E
E
E
E
E
E
E
l
l
l
l
Y
l
l
l
p
l
E
E
v
o
o
o
o
o
o
o
"}
(8,1,1) = {"
o
o
o
o
o
v
v
v
E
E
E
E
E
E
E
E
E
E
E
E
E
l
l
l
l
Z
l
L
l
E
E
E
E
E
P
v
v
v
v
v
v
v
v
"}
(9,1,1) = {"
o
o
o
o
v
v
E
E
E
E
E
E
E
E
E
E
l
E
l
l
l
l
l
l
l
l
i
l
l
l
l
E
E
E
P
u
u
u
u
u
u
u
v
"}
(10,1,1) = {"
o
o
v
v
v
E
E
E
E
E
E
E
E
l
L
l
l
U
l
l
i
l
l
L
l
l
l
l
X
l
l
E
E
E
P
u
u
u
u
u
u
u
v
"}
(11,1,1) = {"
o
v
v
E
E
E
E
E
E
E
E
E
E
E
E
l
l
l
l
l
G
l
l
l
l
l
l
d
l
l
l
E
E
E
P
u
u
u
u
u
u
u
v
"}
(12,1,1) = {"
o
v
E
E
E
E
E
E
E
E
E
E
E
E
l
d
H
Y
l
l
R
l
l
i
l
p
l
f
l
R
l
E
E
E
P
u
u
u
u
u
u
u
v
"}
(13,1,1) = {"
v
v
E
E
E
E
E
E
E
E
E
E
l
l
l
l
Z
Z
l
p
l
l
l
l
l
l
l
d
Z
l
l
E
E
E
P
u
u
u
u
u
u
u
v
"}
(14,1,1) = {"
v
E
E
E
E
E
E
E
E
E
E
E
l
l
x
l
d
l
U
l
l
l
l
l
l
G
l
l
l
l
E
E
E
E
P
u
u
u
u
u
u
u
v
"}
(15,1,1) = {"
v
E
E
E
E
E
E
E
E
E
E
p
l
l
l
l
f
l
l
l
X
d
l
l
l
l
l
x
l
E
E
E
E
E
P
u
u
u
u
u
u
u
v
"}
(16,1,1) = {"
v
E
E
E
E
E
E
E
E
E
E
E
E
E
E
l
l
l
l
l
d
Z
l
l
l
l
l
l
l
l
E
E
E
E
P
u
u
u
u
u
u
u
v
"}
(17,1,1) = {"
v
E
E
E
E
E
E
E
E
E
E
E
E
E
E
E
E
l
l
l
Z
S
l
l
l
l
L
l
l
l
l
E
E
E
E
t
t
t
t
t
O
u
v
"}
(18,1,1) = {"
v
E
E
E
E
E
E
E
E
E
E
E
E
E
E
E
E
E
l
k
H
l
l
l
l
l
l
l
l
l
l
l
E
E
E
t
t
M
M
t
t
u
v
"}
(19,1,1) = {"
v
E
E
E
E
E
E
E
E
E
l
k
l
E
E
E
E
E
l
l
l
l
l
l
d
B
l
l
l
d
l
l
E
l
l
t
t
A
A
t
t
u
v
"}
(20,1,1) = {"
v
E
E
E
E
E
E
E
E
l
l
l
l
l
l
E
E
E
l
l
L
i
l
l
l
Y
l
l
l
l
l
l
l
l
l
t
t
t
t
t
t
u
v
"}
(21,1,1) = {"
v
P
E
E
E
E
E
E
E
p
l
l
R
l
l
l
l
l
l
l
l
l
l
l
l
l
l
l
l
l
l
l
l
l
l
t
t
t
t
t
t
u
v
"}
(22,1,1) = {"
v
P
P
E
E
E
E
E
E
l
l
l
L
l
d
d
l
l
U
l
b
l
l
l
R
l
p
l
l
l
l
l
E
E
E
t
t
t
t
t
t
u
v
"}
(23,1,1) = {"
v
P
P
E
E
E
E
E
E
l
l
l
l
l
l
f
l
l
l
l
l
l
l
l
l
l
l
l
l
L
l
l
E
E
E
t
t
t
t
t
r
u
v
"}
(24,1,1) = {"
v
P
P
E
E
E
E
E
E
l
l
i
l
l
l
l
l
l
l
x
l
p
G
l
l
l
G
l
l
l
l
l
E
E
E
u
u
u
u
u
u
u
v
"}
(25,1,1) = {"
v
v
P
P
E
E
E
E
k
l
l
l
l
l
p
l
l
l
l
l
l
l
l
l
X
l
l
l
l
l
l
l
E
E
E
u
u
u
u
u
u
u
v
"}
(26,1,1) = {"
o
v
P
P
E
E
E
l
l
l
l
l
l
l
l
l
d
f
l
l
l
l
l
l
H
X
l
l
l
l
l
E
E
E
u
u
u
u
u
u
u
u
v
"}
(27,1,1) = {"
o
v
P
P
E
E
E
l
l
l
x
l
l
l
l
X
S
d
l
Y
l
l
l
l
l
l
L
l
l
i
l
E
E
E
u
u
u
u
u
u
u
u
v
"}
(28,1,1) = {"
o
v
P
P
E
E
E
E
l
l
l
l
l
l
l
l
l
l
l
R
X
d
l
l
l
l
l
l
l
l
E
E
E
u
u
u
u
u
u
u
u
u
v
"}
(29,1,1) = {"
o
v
v
P
P
E
E
E
l
l
l
l
l
k
l
l
l
l
l
l
d
f
S
l
l
l
l
x
l
E
E
E
E
u
u
u
u
u
u
u
u
u
v
"}
(30,1,1) = {"
o
o
v
P
P
E
E
l
l
l
k
l
l
l
l
l
l
l
l
l
l
l
l
l
l
d
l
l
l
E
E
E
P
P
u
u
u
u
u
u
u
u
v
"}
(31,1,1) = {"
o
o
v
P
E
E
l
R
Y
l
d
l
l
l
E
l
l
l
l
l
i
l
l
l
l
l
l
l
E
E
E
P
P
P
u
u
u
u
u
u
u
u
v
"}
(32,1,1) = {"
o
o
v
E
E
E
E
l
l
l
l
l
l
E
E
E
l
l
l
L
l
l
l
l
l
l
E
E
E
E
P
P
P
E
E
v
v
v
v
v
v
v
v
"}
(33,1,1) = {"
o
o
v
E
E
E
l
l
l
l
l
l
E
E
E
E
E
E
E
E
E
E
E
E
E
E
E
E
E
E
P
P
E
E
E
v
o
o
o
o
o
o
o
"}
(34,1,1) = {"
o
o
v
E
E
l
l
l
l
E
E
E
E
E
E
E
E
E
E
E
E
E
E
E
E
E
E
E
E
v
v
E
E
E
v
v
o
o
o
o
o
o
o
"}
(35,1,1) = {"
o
o
v
E
E
E
E
E
E
E
E
E
E
E
P
P
P
P
P
E
E
E
E
E
v
v
v
v
v
v
v
E
E
E
v
v
o
o
o
o
o
o
o
"}
(36,1,1) = {"
o
o
v
v
E
E
E
E
E
E
E
E
E
v
v
v
v
v
v
v
v
v
v
v
v
o
o
o
o
o
v
v
v
v
v
o
o
o
o
o
o
o
o
"}
(37,1,1) = {"
o
o
o
v
v
v
v
v
v
v
v
v
v
v
o
o
o
o
o
o
o
o
o
o
o
o
o
o
o
o
o
o
o
o
o
o
o
o
o
o
o
o
o
"}
