//MAP CONVERTED BY dmm2tgm.py THIS HEADER COMMENT PREVENTS RECONVERSION, DO NOT REMOVE
"al" = (
/obj/structure/flora/bush/sunny,
/turf/open/misc/grass,
/area/virtual_domain/fullbright)
"aG" = (
/obj/structure/flora/rock/pile,
/turf/open/water/beach,
/area/virtual_domain/protected_space/fullbright)
"aP" = (
/obj/structure/flora/rock/pile/style_2,
/turf/open/water/beach,
/area/virtual_domain/protected_space/fullbright)
"bb" = (
/obj/effect/turf_decal/weather/sand,
/turf/open/floor/wood,
/area/virtual_domain/fullbright)
"bc" = (
/turf/open/misc/beach/coast{
	dir = 10
	},
/area/virtual_domain/fullbright)
"bw" = (
/obj/structure/flora/rock/pile/style_3,
/turf/open/misc/dirt/jungle,
/area/virtual_domain/protected_space)
"cX" = (
/obj/effect/decal/cleanable/dirt/dust,
/obj/item/claymore/cutlass,
/obj/item/clothing/head/costume/pirate/bandana/armored{
	pixel_x = -9;
	pixel_y = 7
	},
/obj/structure/table/wood,
/obj/item/gun/energy/laser{
	pixel_y = -3
	},
/turf/open/floor/wood{
	icon_state = "wood_large"
	},
/area/virtual_domain/fullbright)
"dc" = (
/turf/open/misc/beach/coast/corner,
/area/virtual_domain/fullbright)
"dG" = (
/obj/effect/turf_decal/siding/wood,
/turf/open/floor/wood,
/area/virtual_domain/protected_space/fullbright)
"dN" = (
/obj/machinery/door/airlock/vault{
	color = "#825427";
	name = "Ye Olde Strong Door"
	},
/turf/open/floor/wood/parquet,
/area/virtual_domain)
"eS" = (
/turf/open/misc/beach/sand,
/area/virtual_domain/fullbright)
"eT" = (
/obj/item/stack/cannonball/shellball{
	pixel_x = 13;
	pixel_y = 11
	},
/obj/item/stack/cannonball{
	pixel_x = 9;
	pixel_y = 9
	},
/obj/effect/decal/cleanable/dirt/dust,
/turf/open/floor/wood,
/area/virtual_domain/protected_space/fullbright)
"fh" = (
/obj/structure/flora/bush/sparsegrass,
/obj/structure/flora/bush/lavendergrass,
/turf/open/misc/grass,
/area/virtual_domain/fullbright)
"fk" = (
/obj/structure/flora/bush/sparsegrass/style_random,
/turf/open/misc/grass,
/area/virtual_domain/fullbright)
"fD" = (
/turf/closed/wall/mineral/wood/nonmetal,
/area/virtual_domain/protected_space/fullbright)
"fR" = (
/obj/effect/baseturf_helper/virtual_domain,
/turf/closed/indestructible/binary,
/area/virtual_domain/fullbright)
"gf" = (
/obj/effect/turf_decal/weather/sand{
	dir = 5
	},
/obj/effect/decal/cleanable/glass,
/turf/open/floor/wood,
/area/virtual_domain/fullbright)
"gu" = (
/obj/structure/flora/bush/stalky,
/turf/open/misc/beach/coast,
/area/virtual_domain/fullbright)
"gx" = (
/obj/effect/mapping_helpers/burnt_floor,
/turf/open/floor/wood{
	icon_state = "wood_large"
	},
/area/virtual_domain/fullbright)
"gB" = (
/obj/effect/turf_decal/weather/sand{
	dir = 9
	},
/turf/open/floor/wood{
	icon_state = "wood_large"
	},
/area/virtual_domain/fullbright)
"gJ" = (
/obj/effect/turf_decal/weather/dirt{
	dir = 4
	},
/turf/open/misc/beach/coast{
	dir = 6
	},
/area/virtual_domain/protected_space)
"gK" = (
/obj/structure/flora/bush/flowers_br/style_random,
/obj/structure/flora/bush/ferny,
/turf/open/misc/grass,
/area/virtual_domain/fullbright)
"ha" = (
/obj/structure/cannon{
	dir = 1
	},
/obj/effect/turf_decal/siding/wood{
	dir = 1
	},
/turf/open/floor/wood,
/area/virtual_domain/protected_space/fullbright)
"hb" = (
/turf/closed/indestructible/binary,
/area/virtual_domain/fullbright)
"iW" = (
/turf/open/floor/wood,
/area/virtual_domain/protected_space/fullbright)
"jp" = (
/obj/effect/landmark/bitrunning/cache_spawn,
/turf/open/misc/beach/sand,
/area/virtual_domain/fullbright)
"jE" = (
/turf/open/floor/wood/parquet,
/area/virtual_domain)
"jH" = (
/obj/structure/headpike/bone,
/turf/open/misc/beach/coast,
/area/virtual_domain/fullbright)
"jN" = (
/obj/structure/flora/tree/jungle,
/obj/structure/flora/bush/fullgrass/style_random,
/turf/open/misc/grass,
/area/virtual_domain/fullbright)
"jZ" = (
/obj/structure/flora/bush/sunny/style_3{
	pixel_y = 22
	},
/turf/open/misc/dirt/jungle,
/area/virtual_domain/protected_space)
"lF" = (
/obj/structure/table/wood,
/obj/item/melee/energy/sword/pirate{
	pixel_y = 10
	},
/obj/item/clothing/mask/cigarette/cigar{
	pixel_x = 4
	},
/obj/item/lighter{
	pixel_x = 10;
	pixel_y = -8
	},
/obj/machinery/light/small/directional/north,
/turf/open/floor/carpet/blue,
/area/virtual_domain)
"lK" = (
/obj/item/stack/cannonball{
	pixel_x = 7;
	pixel_y = 8
	},
/obj/item/stack/cannonball{
	pixel_x = 11;
	pixel_y = -4
	},
/obj/effect/turf_decal/weather/sand{
	dir = 1
	},
/obj/effect/decal/cleanable/oil/streak,
/turf/open/floor/wood,
/area/virtual_domain/fullbright)
"mj" = (
/obj/structure/flora/rock/pile/jungle/large,
/turf/open/misc/dirt/jungle,
/area/virtual_domain/protected_space)
"mp" = (
/turf/open/misc/beach/coast{
	dir = 4
	},
/area/virtual_domain/fullbright)
"mv" = (
/obj/structure/fermenting_barrel{
	pixel_x = 6;
	pixel_y = 11
	},
/obj/effect/turf_decal/weather/sand{
	dir = 9
	},
/obj/effect/mob_spawn/ghost_role/human/virtual_domain/pirate,
/turf/open/floor/wood{
	icon_state = "wood_large"
	},
/area/virtual_domain/fullbright)
"mR" = (
/obj/machinery/smartfridge/drying_rack,
/turf/open/misc/beach/sand,
/area/virtual_domain/fullbright)
"nr" = (
/mob/living/basic/trooper/pirate/melee,
/turf/open/misc/beach/sand,
/area/virtual_domain/fullbright)
"ow" = (
/obj/structure/flora/rock,
/turf/open/water/beach,
/area/virtual_domain/protected_space/fullbright)
"oL" = (
/obj/effect/decal/cleanable/dirt/dust,
/obj/structure/bed/maint,
/turf/open/floor/wood,
/area/virtual_domain/fullbright)
"pi" = (
/obj/structure/flora/rock/style_3,
/turf/open/water/beach,
/area/virtual_domain/fullbright)
"pn" = (
/obj/structure/flora/bush/flowers_br/style_random,
/turf/open/misc/grass,
/area/virtual_domain/fullbright)
"pF" = (
/turf/closed/mineral/random/jungle,
/area/virtual_domain/protected_space/fullbright)
"qE" = (
/obj/structure/table/wood,
/obj/item/book/manual/wiki/ordnance,
/turf/open/floor/carpet/blue,
/area/virtual_domain)
"qO" = (
/obj/effect/turf_decal/siding/wood{
	dir = 1
	},
/obj/structure/table/wood,
/obj/item/gun/energy/laser/musket{
	pixel_y = 7
	},
/obj/item/gun/energy/laser/musket{
	pixel_y = 2
	},
/obj/item/gun/energy/laser/musket{
	pixel_y = -3
	},
/turf/open/floor/wood,
/area/virtual_domain/protected_space/fullbright)
"qS" = (
/obj/effect/decal/cleanable/ants,
/turf/open/misc/grass,
/area/virtual_domain/fullbright)
"ri" = (
/obj/effect/turf_decal/siding/wood{
	dir = 8
	},
/obj/effect/decal/cleanable/dirt/dust,
/mob/living/basic/trooper/pirate/ranged/space,
/turf/open/floor/carpet/blue,
/area/virtual_domain)
"ru" = (
/obj/effect/mapping_helpers/broken_floor,
/obj/effect/decal/cleanable/dirt/dust,
/obj/structure/bed/maint{
	pixel_x = 2;
	pixel_y = 1
	},
/obj/effect/decal/cleanable/cobweb,
/obj/item/toy/plush/beeplushie,
/turf/open/floor/wood,
/area/virtual_domain/fullbright)
"rE" = (
/obj/structure/fermenting_barrel/gunpowder{
	pixel_x = -4;
	pixel_y = 17
	},
/obj/effect/decal/cleanable/dirt/dust,
/turf/open/floor/wood,
/area/virtual_domain/protected_space/fullbright)
"rZ" = (
/obj/structure/flora/grass/jungle/b{
	pixel_x = -15;
	pixel_y = 9
	},
/obj/structure/flora/rock/pile/jungle/large/style_2{
	pixel_x = -3;
	pixel_y = -1
	},
/turf/open/misc/dirt/jungle,
/area/virtual_domain/protected_space)
"sj" = (
/obj/effect/mine/explosive/light,
/turf/open/misc/beach/sand,
/area/virtual_domain/fullbright)
"td" = (
/obj/effect/decal/cleanable/dirt/dust,
/obj/effect/landmark/bitrunning/cache_spawn,
/turf/open/floor/carpet/blue,
/area/virtual_domain)
"tw" = (
/obj/structure/bookcase/random/adult,
/obj/effect/decal/cleanable/cobweb,
/turf/open/floor/wood/parquet,
/area/virtual_domain)
"tH" = (
/obj/structure/closet/cabinet,
/obj/item/clothing/head/costume/pirate/armored,
/obj/item/clothing/suit/costume/pirate/captain/armored,
/obj/effect/decal/cleanable/dirt/dust,
/turf/open/floor/wood/parquet,
/area/virtual_domain)
"tQ" = (
/obj/structure/barricade/sandbags,
/obj/effect/turf_decal/weather/sand{
	dir = 10
	},
/turf/open/floor/wood{
	icon_state = "wood_large"
	},
/area/virtual_domain/fullbright)
"ub" = (
/turf/template_noop,
/area/virtual_domain/safehouse)
"uk" = (
/obj/structure/flora/rock{
	pixel_x = 7
	},
/turf/open/water/beach,
/area/virtual_domain/fullbright)
"uG" = (
/obj/structure/barricade/sandbags,
/obj/effect/turf_decal/weather/sand{
	dir = 4
	},
/turf/open/floor/wood{
	icon_state = "wood_large"
	},
/area/virtual_domain/fullbright)
"uH" = (
/obj/effect/decal/cleanable/dirt/dust,
/obj/structure/table/wood,
/obj/item/flashlight/flare/torch{
	pixel_y = 10
	},
/obj/item/flashlight/flare/torch{
	pixel_x = 8;
	pixel_y = 6
	},
/turf/open/floor/wood{
	icon_state = "wood_large"
	},
/area/virtual_domain/fullbright)
"vB" = (
/obj/effect/decal/cleanable/dirt/dust,
/turf/open/floor/wood,
/area/virtual_domain/protected_space/fullbright)
"wj" = (
/obj/effect/turf_decal/siding/wood{
	dir = 8
	},
/obj/effect/decal/cleanable/dirt/dust,
/obj/effect/decal/cleanable/oil,
/turf/open/floor/wood,
/area/virtual_domain/fullbright)
"wE" = (
/obj/effect/turf_decal/siding/wood,
/obj/item/melee/sabre{
	pixel_y = 12;
	pixel_x = -10
	},
/obj/item/gun/energy/laser/retro,
/obj/effect/decal/cleanable/dirt/dust,
/turf/open/floor/wood,
/area/virtual_domain/protected_space/fullbright)
"wH" = (
/obj/structure/fluff/beach_umbrella{
	pixel_x = -7;
	pixel_y = -10
	},
/turf/open/misc/beach/sand,
/area/virtual_domain/fullbright)
"wP" = (
/obj/structure/railing{
	color = "#4C3117";
	name = "wooden railing"
	},
/obj/effect/turf_decal/weather/sand{
	dir = 9
	},
/turf/open/floor/wood,
/area/virtual_domain/fullbright)
"xg" = (
/turf/template_noop,
/area/template_noop)
"xp" = (
/turf/open/water/beach,
/area/virtual_domain/fullbright)
"yB" = (
/obj/structure/flora/rock/style_3,
/turf/open/water/beach,
/area/virtual_domain/protected_space/fullbright)
"yQ" = (
/obj/structure/flora/grass/jungle/b,
/turf/open/misc/dirt/jungle,
/area/virtual_domain/protected_space)
"zj" = (
/obj/effect/mapping_helpers/burnt_floor,
/obj/effect/decal/cleanable/garbage,
/turf/open/floor/wood,
/area/virtual_domain/fullbright)
"zR" = (
/obj/effect/baseturf_helper/virtual_domain,
/turf/template_noop,
/area/virtual_domain/safehouse)
"zU" = (
/obj/structure/flora/coconuts{
	pixel_x = 12
	},
/obj/structure/flora/tree/palm,
/turf/open/misc/beach/sand,
/area/virtual_domain/fullbright)
"zW" = (
/obj/structure/flora/bush/grassy{
	pixel_y = 8
	},
/obj/structure/flora/bush/lavendergrass{
	pixel_y = -10
	},
/turf/open/misc/grass,
/area/virtual_domain/fullbright)
"Am" = (
/obj/effect/turf_decal/weather/dirt{
	dir = 1
	},
/turf/open/water/beach,
/area/virtual_domain/protected_space)
"AB" = (
/obj/structure/headpike/bone{
	pixel_y = 24
	},
/turf/open/misc/beach/coast,
/area/virtual_domain/fullbright)
"AF" = (
/obj/effect/mapping_helpers/burnt_floor,
/obj/item/storage/bag/money/dutchmen{
	pixel_y = 13
	},
/obj/structure/rack/skeletal,
/turf/open/floor/wood/parquet,
/area/virtual_domain)
"AP" = (
/obj/effect/decal/cleanable/dirt/dust,
/turf/open/floor/wood/parquet,
/area/virtual_domain)
"Bu" = (
/obj/effect/turf_decal/siding/wood{
	dir = 8
	},
/obj/effect/mapping_helpers/burnt_floor,
/obj/effect/decal/cleanable/dirt/dust,
/obj/structure/bed/maint{
	pixel_x = 2;
	pixel_y = 13
	},
/turf/open/floor/wood,
/area/virtual_domain/fullbright)
"BP" = (
/turf/open/water/beach,
/area/virtual_domain/protected_space/fullbright)
"BU" = (
/turf/open/floor/carpet/blue,
/area/virtual_domain)
"BV" = (
/obj/structure/bonfire/prelit,
/turf/open/misc/beach/sand,
/area/virtual_domain/fullbright)
"Ci" = (
/turf/closed/wall/mineral/wood/nonmetal,
/area/virtual_domain/fullbright)
"Cr" = (
/turf/open/water/beach,
/area/virtual_domain/protected_space)
"Cu" = (
/obj/item/kirbyplants/organic/plant21{
	pixel_x = -8
	},
/obj/structure/filingcabinet{
	pixel_x = 11
	},
/turf/open/floor/wood/parquet,
/area/virtual_domain)
"CM" = (
/obj/effect/turf_decal/weather/dirt,
/obj/effect/turf_decal/weather/dirt,
/turf/open/water/beach,
/area/virtual_domain/protected_space)
"DD" = (
/obj/structure/flora/rock/pile/jungle/style_2,
/turf/open/misc/dirt/jungle,
/area/virtual_domain/protected_space)
"DM" = (
/turf/closed/mineral/random/jungle,
/area/virtual_domain/fullbright)
"Eb" = (
/obj/structure/flora/tree/palm,
/turf/open/misc/beach/sand,
/area/virtual_domain/fullbright)
"EL" = (
/obj/effect/decal/cleanable/dirt/dust,
/mob/living/basic/trooper/pirate/melee/space,
/turf/open/floor/wood/parquet,
/area/virtual_domain)
"ER" = (
/obj/effect/turf_decal/siding/wood,
/mob/living/basic/trooper/pirate/ranged,
/turf/open/floor/wood,
/area/virtual_domain/fullbright)
"Fl" = (
/obj/structure/barricade/sandbags,
/obj/effect/turf_decal/weather/sand,
/turf/open/floor/wood{
	icon_state = "wood_large"
	},
/area/virtual_domain/fullbright)
"Fo" = (
/obj/effect/turf_decal/weather/dirt,
/obj/structure/flora/rock/pile,
/turf/open/water/beach,
/area/virtual_domain/protected_space)
"Fq" = (
/obj/structure/flora/rock/pile/jungle/style_3{
	pixel_x = -15;
	pixel_y = -4
	},
/turf/open/misc/dirt/jungle,
/area/virtual_domain/protected_space)
"FP" = (
/obj/effect/turf_decal/weather/sand{
	dir = 4
	},
/obj/effect/decal/cleanable/cobweb/cobweb2,
/obj/machinery/jukebox,
/turf/open/floor/wood{
	icon_state = "wood_large"
	},
/area/virtual_domain/fullbright)
"Gj" = (
/obj/effect/turf_decal/siding/wood{
	dir = 1
	},
/obj/structure/table/wood,
/obj/item/flashlight/flare/torch{
	pixel_y = 10;
	pixel_x = 7
	},
/obj/item/reagent_containers/cup/bucket/wooden{
	pixel_y = -16;
	pixel_x = 12
	},
/obj/machinery/recharger{
	pixel_y = 6;
	pixel_x = -5
	},
/turf/open/floor/wood,
/area/virtual_domain/protected_space/fullbright)
"Gy" = (
/obj/structure/flora/rock/style_2,
/turf/open/water/beach,
/area/virtual_domain/fullbright)
"GH" = (
/obj/effect/landmark/bitrunning/cache_spawn,
/turf/open/misc/dirt/jungle,
/area/virtual_domain/protected_space)
"Hn" = (
/obj/effect/baseturf_helper/virtual_domain,
/turf/closed/wall/mineral/wood/nonmetal,
/area/virtual_domain)
"HO" = (
/obj/structure/table/wood,
/mob/living/basic/parrot{
	name = "pepper"
	},
/turf/open/floor/carpet/blue,
/area/virtual_domain)
"Iv" = (
/obj/structure/closet/crate/goldcrate,
/turf/open/misc/dirt/jungle,
/area/virtual_domain/protected_space)
"IS" = (
/obj/effect/turf_decal/weather/dirt{
	dir = 1
	},
/obj/effect/turf_decal/weather/dirt,
/turf/open/water/beach,
/area/virtual_domain/protected_space)
"Jf" = (
/obj/structure/flora/bush/sparsegrass,
/turf/open/misc/grass,
/area/virtual_domain/fullbright)
"Jq" = (
/obj/effect/mapping_helpers/burnt_floor,
/obj/structure/bed/maint{
	pixel_x = -10;
	pixel_y = 9
	},
/obj/effect/decal/cleanable/wrapping,
/turf/open/floor/wood,
/area/virtual_domain/fullbright)
"Jx" = (
/obj/item/bedsheet/rainbow/double,
/obj/structure/bed/double,
/turf/open/floor/carpet/blue,
/area/virtual_domain)
"JK" = (
/obj/structure/flora/bush/stalky{
	pixel_y = 13;
	pixel_x = -8
	},
/turf/open/water/beach,
/area/virtual_domain/fullbright)
"JX" = (
/turf/open/misc/beach/coast/corner{
	dir = 1
	},
/area/virtual_domain/fullbright)
"KS" = (
/obj/effect/turf_decal/siding/wood{
	dir = 8
	},
/obj/machinery/light/small/directional/south,
/obj/effect/landmark/bitrunning/cache_spawn,
/turf/open/floor/carpet/blue,
/area/virtual_domain)
"LC" = (
/mob/living/basic/trooper/pirate/melee,
/turf/open/misc/grass,
/area/virtual_domain/fullbright)
"LP" = (
/obj/effect/turf_decal/weather/sand{
	dir = 5
	},
/turf/open/floor/wood,
/area/virtual_domain/fullbright)
"Mf" = (
/obj/effect/decal/cleanable/dirt/dust,
/turf/open/floor/wood{
	icon_state = "wood_large"
	},
/area/virtual_domain/fullbright)
"MG" = (
/obj/structure/barricade/sandbags,
/turf/open/misc/beach/sand,
/area/virtual_domain/fullbright)
"MP" = (
/obj/effect/turf_decal/weather/sand{
	dir = 4
	},
/turf/open/floor/wood,
/area/virtual_domain/fullbright)
"NB" = (
/obj/effect/turf_decal/siding/wood{
	dir = 1
	},
/turf/open/floor/wood,
/area/virtual_domain/protected_space/fullbright)
"NE" = (
/obj/effect/mob_spawn/corpse/human/damaged,
/turf/open/water/beach,
/area/virtual_domain/fullbright)
"NN" = (
/obj/structure/flora/bush/fullgrass,
/turf/open/misc/grass,
/area/virtual_domain/fullbright)
"NP" = (
/obj/effect/mapping_helpers/burnt_floor,
/mob/living/basic/trooper/pirate/ranged,
/obj/structure/chair/wood,
/turf/open/floor/wood{
	icon_state = "wood_large"
	},
/area/virtual_domain/fullbright)
"Oj" = (
/obj/effect/turf_decal/siding/wood,
/obj/effect/decal/cleanable/dirt/dust,
/turf/open/floor/wood,
/area/virtual_domain/protected_space/fullbright)
"Ov" = (
/turf/open/misc/beach/coast{
	dir = 6
	},
/area/virtual_domain/fullbright)
"Ox" = (
/obj/structure/chair/comfy/carp{
	dir = 1
	},
/obj/effect/decal/cleanable/dirt/dust,
/turf/open/floor/carpet/blue,
/area/virtual_domain)
"OD" = (
/obj/effect/turf_decal/weather/sand{
	dir = 6
	},
/turf/open/floor/wood,
/area/virtual_domain/fullbright)
"Qc" = (
/obj/effect/mapping_helpers/broken_floor,
/turf/open/floor/wood{
	icon_state = "wood_large"
	},
/area/virtual_domain/fullbright)
"Qi" = (
/obj/effect/turf_decal/weather/dirt{
	dir = 5
	},
/turf/open/water/beach,
/area/virtual_domain/protected_space)
"QA" = (
/obj/effect/turf_decal/siding/wood,
/obj/effect/mapping_helpers/broken_floor,
/turf/open/floor/wood,
/area/virtual_domain/protected_space/fullbright)
"QH" = (
/obj/effect/turf_decal/weather/dirt,
/turf/open/water/beach,
/area/virtual_domain/protected_space)
"QN" = (
/obj/structure/barricade/sandbags,
/obj/effect/turf_decal/weather/sand{
	dir = 6
	},
/obj/item/binoculars{
	pixel_x = -1;
	pixel_y = 1
	},
/turf/open/floor/wood{
	icon_state = "wood_large"
	},
/area/virtual_domain/fullbright)
"QU" = (
/obj/effect/mob_spawn/corpse/human/pirate/melee,
/turf/open/water/beach,
/area/virtual_domain/fullbright)
"Rr" = (
/obj/structure/closet/crate/grave,
/obj/structure/flora/grass/jungle/b,
/turf/open/misc/dirt/jungle,
/area/virtual_domain/protected_space)
"RJ" = (
/obj/effect/turf_decal/siding/wood{
	dir = 8
	},
/obj/effect/mapping_helpers/burnt_floor,
/obj/effect/decal/cleanable/dirt/dust,
/mob/living/basic/trooper/pirate/ranged,
/turf/open/floor/wood,
/area/virtual_domain/fullbright)
"RO" = (
/obj/structure/flora/coconuts{
	pixel_x = 9;
	pixel_y = -14
	},
/obj/structure/flora/tree/palm/style_2,
/turf/open/misc/beach/sand,
/area/virtual_domain/fullbright)
"Sc" = (
/obj/structure/flora/bush/jungle,
/turf/open/misc/grass,
/area/virtual_domain/fullbright)
"SD" = (
/obj/effect/turf_decal/siding/wood,
/obj/effect/turf_decal/weather/sand{
	dir = 10
	},
/obj/effect/turf_decal/weather/sand{
	dir = 9
	},
/turf/open/floor/wood,
/area/virtual_domain/fullbright)
"SK" = (
/turf/open/misc/beach/coast,
/area/virtual_domain/fullbright)
"ST" = (
/obj/structure/bed/maint{
	pixel_x = -5;
	pixel_y = 9
	},
/obj/effect/turf_decal/weather/sand{
	dir = 6
	},
/turf/open/floor/wood,
/area/virtual_domain/fullbright)
"Ta" = (
/obj/structure/flora/bush/flowers_pp,
/turf/open/misc/grass,
/area/virtual_domain/fullbright)
"Th" = (
/obj/effect/turf_decal/weather/sand{
	dir = 10
	},
/turf/open/floor/wood{
	icon_state = "wood_large"
	},
/area/virtual_domain/fullbright)
"To" = (
/obj/structure/bookcase/random/fiction,
/turf/open/floor/wood/parquet,
/area/virtual_domain)
"Tr" = (
/obj/item/clothing/suit/armor/militia{
	pixel_x = -5;
	pixel_y = 12
	},
/obj/effect/turf_decal/siding/wood{
	dir = 1
	},
/obj/item/clothing/suit/armor/militia{
	pixel_x = -5;
	pixel_y = 6
	},
/obj/item/clothing/suit/armor/militia{
	pixel_x = -5;
	pixel_y = -3
	},
/obj/item/clothing/head/costume/fancy{
	pixel_x = 6;
	pixel_y = 12
	},
/obj/item/clothing/head/costume/fancy{
	pixel_x = 6;
	pixel_y = 6
	},
/obj/item/clothing/head/hats/coordinator{
	pixel_x = 8;
	pixel_y = -5
	},
/obj/structure/closet/cabinet,
/turf/open/floor/wood,
/area/virtual_domain/protected_space/fullbright)
"Ua" = (
/obj/effect/turf_decal/weather/dirt{
	dir = 4
	},
/turf/open/water/beach,
/area/virtual_domain/protected_space)
"Uf" = (
/turf/closed/indestructible/binary,
/area/virtual_domain/protected_space/fullbright)
"Ul" = (
/turf/closed/wall/mineral/wood/nonmetal,
/area/virtual_domain)
"UL" = (
/turf/open/misc/dirt/jungle,
/area/virtual_domain/protected_space)
"UN" = (
/obj/effect/mob_spawn/corpse/human/pirate,
/turf/open/misc/dirt/jungle,
/area/virtual_domain/protected_space)
"Vm" = (
/obj/effect/turf_decal/siding/wood{
	dir = 10
	},
/turf/open/floor/wood,
/area/virtual_domain/protected_space/fullbright)
"Vx" = (
/obj/structure/flora/rock/style_4,
/turf/open/water/beach,
/area/virtual_domain/fullbright)
"VG" = (
/obj/effect/turf_decal/siding/wood{
	dir = 8
	},
/obj/effect/decal/cleanable/dirt/dust,
/turf/open/floor/carpet/blue,
/area/virtual_domain)
"Wu" = (
/obj/structure/fermenting_barrel/gunpowder{
	pixel_x = -4;
	pixel_y = 17
	},
/obj/structure/fermenting_barrel/gunpowder{
	pixel_x = 4
	},
/obj/item/stack/cannonball/four{
	pixel_x = -9;
	pixel_y = -10
	},
/obj/item/stack/cannonball{
	pixel_x = 3;
	pixel_y = 8
	},
/obj/item/reagent_containers/cup/bucket/wooden{
	pixel_y = -10
	},
/turf/open/misc/beach/sand,
/area/virtual_domain/fullbright)
"WW" = (
/turf/template_noop,
/area/virtual_domain/fullbright)
"Xc" = (
/obj/item/gun/energy/laser/hellgun{
	pixel_y = 10
	},
/turf/open/misc/dirt/jungle,
/area/virtual_domain/protected_space)
"Xn" = (
/obj/modular_map_root/safehouse{
	key = "wood"
	},
/turf/template_noop,
/area/virtual_domain/safehouse)
"XP" = (
/obj/structure/barricade/wooden/crude,
/turf/closed/wall/mineral/wood/nonmetal,
/area/virtual_domain/fullbright)
"XW" = (
/obj/effect/mob_spawn/corpse/human/pirate,
/turf/open/misc/beach/coast{
	dir = 8
	},
/area/virtual_domain/fullbright)
"Yf" = (
/obj/machinery/loot_locator,
/turf/open/floor/carpet/blue,
/area/virtual_domain)
"Yr" = (
/obj/effect/mob_spawn/corpse/human/pirate,
/obj/effect/decal/cleanable/blood/gibs/old,
/turf/open/misc/beach/sand,
/area/virtual_domain/fullbright)
"YJ" = (
/obj/structure/table/wood,
/obj/effect/turf_decal/siding/wood{
	dir = 8
	},
/obj/item/reagent_containers/cup/glass/bottle/rum{
	desc = "Rum with ghostly properties that can help the drinker enter the spirit realm. It has fermented under the sea of space for ages.";
	name = "Ghost Pirate Rum";
	pixel_x = -4;
	pixel_y = 12
	},
/obj/item/reagent_containers/cup/glass/drinkingglass/shotglass{
	pixel_x = -7;
	pixel_y = 5
	},
/obj/item/reagent_containers/cup/glass/drinkingglass/shotglass{
	pixel_x = 3;
	pixel_y = 7
	},
/turf/open/floor/carpet/blue,
/area/virtual_domain)
"Za" = (
/obj/structure/barricade/wooden,
/turf/open/misc/beach/sand,
/area/virtual_domain/fullbright)
"Zq" = (
/obj/structure/railing{
	color = "#4C3117";
	name = "wooden railing"
	},
/obj/effect/decal/cleanable/vomit/old,
/obj/effect/turf_decal/weather/sand{
	dir = 1
	},
/turf/open/floor/wood,
/area/virtual_domain/fullbright)
"Zt" = (
/obj/structure/cannon,
/obj/effect/turf_decal/siding/wood,
/obj/effect/decal/cleanable/ash/large{
	pixel_y = -5;
	pixel_x = 8
	},
/turf/open/floor/wood,
/area/virtual_domain/fullbright)
"ZM" = (
/obj/structure/flora/grass/jungle/b/style_random{
	pixel_x = -13;
	pixel_y = 18
	},
/turf/open/misc/dirt/jungle,
/area/virtual_domain/protected_space)
"ZY" = (
/obj/structure/flora/grass/jungle,
/turf/open/misc/dirt/jungle,
/area/virtual_domain/protected_space)

(1,1,1) = {"
xg
xg
xg
xg
xg
xg
xg
xg
xg
xg
xg
xg
xg
xg
hb
hb
hb
hb
hb
hb
hb
hb
xg
xg
xg
xg
xg
xg
xg
xg
xg
xg
xg
xg
xg
xg
xg
xg
xg
xg
xg
xg
"}
(2,1,1) = {"
xg
xg
xg
xg
xg
xg
xg
xg
xg
xg
xg
xg
xg
hb
hb
DM
DM
DM
DM
DM
DM
hb
hb
hb
xg
xg
xg
xg
xg
xg
xg
xg
xg
xg
xg
xg
xg
xg
xg
xg
xg
xg
"}
(3,1,1) = {"
xg
xg
xg
xg
xg
xg
xg
xg
xg
xg
xg
hb
hb
hb
DM
DM
DM
DM
DM
DM
DM
DM
DM
hb
xg
xg
xg
xg
xg
xg
xg
xg
xg
xg
xg
xg
xg
xg
xg
xg
xg
xg
"}
(4,1,1) = {"
xg
xg
xg
xg
xg
xg
xg
xg
xg
xg
hb
hb
DM
DM
DM
DM
DM
DM
DM
DM
DM
DM
DM
hb
xg
xg
xg
xg
xg
xg
xg
xg
xg
xg
xg
xg
xg
xg
xg
xg
xg
xg
"}
(5,1,1) = {"
xg
xg
xg
xg
xg
xg
xg
xg
xg
xg
hb
DM
DM
DM
DM
DM
DM
gK
Jf
sj
DM
DM
DM
hb
xg
xg
xg
xg
xg
xg
xg
xg
xg
xg
xg
xg
xg
xg
xg
xg
xg
xg
"}
(6,1,1) = {"
xg
xg
xg
xg
xg
xg
xg
xg
hb
hb
hb
DM
DM
DM
jN
fk
zW
qS
eS
eS
eS
DM
DM
hb
hb
hb
Uf
Uf
Uf
Uf
xg
xg
xg
xg
xg
xg
xg
xg
xg
xg
xg
xg
"}
(7,1,1) = {"
xg
xg
xg
xg
xg
hb
hb
hb
hb
DM
DM
DM
DM
fh
Ta
al
eS
eS
eS
Eb
eS
Yr
DM
hb
hb
DM
pF
pF
pF
Uf
xg
xg
xg
xg
xg
xg
xg
xg
xg
xg
xg
xg
"}
(8,1,1) = {"
xg
xg
xg
xg
hb
hb
DM
DM
DM
DM
DM
Sc
pn
NN
LC
eS
eS
sj
eS
eS
eS
eS
sj
hb
hb
DM
pF
pF
pF
Uf
xg
xg
xg
xg
xg
xg
xg
xg
xg
xg
xg
xg
"}
(9,1,1) = {"
xg
xg
xg
hb
hb
DM
Ci
Ci
Ci
Ci
Wu
MG
MG
eS
eS
dc
mp
mp
mp
mp
mp
mp
mp
Ov
xp
xp
BP
BP
BP
Uf
Uf
Uf
Uf
xg
xg
xg
xg
xg
xg
xg
xg
xg
"}
(10,1,1) = {"
xg
xg
xg
hb
DM
Ci
Ci
Bu
RJ
wj
bb
eS
MG
eS
Yr
gu
JK
xp
xp
xp
xp
xp
xp
xp
xp
NE
BP
BP
BP
BP
BP
fD
Uf
Uf
Uf
xg
xg
xg
xg
xg
xg
xg
"}
(11,1,1) = {"
xg
xg
hb
hb
DM
Ci
ru
oL
Jq
zj
OD
eS
eS
SD
eS
jH
xp
xp
xp
xp
xp
xp
xp
xp
xp
Gy
BP
BP
BP
BP
BP
fD
qO
vB
Uf
hb
hb
hb
hb
hb
hb
fR
"}
(12,1,1) = {"
xg
xg
hb
DM
DM
Ci
jp
gf
MP
ST
Za
eS
wP
XP
dc
Ov
xp
xp
xp
xp
xp
xp
xp
xp
xp
xp
BP
BP
BP
BP
ow
fD
Gj
vB
Oj
ub
ub
ub
ub
ub
Xn
hb
"}
(13,1,1) = {"
hb
hb
hb
DM
DM
DM
Za
eS
eS
eS
eS
eS
lK
Zt
SK
xp
xp
xp
xp
xp
xp
QU
xp
xp
xp
xp
BP
BP
BP
BP
yB
fD
Tr
iW
wE
ub
ub
ub
ub
ub
ub
hb
"}
(14,1,1) = {"
hb
Ul
Ul
Ul
Ul
Ul
Hn
mR
eS
eS
eS
eS
Zq
Ci
AB
xp
xp
xp
xp
xp
xp
xp
xp
xp
xp
xp
BP
BP
BP
BP
BP
fD
fD
iW
QA
ub
ub
ub
ub
ub
ub
hb
"}
(15,1,1) = {"
hb
Ul
tw
To
AF
tH
Ul
nr
eS
BV
eS
eS
LP
ER
SK
xp
xp
xp
xp
xp
xp
xp
xp
xp
xp
xp
BP
BP
BP
BP
BP
BP
BP
BP
dG
ub
ub
ub
ub
ub
ub
hb
"}
(16,1,1) = {"
hb
Ul
Cu
jE
EL
AP
dN
eS
eS
eS
eS
eS
eS
Ci
AB
xp
xp
xp
xp
uk
xp
xp
xp
xp
xp
xp
BP
BP
BP
BP
BP
BP
BP
BP
BP
ub
ub
ub
ub
ub
ub
hb
"}
(17,1,1) = {"
hb
Ul
YJ
ri
VG
KS
Ul
eS
eS
gB
Th
eS
eS
eS
SK
xp
xp
xp
xp
pi
xp
xp
xp
xp
xp
xp
BP
BP
BP
BP
BP
BP
BP
BP
BP
ub
ub
ub
ub
ub
ub
hb
"}
(18,1,1) = {"
hb
Ul
qE
Ox
BU
td
Ul
Ci
mv
Mf
gx
tQ
eS
zU
SK
xp
xp
xp
xp
xp
xp
xp
xp
xp
xp
xp
BP
BP
BP
BP
BP
BP
BP
dG
BP
ub
ub
ub
ub
ub
zR
hb
"}
(19,1,1) = {"
hb
Ul
lF
HO
Yf
Jx
Ul
Ci
uH
gx
gx
Fl
eS
eS
SK
xp
xp
xp
xp
xp
xp
xp
xp
xp
xp
xp
BP
BP
BP
BP
BP
BP
fD
Oj
BP
xp
xp
xp
xp
xp
hb
hb
"}
(20,1,1) = {"
hb
Ul
Ul
Ul
Ul
Ul
Ul
XP
cX
Qc
NP
Fl
eS
eS
SK
xp
xp
xp
xp
xp
xp
xp
xp
xp
xp
xp
BP
BP
BP
BP
BP
BP
ha
eT
Vm
xp
xp
xp
xp
xp
hb
xg
"}
(21,1,1) = {"
hb
hb
hb
DM
DM
eS
eS
Ci
Ci
FP
uG
QN
eS
eS
SK
xp
xp
xp
xp
xp
xp
xp
xp
xp
xp
xp
BP
BP
BP
BP
BP
aP
fD
rE
Oj
xp
xp
xp
xp
xp
hb
xg
"}
(22,1,1) = {"
xg
xg
hb
DM
DM
wH
eS
eS
Ci
Ci
eS
eS
eS
eS
SK
xp
xp
xp
xp
xp
xp
Vx
xp
xp
xp
xp
BP
BP
BP
BP
BP
BP
NB
vB
aG
xp
xp
xp
xp
xp
hb
xg
"}
(23,1,1) = {"
xg
xg
hb
DM
DM
DM
eS
eS
eS
eS
eS
eS
eS
eS
JX
bc
xp
xp
xp
xp
xp
xp
xp
xp
xp
xp
BP
BP
BP
BP
BP
BP
BP
BP
BP
xp
xp
xp
DM
DM
hb
xg
"}
(24,1,1) = {"
xg
xg
hb
DM
DM
DM
DM
Ci
eS
RO
eS
eS
eS
eS
eS
JX
XW
bc
xp
xp
xp
xp
xp
xp
xp
xp
BP
BP
BP
BP
BP
BP
BP
BP
BP
xp
xp
xp
DM
DM
hb
xg
"}
(25,1,1) = {"
xg
xg
hb
hb
DM
DM
DM
DM
eS
eS
eS
eS
eS
eS
nr
eS
eS
SK
xp
xp
xp
xp
xp
xp
xp
xp
BP
BP
BP
BP
BP
BP
BP
BP
BP
xp
xp
DM
DM
DM
hb
xg
"}
(26,1,1) = {"
xg
xg
xg
hb
hb
hb
DM
DM
DM
DM
DM
DM
DM
DM
DM
DM
DM
gJ
Cr
DM
DM
hb
hb
xp
xp
xp
BP
BP
BP
BP
BP
BP
BP
BP
BP
hb
DM
DM
DM
DM
hb
xg
"}
(27,1,1) = {"
xg
xg
xg
xg
WW
hb
DM
DM
DM
DM
DM
DM
DM
DM
DM
DM
DM
yQ
Am
DM
DM
DM
hb
hb
xp
xp
BP
BP
BP
BP
BP
BP
BP
BP
Uf
hb
DM
DM
DM
hb
hb
xg
"}
(28,1,1) = {"
xg
xg
xg
xg
xg
hb
hb
DM
DM
DM
DM
DM
DM
DM
DM
DM
DM
Fq
Am
DM
DM
DM
DM
hb
hb
hb
Uf
BP
BP
BP
BP
BP
BP
Uf
Uf
hb
hb
hb
hb
hb
xg
xg
"}
(29,1,1) = {"
xg
xg
xg
xg
xg
xg
hb
hb
hb
hb
hb
hb
DM
DM
DM
DM
DM
UL
Qi
Cr
DM
DM
DM
DM
DM
DM
Uf
Uf
Uf
Uf
Uf
Uf
Uf
Uf
xg
xg
xg
xg
xg
xg
xg
xg
"}
(30,1,1) = {"
xg
xg
xg
xg
xg
xg
xg
xg
xg
xg
hb
hb
DM
DM
DM
DM
DM
bw
UL
Qi
Ua
Cr
DM
DM
DM
DM
DM
hb
hb
xg
xg
xg
xg
xg
xg
xg
xg
xg
xg
xg
xg
xg
"}
(31,1,1) = {"
xg
xg
xg
xg
xg
xg
xg
xg
xg
xg
xg
hb
hb
DM
DM
DM
DM
DM
UL
UL
UN
Am
Cr
Fo
DD
DM
DM
DM
hb
hb
xg
xg
xg
xg
xg
xg
xg
xg
xg
xg
xg
xg
"}
(32,1,1) = {"
xg
xg
xg
xg
xg
xg
xg
xg
xg
xg
xg
xg
hb
hb
DM
DM
DM
DM
DM
UL
mj
Qi
Cr
CM
UL
Iv
DM
DM
DM
hb
xg
xg
xg
xg
xg
xg
xg
xg
xg
xg
xg
xg
"}
(33,1,1) = {"
xg
xg
xg
xg
xg
xg
xg
xg
xg
xg
xg
xg
xg
hb
hb
DM
DM
DM
DM
ZY
UL
rZ
Qi
QH
jZ
UL
Iv
DM
DM
hb
xg
xg
xg
xg
xg
xg
xg
xg
xg
xg
xg
xg
"}
(34,1,1) = {"
xg
xg
xg
xg
xg
xg
xg
xg
xg
xg
xg
xg
xg
xg
hb
hb
DM
DM
DM
DM
UL
UL
ZM
IS
Rr
Xc
GH
DM
DM
hb
xg
xg
xg
xg
xg
xg
xg
xg
xg
xg
xg
xg
"}
(35,1,1) = {"
xg
xg
xg
xg
xg
xg
xg
xg
xg
xg
xg
xg
xg
xg
xg
hb
hb
hb
DM
DM
DM
DM
DM
DM
DM
DM
DM
DM
DM
hb
xg
xg
xg
xg
xg
xg
xg
xg
xg
xg
xg
xg
"}
(36,1,1) = {"
xg
xg
xg
xg
xg
xg
xg
xg
xg
xg
xg
xg
xg
xg
xg
xg
xg
hb
DM
DM
DM
DM
DM
DM
DM
DM
DM
DM
DM
hb
xg
xg
xg
xg
xg
xg
xg
xg
xg
xg
xg
xg
"}
(37,1,1) = {"
xg
xg
xg
xg
xg
xg
xg
xg
xg
xg
xg
xg
xg
xg
xg
xg
xg
hb
hb
hb
hb
hb
hb
hb
hb
hb
hb
hb
hb
hb
xg
xg
xg
xg
xg
xg
xg
xg
xg
xg
xg
xg
"}
