//MAP CONVERTED BY dmm2tgm.py THIS HEADER COMMENT PREVENTS RECONVERSION, DO NOT REMOVE
"d" = (
/obj/machinery/door/airlock/abductor,
/obj/effect/mapping_helpers/airlock/abandoned,
/turf/open/indestructible/dark,
/area/virtual_domain)
"f" = (
/obj/effect/mob_spawn/corpse/human/cyber_police,
/obj/effect/landmark/bitrunning/cache_spawn,
/turf/open/indestructible/dark,
/area/virtual_domain)
"g" = (
/obj/structure/sign/warning/directional/west,
/turf/open/chasm,
/area/virtual_domain)
"h" = (
/obj/structure/rack,
/turf/open/indestructible/dark,
/area/virtual_domain/protected_space)
"j" = (
/obj/structure/sign/warning/directional/east,
/turf/open/indestructible/dark,
/area/virtual_domain)
"l" = (
/obj/item/pizzabox/bomb/armed,
/obj/structure/rack,
/turf/open/indestructible/dark,
/area/virtual_domain)
"m" = (
/obj/effect/mob_spawn/corpse/human/zombie,
/turf/open/indestructible/dark,
/area/virtual_domain)
"n" = (
/mob/living/simple_animal/hostile/zombie,
/turf/open/indestructible/dark,
/area/virtual_domain)
"o" = (
/turf/template_noop,
/area/template_noop)
"q" = (
/obj/effect/baseturf_helper/virtual_domain,
/turf/open/indestructible/dark,
/area/virtual_domain/protected_space)
"r" = (
/obj/effect/baseturf_helper/virtual_domain,
/turf/template_noop,
/area/virtual_domain/safehouse)
"t" = (
/turf/template_noop,
/area/virtual_domain/safehouse)
"u" = (
/obj/effect/baseturf_helper/virtual_domain,
/turf/closed/indestructible/binary,
/area/virtual_domain/fullbright)
"v" = (
/obj/structure/rack,
/obj/item/reagent_containers/cup/glass/bottle/rootbeer{
	pixel_x = 3
	},
/obj/item/reagent_containers/cup/glass/bottle/rootbeer{
	pixel_x = -3
	},
/obj/item/reagent_containers/cup/glass/bottle/rootbeer{
	pixel_y = 1
	},
/turf/open/indestructible/dark,
/area/virtual_domain)
"w" = (
/obj/machinery/door/airlock/abductor,
/turf/open/indestructible/dark,
/area/virtual_domain)
"C" = (
/obj/effect/spawner/random/trash/caution_sign,
/turf/open/indestructible/dark,
/area/virtual_domain)
"D" = (
/turf/open/indestructible/dark,
/area/virtual_domain/protected_space)
"E" = (
/obj/effect/landmark/bitrunning/cache_spawn,
/turf/open/indestructible/dark,
/area/virtual_domain)
"F" = (
/obj/structure/mystery_box/guns,
/turf/open/indestructible/dark,
/area/virtual_domain/protected_space)
"G" = (
/turf/open/indestructible/dark,
/area/virtual_domain)
"H" = (
/obj/effect/mob_spawn/corpse/human/cyber_police,
/turf/open/indestructible/dark,
/area/virtual_domain)
"J" = (
/obj/machinery/door/airlock/abductor,
/turf/open/indestructible/dark,
/area/virtual_domain/protected_space)
"L" = (
/obj/structure/sign/warning/directional/east,
/turf/open/chasm,
/area/virtual_domain)
"N" = (
/turf/open/chasm,
/area/virtual_domain)
"O" = (
/obj/modular_map_root/safehouse{
	key = "bathroom"
	},
/turf/template_noop,
/area/virtual_domain/safehouse)
"P" = (
/turf/closed/indestructible/binary,
/area/virtual_domain/fullbright)
"S" = (
/obj/effect/mine/explosive/light,
/turf/open/indestructible/dark,
/area/virtual_domain)
"Z" = (
/obj/effect/mapping_helpers/airlock/locked,
/obj/machinery/door/airlock/abductor,
/turf/open/indestructible/dark,
/area/virtual_domain)

(1,1,1) = {"
o
o
o
o
o
o
o
o
P
P
P
P
P
P
P
P
o
o
o
o
o
o
o
o
o
"}
(2,1,1) = {"
o
o
o
o
o
o
P
P
P
G
G
G
G
G
E
P
P
o
o
o
o
o
o
o
o
"}
(3,1,1) = {"
P
P
P
P
P
P
P
G
G
G
G
G
G
G
G
G
P
P
u
o
o
o
o
o
o
"}
(4,1,1) = {"
P
f
n
G
d
G
G
G
G
S
P
P
n
G
G
G
G
P
P
o
o
o
o
o
o
"}
(5,1,1) = {"
P
l
l
v
P
S
G
G
G
P
P
P
P
n
G
G
G
G
P
o
o
o
o
o
o
"}
(6,1,1) = {"
P
P
P
P
P
G
G
G
P
P
G
G
P
P
P
P
G
G
P
o
o
o
o
o
o
"}
(7,1,1) = {"
P
P
P
P
P
P
G
G
P
G
G
G
P
P
P
G
G
G
P
o
o
o
o
o
o
"}
(8,1,1) = {"
P
P
n
G
G
G
G
G
P
G
G
G
G
G
G
G
S
P
P
o
o
o
o
o
o
"}
(9,1,1) = {"
P
P
H
G
G
G
C
G
P
n
G
G
G
G
G
G
G
P
o
o
o
o
o
o
o
"}
(10,1,1) = {"
P
P
G
N
N
N
N
G
P
P
G
N
N
N
N
N
G
P
o
o
o
o
o
o
o
"}
(11,1,1) = {"
P
G
G
N
N
N
N
G
G
P
G
N
N
N
N
N
G
P
o
o
o
o
o
o
o
"}
(12,1,1) = {"
P
G
G
G
G
G
G
G
G
P
G
G
G
G
C
G
G
P
o
o
o
o
o
o
o
"}
(13,1,1) = {"
P
G
G
G
P
P
G
G
G
P
G
P
G
G
G
G
G
P
o
o
o
o
o
o
o
"}
(14,1,1) = {"
P
G
G
G
G
P
G
G
P
P
G
P
G
G
G
G
G
P
o
o
o
o
o
o
o
"}
(15,1,1) = {"
P
G
S
G
P
P
G
G
P
P
G
P
P
G
G
G
n
P
o
o
o
o
o
o
o
"}
(16,1,1) = {"
P
G
G
G
n
P
G
G
n
P
G
G
P
G
P
P
P
P
P
P
P
P
P
P
P
"}
(17,1,1) = {"
P
G
j
G
P
P
G
G
G
Z
G
G
G
G
P
h
D
q
t
t
t
t
t
O
P
"}
(18,1,1) = {"
P
E
P
N
P
P
G
G
P
P
n
G
G
G
P
F
D
D
t
t
t
t
t
t
P
"}
(19,1,1) = {"
P
N
N
N
P
n
G
G
P
P
P
G
G
G
P
D
D
D
t
t
t
t
t
t
P
"}
(20,1,1) = {"
P
N
N
N
P
E
G
G
P
G
G
G
G
G
J
D
D
D
t
t
t
t
t
t
P
"}
(21,1,1) = {"
P
P
N
N
P
P
G
G
P
P
G
S
G
G
P
D
D
D
t
t
t
t
t
t
P
"}
(22,1,1) = {"
P
P
N
P
P
P
G
G
P
P
G
G
G
G
P
F
D
D
t
t
t
t
t
t
P
"}
(23,1,1) = {"
P
P
N
P
P
P
G
G
P
P
P
P
G
G
P
h
D
D
t
t
t
t
t
r
P
"}
(24,1,1) = {"
P
P
N
P
P
P
G
G
P
P
P
P
P
G
P
P
P
P
P
P
P
P
P
P
P
"}
(25,1,1) = {"
P
g
N
P
P
P
w
P
P
P
P
P
P
G
G
S
P
P
o
o
o
o
o
o
o
"}
(26,1,1) = {"
P
N
N
P
P
H
G
H
P
P
P
G
G
G
G
G
P
o
o
o
o
o
o
o
o
"}
(27,1,1) = {"
P
G
G
w
G
G
G
P
P
P
G
G
S
G
G
P
P
o
o
o
o
o
o
o
o
"}
(28,1,1) = {"
P
G
n
P
E
n
n
P
n
P
G
G
G
G
S
P
o
o
o
o
o
o
o
o
o
"}
(29,1,1) = {"
P
G
P
P
P
P
P
P
G
G
G
G
P
P
P
P
o
o
o
o
o
o
o
o
o
"}
(30,1,1) = {"
P
G
G
S
P
P
S
G
G
G
G
G
G
G
n
P
o
o
o
o
o
o
o
o
o
"}
(31,1,1) = {"
P
G
G
G
P
G
G
G
P
P
G
G
G
m
P
P
o
o
o
o
o
o
o
o
o
"}
(32,1,1) = {"
P
G
G
G
P
G
S
P
P
P
P
G
G
G
P
P
P
P
P
o
o
o
o
o
o
"}
(33,1,1) = {"
P
P
S
G
P
G
P
P
G
G
S
G
G
G
G
G
N
N
P
o
o
o
o
o
o
"}
(34,1,1) = {"
o
P
G
G
G
G
G
G
G
P
P
P
G
m
E
H
L
N
P
o
o
o
o
o
o
"}
(35,1,1) = {"
o
P
E
G
G
G
n
P
P
P
P
P
P
P
P
P
P
P
P
o
o
o
o
o
o
"}
(36,1,1) = {"
o
P
P
P
P
P
P
P
o
o
o
o
o
o
o
o
o
o
o
o
o
o
o
o
o
"}
