//MAP CONVERTED BY dmm2tgm.py THIS HEADER COMMENT PREVENTS RECONVERSION, DO NOT REMOVE
"c" = (
/obj/machinery/door/airlock/abductor,
/turf/open/indestructible/dark,
/area/virtual_domain)
"d" = (
/obj/structure/closet/crate/internals,
/obj/item/gun/ballistic/revolver/mateba,
/turf/open/indestructible/dark,
/area/virtual_domain)
"f" = (
/obj/structure/closet/crate/hydroponics,
/turf/open/indestructible/dark,
/area/virtual_domain)
"g" = (
/obj/structure/closet/crate/secure,
/turf/open/indestructible/dark,
/area/virtual_domain)
"h" = (
/obj/structure/closet/crate/preopen,
/obj/item/gun/ballistic/automatic/mini_uzi,
/obj/item/gun/ballistic/revolver{
	pixel_x = 2;
	pixel_y = 3
	},
/obj/item/gun/ballistic/revolver{
	pixel_x = -4;
	pixel_y = 3
	},
/obj/item/gun/ballistic/revolver{
	pixel_x = 1;
	pixel_y = 1
	},
/obj/item/gun/ballistic/revolver{
	pixel_x = -1;
	pixel_y = 5
	},
/obj/item/gun/ballistic/revolver{
	pixel_x = 5;
	pixel_y = 3
	},
/obj/item/gun/ballistic/revolver{
	pixel_x = -3
	},
/obj/item/gun/ballistic/revolver{
	pixel_x = 5;
	pixel_y = -2
	},
/obj/item/gun/ballistic/revolver{
	pixel_x = -4;
	pixel_y = 2
	},
/obj/item/gun/ballistic/revolver,
/turf/template_noop,
/area/virtual_domain/safehouse)
"i" = (
/obj/item/gun/ballistic/shotgun/lethal,
/obj/structure/closet/crate/preopen,
/turf/open/indestructible/dark,
/area/virtual_domain)
"j" = (
/obj/item/gun/ballistic/shotgun/lethal,
/obj/structure/closet/crate/preopen,
/obj/projectile/bullet/shotgun_frag12,
/obj/projectile/bullet/shotgun_frag12,
/obj/projectile/bullet/shotgun_frag12,
/turf/open/indestructible/dark,
/area/virtual_domain)
"l" = (
/obj/structure/closet/crate/eva,
/turf/open/indestructible/dark,
/area/virtual_domain)
"n" = (
/obj/item/gun/ballistic/shotgun/lethal,
/obj/item/gun/ballistic/revolver/mateba,
/obj/structure/closet/crate/preopen,
/turf/open/indestructible/dark,
/area/virtual_domain)
"o" = (
/turf/template_noop,
/area/template_noop)
"p" = (
/obj/effect/baseturf_helper/virtual_domain,
/turf/open/indestructible/dark,
/area/virtual_domain)
"t" = (
/turf/template_noop,
/area/virtual_domain/safehouse)
"u" = (
/turf/open/space,
/area/space/virtual_domain)
"w" = (
/mob/living/simple_animal/hostile/mimic/crate,
/turf/open/indestructible/dark,
/area/virtual_domain)
"y" = (
/mob/living/simple_animal/hostile/mimic,
/turf/open/indestructible/dark,
/area/virtual_domain)
"A" = (
/obj/structure/closet/crate/wooden,
/obj/item/gun/ballistic/revolver/mateba,
/turf/open/indestructible/dark,
/area/virtual_domain)
"C" = (
/obj/structure/closet/crate/secure/loot,
/turf/open/indestructible/dark,
/area/virtual_domain)
"D" = (
/turf/closed/indestructible/binary,
/area/virtual_domain/fullbright)
"E" = (
/turf/open/indestructible/dark,
/area/virtual_domain)
"G" = (
/obj/item/restraints/legcuffs/beartrap/prearmed,
/turf/open/indestructible/dark,
/area/virtual_domain)
"I" = (
/obj/effect/landmark/bitrunning/crate_replacer,
/turf/open/indestructible/dark,
/area/virtual_domain)
"L" = (
/obj/structure/closet/crate/secure/bitrunning/encrypted,
/turf/open/indestructible/dark,
/area/virtual_domain)
"N" = (
/obj/effect/baseturf_helper/virtual_domain,
/turf/template_noop,
/area/virtual_domain/safehouse)
"U" = (
/obj/modular_map_root/safehouse{
	key = "bathroom"
	},
/turf/template_noop,
/area/virtual_domain/safehouse)
"V" = (
/obj/item/toy/gun{
	pixel_y = 3
	},
/obj/structure/closet/crate/wooden,
/turf/open/indestructible/dark,
/area/virtual_domain)
"Z" = (
/obj/structure/closet/crate/freezer/surplus_limbs,
/turf/open/indestructible/dark,
/area/virtual_domain)

(1,1,1) = {"
o
o
o
D
D
D
D
D
D
D
D
D
D
D
D
D
o
o
o
o
o
o
o
o
o
o
"}
(2,1,1) = {"
o
o
o
D
E
E
E
E
E
E
E
E
E
E
g
D
D
o
o
o
o
o
o
o
o
o
"}
(3,1,1) = {"
o
o
o
D
D
l
E
g
E
E
D
E
E
E
E
p
D
o
o
o
o
o
o
o
o
o
"}
(4,1,1) = {"
o
o
D
D
D
V
E
E
E
D
D
D
E
E
E
I
D
o
o
o
o
o
o
o
o
o
"}
(5,1,1) = {"
o
o
D
j
D
D
E
E
E
E
l
D
E
y
D
E
D
D
o
o
o
o
o
o
o
o
"}
(6,1,1) = {"
o
o
D
G
E
D
D
E
E
E
E
E
E
D
D
E
E
D
o
o
o
o
o
o
o
o
"}
(7,1,1) = {"
o
o
D
E
E
E
E
E
E
D
E
E
E
E
E
E
E
D
o
o
o
o
o
o
o
o
"}
(8,1,1) = {"
o
o
D
g
E
G
E
Z
E
D
E
E
L
E
E
E
E
D
o
o
o
o
o
o
o
o
"}
(9,1,1) = {"
o
o
D
G
E
D
E
E
E
E
E
E
E
E
D
D
E
D
D
D
D
D
D
D
D
o
"}
(10,1,1) = {"
o
o
D
g
E
D
E
E
E
E
E
E
E
E
D
E
E
E
t
t
t
t
t
U
D
D
"}
(11,1,1) = {"
o
o
D
D
D
D
E
E
E
D
D
D
E
E
E
E
E
E
t
t
t
t
t
t
u
D
"}
(12,1,1) = {"
o
o
D
y
E
E
E
E
E
D
D
D
g
E
E
E
E
E
t
h
t
t
t
t
u
D
"}
(13,1,1) = {"
o
o
D
E
D
E
E
E
Z
D
D
D
g
E
E
E
E
E
t
t
t
t
t
t
u
D
"}
(14,1,1) = {"
o
o
D
E
D
E
D
D
D
D
D
D
E
E
E
E
E
E
t
t
t
t
t
t
u
D
"}
(15,1,1) = {"
o
o
D
E
D
E
E
A
D
D
E
E
E
E
D
D
E
E
t
t
t
t
t
t
u
D
"}
(16,1,1) = {"
o
o
D
E
E
E
E
E
E
E
E
E
E
E
E
D
E
E
t
t
t
t
t
N
u
D
"}
(17,1,1) = {"
o
o
D
g
E
E
D
E
E
D
D
E
E
C
E
E
E
D
D
D
D
D
D
D
u
D
"}
(18,1,1) = {"
o
o
D
D
E
E
D
E
E
f
E
E
E
E
E
E
E
D
o
o
o
o
o
D
u
D
"}
(19,1,1) = {"
o
o
o
D
D
E
E
E
E
E
E
E
E
E
E
E
E
D
o
o
o
o
o
D
D
D
"}
(20,1,1) = {"
o
o
D
D
D
D
E
E
E
E
E
D
E
E
E
E
E
D
o
o
o
o
o
o
o
o
"}
(21,1,1) = {"
D
D
D
g
D
D
D
D
E
E
E
D
E
D
E
E
D
D
o
o
o
o
o
o
o
o
"}
(22,1,1) = {"
D
g
E
i
E
D
g
E
E
E
E
D
E
D
D
g
D
D
o
o
o
o
o
o
o
o
"}
(23,1,1) = {"
D
E
E
E
w
c
E
E
E
E
D
D
E
D
E
E
E
D
D
o
o
o
o
o
o
o
"}
(24,1,1) = {"
D
D
E
E
g
D
E
g
E
E
E
d
E
D
E
E
E
E
D
o
o
o
o
o
o
o
"}
(25,1,1) = {"
D
D
E
E
E
D
D
D
D
D
D
D
D
D
E
l
E
E
D
o
o
o
o
o
o
o
"}
(26,1,1) = {"
D
E
E
E
E
E
E
E
E
E
E
E
E
g
E
E
E
l
D
o
o
o
o
o
o
o
"}
(27,1,1) = {"
D
g
E
w
D
D
D
w
E
E
E
E
D
D
n
D
E
D
D
o
o
o
o
o
o
o
"}
(28,1,1) = {"
D
E
D
D
D
o
D
D
E
E
D
D
D
D
D
D
D
D
o
o
o
o
o
o
o
o
"}
(29,1,1) = {"
D
D
D
o
o
o
o
D
D
D
D
o
o
o
o
o
o
o
o
o
o
o
o
o
o
o
"}
