//MAP CONVERTED BY dmm2tgm.py THIS HEADER COMMENT PREVENTS RECONVERSION, DO NOT REMOVE
"aA" = (
/obj/machinery/light/small/directional/north,
/obj/effect/turf_decal/sand/plating,
/turf/open/floor/plating{
	initial_gas_mix = "TEMP=2.7"
	},
/area/virtual_domain)
"bs" = (
/obj/effect/turf_decal/sand,
/turf/open/floor/iron/airless,
/area/ruin/space/virtual_domain)
"bF" = (
/obj/effect/turf_decal/sand/plating,
/turf/open/floor/plating{
	initial_gas_mix = "TEMP=2.7"
	},
/area/ruin/space/virtual_domain)
"cz" = (
/obj/effect/baseturf_helper/virtual_domain,
/turf/open/misc/asteroid/airless,
/area/ruin/space/virtual_domain)
"cL" = (
/obj/structure/table/reinforced,
/obj/item/reagent_containers/cup/glass/drinkingglass{
	pixel_x = 6;
	pixel_y = 4
	},
/obj/item/reagent_containers/cup/glass/drinkingglass,
/obj/item/reagent_containers/cup/glass/drinkingglass{
	pixel_x = -6;
	pixel_y = 8
	},
/turf/open/floor/iron/vaporwave,
/area/virtual_domain)
"df" = (
/obj/effect/turf_decal/sand,
/turf/open/floor/iron/airless{
	icon_state = "stairs-l"
	},
/area/ruin/space/virtual_domain)
"eF" = (
/turf/closed/indestructible/binary,
/area/space)
"fx" = (
/obj/item/statuebust,
/turf/open/floor/iron/vaporwave,
/area/virtual_domain)
"fQ" = (
/obj/structure/flora/tree/palm,
/turf/open/floor/holofloor/beach,
/area/virtual_domain)
"gM" = (
/obj/structure/table/reinforced,
/obj/item/clothing/glasses/sunglasses/big{
	name = "aesthetic sunglasses"
	},
/turf/open/floor/iron/vaporwave,
/area/virtual_domain)
"hN" = (
/turf/open/floor/holofloor/beach,
/area/virtual_domain)
"il" = (
/obj/effect/turf_decal/sand,
/obj/effect/turf_decal/sand,
/turf/open/floor/iron/airless,
/area/ruin/space/virtual_domain)
"iP" = (
/obj/machinery/suit_storage_unit/standard_unit,
/turf/template_noop,
/area/virtual_domain/safehouse)
"kj" = (
/obj/structure/window/spawner/directional/east,
/obj/structure/closet/crate/secure/bitrunning/encrypted,
/turf/open/floor/iron/vaporwave,
/area/virtual_domain)
"ku" = (
/turf/template_noop,
/area/virtual_domain/safehouse)
"kF" = (
/obj/effect/turf_decal/sand,
/turf/open/floor/iron/airless{
	icon_state = "stairs-r"
	},
/area/ruin/space/virtual_domain)
"ll" = (
/obj/structure/sign/poster/contraband/clown/directional/north,
/turf/open/floor/iron/vaporwave,
/area/virtual_domain)
"lu" = (
/obj/effect/baseturf_helper/virtual_domain,
/turf/closed/wall/rust,
/area/virtual_domain)
"lB" = (
/obj/item/tank/internals/emergency_oxygen,
/obj/item/tank/internals/emergency_oxygen,
/obj/item/tank/internals/emergency_oxygen,
/turf/template_noop,
/area/virtual_domain/safehouse)
"lI" = (
/obj/structure/table/reinforced,
/obj/machinery/chem_dispenser/drinks/beer/fullupgrade,
/turf/open/floor/iron/vaporwave,
/area/virtual_domain)
"qm" = (
/obj/structure/flora/tree/palm,
/obj/machinery/light/directional/west,
/turf/open/floor/holofloor/beach,
/area/virtual_domain)
"qu" = (
/turf/open/floor/holofloor/beach/water,
/area/virtual_domain)
"rn" = (
/obj/structure/statue/sandstone/venus{
	anchored = 1;
	dir = 4
	},
/obj/effect/turf_decal/sand/plating,
/turf/open/floor/plating{
	initial_gas_mix = "TEMP=2.7"
	},
/area/ruin/space/virtual_domain)
"xb" = (
/obj/structure/chair/stool/directional/west,
/turf/open/floor/iron/vaporwave,
/area/virtual_domain)
"xp" = (
/obj/structure/table/reinforced,
/turf/open/floor/iron/vaporwave,
/area/virtual_domain)
"xK" = (
/turf/closed/wall,
/area/virtual_domain)
"yh" = (
/turf/open/misc/asteroid/airless,
/area/ruin/space/virtual_domain)
"AX" = (
/obj/effect/turf_decal/stripes/asteroid/line,
/obj/effect/turf_decal/sand/plating,
/turf/open/floor/plating{
	initial_gas_mix = "TEMP=2.7"
	},
/area/ruin/space/virtual_domain)
"Cq" = (
/obj/item/instrument/eguitar,
/turf/open/floor/holofloor/beach,
/area/virtual_domain)
"CR" = (
/turf/open/floor/iron/vaporwave,
/area/virtual_domain)
"Dk" = (
/obj/structure/window/spawner/directional/east,
/turf/open/floor/iron/vaporwave,
/area/virtual_domain)
"Es" = (
/obj/structure/chair/comfy/black{
	dir = 4
	},
/turf/open/floor/iron/vaporwave,
/area/virtual_domain)
"Hf" = (
/obj/effect/turf_decal/sand,
/turf/open/floor/iron/airless{
	icon_state = "recharge_floor_asteroid"
	},
/area/ruin/space/virtual_domain)
"HA" = (
/turf/open/floor/holofloor/beach/coast,
/area/virtual_domain)
"HV" = (
/obj/structure/chair/comfy/black{
	dir = 4
	},
/obj/machinery/light/small/directional/north,
/turf/open/floor/iron/vaporwave,
/area/virtual_domain)
"Jr" = (
/obj/structure/window/spawner/directional/west,
/turf/open/floor/iron/vaporwave,
/area/virtual_domain)
"KO" = (
/obj/structure/chair/comfy/black{
	dir = 8
	},
/turf/open/floor/iron/vaporwave,
/area/virtual_domain)
"KY" = (
/obj/effect/turf_decal/sand,
/turf/open/floor/iron/airless{
	icon_state = "stairs-m"
	},
/area/ruin/space/virtual_domain)
"LG" = (
/obj/effect/baseturf_helper/virtual_domain,
/turf/template_noop,
/area/virtual_domain/safehouse)
"LJ" = (
/obj/structure/lattice,
/turf/open/misc/asteroid/airless,
/area/ruin/space/virtual_domain)
"LP" = (
/obj/structure/flora/tree/palm,
/obj/machinery/light/directional/east,
/turf/open/floor/holofloor/beach,
/area/virtual_domain)
"Nz" = (
/obj/structure/window/spawner/directional/east,
/obj/structure/table/reinforced,
/obj/item/storage/fancy/cigarettes/cigars/havana,
/obj/effect/spawner/random/entertainment/lighter,
/turf/open/floor/iron/vaporwave,
/area/virtual_domain)
"NT" = (
/obj/effect/baseturf_helper/virtual_domain,
/turf/open/space/basic,
/area/space/virtual_domain)
"OK" = (
/turf/open/space/basic,
/area/space/virtual_domain)
"Qh" = (
/obj/structure/closet/crate/bin,
/turf/open/misc/asteroid/airless,
/area/ruin/space/virtual_domain)
"Uy" = (
/obj/modular_map_root/safehouse{
	key = "shuttle_space"
	},
/turf/template_noop,
/area/virtual_domain/safehouse)
"UE" = (
/obj/effect/turf_decal/sand,
/obj/effect/turf_decal/sand/plating,
/turf/open/floor/plating{
	initial_gas_mix = "TEMP=2.7"
	},
/area/ruin/space/virtual_domain)
"UV" = (
/obj/structure/lattice,
/turf/open/floor/plating/airless,
/area/ruin/space/virtual_domain)
"Vc" = (
/obj/structure/flora/tree/palm,
/turf/open/misc/asteroid/airless,
/area/ruin/space/virtual_domain)
"VY" = (
/turf/closed/wall/rust,
/area/virtual_domain)
"XJ" = (
/obj/structure/fans/tiny,
/obj/machinery/door/airlock/hatch,
/turf/open/floor/pod/dark,
/area/virtual_domain)
"Yo" = (
/obj/structure/statue/sandstone/venus{
	anchored = 1;
	desc = "Ugh, this is merely an ugly amateurish replica of the other statue! The letters RIPGOAT are scribbled onto the base.";
	dir = 8
	},
/obj/effect/turf_decal/sand/plating,
/turf/open/floor/plating{
	initial_gas_mix = "TEMP=2.7"
	},
/area/ruin/space/virtual_domain)
"YE" = (
/mob/living/basic/butterfly,
/turf/open/floor/iron/vaporwave,
/area/virtual_domain)
"ZI" = (
/obj/effect/spawner/random/structure/musician/piano/random_piano,
/obj/structure/window/spawner/directional/west,
/turf/open/floor/iron/vaporwave,
/area/virtual_domain)

(1,1,1) = {"
eF
eF
eF
eF
eF
eF
eF
eF
eF
eF
eF
eF
eF
eF
eF
eF
eF
eF
eF
eF
eF
eF
eF
eF
eF
eF
eF
eF
"}
(2,1,1) = {"
eF
OK
OK
OK
OK
OK
OK
OK
OK
OK
OK
OK
OK
OK
OK
OK
OK
OK
OK
OK
OK
OK
OK
OK
OK
OK
NT
eF
"}
(3,1,1) = {"
eF
OK
OK
OK
OK
OK
OK
OK
OK
OK
OK
OK
OK
OK
OK
OK
OK
OK
OK
OK
OK
OK
OK
OK
OK
OK
OK
eF
"}
(4,1,1) = {"
eF
OK
OK
OK
OK
OK
OK
OK
OK
OK
OK
OK
OK
OK
OK
OK
OK
OK
OK
OK
OK
OK
OK
OK
OK
OK
OK
eF
"}
(5,1,1) = {"
eF
OK
OK
OK
OK
OK
OK
yh
LJ
yh
OK
OK
OK
OK
OK
OK
OK
OK
OK
OK
OK
OK
OK
OK
OK
OK
OK
eF
"}
(6,1,1) = {"
eF
OK
OK
OK
OK
OK
yh
yh
LJ
yh
yh
LJ
yh
yh
OK
OK
OK
OK
OK
OK
OK
OK
OK
OK
OK
OK
OK
eF
"}
(7,1,1) = {"
eF
OK
OK
OK
OK
yh
yh
yh
UV
LJ
yh
UV
yh
yh
yh
OK
OK
OK
OK
OK
OK
OK
OK
OK
OK
OK
OK
eF
"}
(8,1,1) = {"
eF
OK
OK
OK
OK
yh
xK
xK
VY
VY
VY
xK
lu
UE
yh
yh
OK
OK
OK
OK
OK
OK
OK
OK
OK
OK
OK
eF
"}
(9,1,1) = {"
eF
OK
OK
OK
LJ
Qh
xK
fQ
hN
qm
HA
qu
xK
aA
yh
yh
OK
OK
OK
OK
OK
OK
OK
OK
OK
OK
OK
eF
"}
(10,1,1) = {"
eF
OK
OK
OK
LJ
UV
VY
ZI
Jr
Jr
Jr
Jr
xK
bF
Vc
yh
cz
OK
OK
OK
ku
ku
ku
ku
ku
Uy
OK
eF
"}
(11,1,1) = {"
eF
OK
OK
OK
yh
yh
xK
xb
CR
CR
fx
CR
xK
Yo
il
UE
yh
OK
OK
OK
ku
iP
iP
iP
ku
ku
OK
eF
"}
(12,1,1) = {"
eF
OK
OK
OK
yh
yh
xK
ll
CR
CR
CR
CR
xK
Hf
df
il
yh
OK
OK
OK
ku
ku
ku
ku
ku
ku
OK
eF
"}
(13,1,1) = {"
eF
OK
OK
OK
yh
LJ
xK
HV
Es
CR
CR
CR
XJ
bs
KY
bs
il
OK
OK
OK
ku
ku
ku
ku
ku
ku
OK
eF
"}
(14,1,1) = {"
eF
OK
OK
OK
yh
LJ
VY
xp
gM
CR
CR
cL
xK
Hf
kF
bs
il
OK
OK
OK
ku
ku
ku
ku
ku
ku
OK
eF
"}
(15,1,1) = {"
eF
OK
OK
OK
yh
LJ
VY
KO
KO
CR
YE
lI
VY
rn
il
UE
UE
OK
OK
OK
ku
ku
ku
ku
lB
ku
OK
eF
"}
(16,1,1) = {"
eF
OK
OK
OK
LJ
UV
xK
kj
Dk
Dk
Dk
Nz
xK
AX
Vc
yh
yh
OK
OK
OK
ku
ku
ku
ku
ku
LG
OK
eF
"}
(17,1,1) = {"
eF
OK
OK
OK
yh
yh
VY
fQ
Cq
LP
HA
qu
VY
aA
yh
yh
OK
OK
OK
OK
OK
OK
OK
OK
OK
OK
OK
eF
"}
(18,1,1) = {"
eF
OK
OK
OK
yh
yh
xK
xK
VY
xK
VY
VY
VY
UE
yh
yh
OK
OK
OK
OK
OK
OK
OK
OK
OK
OK
OK
eF
"}
(19,1,1) = {"
eF
OK
OK
OK
OK
yh
yh
yh
UV
LJ
Qh
UV
yh
yh
yh
OK
OK
OK
OK
OK
OK
OK
OK
OK
OK
OK
OK
eF
"}
(20,1,1) = {"
eF
OK
OK
OK
OK
OK
OK
yh
LJ
yh
yh
LJ
yh
yh
yh
OK
OK
OK
OK
OK
OK
OK
OK
OK
OK
OK
OK
eF
"}
(21,1,1) = {"
eF
OK
OK
OK
OK
OK
OK
OK
LJ
yh
yh
yh
yh
OK
OK
OK
OK
OK
OK
OK
OK
OK
OK
OK
OK
OK
OK
eF
"}
(22,1,1) = {"
eF
OK
OK
OK
OK
OK
OK
OK
OK
OK
OK
OK
OK
OK
OK
OK
OK
OK
OK
OK
OK
OK
OK
OK
OK
OK
OK
eF
"}
(23,1,1) = {"
eF
OK
OK
OK
OK
OK
OK
OK
OK
OK
OK
OK
OK
OK
OK
OK
OK
OK
OK
OK
OK
OK
OK
OK
OK
OK
OK
eF
"}
(24,1,1) = {"
eF
OK
OK
OK
OK
OK
OK
OK
OK
OK
OK
OK
OK
OK
OK
OK
OK
OK
OK
OK
OK
OK
OK
OK
OK
OK
OK
eF
"}
(25,1,1) = {"
eF
eF
eF
eF
eF
eF
eF
eF
eF
eF
eF
eF
eF
eF
eF
eF
eF
eF
eF
eF
eF
eF
eF
eF
eF
eF
eF
eF
"}
