//MAP CONVERTED BY dmm2tgm.py THIS HEADER COMMENT PREVENTS RECONVERSION, DO NOT REMOVE
"aq" = (
/obj/item/statuebust,
/turf/open/floor/iron/vaporwave,
/area/virtual_domain)
"ch" = (
/obj/structure/chair/comfy/black{
	dir = 4
	},
/turf/open/floor/iron/vaporwave,
/area/virtual_domain)
"eF" = (
/turf/closed/indestructible/binary,
/area/space)
"gr" = (
/obj/effect/turf_decal/sand,
/obj/effect/turf_decal/sand/plating,
/turf/open/floor/plating{
	initial_gas_mix = "TEMP=2.7"
	},
/area/ruin/space/virtual_domain)
"hV" = (
/turf/open/misc/asteroid/airless,
/area/ruin/space/virtual_domain)
"iP" = (
/obj/machinery/suit_storage_unit/standard_unit,
/turf/template_noop,
/area/virtual_domain/safehouse)
"jj" = (
/turf/open/space/basic,
/area/space/virtual_domain)
"jX" = (
/turf/closed/wall/rust,
/area/virtual_domain)
"ku" = (
/turf/template_noop,
/area/virtual_domain/safehouse)
"kQ" = (
/obj/structure/fans/tiny,
/obj/machinery/door/airlock/hatch,
/turf/open/floor/pod/dark,
/area/virtual_domain)
"lB" = (
/obj/item/tank/internals/emergency_oxygen,
/obj/item/tank/internals/emergency_oxygen,
/obj/item/tank/internals/emergency_oxygen,
/turf/template_noop,
/area/virtual_domain/safehouse)
"lT" = (
/turf/open/floor/holofloor/beach/water,
/area/virtual_domain)
"mf" = (
/obj/structure/flora/tree/palm,
/turf/open/floor/holofloor/beach,
/area/virtual_domain)
"nC" = (
/obj/effect/baseturf_helper/virtual_domain,
/turf/open/misc/asteroid/airless,
/area/ruin/space/virtual_domain)
"nI" = (
/obj/structure/window/spawner/directional/west,
/turf/open/floor/iron/vaporwave,
/area/virtual_domain)
"qo" = (
/obj/effect/turf_decal/sand,
/turf/open/floor/iron/airless{
	icon_state = "stairs-m"
	},
/area/ruin/space/virtual_domain)
"ru" = (
/obj/effect/turf_decal/stripes/asteroid/line,
/obj/effect/turf_decal/sand/plating,
/turf/open/floor/plating{
	initial_gas_mix = "TEMP=2.7"
	},
/area/ruin/space/virtual_domain)
"ss" = (
/obj/effect/turf_decal/sand,
/turf/open/floor/iron/airless{
	icon_state = "stairs-r"
	},
/area/ruin/space/virtual_domain)
"tK" = (
/turf/open/floor/holofloor/beach/coast,
/area/virtual_domain)
"tP" = (
/obj/structure/closet/crate/bin,
/turf/open/misc/asteroid/airless,
/area/ruin/space/virtual_domain)
"vf" = (
/obj/structure/statue/sandstone/venus{
	anchored = 1;
	dir = 4
	},
/obj/effect/turf_decal/sand/plating,
/turf/open/floor/plating{
	initial_gas_mix = "TEMP=2.7"
	},
/area/ruin/space/virtual_domain)
"vv" = (
/obj/effect/turf_decal/sand/plating,
/turf/open/floor/plating{
	initial_gas_mix = "TEMP=2.7"
	},
/area/ruin/space/virtual_domain)
"vL" = (
/mob/living/basic/butterfly,
/turf/open/floor/iron/vaporwave,
/area/virtual_domain)
"wu" = (
/obj/effect/turf_decal/sand,
/obj/effect/turf_decal/sand,
/turf/open/floor/iron/airless,
/area/ruin/space/virtual_domain)
"wB" = (
/obj/structure/window/spawner/directional/east,
/obj/structure/table/reinforced,
/obj/item/storage/fancy/cigarettes/cigars/havana,
/obj/effect/spawner/random/entertainment/lighter,
/turf/open/floor/iron/vaporwave,
/area/virtual_domain)
"xg" = (
/obj/structure/flora/tree/palm,
/turf/open/misc/asteroid/airless,
/area/ruin/space/virtual_domain)
"xi" = (
/obj/effect/baseturf_helper/virtual_domain,
/turf/closed/wall/rust,
/area/virtual_domain)
"xD" = (
/obj/structure/sign/poster/contraband/clown/directional/north,
/turf/open/floor/iron/vaporwave,
/area/virtual_domain)
"ys" = (
/obj/structure/chair/comfy/black{
	dir = 8
	},
/turf/open/floor/iron/vaporwave,
/area/virtual_domain)
"AB" = (
/obj/structure/window/spawner/directional/east,
/turf/open/floor/iron/vaporwave,
/area/virtual_domain)
"AD" = (
/obj/structure/table/reinforced,
/turf/open/floor/iron/vaporwave,
/area/virtual_domain)
"AS" = (
/obj/effect/turf_decal/sand,
/turf/open/floor/iron/airless,
/area/ruin/space/virtual_domain)
"Bn" = (
/turf/open/floor/iron/vaporwave,
/area/virtual_domain)
"CA" = (
/turf/open/floor/holofloor/beach,
/area/virtual_domain)
"CF" = (
/obj/machinery/light/small/directional/north,
/obj/effect/turf_decal/sand/plating,
/turf/open/floor/plating{
	initial_gas_mix = "TEMP=2.7"
	},
/area/virtual_domain)
"Eh" = (
/obj/structure/flora/tree/palm,
/obj/machinery/light/directional/west,
/turf/open/floor/holofloor/beach,
/area/virtual_domain)
"JX" = (
/obj/effect/baseturf_helper/virtual_domain,
/turf/open/space/basic,
/area/space/virtual_domain)
"Km" = (
/obj/structure/table/reinforced,
/obj/machinery/chem_dispenser/drinks/beer/fullupgrade,
/turf/open/floor/iron/vaporwave,
/area/virtual_domain)
"LG" = (
/obj/effect/baseturf_helper/virtual_domain,
/turf/template_noop,
/area/virtual_domain/safehouse)
"LY" = (
/obj/structure/lattice,
/turf/open/misc/asteroid/airless,
/area/ruin/space/virtual_domain)
"Mm" = (
/obj/structure/window/spawner/directional/east,
/obj/structure/closet/crate/secure/bitrunning/encrypted,
/turf/open/floor/iron/vaporwave,
/area/virtual_domain)
"MP" = (
/turf/closed/wall,
/area/virtual_domain)
"MV" = (
/obj/structure/table/reinforced,
/obj/item/reagent_containers/cup/glass/drinkingglass{
	pixel_x = 6;
	pixel_y = 4
	},
/obj/item/reagent_containers/cup/glass/drinkingglass,
/obj/item/reagent_containers/cup/glass/drinkingglass{
	pixel_x = -6;
	pixel_y = 8
	},
/turf/open/floor/iron/vaporwave,
/area/virtual_domain)
"NZ" = (
/obj/structure/statue/sandstone/venus{
	anchored = 1;
	desc = "Ugh, this is merely an ugly amateurish replica of the other statue! The letters RIPGOAT are scribbled onto the base.";
	dir = 8
	},
/obj/effect/turf_decal/sand/plating,
/turf/open/floor/plating{
	initial_gas_mix = "TEMP=2.7"
	},
/area/ruin/space/virtual_domain)
"Pa" = (
/obj/item/instrument/eguitar,
/turf/open/floor/holofloor/beach,
/area/virtual_domain)
"TD" = (
/obj/structure/chair/stool/directional/west,
/turf/open/floor/iron/vaporwave,
/area/virtual_domain)
"Uy" = (
/obj/modular_map_root/safehouse{
	key = "shuttle_space"
	},
/turf/template_noop,
/area/virtual_domain/safehouse)
"UK" = (
/obj/effect/turf_decal/sand,
/turf/open/floor/iron/airless{
	icon_state = "stairs-l"
	},
/area/ruin/space/virtual_domain)
"Vi" = (
/obj/effect/turf_decal/sand,
/turf/open/floor/iron/airless{
	icon_state = "recharge_floor_asteroid"
	},
/area/ruin/space/virtual_domain)
"Xe" = (
/obj/structure/table/reinforced,
/obj/item/clothing/glasses/sunglasses/big{
	name = "aesthetic sunglasses"
	},
/turf/open/floor/iron/vaporwave,
/area/virtual_domain)
"Xi" = (
/obj/structure/lattice,
/turf/open/floor/plating/airless,
/area/ruin/space/virtual_domain)
"Ya" = (
/obj/effect/spawner/random/structure/musician/piano/random_piano,
/obj/structure/window/spawner/directional/west,
/turf/open/floor/iron/vaporwave,
/area/virtual_domain)
"ZA" = (
/obj/structure/flora/tree/palm,
/obj/machinery/light/directional/east,
/turf/open/floor/holofloor/beach,
/area/virtual_domain)
"ZK" = (
/obj/structure/chair/comfy/black{
	dir = 4
	},
/obj/machinery/light/small/directional/north,
/turf/open/floor/iron/vaporwave,
/area/virtual_domain)

(1,1,1) = {"
eF
eF
eF
eF
eF
eF
eF
eF
eF
eF
eF
eF
eF
eF
eF
eF
eF
eF
eF
eF
eF
eF
eF
eF
eF
eF
eF
eF
"}
(2,1,1) = {"
eF
jj
jj
jj
jj
jj
jj
jj
jj
jj
jj
jj
jj
jj
jj
jj
jj
jj
jj
jj
jj
jj
jj
jj
jj
jj
JX
eF
"}
(3,1,1) = {"
eF
jj
jj
jj
jj
jj
jj
jj
jj
jj
jj
jj
jj
jj
jj
jj
jj
jj
jj
jj
jj
jj
jj
jj
jj
jj
jj
eF
"}
(4,1,1) = {"
eF
jj
jj
jj
jj
jj
jj
jj
jj
jj
jj
jj
jj
jj
jj
jj
jj
jj
jj
jj
jj
jj
jj
jj
jj
jj
jj
eF
"}
(5,1,1) = {"
eF
jj
jj
jj
jj
jj
jj
hV
LY
hV
jj
jj
jj
jj
jj
jj
jj
jj
jj
jj
jj
jj
jj
jj
jj
jj
jj
eF
"}
(6,1,1) = {"
eF
jj
jj
jj
jj
jj
hV
hV
LY
hV
hV
LY
hV
hV
jj
jj
jj
jj
jj
jj
jj
jj
jj
jj
jj
jj
jj
eF
"}
(7,1,1) = {"
eF
jj
jj
jj
jj
hV
hV
hV
Xi
LY
hV
Xi
hV
hV
hV
jj
jj
jj
jj
jj
jj
jj
jj
jj
jj
jj
jj
eF
"}
(8,1,1) = {"
eF
jj
jj
jj
jj
hV
MP
MP
jX
jX
jX
MP
xi
gr
hV
hV
jj
jj
jj
jj
jj
jj
jj
jj
jj
jj
jj
eF
"}
(9,1,1) = {"
eF
jj
jj
jj
LY
tP
MP
mf
CA
Eh
tK
lT
MP
CF
hV
hV
jj
jj
jj
jj
jj
jj
jj
jj
jj
jj
jj
eF
"}
(10,1,1) = {"
eF
jj
jj
jj
LY
Xi
jX
Ya
nI
nI
nI
nI
MP
vv
xg
hV
nC
jj
jj
jj
ku
ku
ku
ku
ku
Uy
jj
eF
"}
(11,1,1) = {"
eF
jj
jj
jj
hV
hV
MP
TD
Bn
Bn
aq
Bn
MP
NZ
wu
gr
hV
jj
jj
jj
ku
iP
iP
iP
ku
ku
jj
eF
"}
(12,1,1) = {"
eF
jj
jj
jj
hV
hV
MP
xD
Bn
Bn
Bn
Bn
MP
Vi
UK
wu
hV
jj
jj
jj
ku
ku
ku
ku
ku
ku
jj
eF
"}
(13,1,1) = {"
eF
jj
jj
jj
hV
LY
MP
ZK
ch
Bn
Bn
Bn
kQ
AS
qo
AS
wu
jj
jj
jj
ku
ku
ku
ku
ku
ku
jj
eF
"}
(14,1,1) = {"
eF
jj
jj
jj
hV
LY
jX
AD
Xe
Bn
Bn
MV
MP
Vi
ss
AS
wu
jj
jj
jj
ku
ku
ku
ku
ku
ku
jj
eF
"}
(15,1,1) = {"
eF
jj
jj
jj
hV
LY
jX
ys
ys
Bn
vL
Km
jX
vf
wu
gr
gr
jj
jj
jj
ku
ku
ku
ku
lB
ku
jj
eF
"}
(16,1,1) = {"
eF
jj
jj
jj
LY
Xi
MP
Mm
AB
AB
AB
wB
MP
ru
xg
hV
hV
jj
jj
jj
ku
ku
ku
ku
ku
LG
jj
eF
"}
(17,1,1) = {"
eF
jj
jj
jj
hV
hV
jX
mf
Pa
ZA
tK
lT
jX
CF
hV
hV
jj
jj
jj
jj
jj
jj
jj
jj
jj
jj
jj
eF
"}
(18,1,1) = {"
eF
jj
jj
jj
hV
hV
MP
MP
jX
MP
jX
jX
jX
gr
hV
hV
jj
jj
jj
jj
jj
jj
jj
jj
jj
jj
jj
eF
"}
(19,1,1) = {"
eF
jj
jj
jj
jj
hV
hV
hV
Xi
LY
tP
Xi
hV
hV
hV
jj
jj
jj
jj
jj
jj
jj
jj
jj
jj
jj
jj
eF
"}
(20,1,1) = {"
eF
jj
jj
jj
jj
jj
jj
hV
LY
hV
hV
LY
hV
hV
hV
jj
jj
jj
jj
jj
jj
jj
jj
jj
jj
jj
jj
eF
"}
(21,1,1) = {"
eF
jj
jj
jj
jj
jj
jj
jj
LY
hV
hV
hV
hV
jj
jj
jj
jj
jj
jj
jj
jj
jj
jj
jj
jj
jj
jj
eF
"}
(22,1,1) = {"
eF
jj
jj
jj
jj
jj
jj
jj
jj
jj
jj
jj
jj
jj
jj
jj
jj
jj
jj
jj
jj
jj
jj
jj
jj
jj
jj
eF
"}
(23,1,1) = {"
eF
jj
jj
jj
jj
jj
jj
jj
jj
jj
jj
jj
jj
jj
jj
jj
jj
jj
jj
jj
jj
jj
jj
jj
jj
jj
jj
eF
"}
(24,1,1) = {"
eF
jj
jj
jj
jj
jj
jj
jj
jj
jj
jj
jj
jj
jj
jj
jj
jj
jj
jj
jj
jj
jj
jj
jj
jj
jj
jj
eF
"}
(25,1,1) = {"
eF
eF
eF
eF
eF
eF
eF
eF
eF
eF
eF
eF
eF
eF
eF
eF
eF
eF
eF
eF
eF
eF
eF
eF
eF
eF
eF
eF
"}
