//MAP CONVERTED BY dmm2tgm.py THIS HEADER COMMENT PREVENTS RECONVERSION, DO NOT REMOVE
"aa" = (
/turf/template_noop,
/area/template_noop)
"ab" = (
/obj/structure/alien/weeds,
/obj/structure/alien/weeds,
/turf/open/misc/asteroid/basalt/lava_land_surface/no_ruins,
/area/virtual_domain)
"ac" = (
/obj/structure/alien/weeds,
/obj/structure/alien/resin/wall,
/obj/structure/alien/resin/wall,
/turf/open/misc/asteroid/basalt/lava_land_surface,
/area/ruin/space/has_grav/powered/virtual_domain)
"ad" = (
/obj/structure/alien/resin/wall,
/turf/closed/indestructible/binary,
/area/ruin/space/has_grav/powered/virtual_domain)
"ae" = (
/obj/structure/alien/weeds,
/turf/open/misc/asteroid/basalt/lava_land_surface,
/area/ruin/space/has_grav/powered/virtual_domain)
"af" = (
/obj/structure/alien/weeds,
/obj/structure/alien/egg/burst,
/obj/effect/decal/cleanable/blood,
/turf/open/misc/asteroid/basalt/lava_land_surface,
/area/ruin/space/has_grav/powered/virtual_domain)
"ag" = (
/turf/open/misc/asteroid/basalt/lava_land_surface/no_ruins,
/area/virtual_domain)
"ah" = (
/obj/structure/alien/weeds,
/obj/effect/landmark/bitrunning/mob_segment,
/turf/open/misc/asteroid/basalt/lava_land_surface,
/area/ruin/space/has_grav/powered/virtual_domain)
"ai" = (
/obj/structure/alien/weeds,
/obj/structure/bed/nest,
/obj/effect/decal/cleanable/blood/gibs,
/obj/effect/decal/cleanable/blood,
/obj/item/clothing/under/syndicate,
/obj/item/clothing/glasses/night,
/turf/open/misc/asteroid/basalt/lava_land_surface,
/area/ruin/space/has_grav/powered/virtual_domain)
"aj" = (
/obj/machinery/suit_storage_unit/spaceruin,
/turf/template_noop,
/area/virtual_domain/safehouse)
"ak" = (
/obj/structure/alien/weeds/node,
/obj/structure/alien/resin/wall,
/turf/open/misc/asteroid/basalt/lava_land_surface,
/area/ruin/space/has_grav/powered/virtual_domain)
"al" = (
/obj/structure/alien/weeds,
/obj/structure/alien/resin/wall,
/turf/closed/indestructible/binary,
/area/ruin/space/has_grav/powered/virtual_domain)
"am" = (
/obj/structure/alien/weeds,
/obj/structure/bed/nest,
/obj/structure/alien/resin/wall,
/turf/open/misc/asteroid/basalt/lava_land_surface,
/area/ruin/space/has_grav/powered/virtual_domain)
"an" = (
/turf/template_noop,
/area/virtual_domain/safehouse)
"ao" = (
/obj/structure/alien/weeds,
/obj/effect/decal/cleanable/blood/gibs,
/turf/open/misc/asteroid/basalt/lava_land_surface,
/area/ruin/space/has_grav/powered/virtual_domain)
"ap" = (
/obj/structure/alien/weeds,
/mob/living/basic/alien/drone{
	can_plant_weeds = 0
	},
/turf/open/misc/asteroid/basalt/lava_land_surface,
/area/ruin/space/has_grav/powered/virtual_domain)
"aq" = (
/obj/structure/alien/resin/wall,
/turf/open/space/basic,
/area/ruin/space/has_grav/powered/virtual_domain)
"ar" = (
/obj/effect/baseturf_helper/virtual_domain,
/turf/template_noop,
/area/virtual_domain/safehouse)
"as" = (
/obj/structure/alien/weeds/node,
/mob/living/basic/alien/drone{
	can_plant_weeds = 0
	},
/turf/open/misc/asteroid/basalt/lava_land_surface,
/area/ruin/space/has_grav/powered/virtual_domain)
"at" = (
/obj/structure/alien/weeds,
/obj/structure/alien/weeds,
/turf/open/misc/asteroid/basalt/lava_land_surface,
/area/ruin/space/has_grav/powered/virtual_domain)
"au" = (
/obj/structure/alien/weeds/node,
/obj/effect/decal/cleanable/blood,
/turf/open/misc/asteroid/basalt/lava_land_surface,
/area/ruin/space/has_grav/powered/virtual_domain)
"av" = (
/obj/modular_map_root/safehouse{
	key = "shuttle"
	},
/turf/template_noop,
/area/virtual_domain/safehouse)
"aw" = (
/turf/closed/indestructible/binary,
/area/virtual_domain/fullbright)
"ax" = (
/obj/structure/alien/weeds,
/obj/structure/bed/nest,
/obj/effect/landmark/bitrunning/cache_spawn,
/turf/open/misc/asteroid/basalt/lava_land_surface,
/area/ruin/space/has_grav/powered/virtual_domain)
"ay" = (
/obj/structure/alien/weeds/node,
/obj/effect/landmark/bitrunning/mob_segment,
/turf/open/misc/asteroid/basalt/lava_land_surface,
/area/ruin/space/has_grav/powered/virtual_domain)
"az" = (
/obj/structure/alien/weeds,
/obj/structure/alien/resin/wall,
/turf/open/misc/asteroid/basalt/lava_land_surface,
/area/ruin/space/has_grav/powered/virtual_domain)
"aA" = (
/turf/open/misc/asteroid/basalt/lava_land_surface/no_ruins,
/area/ruin/space/has_grav/powered/virtual_domain)
"aB" = (
/obj/structure/alien/weeds,
/obj/effect/decal/cleanable/blood,
/turf/open/misc/asteroid/basalt/lava_land_surface,
/area/ruin/space/has_grav/powered/virtual_domain)
"aC" = (
/obj/structure/alien/weeds,
/turf/open/misc/asteroid/basalt/lava_land_surface/no_ruins,
/area/ruin/space/has_grav/powered/virtual_domain)
"aD" = (
/obj/structure/alien/weeds,
/obj/structure/alien/weeds,
/turf/open/misc/asteroid/basalt/lava_land_surface/no_ruins,
/area/ruin/space/has_grav/powered/virtual_domain)
"aE" = (
/turf/closed/indestructible/binary,
/area/ruin/space/has_grav/powered/virtual_domain)
"aF" = (
/obj/structure/table/greyscale,
/obj/item/gun/energy/xray,
/obj/item/gun/energy/laser{
	pixel_x = 4;
	pixel_y = -6
	},
/obj/item/gun/energy/laser{
	pixel_x = -8;
	pixel_y = 6
	},
/turf/template_noop,
/area/virtual_domain/safehouse)
"aG" = (
/obj/structure/alien/resin/wall,
/obj/structure/alien/weeds,
/turf/open/misc/asteroid/basalt/lava_land_surface,
/area/ruin/space/has_grav/powered/virtual_domain)
"aH" = (
/obj/structure/table/greyscale,
/obj/machinery/recharger{
	pixel_x = 8;
	pixel_y = 4
	},
/obj/machinery/recharger{
	pixel_x = -8;
	pixel_y = 4
	},
/turf/template_noop,
/area/virtual_domain/safehouse)
"aI" = (
/obj/structure/alien/weeds,
/obj/structure/bed/nest,
/turf/open/misc/asteroid/basalt/lava_land_surface,
/area/ruin/space/has_grav/powered/virtual_domain)
"aJ" = (
/obj/structure/alien/weeds,
/mob/living/basic/alien/queen/large{
	desc = "A gigantic alien who is in charge of the hive and all of its loyal servants.";
	name = "alien queen";
	pixel_x = -16;
	can_plant_weeds = 0
	},
/turf/open/misc/asteroid/basalt/lava_land_surface,
/area/ruin/space/has_grav/powered/virtual_domain)
"aK" = (
/obj/structure/alien/weeds,
/obj/effect/landmark/bitrunning/cache_spawn,
/turf/open/misc/asteroid/basalt/lava_land_surface,
/area/ruin/space/has_grav/powered/virtual_domain)
"aL" = (
/obj/item/storage/medkit/regular,
/obj/item/storage/medkit/regular,
/turf/template_noop,
/area/virtual_domain/safehouse)
"aM" = (
/obj/structure/alien/weeds,
/obj/structure/alien/resin/wall{
	move_force = 1000;
	move_resist = 3000;
	pull_force = 1000
	},
/turf/open/misc/asteroid/basalt/lava_land_surface,
/area/ruin/space/has_grav/powered/virtual_domain)
"aN" = (
/obj/structure/alien/weeds,
/obj/structure/bed/nest,
/obj/effect/decal/cleanable/blood/gibs,
/obj/item/clothing/under/rank/security/officer,
/obj/item/clothing/suit/armor/vest,
/obj/item/melee/baton/security/loaded,
/obj/item/clothing/head/helmet,
/turf/open/misc/asteroid/basalt/lava_land_surface,
/area/ruin/space/has_grav/powered/virtual_domain)
"aO" = (
/obj/effect/baseturf_helper/virtual_domain,
/turf/closed/indestructible/binary,
/area/ruin/space/has_grav/powered/virtual_domain)
"aP" = (
/obj/structure/alien/weeds/node,
/mob/living/basic/alien,
/turf/open/misc/asteroid/basalt/lava_land_surface,
/area/ruin/space/has_grav/powered/virtual_domain)
"aQ" = (
/obj/structure/alien/resin/wall,
/obj/structure/alien/resin/wall,
/turf/closed/indestructible/binary,
/area/ruin/space/has_grav/powered/virtual_domain)
"aR" = (
/obj/structure/alien/resin/wall,
/turf/open/misc/asteroid/basalt/lava_land_surface/no_ruins,
/area/virtual_domain)
"aS" = (
/obj/structure/alien/weeds,
/mob/living/basic/alien,
/turf/open/misc/asteroid/basalt/lava_land_surface,
/area/ruin/space/has_grav/powered/virtual_domain)
"aT" = (
/obj/structure/alien/weeds,
/obj/structure/alien/egg/burst,
/obj/effect/decal/cleanable/blood/gibs,
/turf/open/misc/asteroid/basalt/lava_land_surface,
/area/ruin/space/has_grav/powered/virtual_domain)
"aU" = (
/obj/structure/alien/weeds,
/obj/structure/bed/nest,
/obj/effect/decal/cleanable/blood/gibs,
/obj/item/gun/ballistic/automatic/pistol,
/turf/open/misc/asteroid/basalt/lava_land_surface,
/area/ruin/space/has_grav/powered/virtual_domain)
"aV" = (
/obj/structure/alien/weeds/node,
/turf/open/misc/asteroid/basalt/lava_land_surface,
/area/ruin/space/has_grav/powered/virtual_domain)
"aW" = (
/obj/structure/alien/weeds,
/obj/structure/alien/egg/burst,
/turf/open/misc/asteroid/basalt/lava_land_surface,
/area/ruin/space/has_grav/powered/virtual_domain)
"aX" = (
/obj/effect/baseturf_helper/virtual_domain,
/turf/closed/indestructible/binary,
/area/virtual_domain/fullbright)
"aY" = (
/obj/structure/alien/weeds,
/turf/open/misc/asteroid/basalt/lava_land_surface/no_ruins,
/area/virtual_domain)
"aZ" = (
/obj/structure/alien/weeds,
/obj/structure/bed/nest,
/obj/effect/decal/cleanable/blood/gibs,
/obj/item/tank/internals/oxygen,
/obj/item/clothing/suit/space/syndicate/orange,
/obj/item/clothing/mask/gas,
/obj/item/clothing/head/helmet/space/syndicate/orange,
/turf/open/misc/asteroid/basalt/lava_land_surface,
/area/ruin/space/has_grav/powered/virtual_domain)
"bt" = (
/obj/structure/alien/weeds,
/obj/structure/bed/nest,
/obj/structure/alien/resin/wall,
/turf/open/misc/asteroid/basalt/lava_land_surface,
/area/virtual_domain)
"bR" = (
/obj/structure/alien/weeds,
/obj/structure/bed/nest,
/obj/effect/landmark/bitrunning/cache_spawn,
/turf/open/misc/asteroid/basalt/lava_land_surface,
/area/virtual_domain)
"bU" = (
/obj/structure/alien/weeds,
/obj/structure/alien/resin/wall,
/turf/open/misc/asteroid/basalt/lava_land_surface/no_ruins,
/area/virtual_domain)
"bV" = (
/obj/structure/alien/weeds,
/obj/structure/alien/weeds,
/turf/open/misc/asteroid/basalt/lava_land_surface,
/area/virtual_domain)
"cw" = (
/obj/structure/alien/weeds,
/turf/open/misc/asteroid/basalt/lava_land_surface,
/area/virtual_domain)
"dl" = (
/obj/structure/alien/weeds,
/obj/structure/alien/resin/wall,
/turf/closed/indestructible/binary,
/area/virtual_domain/fullbright)
"ds" = (
/obj/structure/alien/weeds,
/obj/structure/alien/egg/burst,
/obj/effect/decal/cleanable/blood,
/turf/open/misc/asteroid/basalt/lava_land_surface,
/area/virtual_domain)
"eD" = (
/obj/structure/alien/weeds,
/obj/structure/bed/nest,
/obj/effect/decal/cleanable/blood/gibs,
/obj/effect/decal/cleanable/blood,
/obj/item/clothing/under/syndicate,
/obj/item/clothing/glasses/night,
/turf/open/misc/asteroid/basalt/lava_land_surface,
/area/virtual_domain)
"go" = (
/obj/structure/alien/weeds,
/obj/structure/bed/nest,
/obj/effect/decal/cleanable/blood/gibs,
/obj/item/gun/ballistic/automatic/pistol,
/turf/open/misc/asteroid/basalt/lava_land_surface,
/area/virtual_domain)
"ie" = (
/obj/structure/alien/weeds,
/obj/structure/alien/resin/wall,
/obj/structure/alien/resin/wall,
/turf/open/misc/asteroid/basalt/lava_land_surface,
/area/virtual_domain)
"jG" = (
/obj/structure/alien/weeds/node,
/obj/structure/alien/resin/wall,
/turf/open/misc/asteroid/basalt/lava_land_surface,
/area/virtual_domain)
"my" = (
/obj/structure/alien/weeds/node,
/obj/effect/decal/cleanable/blood,
/turf/open/misc/asteroid/basalt/lava_land_surface,
/area/virtual_domain)
"mT" = (
/obj/structure/alien/weeds/node,
/obj/effect/landmark/bitrunning/mob_segment,
/turf/open/misc/asteroid/basalt/lava_land_surface,
/area/virtual_domain)
"nq" = (
/obj/structure/alien/weeds/node,
/mob/living/basic/alien/drone{
	can_plant_weeds = 0
	},
/turf/open/misc/asteroid/basalt/lava_land_surface,
/area/virtual_domain)
"oD" = (
/obj/structure/alien/weeds,
/obj/structure/bed/nest,
/obj/effect/decal/cleanable/blood/gibs,
/obj/item/tank/internals/oxygen,
/obj/item/clothing/suit/space/syndicate/orange,
/obj/item/clothing/mask/gas,
/obj/item/clothing/head/helmet/space/syndicate/orange,
/turf/open/misc/asteroid/basalt/lava_land_surface,
/area/virtual_domain)
"rY" = (
/obj/structure/alien/weeds,
/obj/structure/bed/nest,
/turf/open/misc/asteroid/basalt/lava_land_surface,
/area/virtual_domain)
"sO" = (
/obj/structure/alien/weeds/node,
/turf/open/misc/asteroid/basalt/lava_land_surface,
/area/virtual_domain)
"tG" = (
/obj/structure/alien/weeds,
/mob/living/basic/alien/drone{
	can_plant_weeds = 0
	},
/turf/open/misc/asteroid/basalt/lava_land_surface,
/area/virtual_domain)
"vP" = (
/obj/structure/alien/weeds,
/obj/structure/alien/resin/wall,
/turf/open/misc/asteroid/basalt/lava_land_surface,
/area/virtual_domain)
"BB" = (
/obj/structure/alien/weeds,
/mob/living/basic/alien/queen/large{
	desc = "A gigantic alien who is in charge of the hive and all of its loyal servants.";
	name = "alien queen";
	pixel_x = -16;
	can_plant_weeds = 0
	},
/turf/open/misc/asteroid/basalt/lava_land_surface,
/area/virtual_domain)
"FI" = (
/obj/structure/alien/weeds,
/mob/living/basic/alien,
/turf/open/misc/asteroid/basalt/lava_land_surface,
/area/virtual_domain)
"Hu" = (
/obj/structure/alien/weeds,
/obj/effect/landmark/bitrunning/mob_segment,
/turf/open/misc/asteroid/basalt/lava_land_surface,
/area/virtual_domain)
"JT" = (
/obj/structure/alien/weeds,
/obj/effect/landmark/bitrunning/cache_spawn,
/turf/open/misc/asteroid/basalt/lava_land_surface,
/area/virtual_domain)
"JZ" = (
/obj/structure/alien/weeds,
/obj/structure/alien/egg/burst,
/turf/open/misc/asteroid/basalt/lava_land_surface,
/area/virtual_domain)
"Lb" = (
/obj/structure/alien/weeds,
/obj/effect/decal/cleanable/blood/gibs,
/turf/open/misc/asteroid/basalt/lava_land_surface,
/area/virtual_domain)
"RZ" = (
/obj/structure/alien/weeds,
/obj/structure/alien/egg/burst,
/obj/effect/decal/cleanable/blood/gibs,
/turf/open/misc/asteroid/basalt/lava_land_surface,
/area/virtual_domain)
"SC" = (
/obj/structure/alien/weeds,
/obj/structure/alien/resin/wall{
	move_resist = 3000
	},
/turf/open/misc/asteroid/basalt/lava_land_surface,
/area/virtual_domain)
"SD" = (
/obj/structure/alien/weeds,
/obj/effect/decal/cleanable/blood,
/turf/open/misc/asteroid/basalt/lava_land_surface,
/area/virtual_domain)
"TA" = (
/obj/structure/alien/resin/wall,
/obj/structure/alien/resin/wall,
/turf/open/misc/asteroid/basalt/lava_land_surface/no_ruins,
/area/virtual_domain)
"Wp" = (
/obj/structure/alien/weeds/node,
/mob/living/basic/alien,
/turf/open/misc/asteroid/basalt/lava_land_surface,
/area/virtual_domain)
"WD" = (
/obj/structure/alien/resin/wall,
/obj/structure/alien/weeds,
/turf/open/misc/asteroid/basalt/lava_land_surface,
/area/virtual_domain)
"XX" = (
/obj/structure/alien/weeds,
/obj/structure/bed/nest,
/obj/effect/decal/cleanable/blood/gibs,
/obj/item/clothing/under/rank/security/officer,
/obj/item/clothing/suit/armor/vest,
/obj/item/melee/baton/security/loaded,
/obj/item/clothing/head/helmet,
/turf/open/misc/asteroid/basalt/lava_land_surface,
/area/virtual_domain)

(1,1,1) = {"
aa
aa
aa
aa
aw
aw
aw
aw
aw
aw
aw
aw
aw
aw
aa
aa
aa
aa
aa
aa
aa
aa
aa
aa
aa
aa
aa
aa
aa
aa
aa
aa
aa
aa
aa
aa
aa
aa
aa
"}
(2,1,1) = {"
aa
aa
aa
aa
aw
vP
vP
vP
vP
vP
vP
vP
vP
aw
aw
aa
aa
aa
aa
aa
aa
aa
aa
aa
aa
aa
aa
aa
aa
aa
aa
aa
aa
aa
aa
aa
aa
aa
aa
"}
(3,1,1) = {"
aa
aa
aa
aw
aw
vP
cw
JZ
JZ
vP
cw
cw
vP
SC
aw
aa
aa
aa
aa
aa
aa
aa
aa
aa
aa
aa
aa
aa
aa
aa
aa
aa
aa
aa
aa
aa
aa
aa
aa
"}
(4,1,1) = {"
aa
aa
aa
aw
vP
vP
cw
cw
cw
cw
tG
cw
JZ
vP
aw
aa
aa
aa
aa
aa
aa
aa
aa
aa
aa
aa
aa
aa
aa
aa
aa
aa
aa
aa
aa
aa
aa
aa
aa
"}
(5,1,1) = {"
aa
aa
aa
aw
vP
cw
cw
jG
vP
vP
vP
jG
vP
vP
aw
aa
aa
aa
aa
aa
aa
aa
aa
aa
aa
aa
aa
aa
aa
aa
aa
aa
aa
aa
aa
aa
aa
aa
aa
"}
(6,1,1) = {"
aa
aa
aa
aw
vP
cw
Hu
bt
JT
BB
Lb
eD
vP
vP
aw
aa
aa
aa
aa
aa
aa
aa
aa
aa
aa
aa
aa
aa
aa
aa
aa
aa
aa
aa
aa
aa
aa
aa
aa
"}
(7,1,1) = {"
aa
aa
aa
aw
vP
JZ
cw
cw
cw
cw
SD
Lb
JT
vP
aw
aa
aa
aa
aa
aa
aa
aa
aa
aa
aa
aa
aa
aa
aa
aa
aa
aa
aa
aa
aa
aa
aa
aa
aa
"}
(8,1,1) = {"
aa
aa
aa
aw
vP
rY
Lb
vP
cw
sO
cw
cw
JZ
vP
aw
aa
aa
aa
aa
aa
aa
aa
aa
aa
aa
aa
aa
aa
aa
aa
aa
aa
aa
aa
aa
aa
aa
aa
aa
"}
(9,1,1) = {"
aa
aa
aa
aw
vP
go
my
cw
vP
cw
cw
JZ
vP
vP
aw
aa
aa
aa
aa
aa
aa
aa
aa
aa
aa
aa
aa
aa
aa
aa
aa
aa
aa
aa
aa
aa
aa
aa
aa
"}
(10,1,1) = {"
aa
aa
aa
aw
vP
cw
Lb
vP
cw
cw
cw
jG
JZ
vP
aw
aa
aa
aa
aa
aa
aa
aa
aa
aa
aa
aw
aw
aw
aw
aw
aw
aa
aa
aa
aa
aa
aa
aa
aa
"}
(11,1,1) = {"
aa
aa
aa
aw
vP
vP
cw
cw
cw
cw
cw
Hu
cw
vP
aw
aa
aa
aa
aa
aa
aa
aa
aa
aa
aw
aw
vP
vP
vP
vP
aw
aw
aa
aa
aa
aa
aa
aa
aa
"}
(12,1,1) = {"
aa
aa
aa
aw
aw
vP
JZ
cw
cw
cw
cw
cw
cw
vP
aw
aa
aa
aa
aa
aa
aa
aa
aa
aw
aw
vP
vP
oD
rY
vP
vP
aw
aa
aa
aa
aa
aa
aa
aa
"}
(13,1,1) = {"
aa
aa
aa
aa
aw
vP
vP
cw
cw
sO
cw
cw
vP
vP
aw
aa
aa
aa
aa
aa
aa
aa
aa
aw
vP
vP
JZ
Lb
SD
JT
vP
aw
aa
aa
aa
aa
aa
aa
aa
"}
(14,1,1) = {"
aa
aa
aa
aa
aw
aw
vP
vP
cw
cw
cw
vP
vP
aw
aw
aa
aa
aa
aa
aa
aa
aw
aw
aw
vP
rY
cw
mT
cw
JZ
vP
aw
aa
aa
aa
aa
aa
aa
aa
"}
(15,1,1) = {"
aa
aa
aa
aa
aa
aw
aw
vP
vP
vP
vP
vP
aw
aw
aa
aa
aa
aa
aa
aa
aw
aw
vP
vP
vP
cw
cw
cw
rY
vP
vP
aw
aa
aa
aa
aa
aa
aa
aa
"}
(16,1,1) = {"
aa
aa
aa
aa
aa
aa
aw
vP
sO
sO
vP
aw
aw
aw
aw
aw
aw
aw
aw
aw
aw
vP
vP
cw
FI
cw
JZ
vP
vP
vP
aw
aw
aa
aa
aa
aa
aa
aa
aa
"}
(17,1,1) = {"
aa
aa
aa
aa
aa
aa
aw
vP
tG
cw
vP
vP
aw
vP
vP
vP
vP
vP
vP
vP
vP
vP
cw
cw
vP
vP
vP
vP
aw
aw
aw
aa
aa
aa
aa
aa
aa
aa
aa
"}
(18,1,1) = {"
aa
aa
aa
aa
aa
aa
aw
vP
cw
cw
cw
vP
vP
vP
cw
cw
cw
cw
cw
cw
vP
vP
cw
vP
vP
aw
aw
aw
aw
aw
aw
aw
aw
aw
aw
aw
aw
aw
aX
"}
(19,1,1) = {"
aw
aw
aw
aw
aw
aw
aw
vP
vP
cw
cw
cw
vP
cw
cw
cw
cw
cw
cw
sO
cw
cw
cw
vP
aw
aw
aa
aa
aa
aw
TA
aR
aR
aR
aR
aR
aR
aR
aw
"}
(20,1,1) = {"
aw
vP
vP
vP
vP
aw
aw
aw
vP
vP
cw
sO
cw
cw
cw
vP
vP
vP
vP
cw
cw
bV
vP
vP
aw
aa
aa
aa
aa
aw
aR
ag
ag
ag
ag
ag
ag
ag
aw
"}
(21,1,1) = {"
aw
vP
JZ
rY
vP
vP
vP
vP
vP
vP
cw
cw
cw
cw
vP
vP
aw
aw
vP
vP
cw
cw
vP
aw
aw
aa
aa
aa
aa
aw
aR
ag
ag
ag
ag
ag
ag
ag
aw
"}
(22,1,1) = {"
aw
WD
bV
Hu
cw
vP
vP
cw
cw
cw
cw
cw
cw
vP
vP
aw
aw
aw
vP
cw
cw
cw
vP
aw
aa
aa
aa
aa
aa
aw
aR
ag
aY
ag
ag
ag
ag
ag
aw
"}
(23,1,1) = {"
aw
WD
JT
JZ
sO
cw
cw
cw
vP
vP
cw
vP
vP
vP
aw
aw
aw
aw
vP
cw
cw
vP
vP
aw
aa
aa
aa
aa
aa
aw
aR
aY
aY
aY
ag
ag
ag
ag
aw
"}
(24,1,1) = {"
aw
vP
vP
rY
rY
vP
vP
vP
vP
vP
cw
vP
aw
aw
aw
aw
aw
aw
vP
cw
cw
vP
aw
aw
aw
aa
aa
aa
aa
aw
aR
aY
aY
ag
ag
aY
ag
ag
aw
"}
(25,1,1) = {"
aw
aw
vP
vP
vP
vP
aw
aw
aw
vP
cw
vP
vP
aw
aw
aw
aw
aw
vP
cw
nq
vP
vP
vP
aw
aw
aw
aw
aw
aw
bU
aY
aY
aY
ag
aY
aY
ag
aw
"}
(26,1,1) = {"
aa
aw
aw
aw
aw
aw
aw
aw
aw
vP
cw
cw
vP
aw
aw
aw
aw
aw
vP
cw
cw
cw
cw
vP
vP
vP
aw
aw
aw
vP
vP
an
an
an
an
an
av
ag
aw
"}
(27,1,1) = {"
aa
aa
aa
aa
aa
aw
aw
vP
vP
vP
cw
cw
vP
vP
aw
aw
aw
aw
vP
vP
cw
cw
cw
cw
cw
vP
vP
vP
vP
jG
cw
an
aj
aj
aj
an
an
ag
aw
"}
(28,1,1) = {"
aa
aa
aa
aa
aa
aw
vP
vP
RZ
cw
Hu
sO
JZ
vP
aw
aw
aw
vP
vP
cw
cw
vP
vP
cw
cw
cw
vP
sO
cw
cw
cw
an
an
an
an
an
an
ag
aw
"}
(29,1,1) = {"
aa
aa
aa
aa
aa
aw
vP
XX
ds
cw
cw
JZ
rY
vP
aw
aw
aw
vP
cw
cw
vP
vP
vP
vP
cw
sO
vP
sO
bV
cw
cw
an
an
aF
aH
an
an
ag
aw
"}
(30,1,1) = {"
aa
aa
aa
aa
aa
aw
vP
bR
Lb
cw
rY
rY
vP
vP
aw
aw
aw
vP
cw
vP
vP
aw
aw
vP
vP
vP
vP
vP
jG
cw
cw
an
an
an
an
an
an
ag
aw
"}
(31,1,1) = {"
aa
aa
aa
aa
aa
aw
vP
vP
vP
cw
vP
vP
vP
aw
aw
aw
aw
vP
cw
vP
vP
aw
aw
aw
aw
aw
aw
aw
vP
cw
cw
an
aL
an
an
an
an
ag
aw
"}
(32,1,1) = {"
aa
aa
aa
aa
aa
aw
aw
aw
vP
cw
vP
aw
aw
aw
aw
aw
aw
vP
cw
cw
vP
aw
aa
aa
aa
aa
aw
aw
vP
cw
cw
an
an
an
an
an
ar
ag
aw
"}
(33,1,1) = {"
aa
aa
aa
aa
aa
aa
aa
aw
vP
cw
vP
aw
aw
aa
aa
aa
aw
dl
vP
sO
vP
aw
aa
aa
aa
aa
aw
vP
vP
vP
aR
aY
ag
ag
aY
ag
ag
ag
aw
"}
(34,1,1) = {"
aa
aa
aa
aa
aa
aa
aa
aw
vP
sO
vP
aw
aw
aa
aa
aa
aw
aw
vP
cw
vP
aw
aa
aa
aa
aa
aw
vP
aw
aR
aR
aY
aY
aY
ag
ag
ag
ag
aw
"}
(35,1,1) = {"
aa
aa
aa
aa
aa
aa
aa
aw
vP
cw
vP
aw
aw
aa
aa
aa
aw
aw
vP
cw
vP
aw
aa
aa
aa
aa
aw
aw
aw
aR
aR
ag
ag
ag
ag
ag
ag
ag
aw
"}
(36,1,1) = {"
aa
aa
aa
aa
aa
aa
aa
aw
vP
cw
vP
aw
aw
aw
aw
aw
aw
vP
vP
cw
vP
aw
aa
aa
aa
aa
aa
aa
aw
aR
aR
ag
aY
ab
ag
ag
ag
ag
aw
"}
(37,1,1) = {"
aa
aa
aa
aa
aa
aa
aw
aw
vP
cw
vP
aw
aw
aw
aw
aw
vP
vP
cw
cw
vP
aw
aa
aa
aa
aa
aa
aa
aw
aR
aR
ag
ag
ag
ag
ag
ag
ag
aw
"}
(38,1,1) = {"
aa
aa
aa
aa
aa
aw
aw
vP
vP
cw
vP
vP
vP
vP
vP
vP
vP
cw
cw
vP
vP
aw
aa
aa
aa
aa
aa
aa
aw
aR
aR
ag
ag
ag
ag
ag
ag
ag
aw
"}
(39,1,1) = {"
aa
aa
aa
aa
aa
aw
vP
vP
cw
cw
JZ
vP
vP
cw
cw
Wp
cw
cw
vP
vP
aw
aw
aa
aa
aa
aa
aa
aa
aw
TA
aR
aR
aR
aR
aR
aR
aR
aR
aw
"}
(40,1,1) = {"
aa
aa
aa
aa
aw
aw
vP
rY
cw
Hu
cw
cw
cw
cw
vP
vP
vP
vP
vP
aw
aw
aa
aa
aa
aa
aa
aa
aa
aw
aw
aw
aw
aw
aw
aw
aw
aw
aw
aw
"}
(41,1,1) = {"
aa
aa
aa
aa
aw
vP
vP
JZ
cw
sO
cw
JZ
vP
vP
vP
aw
aw
aw
aw
aw
aa
aa
aa
aa
aa
aa
aa
aa
aa
aa
aa
aa
aa
aa
aa
aa
aa
aa
aa
"}
(42,1,1) = {"
aa
aa
aa
aa
aw
vP
JZ
JT
cw
rY
rY
vP
vP
aw
aw
aw
aa
aa
aa
aa
aa
aa
aa
aa
aa
aa
aa
aa
aa
aa
aa
aa
aa
aa
aa
aa
aa
aa
aa
"}
(43,1,1) = {"
aa
aa
aa
aa
aw
ie
vP
vP
vP
vP
vP
vP
aw
aw
aa
aa
aa
aa
aa
aa
aa
aa
aa
aa
aa
aa
aa
aa
aa
aa
aa
aa
aa
aa
aa
aa
aa
aa
aa
"}
(44,1,1) = {"
aa
aa
aa
aa
aw
aw
aw
aw
aw
aw
aw
aw
aw
aa
aa
aa
aa
aa
aa
aa
aa
aa
aa
aa
aa
aa
aa
aa
aa
aa
aa
aa
aa
aa
aa
aa
aa
aa
aa
"}
