//MAP CONVERTED BY dmm2tgm.py THIS HEADER COMMENT PREVENTS RECONVERSION, DO NOT REMOVE
"ac" = (
/obj/machinery/door/poddoor/shutters/radiation/preopen{
	id = "engsm";
	name = "Radiation Chamber Shutters"
	},
/turf/open/floor/plating,
/area/station/engineering/supermatter/room)
"az" = (
/obj/structure/cable,
/turf/closed/wall/r_wall,
/area/station/engineering/supermatter/room)
"aZ" = (
/obj/machinery/firealarm/directional/north,
/obj/structure/cable,
/turf/open/floor/iron/dark,
/area/station/engineering/supermatter/room)
"dp" = (
/obj/effect/turf_decal/stripes/line,
/obj/structure/cable,
/obj/machinery/particle_accelerator/control_box,
/turf/open/floor/engine,
/area/station/engineering/supermatter/room)
"dr" = (
/turf/closed/wall/r_wall,
/area/station/engineering/supermatter/room)
"eP" = (
/obj/effect/turf_decal/stripes/line{
	dir = 6
	},
/obj/structure/cable,
/turf/open/floor/engine,
/area/station/engineering/supermatter/room)
"fa" = (
/obj/item/wrench,
/turf/open/floor/plating,
/area/station/engineering/supermatter/room)
"ha" = (
/obj/effect/turf_decal/stripes/line{
	dir = 9
	},
/obj/structure/particle_accelerator/power_box{
	dir = 4
	},
/turf/open/floor/engine,
/area/station/engineering/supermatter/room)
"hh" = (
/obj/machinery/light/small/directional/north,
/obj/structure/cable,
/turf/open/floor/plating,
/area/station/engineering/supermatter/room)
"hD" = (
/obj/effect/turf_decal/stripes/line,
/turf/open/floor/iron/dark,
/area/station/engineering/supermatter/room)
"jb" = (
/obj/machinery/atmospherics/pipe/smart/manifold4w/supply/hidden/layer4,
/obj/machinery/atmospherics/pipe/smart/manifold4w/scrubbers/hidden/layer2,
/obj/effect/spawner/structure/window/reinforced/plasma,
/turf/open/floor/plating,
/area/station/engineering/supermatter/room)
"jp" = (
/obj/effect/decal/cleanable/dirt,
/turf/open/floor/iron,
/area/station/engineering/supermatter/room)
"kx" = (
/obj/effect/turf_decal/stripes/line{
	dir = 8
	},
/turf/open/floor/iron/dark,
/area/station/engineering/supermatter/room)
"kV" = (
/turf/open/floor/iron/dark,
/area/station/engineering/supermatter/room)
"lg" = (
/obj/machinery/door/airlock/external/glass/emp_proof,
/obj/effect/mapping_helpers/airlock/cyclelink_helper{
	dir = 4
	},
/obj/structure/cable,
/turf/open/floor/plating,
/area/station/engineering/supermatter/room)
"lU" = (
/obj/machinery/atmospherics/pipe/layer_manifold/scrubbers/visible{
	dir = 4
	},
/turf/open/floor/iron,
/area/station/engineering/supermatter/room)
"mF" = (
/obj/structure/cable,
/obj/machinery/door/airlock/engineering/glass{
	name = "Supermatter Engine Room"
	},
/obj/effect/turf_decal/stripes/line{
	dir = 8
	},
/obj/effect/turf_decal/stripes/line{
	dir = 4
	},
/obj/machinery/door/firedoor,
/obj/effect/mapping_helpers/airlock/access/all/engineering/general,
/obj/effect/mapping_helpers/airlock/cyclelink_helper_multi{
	cycle_id = "engine-entrance"
	},
/turf/open/floor/iron,
/area/station/engineering/supermatter/room)
"nk" = (
/obj/effect/turf_decal/caution/red{
	dir = 8
	},
/obj/effect/turf_decal/caution/red{
	dir = 4
	},
/turf/open/floor/plating,
/area/space/nearstation)
"no" = (
/obj/effect/spawner/structure/window/reinforced/plasma,
/obj/structure/cable,
/turf/open/floor/plating,
/area/station/engineering/supermatter/room)
"nq" = (
/obj/machinery/light/directional/north,
/turf/open/floor/iron/dark,
/area/station/engineering/supermatter/room)
"nL" = (
/obj/effect/turf_decal/stripes/line{
	dir = 8
	},
/obj/structure/cable,
/obj/structure/particle_accelerator/particle_emitter/center,
/turf/open/floor/engine,
/area/station/engineering/supermatter/room)
"nS" = (
/obj/effect/turf_decal/stripes/red/full,
/turf/open/floor/plating,
/area/space/nearstation)
"oE" = (
/obj/machinery/light/directional/north,
/turf/open/floor/plating,
/area/station/engineering/supermatter/room)
"oV" = (
/obj/machinery/atmospherics/pipe/smart/manifold4w/scrubbers/visible,
/obj/machinery/door/airlock/engineering/glass{
	name = "Supermatter Engine Room"
	},
/obj/effect/turf_decal/stripes/line{
	dir = 8
	},
/obj/effect/turf_decal/stripes/line{
	dir = 4
	},
/obj/machinery/door/firedoor,
/obj/effect/mapping_helpers/airlock/access/all/engineering/general,
/obj/effect/mapping_helpers/airlock/cyclelink_helper_multi{
	cycle_id = "engine-entrance"
	},
/turf/open/floor/iron,
/area/station/engineering/supermatter/room)
"qu" = (
/obj/item/screwdriver,
/obj/structure/cable,
/obj/machinery/light/directional/east,
/turf/open/floor/plating,
/area/station/engineering/supermatter/room)
"qy" = (
/obj/structure/sign/warning/radiation,
/turf/closed/wall/r_wall,
/area/space/nearstation)
"rQ" = (
/obj/structure/cable,
/turf/open/floor/engine,
/area/station/engineering/supermatter/room)
"te" = (
/obj/structure/cable,
/obj/effect/turf_decal/stripes/line{
	dir = 8
	},
/turf/open/floor/iron/dark,
/area/station/engineering/supermatter/room)
"tm" = (
/obj/effect/turf_decal/stripes/red/line,
/obj/item/stack/cable_coil,
/turf/open/floor/plating,
/area/station/engineering/supermatter/room)
"vu" = (
/obj/machinery/button/door/directional/west{
	id = "engsm";
	name = "Radiation Shutters Control"
	},
/obj/machinery/airalarm/directional/east,
/turf/open/floor/iron/dark,
/area/station/engineering/supermatter/room)
"vP" = (
/obj/machinery/atmospherics/pipe/smart/manifold4w/supply/hidden/layer4,
/obj/machinery/atmospherics/components/unary/vent_scrubber/on/layer2{
	dir = 4
	},
/obj/effect/decal/cleanable/dirt,
/turf/open/floor/iron/checker,
/area/station/engineering/supermatter/room)
"wh" = (
/obj/structure/cable,
/turf/open/floor/plating,
/area/space/nearstation)
"wz" = (
/obj/effect/turf_decal/stripes/red/line{
	dir = 1
	},
/turf/open/floor/plating,
/area/station/engineering/supermatter/room)
"wE" = (
/obj/structure/sign/warning/radiation,
/turf/closed/wall/r_wall,
/area/station/maintenance/department/science/xenobiology)
"wU" = (
/obj/structure/lattice,
/obj/machinery/camera/emp_proof/directional/north,
/turf/open/space/basic,
/area/space/nearstation)
"xF" = (
/obj/structure/cable,
/obj/effect/turf_decal/stripes/line,
/turf/open/floor/iron/dark,
/area/station/engineering/supermatter/room)
"xR" = (
/obj/structure/cable,
/obj/machinery/atmospherics/pipe/smart/manifold4w/supply/hidden/layer4,
/obj/machinery/atmospherics/pipe/smart/manifold4w/scrubbers/hidden/layer2,
/obj/effect/turf_decal/stripes/line{
	dir = 8
	},
/obj/effect/turf_decal/stripes/line{
	dir = 4
	},
/obj/machinery/door/airlock/engineering/glass{
	name = "Supermatter Engine Room"
	},
/obj/machinery/door/firedoor,
/obj/effect/mapping_helpers/airlock/access/all/engineering/general,
/turf/open/floor/iron,
/area/station/engineering/supermatter/room)
"xV" = (
/obj/structure/cable,
/obj/effect/turf_decal/stripes/line{
	dir = 1
	},
/turf/open/floor/iron/dark,
/area/station/engineering/supermatter/room)
"ys" = (
/obj/effect/turf_decal/stripes/line{
	dir = 5
	},
/obj/structure/cable,
/turf/open/floor/engine,
/area/station/engineering/supermatter/room)
"yW" = (
/obj/structure/lattice,
/obj/machinery/camera/emp_proof/directional/south,
/turf/open/space/basic,
/area/space/nearstation)
"zo" = (
/obj/effect/turf_decal/stripes/line{
	dir = 10
	},
/turf/open/floor/engine,
/area/station/engineering/supermatter/room)
"zM" = (
/obj/machinery/door/poddoor/shutters/radiation/preopen{
	id = "engsm";
	name = "Radiation Chamber Shutters"
	},
/obj/structure/cable,
/turf/open/floor/plating,
/area/station/engineering/supermatter/room)
"Aa" = (
/obj/effect/turf_decal/stripes/line{
	dir = 1
	},
/obj/structure/particle_accelerator/end_cap{
	dir = 4
	},
/turf/open/floor/engine,
/area/station/engineering/supermatter/room)
"Ar" = (
/obj/machinery/light/directional/south,
/turf/open/floor/iron/dark,
/area/station/engineering/supermatter/room)
"AP" = (
/obj/effect/turf_decal/stripes/line,
/obj/structure/sign/warning/vacuum/external/directional/west,
/turf/open/floor/iron/dark,
/area/station/engineering/supermatter/room)
"Be" = (
/obj/structure/cable,
/obj/machinery/light/directional/east,
/turf/open/floor/iron/dark,
/area/station/engineering/supermatter/room)
"BI" = (
/turf/open/floor/plating,
/area/station/engineering/supermatter/room)
"Cq" = (
/obj/effect/turf_decal/stripes/line,
/obj/structure/particle_accelerator/particle_emitter/left{
	dir = 4
	},
/turf/open/floor/engine,
/area/station/engineering/supermatter/room)
"Cu" = (
/obj/machinery/door/poddoor/shutters/radiation/preopen{
	id = "engsm";
	name = "Radiation Chamber Shutters"
	},
/obj/structure/sign/warning/vacuum/external/directional/west,
/turf/open/floor/plating,
/area/station/engineering/supermatter/room)
"DG" = (
/obj/machinery/atmospherics/components/unary/vent_pump/on/layer4{
	dir = 4
	},
/obj/effect/decal/cleanable/oil,
/obj/effect/decal/cleanable/dirt,
/turf/open/floor/iron/checker,
/area/station/engineering/supermatter/room)
"Em" = (
/obj/machinery/door/airlock/highsecurity{
	name = "Emergency Access"
	},
/obj/effect/mapping_helpers/airlock/cyclelink_helper,
/obj/effect/turf_decal/stripes/line,
/obj/effect/turf_decal/stripes/line{
	dir = 1
	},
/obj/machinery/door/firedoor/heavy,
/obj/effect/mapping_helpers/airlock/access/all/engineering/general,
/turf/open/floor/iron,
/area/station/engineering/supermatter/room)
"Ew" = (
/obj/effect/turf_decal/caution/red{
	dir = 4
	},
/obj/effect/turf_decal/caution/red{
	dir = 8
	},
/turf/open/floor/plating,
/area/space/nearstation)
"FX" = (
/obj/effect/turf_decal/bot_white,
/obj/structure/cable,
/obj/machinery/power/emitter{
	dir = 1
	},
/turf/open/floor/plating,
/area/space/nearstation)
"Gh" = (
/obj/effect/turf_decal/stripes/red/full,
/obj/structure/cable,
/turf/open/floor/plating,
/area/space/nearstation)
"GV" = (
/turf/open/floor/plating,
/area/space/nearstation)
"Hp" = (
/obj/structure/tank_dispenser,
/turf/open/floor/iron/dark,
/area/station/engineering/supermatter/room)
"Hs" = (
/obj/machinery/atmospherics/components/binary/temperature_gate{
	dir = 4;
	on = 1
	},
/obj/effect/turf_decal/box,
/turf/open/floor/iron,
/area/station/engineering/supermatter/room)
"IM" = (
/obj/machinery/atmospherics/pipe/smart/manifold4w/supply/hidden/layer4,
/obj/machinery/atmospherics/pipe/smart/manifold4w/scrubbers/hidden/layer2,
/obj/machinery/door/airlock/engineering/glass{
	name = "Supermatter Engine Room"
	},
/obj/effect/turf_decal/stripes/line{
	dir = 8
	},
/obj/effect/turf_decal/stripes/line{
	dir = 4
	},
/obj/effect/mapping_helpers/airlock/cyclelink_helper_multi{
	cycle_id = "engine-side"
	},
/obj/machinery/door/firedoor,
/obj/effect/mapping_helpers/airlock/access/all/engineering/general,
/turf/open/floor/iron,
/area/station/engineering/supermatter/room)
"IX" = (
/obj/effect/turf_decal/stripes/line{
	dir = 4
	},
/obj/structure/cable,
/obj/structure/particle_accelerator/particle_emitter/right{
	dir = 4
	},
/turf/open/floor/engine,
/area/station/engineering/supermatter/room)
"JD" = (
/obj/machinery/door/airlock/external/glass/emp_proof,
/obj/effect/mapping_helpers/airlock/cyclelink_helper{
	dir = 8
	},
/obj/structure/cable,
/turf/open/floor/plating,
/area/station/engineering/supermatter/room)
"Lb" = (
/obj/effect/decal/cleanable/dirt,
/obj/machinery/atmospherics/pipe/smart/manifold4w/scrubbers/visible,
/turf/open/floor/iron,
/area/station/engineering/supermatter/room)
"Ll" = (
/obj/structure/lattice,
/turf/open/space/basic,
/area/space/nearstation)
"LP" = (
/turf/open/space/basic,
/area/space)
"LV" = (
/turf/closed/wall/r_wall,
/area/station/maintenance/department/science/xenobiology)
"NN" = (
/obj/structure/closet/firecloset,
/turf/open/floor/iron/dark,
/area/station/engineering/supermatter/room)
"NW" = (
/obj/machinery/power/apc/auto_name/emp_proof/directional/east,
/obj/effect/mapping_helpers/apc/cell_10k,
/obj/effect/turf_decal/stripes/line{
	dir = 8
	},
/turf/open/floor/iron/dark,
/area/station/engineering/supermatter/room)
"OL" = (
/obj/structure/sign/warning/secure_area,
/turf/closed/wall/r_wall,
/area/station/engineering/supermatter/room)
"Pa" = (
/turf/closed/wall/r_wall,
/area/station/maintenance/port)
"Pz" = (
/obj/machinery/singularity_generator,
/obj/item/wrench,
/turf/open/floor/plating,
/area/space/nearstation)
"PO" = (
/obj/machinery/button/door/directional/west{
	id = "engsm";
	name = "Radiation Shutters Control"
	},
/obj/structure/cable,
/turf/open/floor/iron/dark,
/area/station/engineering/supermatter/room)
"PY" = (
/obj/structure/cable,
/obj/effect/turf_decal/bot_white,
/obj/machinery/power/emitter,
/turf/open/floor/plating,
/area/space/nearstation)
"QC" = (
/obj/structure/cable,
/turf/open/floor/iron/dark,
/area/station/engineering/supermatter/room)
"QE" = (
/obj/effect/turf_decal/caution/stand_clear/red{
	dir = 4
	},
/turf/open/floor/plating,
/area/station/engineering/supermatter/room)
"Ri" = (
/turf/closed/wall/r_wall,
/area/space/nearstation)
"RD" = (
/obj/machinery/light/directional/south,
/turf/open/floor/plating,
/area/station/engineering/supermatter/room)
"RM" = (
/obj/structure/cable,
/obj/effect/turf_decal/bot_white,
/obj/machinery/power/emitter{
	dir = 1
	},
/turf/open/floor/plating,
/area/space/nearstation)
"Sa" = (
/obj/machinery/atmospherics/pipe/smart/manifold4w/supply/hidden/layer4,
/obj/machinery/atmospherics/pipe/smart/manifold4w/scrubbers/hidden/layer2,
/turf/open/floor/iron,
/area/station/engineering/supermatter/room)
"SL" = (
/obj/structure/sign/warning/radiation,
/turf/closed/wall/r_wall,
/area/station/maintenance/port)
"SZ" = (
/obj/effect/turf_decal/stripes/line{
	dir = 1
	},
/obj/structure/cable,
/obj/structure/particle_accelerator/fuel_chamber{
	dir = 4
	},
/turf/open/floor/engine,
/area/station/engineering/supermatter/room)
"TG" = (
/obj/machinery/field/generator/singularity,
/obj/effect/turf_decal/bot_red,
/obj/structure/cable,
/turf/open/floor/plating,
/area/space/nearstation)
"TM" = (
/obj/structure/sign/warning/radiation,
/turf/closed/wall/r_wall,
/area/station/engineering/supermatter/room)
"UD" = (
/obj/structure/lattice/catwalk,
/obj/structure/cable,
/turf/open/space/basic,
/area/space/nearstation)
"VL" = (
/obj/machinery/light/directional/east,
/turf/open/floor/plating,
/area/station/engineering/supermatter/room)
"Xq" = (
/obj/structure/cable,
/obj/effect/turf_decal/bot_blue,
/obj/machinery/power/energy_accumulator/rad_collector,
/turf/open/floor/plating,
/area/space/nearstation)
"XD" = (
/obj/structure/closet/emcloset/anchored,
/turf/open/floor/plating,
/area/station/engineering/supermatter/room)
"XO" = (
/obj/structure/lattice/catwalk,
/turf/open/space/basic,
/area/space/nearstation)
"Yi" = (
/obj/machinery/field/generator/singularity,
/obj/effect/turf_decal/bot_red,
/turf/open/floor/plating,
/area/space/nearstation)
"YT" = (
/obj/effect/spawner/structure/window/reinforced/plasma,
/turf/open/floor/plating,
/area/station/engineering/supermatter/room)
"Zj" = (
/obj/structure/cable,
/turf/open/floor/plating,
/area/station/engineering/supermatter/room)
"Zq" = (
/obj/machinery/firealarm/directional/east,
/turf/open/floor/iron/dark,
/area/station/engineering/supermatter/room)

(1,1,1) = {"
Ri
Ri
Ri
Ri
Ri
qy
Ri
Ri
Ri
Ri
Ri
Ri
Ri
Ri
Ri
qy
Ri
Ri
Ri
Ri
LV
"}
(2,1,1) = {"
Ri
Ll
wh
wh
wh
wh
wh
wh
wh
wh
wh
wh
wh
wh
wh
wh
wh
wh
wh
Ll
LV
"}
(3,1,1) = {"
qy
Ll
PY
nk
Ew
Ew
nS
Yi
XO
XO
GV
XO
XO
Yi
nS
Ew
Ew
Ew
RM
Ll
wE
"}
(4,1,1) = {"
Ri
Ll
wh
LP
LP
Ll
Xq
XO
LP
LP
GV
LP
LP
XO
Xq
Ll
LP
LP
wh
Ll
LV
"}
(5,1,1) = {"
Ri
Ll
wh
LP
LP
Ll
wh
XO
LP
LP
GV
LP
LP
XO
wh
Ll
LP
LP
wh
Ll
LV
"}
(6,1,1) = {"
Ri
wU
wh
Ll
Ll
Ll
Xq
GV
GV
GV
Pz
GV
GV
GV
Xq
Ll
Ll
Ll
wh
yW
LV
"}
(7,1,1) = {"
Ri
Ll
wh
LP
LP
Ll
wh
XO
LP
LP
GV
LP
LP
XO
wh
Ll
LP
LP
wh
Ll
LV
"}
(8,1,1) = {"
Ri
Ll
wh
LP
LP
Ll
Xq
XO
LP
LP
GV
LP
LP
XO
Xq
Ll
LP
LP
wh
Ll
LV
"}
(9,1,1) = {"
Ri
Ll
PY
Ew
Ew
Ew
Gh
TG
UD
UD
wh
UD
UD
TG
Gh
nk
FX
az
no
YT
dr
"}
(10,1,1) = {"
Ri
Ll
wh
wh
wh
Ll
GV
Ll
Ll
Ll
Ll
Ll
Ll
Ll
wh
wh
GV
dr
kV
kV
Em
"}
(11,1,1) = {"
dr
YT
YT
dr
lg
dr
dr
YT
YT
YT
YT
YT
YT
YT
dr
lg
dr
dr
kV
kV
dr
"}
(12,1,1) = {"
dr
Hp
Hp
dr
hh
XD
dr
oE
tm
QE
QE
QE
wz
RD
dr
hh
dr
nq
kV
kV
Pa
"}
(13,1,1) = {"
dr
nq
kV
TM
JD
dr
dr
BI
BI
ha
nL
zo
BI
BI
dr
JD
TM
kV
kV
Ar
Pa
"}
(14,1,1) = {"
dr
kV
kV
kV
QC
AP
ac
BI
BI
SZ
rQ
dp
BI
BI
Cu
xV
kV
kV
dr
oV
SL
"}
(15,1,1) = {"
TM
kV
kV
kV
QC
hD
ac
BI
BI
Aa
rQ
Cq
fa
BI
ac
xV
kV
kV
YT
Lb
jp
"}
(16,1,1) = {"
dr
kV
kV
kV
QC
xF
zM
qu
Zj
ys
IX
eP
BI
VL
ac
xV
kV
kV
YT
Hs
DG
"}
(17,1,1) = {"
dr
nq
kV
kV
QC
Ar
dr
dr
ac
ac
ac
ac
ac
dr
dr
QC
kV
kV
YT
lU
vP
"}
(18,1,1) = {"
dr
aZ
Be
QC
QC
kV
vu
Zq
NW
kx
kx
te
te
QC
PO
Be
kV
NN
jb
Sa
Sa
"}
(19,1,1) = {"
dr
xR
OL
YT
YT
YT
dr
dr
dr
TM
YT
mF
YT
TM
dr
dr
dr
YT
dr
dr
IM
"}
