//MAP CONVERTED BY dmm2tgm.py THIS HEADER COMMENT PREVENTS RECONVERSION, DO NOT REMOVE
"aa" = (
/obj/machinery/door/airlock/maintenance,
/obj/effect/mapping_helpers/airlock/access/all/engineering/maintenance,
/turf/open/floor/plating/nitrogen,
/area/station/security/range)
"aS" = (
/obj/machinery/space_heater,
/obj/effect/turf_decal/delivery,
/obj/effect/decal/cleanable/dirt,
/obj/structure/sign/poster/contraband/random/directional/north,
/turf/open/floor/plating/nitrogen,
/area/station/security/range)
"aT" = (
/obj/effect/decal/cleanable/dirt,
/obj/structure/closet/emcloset{
	name = "plasmaperson emergency closet"
	},
/obj/item/clothing/under/plasmaman,
/obj/item/clothing/under/plasmaman,
/obj/item/clothing/head/helmet/space/plasmaman,
/obj/item/clothing/head/helmet/space/plasmaman,
/obj/item/tank/internals/plasmaman/belt/full,
/obj/item/tank/internals/plasmaman/belt/full,
/obj/effect/decal/cleanable/dirt,
/obj/effect/turf_decal/bot,
/obj/effect/mapping_helpers/broken_floor,
/turf/open/floor/plating/nitrogen,
/area/station/security/range)
"bd" = (
/obj/machinery/computer/security{
	dir = 4;
	network = list("shoothouse");
	name = "shoothouse monitor"
	},
/obj/effect/turf_decal/stripes/line{
	dir = 4
	},
/turf/open/floor/iron/dark/nitrogen,
/area/station/security/range)
"bn" = (
/obj/effect/decal/cleanable/dirt,
/obj/structure/closet/crate,
/obj/item/clothing/suit/hazardvest,
/obj/item/clothing/suit/hazardvest,
/obj/structure/sign/poster/contraband/random/directional/west,
/turf/open/floor/plating/nitrogen,
/area/station/security/range)
"bG" = (
/turf/closed/wall,
/area/station/security/range)
"cq" = (
/obj/effect/decal/cleanable/dirt,
/obj/structure/trash_pile,
/turf/open/floor/plating/nitrogen,
/area/station/security/range)
"cv" = (
/obj/effect/decal/cleanable/dirt,
/obj/effect/decal/cleanable/dirt,
/obj/structure/closet/cardboard,
/obj/effect/spawner/random/maintenance,
/turf/open/floor/plating/nitrogen,
/area/station/security/range)
"eb" = (
/obj/effect/decal/cleanable/dirt,
/obj/machinery/power/apc/auto_name/directional/north,
/obj/structure/cable,
/turf/open/floor/plating/nitrogen,
/area/station/security/range)
"eO" = (
/obj/effect/decal/cleanable/dirt,
/obj/structure/rack,
/obj/effect/turf_decal/bot,
/obj/item/storage/box/lights/mixed,
/turf/open/floor/plating/nitrogen,
/area/station/security/range)
"gg" = (
/obj/effect/spawner/structure/window/reinforced,
/turf/open/floor/plating/nitrogen,
/area/station/security/range)
"hW" = (
/obj/machinery/door/airlock/maintenance,
/obj/effect/mapping_helpers/airlock/access/all/engineering/engine_equipment,
/obj/structure/disposalpipe/segment,
/obj/effect/decal/cleanable/dirt,
/turf/open/floor/plating/nitrogen,
/area/station/security/range)
"ia" = (
/obj/effect/mapping_helpers/airlock/access/all/engineering/engine_equipment,
/obj/structure/barricade/wooden,
/obj/machinery/door/airlock/maintenance_hatch,
/turf/open/floor/plating/nitrogen,
/area/station/security/range)
"iB" = (
/obj/machinery/light/small/directional/east,
/obj/effect/decal/cleanable/dirt,
/turf/open/floor/plating/nitrogen,
/area/station/security/range)
"jw" = (
/obj/effect/decal/cleanable/dirt,
/obj/structure/rack,
/obj/effect/turf_decal/bot,
/obj/effect/spawner/random/decoration/glowstick,
/turf/open/floor/plating/nitrogen,
/area/station/security/range)
"jY" = (
/obj/item/trash/cnds,
/obj/effect/decal/cleanable/dirt,
/obj/structure/cable,
/turf/open/floor/plating/nitrogen,
/area/station/security/range)
"kC" = (
/obj/structure/disposalpipe/segment{
	dir = 4
	},
/obj/effect/decal/cleanable/dirt,
/turf/open/floor/plating/nitrogen,
/area/station/security/range)
"kE" = (
/obj/effect/spawner/random/trash/mess,
/obj/effect/decal/cleanable/dirt,
/obj/structure/cable,
/turf/open/floor/plating/nitrogen,
/area/station/security/range)
"kH" = (
/obj/structure/disposalpipe/junction/flip,
/obj/effect/decal/cleanable/dirt,
/turf/open/floor/plating/nitrogen,
/area/station/security/range)
"ld" = (
/obj/effect/decal/cleanable/dirt,
/obj/effect/turf_decal/delivery,
/obj/machinery/space_heater,
/turf/open/floor/plating/nitrogen,
/area/station/security/range)
"lB" = (
/obj/effect/decal/cleanable/dirt,
/obj/effect/decal/cleanable/dirt,
/obj/structure/closet/crate{
	icon_state = "crateopen"
	},
/obj/item/toy/plush/lizard_plushie/green{
	name = "Takes-No-Prisoners"
	},
/obj/item/toy/gun{
	pixel_x = 13;
	pixel_y = -2
	},
/turf/open/floor/plating/nitrogen,
/area/station/security/range)
"lR" = (
/obj/machinery/door/airlock/maintenance,
/obj/effect/mapping_helpers/airlock/access/all/engineering/maintenance,
/obj/effect/decal/cleanable/dirt,
/turf/open/floor/plating/nitrogen,
/area/station/security/range)
"lV" = (
/obj/structure/disposalpipe/segment{
	dir = 10
	},
/obj/effect/decal/cleanable/dirt,
/turf/open/floor/plating/nitrogen,
/area/station/security/range)
"mi" = (
/obj/effect/decal/cleanable/dirt,
/turf/open/floor/plating/nitrogen,
/area/station/security/range)
"mu" = (
/obj/structure/table,
/obj/machinery/recharger{
	pixel_x = -6;
	pixel_y = 2
	},
/obj/machinery/recharger{
	pixel_x = 6;
	pixel_y = 2
	},
/obj/effect/turf_decal/stripes/line{
	dir = 4
	},
/turf/open/floor/iron/dark/nitrogen,
/area/station/security/range)
"nV" = (
/obj/modular_map_connector{
	dir = 4
	},
/obj/structure/cable,
/turf/closed/wall,
/area/station/security/range)
"pa" = (
/obj/structure/disposalpipe/segment{
	dir = 9
	},
/obj/effect/decal/cleanable/dirt,
/obj/structure/cable,
/turf/open/floor/plating/nitrogen,
/area/station/security/range)
"ts" = (
/obj/structure/disposalpipe/segment,
/obj/effect/spawner/random/trash/mess,
/obj/effect/decal/cleanable/dirt,
/turf/open/floor/plating/nitrogen,
/area/station/security/range)
"wn" = (
/obj/structure/training_machine,
/obj/structure/training_machine,
/obj/structure/rack,
/obj/effect/turf_decal/stripes/line{
	dir = 4
	},
/turf/open/floor/iron/dark/nitrogen,
/area/station/security/range)
"wK" = (
/obj/structure/lattice/catwalk,
/obj/effect/decal/cleanable/dirt,
/obj/structure/cable,
/turf/open/floor/plating/nitrogen,
/area/station/security/range)
"yg" = (
/obj/effect/decal/cleanable/dirt,
/obj/effect/decal/cleanable/dirt,
/obj/machinery/portable_atmospherics/scrubber,
/obj/effect/turf_decal/delivery,
/turf/open/floor/plating/nitrogen,
/area/station/security/range)
"AI" = (
/obj/structure/grille,
/obj/structure/window{
	dir = 1
	},
/turf/open/floor/plating/nitrogen,
/area/station/security/range)
"AP" = (
/obj/effect/turf_decal/stripes/line{
	dir = 4
	},
/turf/open/floor/iron/dark/nitrogen,
/area/station/security/range)
"Bq" = (
/obj/structure/grille,
/obj/structure/window{
	dir = 8
	},
/obj/structure/window,
/turf/open/floor/plating/nitrogen,
/area/station/security/range)
"Eo" = (
/obj/structure/girder/displaced,
/turf/open/floor/plating/nitrogen,
/area/station/security/range)
"Fz" = (
/obj/structure/grille,
/obj/structure/window{
	dir = 8
	},
/turf/open/floor/plating/nitrogen,
/area/station/security/range)
"Ho" = (
/obj/machinery/door/airlock/engineering{
	name = "Power Access Hatch"
	},
/obj/effect/mapping_helpers/airlock/access/all/engineering/engine_equipment,
/obj/effect/decal/cleanable/dirt,
/turf/open/floor/plating/nitrogen,
/area/station/security/range)
"Iv" = (
/obj/effect/decal/cleanable/dirt,
/obj/structure/closet/cardboard,
/obj/effect/spawner/random/maintenance,
/turf/open/floor/plating{
	initial_gas_mix = "n2=104;TEMP=293.15"
	},
/area/station/security/range)
"Jd" = (
/obj/structure/disposalpipe/segment{
	dir = 4
	},
/obj/effect/decal/cleanable/dirt,
/obj/structure/cable,
/turf/open/floor/plating/nitrogen,
/area/station/security/range)
"JN" = (
/obj/effect/spawner/random/trash/grille_or_waste,
/obj/effect/decal/cleanable/dirt,
/turf/open/floor/plating/nitrogen,
/area/station/security/range)
"JR" = (
/obj/structure/grille/broken,
/obj/effect/decal/cleanable/dirt,
/obj/structure/cable,
/turf/open/floor/plating/nitrogen,
/area/station/security/range)
"Lf" = (
/obj/effect/decal/cleanable/dirt,
/obj/effect/decal/cleanable/dirt,
/obj/structure/rack,
/obj/effect/turf_decal/bot,
/obj/item/screwdriver,
/obj/effect/spawner/random/decoration/glowstick,
/turf/open/floor/plating/nitrogen,
/area/station/security/range)
"LO" = (
/obj/effect/decal/cleanable/dirt,
/obj/machinery/disposal/bin,
/obj/effect/turf_decal/delivery,
/obj/machinery/camera/xray/directional/east{
	c_tag = "Security - Shoot house";
	network = list("ss13","shoothouse")
	},
/turf/open/floor/plating/nitrogen,
/area/station/security/range)
"Mx" = (
/obj/effect/spawner/random/trash/mess,
/obj/effect/decal/cleanable/dirt,
/turf/open/floor/plating/nitrogen,
/area/station/security/range)
"MR" = (
/obj/structure/cable,
/turf/closed/wall,
/area/station/security/range)
"Oa" = (
/obj/structure/closet/crate/secure{
	desc = "A secure crate containing various materials for building a customised test-site.";
	name = "Firing Range Gear Crate";
	req_access = list("security")
	},
/obj/item/target,
/obj/item/target,
/obj/item/target/alien,
/obj/item/target/alien,
/obj/item/target/clown,
/obj/item/target/clown,
/obj/item/target/syndicate,
/obj/item/target/syndicate,
/obj/effect/turf_decal/stripes/line{
	dir = 4
	},
/turf/open/floor/iron/dark/nitrogen,
/area/station/security/range)
"Op" = (
/obj/effect/decal/cleanable/dirt,
/obj/item/trash/peanuts,
/obj/effect/mapping_helpers/broken_floor,
/turf/open/floor/plating/nitrogen,
/area/station/security/range)
"Oq" = (
/obj/effect/turf_decal/bot,
/obj/structure/rack,
/obj/item/storage/backpack/satchel/eng,
/obj/item/wirecutters,
/turf/open/floor/plating/nitrogen,
/area/station/security/range)
"Ry" = (
/obj/effect/spawner/random/structure/crate,
/obj/effect/decal/cleanable/dirt,
/obj/machinery/light/small/directional/east,
/turf/open/floor/plating/nitrogen,
/area/station/security/range)
"RP" = (
/obj/effect/spawner/random/trash/grille_or_waste,
/turf/open/floor/plating/nitrogen,
/area/station/security/range)
"RS" = (
/obj/effect/turf_decal/bot,
/obj/effect/decal/cleanable/dirt,
/obj/structure/closet,
/obj/effect/spawner/random/maintenance,
/obj/structure/disposalpipe/segment,
/turf/open/floor/plating/nitrogen,
/area/station/security/range)
"Su" = (
/obj/machinery/door/airlock/maintenance{
	name = "Abandoned Art Studio"
	},
/obj/effect/mapping_helpers/airlock/abandoned,
/obj/effect/decal/cleanable/dirt,
/turf/open/floor/plating/nitrogen,
/area/station/security/range)
"SN" = (
/obj/structure/disposalpipe/segment{
	dir = 4
	},
/obj/item/trash/cheesie,
/obj/effect/decal/cleanable/dirt,
/turf/open/floor/plating/nitrogen,
/area/station/security/range)
"Ul" = (
/obj/structure/barricade/wooden,
/obj/machinery/door/airlock/maintenance_hatch,
/obj/structure/cable,
/turf/open/floor/plating/nitrogen,
/area/station/security/range)
"Vb" = (
/obj/structure/disposalpipe/segment,
/obj/effect/decal/cleanable/dirt,
/turf/open/floor/plating/nitrogen,
/area/station/security/range)
"Ve" = (
/obj/structure/disposalpipe/segment{
	dir = 6
	},
/obj/effect/decal/cleanable/dirt,
/obj/structure/cable,
/turf/open/floor/plating/nitrogen,
/area/station/security/range)
"Vy" = (
/obj/structure/grille,
/obj/structure/window{
	dir = 4
	},
/turf/open/floor/plating/nitrogen,
/area/station/security/range)
"Wr" = (
/obj/effect/decal/cleanable/dirt,
/obj/structure/cable,
/turf/open/floor/plating/nitrogen,
/area/station/security/range)
"WT" = (
/obj/structure/rack,
/obj/item/gun/energy/laser/practice{
	pixel_x = 2;
	pixel_y = -2
	},
/obj/item/gun/energy/laser/practice{
	pixel_x = 2;
	pixel_y = 1
	},
/obj/item/gun/energy/laser/practice{
	pixel_x = 2;
	pixel_y = 5
	},
/obj/effect/turf_decal/stripes/line{
	dir = 4
	},
/turf/open/floor/iron/dark/nitrogen,
/area/station/security/range)

(1,1,1) = {"
bG
MR
MR
MR
MR
MR
MR
MR
MR
MR
MR
MR
MR
MR
nV
MR
"}
(2,1,1) = {"
bG
bn
iB
Ho
SN
Eo
bG
mi
mi
cq
cv
bG
Ul
bG
Vy
Vy
"}
(3,1,1) = {"
bG
bG
bG
bG
kC
Mx
bG
Su
gg
gg
gg
bG
eb
Ve
Vb
RS
"}
(4,1,1) = {"
bG
Wr
lR
mi
kC
mi
RP
mi
Op
yg
lB
bG
bG
Jd
mi
mi
"}
(5,1,1) = {"
bG
Wr
bG
aS
lV
Vb
ts
Vb
kH
Vb
Vb
hW
Vb
pa
kE
mi
"}
(6,1,1) = {"
bG
wK
bG
bG
bG
bG
bG
LO
Ry
Lf
eO
bG
Fz
Bq
Wr
ia
"}
(7,1,1) = {"
bG
wK
cq
jw
aT
ld
bG
bG
bG
bG
bG
bG
Iv
Wr
jY
bG
"}
(8,1,1) = {"
bG
wK
Wr
Wr
Wr
Wr
Wr
Wr
JR
Wr
AI
bG
bG
Wr
JN
bG
"}
(9,1,1) = {"
bG
bG
bG
bG
bG
bG
aa
bG
bG
Wr
Wr
Wr
Wr
Wr
Oq
bG
"}
(10,1,1) = {"
bG
wn
Oa
mu
WT
WT
AP
bd
bG
bG
bG
bG
bG
bG
bG
bG
"}
