//MAP CONVERTED BY dmm2tgm.py THIS HEADER COMMENT PREVENTS RECONVERSION, DO NOT REMOVE
"a" = (
/obj/effect/spawner/structure/window/reinforced,
/obj/structure/cable,
/turf/open/floor/plating/nitrogen,
/area/station/security/range)
"b" = (
/obj/effect/turf_decal/trimline/red/filled/line{
	dir = 4
	},
/obj/structure/cable,
/turf/open/floor/iron/dark/nitrogen,
/area/station/security/range)
"c" = (
/obj/structure/table,
/obj/item/wirecutters,
/obj/item/multitool{
	pixel_x = 4;
	pixel_y = 12
	},
/obj/item/screwdriver{
	pixel_x = -2;
	pixel_y = 10
	},
/obj/machinery/syndicatebomb/training,
/turf/open/floor/iron/nitrogen,
/area/station/security/range)
"d" = (
/obj/effect/turf_decal/trimline/red/filled/corner{
	dir = 4
	},
/obj/structure/cable,
/turf/open/floor/iron/dark/nitrogen,
/area/station/security/range)
"e" = (
/obj/structure/table,
/obj/item/paper_bin,
/obj/effect/spawner/random/bureaucracy/pen,
/turf/open/floor/iron/dark/nitrogen,
/area/station/security/range)
"f" = (
/obj/effect/turf_decal/trimline/red/filled/line{
	dir = 1
	},
/turf/open/floor/iron/dark/nitrogen,
/area/station/security/range)
"g" = (
/obj/item/target/clown,
/obj/effect/turf_decal/trimline/red/filled/corner,
/turf/open/floor/iron/dark/nitrogen,
/area/station/security/range)
"h" = (
/obj/machinery/holopad/secure,
/obj/effect/turf_decal/bot,
/turf/open/floor/iron/nitrogen,
/area/station/security/range)
"i" = (
/obj/structure/chair/office{
	dir = 1
	},
/obj/item/toy/plush/nukeplushie,
/obj/item/clothing/mask/fakemoustache/italian,
/turf/open/floor/iron/nitrogen,
/area/station/security/range)
"j" = (
/obj/machinery/light/directional/east,
/obj/effect/turf_decal/trimline/red/filled/line{
	dir = 8
	},
/obj/structure/cable,
/turf/open/floor/iron/dark/nitrogen,
/area/station/security/range)
"k" = (
/obj/structure/table,
/obj/item/book/manual/wiki/security_space_law{
	pixel_y = 4
	},
/turf/open/floor/iron/nitrogen,
/area/station/security/range)
"l" = (
/obj/machinery/light/directional/east,
/turf/open/floor/iron/dark/nitrogen,
/area/station/security/range)
"m" = (
/obj/effect/turf_decal/trimline/red/filled/corner{
	dir = 1
	},
/obj/structure/cable,
/turf/open/floor/iron/dark/nitrogen,
/area/station/security/range)
"o" = (
/obj/structure/chair/office{
	dir = 1
	},
/turf/open/floor/iron/nitrogen,
/area/station/security/range)
"p" = (
/obj/structure/table,
/obj/item/restraints/handcuffs,
/obj/item/reagent_containers/spray/pepper,
/turf/open/floor/iron/nitrogen,
/area/station/security/range)
"q" = (
/obj/effect/turf_decal/trimline/red/filled/line{
	dir = 8
	},
/turf/open/floor/iron/dark/nitrogen,
/area/station/security/range)
"r" = (
/obj/structure/table,
/obj/item/book/manual/wiki/security_space_law{
	pixel_x = -3;
	pixel_y = 5
	},
/turf/open/floor/iron/nitrogen,
/area/station/security/range)
"s" = (
/obj/effect/turf_decal/trimline/red/filled/line{
	dir = 8
	},
/obj/structure/cable,
/obj/structure/sign/poster/official/random/directional/east,
/turf/open/floor/iron/dark/nitrogen,
/area/station/security/range)
"t" = (
/obj/structure/table,
/obj/item/book/fish_catalog,
/obj/item/book/manual/wiki/security_space_law{
	pixel_y = 4
	},
/turf/open/floor/iron/nitrogen,
/area/station/security/range)
"u" = (
/obj/effect/turf_decal/trimline/red/filled/corner,
/turf/open/floor/iron/dark/nitrogen,
/area/station/security/range)
"v" = (
/turf/open/floor/iron/dark/nitrogen,
/area/station/security/range)
"w" = (
/obj/structure/table,
/obj/item/book/manual/wiki/security_space_law,
/turf/open/floor/iron/nitrogen,
/area/station/security/range)
"x" = (
/obj/structure/cable,
/turf/open/floor/iron/dark/nitrogen,
/area/station/security/range)
"z" = (
/obj/structure/cable,
/obj/modular_map_connector{
	dir = 4
	},
/turf/open/floor/iron/dark/nitrogen,
/area/station/security/range)
"A" = (
/obj/effect/turf_decal/trimline/red/filled/line{
	dir = 6
	},
/turf/open/floor/iron/dark/nitrogen,
/area/station/security/range)
"C" = (
/obj/structure/table,
/obj/item/folder/red{
	pixel_x = -2;
	pixel_y = 2
	},
/obj/item/pen{
	pixel_y = 4
	},
/turf/open/floor/iron/nitrogen,
/area/station/security/range)
"D" = (
/obj/structure/sign/poster/official/help_others{
	pixel_x = -32
	},
/obj/structure/reagent_dispensers/water_cooler,
/turf/open/floor/iron/dark/nitrogen,
/area/station/security/range)
"E" = (
/obj/effect/turf_decal/trimline/red/filled/line,
/turf/open/floor/iron/dark/nitrogen,
/area/station/security/range)
"F" = (
/obj/machinery/power/apc/auto_name/directional/south,
/obj/structure/cable,
/turf/open/floor/iron/dark/nitrogen,
/area/station/security/range)
"G" = (
/turf/open/floor/iron/nitrogen,
/area/station/security/range)
"H" = (
/obj/structure/table,
/turf/open/floor/iron/nitrogen,
/area/station/security/range)
"I" = (
/obj/structure/table,
/obj/item/book/manual/wiki/security_space_law{
	pixel_x = 5;
	pixel_y = 2
	},
/turf/open/floor/iron/nitrogen,
/area/station/security/range)
"J" = (
/obj/effect/turf_decal/trimline/red/filled/line{
	dir = 10
	},
/turf/open/floor/iron/dark/nitrogen,
/area/station/security/range)
"K" = (
/obj/effect/turf_decal/trimline/red/filled/line{
	dir = 4
	},
/turf/open/floor/iron/dark/nitrogen,
/area/station/security/range)
"M" = (
/turf/closed/wall,
/area/station/security/range)
"N" = (
/obj/effect/turf_decal/trimline/red/filled/line{
	dir = 4
	},
/obj/structure/sign/poster/official/random/directional/west,
/obj/structure/cable,
/turf/open/floor/iron/dark/nitrogen,
/area/station/security/range)
"O" = (
/obj/structure/table,
/obj/item/melee/baton/security/loaded,
/obj/item/assembly/flash/handheld{
	pixel_x = -6
	},
/turf/open/floor/iron/nitrogen,
/area/station/security/range)
"P" = (
/obj/structure/table,
/obj/item/storage/fancy/donut_box,
/turf/open/floor/iron/dark/nitrogen,
/area/station/security/range)
"Q" = (
/obj/machinery/light/directional/west,
/obj/effect/turf_decal/trimline/red/filled/line{
	dir = 4
	},
/obj/structure/cable,
/turf/open/floor/iron/dark/nitrogen,
/area/station/security/range)
"R" = (
/obj/effect/turf_decal/trimline/red/filled/line,
/obj/machinery/status_display/evac/directional/north,
/turf/open/floor/iron/dark/nitrogen,
/area/station/security/range)
"S" = (
/obj/effect/turf_decal/trimline/red/filled/line{
	dir = 8
	},
/obj/structure/cable,
/turf/open/floor/iron/dark/nitrogen,
/area/station/security/range)
"T" = (
/obj/effect/turf_decal/trimline/red/filled/corner{
	dir = 8
	},
/turf/open/floor/iron/dark/nitrogen,
/area/station/security/range)
"V" = (
/obj/item/target,
/obj/machinery/light/directional/west,
/turf/open/floor/iron/dark/nitrogen,
/area/station/security/range)
"W" = (
/obj/structure/table,
/obj/item/folder/red{
	pixel_y = 3
	},
/obj/item/pen{
	pixel_y = 4
	},
/turf/open/floor/iron/nitrogen,
/area/station/security/range)
"Y" = (
/obj/structure/table,
/obj/item/book/manual/wiki/security_space_law{
	pixel_x = 3;
	pixel_y = 3
	},
/turf/open/floor/iron/nitrogen,
/area/station/security/range)

(1,1,1) = {"
M
M
a
a
a
M
M
M
M
a
a
a
M
v
z
M
"}
(2,1,1) = {"
M
V
g
K
b
b
N
N
b
b
b
b
Q
d
x
D
"}
(3,1,1) = {"
M
u
A
G
G
H
o
G
r
o
G
C
o
f
x
F
"}
(4,1,1) = {"
M
E
G
c
G
I
o
G
H
o
G
w
o
f
x
v
"}
(5,1,1) = {"
M
E
G
O
G
G
G
G
G
G
G
G
G
f
x
v
"}
(6,1,1) = {"
M
R
G
p
G
G
G
G
h
G
G
G
G
f
x
v
"}
(7,1,1) = {"
M
E
G
k
G
k
o
G
W
o
G
t
o
f
x
v
"}
(8,1,1) = {"
M
T
J
G
G
H
o
G
Y
o
G
k
i
f
x
e
"}
(9,1,1) = {"
M
l
T
q
S
S
s
s
s
S
S
S
j
m
x
P
"}
(10,1,1) = {"
M
M
a
a
a
M
M
M
M
a
a
a
M
v
v
M
"}
