//MAP CONVERTED BY dmm2tgm.py THIS HEADER COMMENT PREVENTS RECONVERSION, DO NOT REMOVE
"aa" = (
/obj/machinery/door/airlock/maintenance,
/obj/effect/mapping_helpers/airlock/access/all/engineering/maintenance,
/turf/open/floor/plating/nitrogen,
/area/station/security/range)
"aS" = (
/obj/effect/spawner/random/trash/mess,
/obj/structure/cable,
/turf/open/floor/plating/nitrogen,
/area/station/security/range)
"aT" = (
/obj/effect/decal/cleanable/dirt,
/obj/structure/closet/emcloset{
	name = "plasmaperson emergency closet"
	},
/obj/item/clothing/under/plasmaman,
/obj/item/clothing/under/plasmaman,
/obj/item/clothing/head/helmet/space/plasmaman,
/obj/item/clothing/head/helmet/space/plasmaman,
/obj/item/tank/internals/plasmaman/belt/full,
/obj/item/tank/internals/plasmaman/belt/full,
/obj/effect/decal/cleanable/dirt,
/obj/effect/turf_decal/bot,
/obj/effect/mapping_helpers/broken_floor,
/turf/open/floor/plating/nitrogen,
/area/station/security/range)
"bd" = (
/obj/effect/decal/cleanable/dirt,
/obj/structure/disposalpipe/junction/flip{
	dir = 8
	},
/turf/open/floor/plating/nitrogen,
/area/station/security/range)
"bn" = (
/obj/effect/decal/cleanable/dirt,
/obj/structure/closet/crate,
/obj/item/clothing/suit/hazardvest,
/obj/item/clothing/suit/hazardvest,
/obj/item/clothing/head/hardhat,
/obj/item/clothing/head/hardhat,
/obj/structure/sign/poster/contraband/random/directional/west,
/turf/open/floor/plating/nitrogen,
/area/station/security/range)
"bG" = (
/turf/closed/wall,
/area/station/security/range)
"cq" = (
/obj/effect/decal/cleanable/dirt,
/obj/structure/trash_pile,
/turf/open/floor/plating/nitrogen,
/area/station/security/range)
"cv" = (
/obj/effect/decal/cleanable/dirt,
/obj/effect/decal/cleanable/dirt,
/obj/structure/closet/cardboard,
/obj/effect/spawner/random/maintenance,
/turf/open/floor/plating/nitrogen,
/area/station/security/range)
"cD" = (
/obj/effect/decal/cleanable/dirt,
/obj/structure/grille/broken,
/obj/structure/cable,
/obj/structure/sign/poster/contraband/random{
	pixel_y = 32
	},
/turf/open/floor/plating/nitrogen,
/area/station/security/range)
"eb" = (
/obj/structure/grille,
/obj/structure/window{
	dir = 1
	},
/obj/effect/decal/cleanable/dirt,
/turf/open/floor/plating/nitrogen,
/area/station/security/range)
"eO" = (
/obj/effect/decal/cleanable/dirt,
/obj/structure/rack,
/obj/effect/turf_decal/bot,
/obj/item/storage/box/lights/mixed,
/turf/open/floor/plating/nitrogen,
/area/station/security/range)
"fw" = (
/obj/structure/table,
/obj/machinery/recharger{
	pixel_x = -6;
	pixel_y = 2
	},
/obj/machinery/recharger{
	pixel_x = 6;
	pixel_y = 2
	},
/obj/effect/turf_decal/stripes/line,
/turf/open/floor/iron/dark/nitrogen,
/area/station/security/range)
"fY" = (
/obj/effect/decal/cleanable/dirt,
/obj/effect/decal/cleanable/dirt,
/obj/structure/cable,
/obj/structure/sign/poster/contraband/random{
	pixel_x = 32
	},
/turf/open/floor/plating/nitrogen,
/area/station/security/range)
"gg" = (
/obj/effect/decal/cleanable/dirt,
/obj/effect/decal/cleanable/dirt,
/obj/structure/cable,
/obj/structure/disposalpipe/segment{
	dir = 10
	},
/turf/open/floor/plating/nitrogen,
/area/station/security/range)
"hI" = (
/obj/effect/decal/cleanable/dirt,
/obj/structure/disposalpipe/segment{
	dir = 4
	},
/turf/open/floor/plating/nitrogen,
/area/station/security/range)
"hW" = (
/obj/effect/decal/cleanable/dirt,
/obj/effect/spawner/random/trash/grille_or_waste,
/turf/open/floor/plating/nitrogen,
/area/station/security/range)
"ia" = (
/obj/effect/decal/cleanable/dirt,
/obj/effect/decal/cleanable/dirt,
/obj/structure/girder,
/obj/structure/grille/broken,
/obj/structure/window/reinforced/tinted{
	dir = 4
	},
/obj/effect/turf_decal/stripes/line{
	dir = 4
	},
/turf/open/floor/plating{
	initial_gas_mix = "n2=104;TEMP=293.15"
	},
/area/station/security/range)
"iB" = (
/obj/structure/closet/crate/secure{
	desc = "A secure crate containing various materials for building a customised test-site.";
	name = "Firing Range Gear Crate";
	req_access = list("security")
	},
/obj/item/target,
/obj/item/target,
/obj/item/target/alien,
/obj/item/target/alien,
/obj/item/target/clown,
/obj/item/target/clown,
/obj/item/target/syndicate,
/obj/item/target/syndicate,
/obj/effect/turf_decal/stripes/line,
/turf/open/floor/iron/dark/nitrogen,
/area/station/security/range)
"js" = (
/obj/effect/decal/cleanable/dirt,
/obj/effect/spawner/random/trash/cigbutt,
/obj/structure/cable,
/obj/structure/window/reinforced/tinted{
	dir = 1
	},
/obj/effect/turf_decal/stripes/line{
	dir = 1
	},
/turf/open/floor/plating/nitrogen,
/area/station/security/range)
"jw" = (
/obj/effect/decal/cleanable/dirt,
/obj/structure/rack,
/obj/effect/turf_decal/bot,
/obj/effect/spawner/random/decoration/glowstick,
/turf/open/floor/plating/nitrogen,
/area/station/security/range)
"jY" = (
/obj/effect/spawner/random/structure/crate,
/obj/effect/decal/cleanable/dirt,
/obj/structure/cable,
/turf/open/floor/plating/nitrogen,
/area/station/security/range)
"kC" = (
/obj/effect/decal/cleanable/dirt,
/obj/effect/decal/cleanable/dirt,
/obj/effect/spawner/random/structure/crate,
/obj/machinery/light/small/directional/south,
/turf/open/floor/plating/nitrogen,
/area/station/security/range)
"kE" = (
/obj/effect/decal/cleanable/dirt,
/obj/machinery/light/small/directional/south,
/turf/open/floor/plating/nitrogen,
/area/station/security/range)
"kH" = (
/obj/effect/turf_decal/bot,
/obj/effect/decal/cleanable/dirt,
/obj/structure/closet,
/obj/effect/spawner/random/maintenance,
/turf/open/floor/plating/nitrogen,
/area/station/security/range)
"ld" = (
/obj/effect/decal/cleanable/dirt,
/obj/effect/turf_decal/delivery,
/obj/machinery/space_heater,
/turf/open/floor/plating/nitrogen,
/area/station/security/range)
"lB" = (
/obj/effect/decal/cleanable/dirt,
/obj/effect/decal/cleanable/dirt,
/obj/structure/closet/crate{
	icon_state = "crateopen"
	},
/obj/effect/spawner/random/maintenance,
/obj/item/toy/plush/lizard_plushie/green{
	name = "Takes-No-Prisoners"
	},
/obj/item/toy/gun{
	pixel_x = 13;
	pixel_y = -2
	},
/turf/open/floor/plating/nitrogen,
/area/station/security/range)
"lR" = (
/obj/effect/decal/cleanable/dirt,
/obj/effect/decal/cleanable/dirt,
/obj/structure/disposalpipe/segment{
	dir = 4
	},
/turf/open/floor/plating/nitrogen,
/area/station/security/range)
"lV" = (
/obj/effect/decal/cleanable/dirt,
/obj/structure/cable,
/obj/effect/mapping_helpers/broken_floor,
/obj/structure/window/reinforced/tinted{
	dir = 1
	},
/obj/effect/turf_decal/stripes/line{
	dir = 1
	},
/turf/open/floor/plating/nitrogen,
/area/station/security/range)
"mi" = (
/obj/effect/decal/cleanable/dirt,
/turf/open/floor/plating/nitrogen,
/area/station/security/range)
"mu" = (
/obj/effect/spawner/random/trash/mess,
/obj/effect/decal/cleanable/dirt,
/obj/effect/decal/cleanable/dirt,
/obj/structure/cable,
/obj/effect/mapping_helpers/broken_floor,
/turf/open/floor/plating/nitrogen,
/area/station/security/range)
"nV" = (
/obj/structure/grille,
/obj/structure/window{
	dir = 8
	},
/obj/effect/decal/cleanable/dirt,
/obj/structure/window/reinforced/tinted{
	dir = 4
	},
/obj/effect/turf_decal/stripes/line{
	dir = 4
	},
/turf/open/floor/plating{
	initial_gas_mix = "n2=104;TEMP=293.15"
	},
/area/station/security/range)
"ou" = (
/obj/structure/rack,
/obj/item/gun/energy/laser/redtag,
/obj/item/gun/energy/laser/redtag,
/obj/item/gun/energy/laser/redtag,
/obj/item/clothing/suit/redtag,
/obj/item/clothing/suit/redtag,
/obj/item/clothing/suit/redtag,
/obj/item/clothing/head/helmet/redtaghelm,
/obj/item/clothing/head/helmet/redtaghelm,
/obj/item/clothing/head/helmet/redtaghelm,
/obj/effect/turf_decal/stripes/line,
/turf/open/floor/iron/dark/nitrogen,
/area/station/security/range)
"pa" = (
/obj/effect/decal/cleanable/dirt,
/obj/structure/cable,
/obj/structure/sign/poster/contraband/random/directional/west,
/turf/open/floor/plating/nitrogen,
/area/station/security/range)
"pP" = (
/obj/effect/turf_decal/stripes/line,
/turf/open/floor/iron/dark/nitrogen,
/area/station/security/range)
"qU" = (
/obj/effect/decal/cleanable/dirt,
/obj/structure/grille,
/obj/structure/window{
	dir = 8
	},
/obj/structure/window/reinforced/tinted{
	dir = 4
	},
/obj/effect/turf_decal/stripes/line{
	dir = 4
	},
/turf/open/floor/plating{
	initial_gas_mix = "n2=104;TEMP=293.15"
	},
/area/station/security/range)
"rx" = (
/obj/effect/decal/cleanable/dirt,
/obj/item/trash/syndi_cakes,
/obj/structure/cable,
/turf/open/floor/plating/nitrogen,
/area/station/security/range)
"ts" = (
/obj/effect/decal/cleanable/dirt,
/obj/effect/decal/cleanable/dirt,
/obj/structure/barricade/wooden,
/obj/machinery/door/airlock/maintenance_hatch{
	name = "Maintenance Hatch"
	},
/obj/effect/mapping_helpers/airlock/abandoned,
/obj/effect/decal/cleanable/dirt,
/obj/structure/cable,
/obj/machinery/door/firedoor,
/obj/structure/window/reinforced/tinted{
	dir = 1
	},
/obj/effect/turf_decal/stripes/line{
	dir = 1
	},
/turf/open/floor/plating/nitrogen,
/area/station/security/range)
"tW" = (
/obj/machinery/door/airlock/engineering{
	name = "Power Access Hatch"
	},
/obj/effect/decal/cleanable/dirt,
/obj/structure/cable,
/obj/effect/mapping_helpers/airlock/access/all/engineering/engine_equipment,
/obj/structure/window/reinforced/tinted{
	dir = 1
	},
/obj/effect/turf_decal/stripes/line{
	dir = 1
	},
/turf/open/floor/plating/nitrogen,
/area/station/security/range)
"vt" = (
/obj/effect/decal/cleanable/dirt,
/obj/effect/spawner/random/maintenance,
/obj/structure/cable,
/turf/open/floor/plating/nitrogen,
/area/station/security/range)
"vB" = (
/obj/machinery/door/airlock/maintenance,
/obj/effect/decal/cleanable/dirt,
/obj/machinery/door/firedoor,
/obj/effect/mapping_helpers/airlock/access/all/engineering/maintenance,
/turf/open/floor/plating{
	initial_gas_mix = "n2=104;TEMP=293.15"
	},
/area/station/security/range)
"wn" = (
/obj/structure/training_machine,
/obj/structure/training_machine,
/obj/effect/turf_decal/stripes/line,
/obj/structure/rack,
/turf/open/floor/iron/dark/nitrogen,
/area/station/security/range)
"wK" = (
/obj/effect/decal/cleanable/dirt,
/obj/structure/cable,
/obj/structure/window/reinforced/tinted{
	dir = 1
	},
/obj/machinery/power/apc/auto_name/directional/west,
/obj/effect/turf_decal/stripes/line{
	dir = 9
	},
/turf/open/floor/plating/nitrogen,
/area/station/security/range)
"wX" = (
/obj/effect/decal/cleanable/dirt,
/obj/structure/disposalpipe/segment,
/obj/effect/mapping_helpers/broken_floor,
/turf/open/floor/plating/nitrogen,
/area/station/security/range)
"yg" = (
/obj/effect/decal/cleanable/dirt,
/obj/effect/decal/cleanable/dirt,
/obj/machinery/portable_atmospherics/scrubber,
/obj/effect/turf_decal/delivery,
/turf/open/floor/plating/nitrogen,
/area/station/security/range)
"AI" = (
/obj/structure/grille,
/obj/structure/window{
	dir = 1
	},
/turf/open/floor/plating/nitrogen,
/area/station/security/range)
"AP" = (
/obj/effect/mapping_helpers/airlock/abandoned,
/obj/effect/decal/cleanable/dirt,
/obj/machinery/door/airlock/maintenance{
	name = "Abandoned Art Studio"
	},
/obj/effect/turf_decal/siding/wood{
	dir = 8
	},
/obj/structure/cable,
/obj/structure/window/reinforced/tinted{
	dir = 1
	},
/obj/effect/turf_decal/stripes/line{
	dir = 1
	},
/turf/open/floor/plating/nitrogen,
/area/station/security/range)
"Bq" = (
/obj/structure/grille,
/obj/effect/decal/cleanable/dirt,
/obj/structure/window{
	dir = 4
	},
/turf/open/floor/plating/nitrogen,
/area/station/security/range)
"BW" = (
/obj/effect/decal/cleanable/dirt,
/obj/effect/decal/cleanable/dirt,
/obj/structure/cable,
/obj/structure/window/reinforced/tinted{
	dir = 1
	},
/obj/effect/turf_decal/stripes/line{
	dir = 1
	},
/turf/open/floor/plating/nitrogen,
/area/station/security/range)
"Df" = (
/obj/effect/decal/cleanable/dirt,
/obj/effect/decal/cleanable/dirt,
/obj/structure/closet,
/obj/effect/spawner/random/trash/garbage,
/obj/effect/turf_decal/bot,
/obj/structure/window/reinforced/tinted{
	dir = 4
	},
/obj/effect/turf_decal/stripes/line{
	dir = 4
	},
/turf/open/floor/plating/nitrogen,
/area/station/security/range)
"Ds" = (
/obj/effect/decal/cleanable/dirt,
/obj/effect/decal/cleanable/dirt,
/obj/effect/turf_decal/stripes/end{
	dir = 8
	},
/obj/structure/window/reinforced/tinted{
	dir = 4
	},
/obj/effect/turf_decal/stripes/line{
	dir = 4
	},
/turf/open/floor/plating/nitrogen,
/area/station/security/range)
"Eo" = (
/obj/machinery/door/airlock/maintenance,
/obj/effect/decal/cleanable/dirt,
/obj/structure/disposalpipe/segment{
	dir = 4
	},
/obj/machinery/door/firedoor,
/obj/effect/mapping_helpers/airlock/access/all/engineering/maintenance,
/turf/open/floor/plating/nitrogen,
/area/station/security/range)
"Fr" = (
/obj/effect/decal/cleanable/dirt,
/obj/structure/cable,
/obj/structure/disposalpipe/segment{
	dir = 5
	},
/turf/open/floor/plating/nitrogen,
/area/station/security/range)
"Fz" = (
/obj/effect/decal/cleanable/dirt,
/obj/item/trash/tray,
/obj/structure/cable,
/obj/effect/mapping_helpers/broken_floor,
/obj/structure/window/reinforced/tinted{
	dir = 4
	},
/obj/effect/turf_decal/stripes/line{
	dir = 4
	},
/turf/open/floor/plating/nitrogen,
/area/station/security/range)
"Ho" = (
/obj/effect/decal/cleanable/dirt,
/obj/machinery/disposal/bin,
/obj/effect/turf_decal/delivery,
/turf/open/floor/plating/nitrogen,
/area/station/security/range)
"Iv" = (
/obj/effect/decal/cleanable/dirt,
/obj/structure/closet/cardboard,
/obj/effect/spawner/random/maintenance,
/turf/open/floor/plating{
	initial_gas_mix = "n2=104;TEMP=293.15"
	},
/area/station/security/range)
"Jd" = (
/obj/effect/decal/cleanable/dirt,
/obj/effect/decal/cleanable/dirt,
/obj/item/trash/peanuts,
/obj/structure/cable,
/obj/effect/mapping_helpers/broken_floor,
/turf/open/floor/plating/nitrogen,
/area/station/security/range)
"JN" = (
/obj/structure/cable,
/obj/effect/mapping_helpers/broken_floor,
/obj/structure/window/reinforced/tinted{
	dir = 1
	},
/obj/effect/turf_decal/stripes/line{
	dir = 1
	},
/turf/open/floor/plating/nitrogen,
/area/station/security/range)
"JR" = (
/obj/effect/spawner/structure/window/reinforced,
/turf/open/floor/plating{
	initial_gas_mix = "n2=104;TEMP=293.15"
	},
/area/station/security/range)
"JU" = (
/obj/structure/grille,
/obj/structure/window{
	dir = 1
	},
/obj/structure/window{
	dir = 8
	},
/turf/open/floor/plating/nitrogen,
/area/station/security/range)
"JW" = (
/obj/effect/decal/cleanable/dirt,
/obj/effect/decal/cleanable/dirt,
/obj/structure/cable,
/obj/effect/mapping_helpers/broken_floor,
/obj/structure/window/reinforced/tinted{
	dir = 1
	},
/obj/effect/turf_decal/stripes/line{
	dir = 1
	},
/turf/open/floor/plating/nitrogen,
/area/station/security/range)
"Kb" = (
/obj/structure/girder/displaced,
/obj/effect/decal/cleanable/dirt,
/turf/open/floor/plating/nitrogen,
/area/station/security/range)
"Lf" = (
/obj/effect/decal/cleanable/dirt,
/obj/effect/decal/cleanable/dirt,
/obj/structure/rack,
/obj/effect/turf_decal/bot,
/obj/item/screwdriver,
/obj/effect/spawner/random/decoration/glowstick,
/turf/open/floor/plating/nitrogen,
/area/station/security/range)
"LO" = (
/obj/effect/decal/cleanable/dirt,
/obj/effect/decal/cleanable/dirt,
/obj/item/kirbyplants/random,
/obj/effect/mapping_helpers/broken_floor,
/turf/open/floor/plating/nitrogen,
/area/station/security/range)
"Mx" = (
/obj/effect/spawner/random/trash/mess,
/obj/effect/decal/cleanable/dirt,
/turf/open/floor/plating/nitrogen,
/area/station/security/range)
"MR" = (
/obj/structure/grille,
/obj/structure/window{
	dir = 1
	},
/obj/structure/window{
	dir = 8
	},
/obj/effect/decal/cleanable/dirt,
/turf/open/floor/plating/nitrogen,
/area/station/security/range)
"Oa" = (
/obj/effect/decal/cleanable/dirt,
/obj/effect/decal/cleanable/dirt,
/turf/open/floor/plating/nitrogen,
/area/station/security/range)
"Op" = (
/obj/effect/decal/cleanable/dirt,
/obj/item/trash/peanuts,
/obj/effect/mapping_helpers/broken_floor,
/turf/open/floor/plating/nitrogen,
/area/station/security/range)
"Oq" = (
/obj/effect/turf_decal/bot,
/obj/structure/rack,
/obj/item/storage/backpack/satchel/eng,
/obj/item/wirecutters,
/turf/open/floor/plating/nitrogen,
/area/station/security/range)
"Qw" = (
/obj/effect/decal/cleanable/dirt,
/obj/effect/spawner/random/trash/mess,
/obj/structure/disposalpipe/segment{
	dir = 4
	},
/obj/machinery/camera/xray/directional/south{
	name = "Security Camera";
	c_tag = "Security - Shoot house"
	},
/turf/open/floor/plating/nitrogen,
/area/station/security/range)
"Ry" = (
/turf/open/floor/plating/nitrogen,
/area/station/security/range)
"RP" = (
/obj/effect/decal/cleanable/dirt,
/obj/structure/cable,
/obj/structure/window/reinforced/tinted{
	dir = 1
	},
/obj/effect/turf_decal/stripes/line{
	dir = 1
	},
/turf/open/floor/plating/nitrogen,
/area/station/security/range)
"RS" = (
/obj/effect/decal/cleanable/dirt,
/obj/effect/decal/cleanable/dirt,
/obj/structure/cable,
/obj/modular_map_connector,
/obj/structure/window/reinforced/tinted{
	dir = 1
	},
/obj/effect/turf_decal/stripes/line{
	dir = 1
	},
/turf/open/floor/plating/nitrogen,
/area/station/security/range)
"Su" = (
/obj/structure/lattice/catwalk,
/obj/structure/cable,
/turf/open/floor/plating/nitrogen,
/area/station/security/range)
"SN" = (
/obj/structure/closet/crate/bin,
/obj/effect/spawner/random/trash/garbage,
/obj/item/camera_film,
/turf/open/floor/plating/nitrogen,
/area/station/security/range)
"Ul" = (
/obj/effect/decal/cleanable/dirt,
/obj/effect/decal/cleanable/dirt,
/obj/item/trash/cnds,
/obj/structure/cable,
/obj/effect/mapping_helpers/broken_floor,
/turf/open/floor/plating/nitrogen,
/area/station/security/range)
"Uz" = (
/obj/structure/rack,
/obj/item/gun/energy/laser/bluetag,
/obj/item/gun/energy/laser/bluetag,
/obj/item/gun/energy/laser/bluetag,
/obj/item/clothing/suit/bluetag,
/obj/item/clothing/suit/bluetag,
/obj/item/clothing/suit/bluetag,
/obj/item/clothing/head/helmet/bluetaghelm,
/obj/item/clothing/head/helmet/bluetaghelm,
/obj/item/clothing/head/helmet/bluetaghelm,
/obj/effect/turf_decal/stripes/line,
/turf/open/floor/iron/dark/nitrogen,
/area/station/security/range)
"Vb" = (
/turf/open/floor/plating{
	initial_gas_mix = "n2=104;TEMP=293.15"
	},
/area/station/security/range)
"Ve" = (
/obj/effect/decal/cleanable/dirt,
/obj/effect/decal/cleanable/dirt,
/obj/structure/cable,
/turf/open/floor/plating/nitrogen,
/area/station/security/range)
"Vy" = (
/obj/effect/decal/cleanable/dirt,
/obj/item/trash/cheesie,
/obj/structure/disposalpipe/segment,
/turf/open/floor/plating/nitrogen,
/area/station/security/range)
"Wr" = (
/obj/effect/decal/cleanable/dirt,
/obj/structure/cable,
/turf/open/floor/plating/nitrogen,
/area/station/security/range)
"WT" = (
/obj/effect/decal/cleanable/dirt,
/obj/effect/decal/cleanable/dirt,
/obj/structure/window/reinforced/tinted{
	dir = 4
	},
/obj/structure/window/reinforced/tinted{
	dir = 1
	},
/obj/effect/turf_decal/stripes/line{
	dir = 5
	},
/turf/open/floor/plating/nitrogen,
/area/station/security/range)
"Xg" = (
/obj/machinery/computer/security,
/obj/effect/turf_decal/stripes/line,
/turf/open/floor/iron/dark/nitrogen,
/area/station/security/range)
"XE" = (
/obj/machinery/space_heater,
/obj/effect/turf_decal/delivery,
/obj/effect/decal/cleanable/dirt,
/turf/open/floor/plating/nitrogen,
/area/station/security/range)
"XH" = (
/obj/machinery/door/airlock/maintenance_hatch{
	name = "Medbay Maintenance"
	},
/obj/effect/mapping_helpers/airlock/access/all/engineering/maintenance,
/turf/open/floor/plating/nitrogen,
/area/station/security/range)
"Yk" = (
/obj/effect/decal/cleanable/dirt,
/obj/structure/disposalpipe/segment{
	dir = 9
	},
/turf/open/floor/plating/nitrogen,
/area/station/security/range)
"Zr" = (
/obj/effect/decal/cleanable/dirt,
/obj/item/stack/sheet/cardboard,
/obj/item/storage/box/lights,
/obj/structure/cable,
/obj/structure/disposalpipe/segment,
/turf/open/floor/plating/nitrogen,
/area/station/security/range)

(1,1,1) = {"
wK
MR
kH
Ry
Ry
XH
bG
bG
bG
bG
"}
(2,1,1) = {"
RS
eb
hI
Ry
aS
Wr
Ul
Ry
Oq
bG
"}
(3,1,1) = {"
BW
bG
gg
Zr
Fr
JU
Wr
Ve
Wr
bG
"}
(4,1,1) = {"
RP
fY
rx
bG
lR
AI
Iv
bG
Wr
bG
"}
(5,1,1) = {"
ts
Vb
bG
bG
Eo
bG
bG
bG
Ve
bG
"}
(6,1,1) = {"
RP
LO
JR
lB
hI
eO
bG
Bq
mu
bG
"}
(7,1,1) = {"
JN
cv
JR
yg
hI
Lf
bG
Wr
jY
bG
"}
(8,1,1) = {"
lV
cq
JR
Op
bd
kC
bG
cD
bG
bG
"}
(9,1,1) = {"
JW
SN
JR
mi
lR
Ho
bG
vt
bG
Xg
"}
(10,1,1) = {"
AP
bG
bG
hW
Qw
bG
bG
Wr
aa
pP
"}
(11,1,1) = {"
RP
Kb
Mx
Oa
hI
bG
ld
Jd
bG
ou
"}
(12,1,1) = {"
BW
Vy
wX
wX
Yk
bG
aT
Wr
bG
Uz
"}
(13,1,1) = {"
tW
bG
bG
Oa
XE
bG
jw
Wr
bG
fw
"}
(14,1,1) = {"
BW
bn
bG
vB
bG
bG
cq
Wr
bG
iB
"}
(15,1,1) = {"
js
kE
bG
Wr
pa
Su
Su
Su
bG
wn
"}
(16,1,1) = {"
WT
Ds
bG
Fz
Df
ia
qU
nV
bG
bG
"}
