//MAP CONVERTED BY dmm2tgm.py THIS HEADER COMMENT PREVENTS RECONVERSION, DO NOT REMOVE
"a" = (
/obj/effect/spawner/structure/window/reinforced,
/obj/structure/cable,
/obj/effect/spawner/structure/window/reinforced,
/turf/open/floor/plating/nitrogen,
/area/station/security/range)
"d" = (
/obj/effect/turf_decal/stripes/line{
	dir = 6
	},
/turf/open/floor/iron/dark/nitrogen,
/area/station/security/range)
"f" = (
/obj/effect/turf_decal/stripes/line{
	dir = 8
	},
/obj/modular_map_connector{
	dir = 4
	},
/obj/structure/cable,
/turf/open/floor/iron/dark/nitrogen,
/area/station/security/range)
"i" = (
/turf/closed/wall/r_wall,
/area/station/security/range)
"l" = (
/obj/effect/turf_decal/stripes/line{
	dir = 8
	},
/obj/structure/cable,
/turf/open/floor/iron/dark/nitrogen,
/area/station/security/range)
"n" = (
/obj/effect/turf_decal/stripes/line{
	dir = 4
	},
/obj/structure/cable,
/turf/open/floor/iron/dark/nitrogen,
/area/station/security/range)
"q" = (
/obj/effect/turf_decal/stripes/line{
	dir = 10
	},
/turf/open/floor/iron/dark/nitrogen,
/area/station/security/range)
"r" = (
/obj/machinery/dish_drive/bullet,
/turf/open/floor/iron/dark/nitrogen,
/area/station/security/range)
"v" = (
/obj/machinery/light/directional/east,
/turf/open/floor/iron/dark/nitrogen,
/area/station/security/range)
"w" = (
/obj/effect/turf_decal/stripes/line{
	dir = 1
	},
/obj/effect/turf_decal/caution,
/turf/open/floor/iron/dark/nitrogen,
/area/station/security/range)
"z" = (
/obj/structure/table,
/obj/machinery/recharger{
	pixel_x = -6;
	pixel_y = 2
	},
/obj/structure/window/reinforced{
	dir = 8;
	layer = 2.9
	},
/obj/structure/window/reinforced{
	dir = 1
	},
/obj/effect/turf_decal/trimline/red/filled/line{
	dir = 9
	},
/turf/open/floor/iron/dark/nitrogen,
/area/station/security/range)
"A" = (
/obj/structure/rack,
/obj/item/clothing/suit/armor/vest/peacekeeper/brit{
	name = "range safety officer vest";
	desc = "Safety waits for no one!"
	},
/obj/item/clothing/mask/whistle,
/turf/open/floor/iron/dark/nitrogen,
/area/station/security/range)
"B" = (
/obj/structure/rack,
/obj/item/gun/energy/laser/practice{
	pixel_x = 2;
	pixel_y = -2
	},
/obj/item/gun/energy/laser/practice{
	pixel_x = 2;
	pixel_y = 1
	},
/obj/item/gun/energy/laser/practice{
	pixel_x = 2;
	pixel_y = 5
	},
/turf/open/floor/iron/dark/nitrogen,
/area/station/security/range)
"D" = (
/obj/effect/turf_decal/stripes/line{
	dir = 5
	},
/turf/open/floor/iron/dark/nitrogen,
/area/station/security/range)
"E" = (
/obj/structure/training_machine,
/obj/item/target/syndicate,
/turf/open/floor/iron/dark/nitrogen,
/area/station/security/range)
"F" = (
/obj/effect/turf_decal/trimline/red/filled/warning,
/turf/open/floor/iron/dark/nitrogen,
/area/station/security/range)
"H" = (
/obj/effect/turf_decal/trimline/red/filled/line{
	dir = 1
	},
/turf/open/floor/iron/dark/nitrogen,
/area/station/security/range)
"I" = (
/obj/machinery/holopad/secure,
/obj/effect/turf_decal/bot,
/turf/open/floor/iron/dark/nitrogen,
/area/station/security/range)
"J" = (
/obj/structure/closet/crate/secure{
	desc = "A secure crate containing various materials for building a customised test-site.";
	name = "Firing Range Gear Crate";
	req_access = list("security")
	},
/obj/item/target,
/obj/item/target,
/obj/item/target/alien,
/obj/item/target/alien,
/obj/item/target/clown,
/obj/item/target/clown,
/obj/item/target/syndicate,
/obj/item/target/syndicate,
/turf/open/floor/iron/dark/nitrogen,
/area/station/security/range)
"K" = (
/obj/structure/cable,
/turf/open/floor/iron/dark/nitrogen,
/area/station/security/range)
"M" = (
/turf/open/floor/iron/dark/nitrogen,
/area/station/security/range)
"N" = (
/obj/machinery/power/apc/auto_name/directional/south,
/obj/structure/cable,
/turf/open/floor/iron/dark/nitrogen,
/area/station/security/range)
"O" = (
/obj/machinery/ammo_workbench,
/obj/machinery/light/directional/south,
/turf/open/floor/iron/dark/nitrogen,
/area/station/security/range)
"Q" = (
/obj/machinery/light/directional/west,
/turf/open/floor/iron/dark/nitrogen,
/area/station/security/range)
"S" = (
/obj/structure/training_machine,
/obj/structure/training_machine,
/obj/structure/rack,
/obj/machinery/light/directional/south,
/turf/open/floor/iron/dark/nitrogen,
/area/station/security/range)
"U" = (
/obj/structure/table,
/obj/machinery/recharger{
	pixel_x = -6;
	pixel_y = 2
	},
/obj/machinery/recharger{
	pixel_x = 6;
	pixel_y = 2
	},
/turf/open/floor/iron/dark/nitrogen,
/area/station/security/range)
"W" = (
/obj/effect/turf_decal/stripes/line{
	dir = 9
	},
/turf/open/floor/iron/dark/nitrogen,
/area/station/security/range)
"Z" = (
/obj/structure/table,
/obj/item/clothing/ears/earmuffs{
	pixel_x = -3;
	pixel_y = -2
	},
/obj/item/clothing/ears/earmuffs{
	pixel_y = 7
	},
/obj/structure/window/reinforced{
	dir = 4
	},
/obj/structure/window/reinforced{
	dir = 1
	},
/obj/effect/turf_decal/trimline/red/filled/line{
	dir = 5
	},
/turf/open/floor/iron/dark/nitrogen,
/area/station/security/range)

(1,1,1) = {"
i
i
i
i
i
i
i
i
a
a
a
a
a
l
f
a
"}
(2,1,1) = {"
i
W
Q
q
M
M
Q
M
M
M
z
F
M
M
K
O
"}
(3,1,1) = {"
i
M
E
M
M
M
M
M
M
M
H
F
M
M
K
B
"}
(4,1,1) = {"
i
D
M
d
M
M
M
M
M
M
Z
F
M
M
K
A
"}
(5,1,1) = {"
i
M
M
M
M
M
M
M
M
M
w
F
M
M
K
r
"}
(6,1,1) = {"
i
M
M
M
M
M
M
M
M
M
w
F
I
M
K
N
"}
(7,1,1) = {"
i
W
M
q
M
M
M
M
M
M
z
F
M
M
K
U
"}
(8,1,1) = {"
i
M
E
M
M
M
M
M
M
M
H
F
M
M
K
J
"}
(9,1,1) = {"
i
D
v
d
M
M
v
M
M
M
Z
F
M
M
K
S
"}
(10,1,1) = {"
i
i
i
i
i
i
i
i
a
a
a
a
a
n
n
a
"}
