//MAP CONVERTED BY dmm2tgm.py THIS HEADER COMMENT PREVENTS RECONVERSION, DO NOT REMOVE
"ag" = (
/obj/machinery/light/directional/east,
/turf/open/floor/iron/dark/nitrogen,
/area/station/security/range)
"aO" = (
/obj/effect/turf_decal/stripes/line{
	dir = 10
	},
/obj/structure/cable,
/turf/open/floor/plating/nitrogen,
/area/station/security/range)
"eb" = (
/obj/machinery/door/airlock/maintenance,
/obj/effect/mapping_helpers/airlock/access/any/security/maintenance,
/turf/open/floor/plating/nitrogen,
/area/station/security/range)
"eN" = (
/obj/structure/table/wood,
/obj/item/radio/intercom/directional/south,
/turf/open/floor/iron/dark/nitrogen,
/area/station/security/range)
"eT" = (
/obj/structure/window/reinforced,
/obj/structure/table/wood,
/obj/machinery/recharger,
/obj/machinery/power/apc/auto_name/directional/east,
/obj/structure/cable,
/turf/open/floor/iron/dark/nitrogen,
/area/station/security/range)
"fk" = (
/obj/item/kirbyplants/random,
/obj/machinery/airalarm/Nitrogen_Atmosphere{
	dir = 4;
	name = "east";
	pixel_x = 24
	},
/turf/open/floor/iron/dark/nitrogen,
/area/station/security/range)
"gy" = (
/obj/machinery/door/airlock/command{
	name = "Emergency Escape"
	},
/obj/effect/mapping_helpers/airlock/access/all/security/armory,
/turf/open/floor/iron/dark/nitrogen,
/area/station/security/range)
"gW" = (
/obj/structure/toilet{
	dir = 4
	},
/obj/machinery/light/directional/south,
/turf/open/floor/iron/nitrogen,
/area/station/security/range)
"hp" = (
/obj/machinery/door/airlock/command{
	name = "Captain's Quarters"
	},
/obj/effect/mapping_helpers/airlock/access/all/security/armory,
/obj/structure/cable,
/turf/open/floor/iron/dark/nitrogen,
/area/station/security/range)
"hJ" = (
/obj/structure/window/reinforced,
/obj/structure/table/wood,
/obj/item/flashlight/lamp/green,
/turf/open/floor/iron/dark/nitrogen,
/area/station/security/range)
"iu" = (
/obj/effect/turf_decal/stripes/line{
	dir = 9
	},
/turf/open/floor/plating/nitrogen,
/area/station/security/range)
"iY" = (
/turf/open/floor/plating/nitrogen,
/area/station/security/range)
"lp" = (
/obj/effect/turf_decal/stripes/line{
	dir = 8
	},
/turf/open/floor/plating/nitrogen,
/area/station/security/range)
"lS" = (
/obj/structure/filingcabinet/security,
/turf/open/floor/iron/dark/nitrogen,
/area/station/security/range)
"mg" = (
/obj/machinery/status_display/evac/directional/north,
/obj/machinery/light/directional/north,
/obj/machinery/computer/security/shoot_house,
/turf/open/floor/iron/dark/nitrogen,
/area/station/security/range)
"mm" = (
/obj/structure/noticeboard/directional/north,
/turf/open/floor/iron/dark/nitrogen,
/area/station/security/range)
"nh" = (
/obj/structure/chair{
	dir = 1
	},
/turf/open/floor/iron/dark/nitrogen,
/area/station/security/range)
"nm" = (
/obj/effect/turf_decal/stripes/line{
	dir = 5
	},
/turf/open/floor/plating/nitrogen,
/area/station/security/range)
"nE" = (
/obj/structure/rack,
/obj/item/gun/energy/laser/practice{
	pixel_x = 2;
	pixel_y = -2
	},
/obj/item/gun/energy/laser/practice{
	pixel_x = 2;
	pixel_y = 1
	},
/obj/item/gun/energy/laser/practice{
	pixel_x = 2;
	pixel_y = 5
	},
/obj/structure/sign/poster/official/safety_eye_protection/directional/north,
/turf/open/floor/iron/dark/nitrogen,
/area/station/security/range)
"oS" = (
/obj/structure/closet/crate/secure{
	desc = "A secure crate containing various materials for building a customised test-site.";
	name = "Firing Range Gear Crate";
	req_access = list("security")
	},
/obj/item/target,
/obj/item/target,
/obj/item/target/alien,
/obj/item/target/alien,
/obj/item/target/clown,
/obj/item/target/clown,
/obj/item/target/syndicate,
/obj/item/target/syndicate,
/turf/open/floor/iron/dark/nitrogen,
/area/station/security/range)
"pM" = (
/obj/structure/dresser,
/turf/open/floor/iron/dark/nitrogen,
/area/station/security/range)
"qD" = (
/turf/closed/wall,
/area/station/security/range)
"sI" = (
/obj/machinery/shower/directional/east,
/obj/item/soap/deluxe,
/obj/structure/curtain,
/turf/open/floor/iron/nitrogen,
/area/station/security/range)
"tZ" = (
/obj/effect/turf_decal/stripes/line{
	dir = 1
	},
/obj/machinery/light/directional/south,
/turf/open/floor/plating/nitrogen,
/area/station/security/range)
"uK" = (
/obj/structure/table,
/obj/machinery/airalarm/Nitrogen_Atmosphere{
	dir = 1;
	pixel_y = 24;
	name = "north"
	},
/obj/item/storage/medkit/emergency,
/turf/open/floor/iron/dark/nitrogen,
/area/station/security/range)
"vi" = (
/obj/machinery/photocopier,
/turf/open/floor/iron/dark/nitrogen,
/area/station/security/range)
"vl" = (
/turf/open/floor/iron/dark/nitrogen,
/area/station/security/range)
"xz" = (
/obj/effect/turf_decal/stripes/line{
	dir = 6
	},
/obj/machinery/suit_storage_unit/standard_unit,
/turf/open/floor/iron/dark/nitrogen,
/area/station/security/range)
"ze" = (
/obj/structure/cable,
/turf/open/floor/iron/dark/nitrogen,
/area/station/security/range)
"zx" = (
/obj/structure/table/wood,
/obj/machinery/computer/security/wooden_tv,
/obj/machinery/light/small/directional/east,
/turf/open/floor/iron/dark/nitrogen,
/area/station/security/range)
"zO" = (
/obj/effect/turf_decal/stripes/line{
	dir = 6
	},
/turf/open/floor/plating/nitrogen,
/area/station/security/range)
"Bi" = (
/obj/effect/turf_decal/stripes/line{
	dir = 4
	},
/obj/machinery/light/directional/west,
/turf/open/floor/plating/nitrogen,
/area/station/security/range)
"Cy" = (
/obj/structure/table/wood,
/obj/item/razor,
/turf/open/floor/iron/dark/nitrogen,
/area/station/security/range)
"Dg" = (
/obj/item/kirbyplants/random,
/obj/machinery/airalarm/Nitrogen_Atmosphere{
	dir = 1;
	pixel_y = 24;
	name = "north"
	},
/turf/open/floor/iron/dark/nitrogen,
/area/station/security/range)
"Dm" = (
/obj/structure/table,
/obj/machinery/recharger{
	pixel_x = -6;
	pixel_y = 2
	},
/obj/machinery/recharger{
	pixel_x = 6;
	pixel_y = 2
	},
/turf/open/floor/iron/dark/nitrogen,
/area/station/security/range)
"DB" = (
/obj/effect/turf_decal/stripes/line{
	dir = 4
	},
/turf/open/floor/plating/nitrogen,
/area/station/security/range)
"He" = (
/obj/structure/rack,
/obj/item/gun/energy/laser/practice{
	pixel_x = 2;
	pixel_y = -2
	},
/obj/item/gun/energy/laser/practice{
	pixel_x = 2;
	pixel_y = 1
	},
/obj/item/gun/energy/laser/practice{
	pixel_x = 2;
	pixel_y = 5
	},
/turf/open/floor/iron/dark/nitrogen,
/area/station/security/range)
"Hg" = (
/obj/structure/chair/comfy/brown,
/obj/structure/cable,
/turf/open/floor/iron/dark/nitrogen,
/area/station/security/range)
"Jl" = (
/obj/structure/cable,
/obj/modular_map_connector{
	dir = 4
	},
/turf/open/floor/iron/dark/nitrogen,
/area/station/security/range)
"KI" = (
/obj/effect/turf_decal/stripes/line{
	dir = 1
	},
/turf/open/floor/plating/nitrogen,
/area/station/security/range)
"LW" = (
/obj/structure/bed,
/obj/item/bedsheet/captain,
/obj/machinery/light/small/directional/north,
/turf/open/floor/iron/dark/nitrogen,
/area/station/security/range)
"OP" = (
/obj/effect/turf_decal/stripes/line{
	dir = 8
	},
/obj/structure/cable,
/turf/open/floor/plating/nitrogen,
/area/station/security/range)
"SJ" = (
/obj/effect/turf_decal/stripes/line{
	dir = 8
	},
/obj/machinery/light/directional/east,
/turf/open/floor/plating/nitrogen,
/area/station/security/range)
"TA" = (
/obj/item/kirbyplants/random,
/obj/machinery/camera/xray/directional/east{
	c_tag = "Security - Shoot house";
	network = list("ss13","shoothouse")
	},
/turf/open/floor/iron/dark/nitrogen,
/area/station/security/range)
"Uw" = (
/turf/closed/wall/r_wall,
/area/station/security/range)
"VV" = (
/obj/machinery/door/window/brigdoor/left/directional/west{
	name = "Captain's Bedroom";
	req_access = list("armory");
	dir = 2
	},
/obj/structure/cable,
/turf/open/floor/iron/dark/nitrogen,
/area/station/security/range)
"Wc" = (
/obj/structure/training_machine,
/obj/structure/training_machine,
/obj/structure/rack,
/turf/open/floor/iron/dark/nitrogen,
/area/station/security/range)
"WK" = (
/obj/machinery/door/airlock/silver{
	name = "Bathroom"
	},
/obj/effect/mapping_helpers/airlock/access/all/security/armory,
/turf/open/floor/iron/nitrogen,
/area/station/security/range)
"WR" = (
/obj/structure/table/wood,
/obj/item/folder/blue,
/obj/item/pen/fourcolor,
/turf/open/floor/iron/dark/nitrogen,
/area/station/security/range)
"Xt" = (
/obj/machinery/light/directional/west,
/turf/open/floor/iron/dark/nitrogen,
/area/station/security/range)
"XK" = (
/obj/effect/turf_decal/stripes/line{
	dir = 5
	},
/obj/structure/closet/secure_closet,
/obj/item/toy/plush/lizard_plushie/green{
	name = "Pushes-The-Buttons"
	},
/obj/item/toy/nuke{
	pixel_y = -10
	},
/turf/open/floor/iron/dark/nitrogen,
/area/station/security/range)
"XP" = (
/obj/machinery/holopad/secure,
/obj/structure/cable,
/turf/open/floor/iron/dark/nitrogen,
/area/station/security/range)
"Yz" = (
/obj/structure/sign/nanotrasen,
/turf/closed/wall/r_wall,
/area/station/security/range)

(1,1,1) = {"
iu
Uw
Uw
Uw
Uw
lp
lp
SJ
OP
aO
ze
ze
ze
ze
Jl
qD
"}
(2,1,1) = {"
KI
Uw
sI
gW
Uw
Yz
Uw
Uw
hp
Uw
Uw
vl
vl
vl
vl
Xt
"}
(3,1,1) = {"
tZ
Uw
Uw
WK
Uw
XK
xz
vl
ze
vi
Uw
nE
vl
vl
vl
vl
"}
(4,1,1) = {"
KI
Uw
Dg
vl
hJ
vl
vl
vl
ze
eN
Uw
He
vl
nh
nh
vl
"}
(5,1,1) = {"
KI
Uw
LW
vl
VV
ze
XP
ze
Hg
WR
Uw
mg
vl
nh
nh
vl
"}
(6,1,1) = {"
KI
Uw
pM
lS
eT
TA
ze
fk
zx
Cy
Uw
mm
vl
nh
nh
vl
"}
(7,1,1) = {"
tZ
Uw
Uw
Uw
Uw
Uw
gy
Uw
Uw
Uw
Uw
uK
vl
nh
nh
vl
"}
(8,1,1) = {"
KI
Uw
iY
iY
iY
iY
iY
qD
Wc
oS
Uw
Dm
vl
vl
vl
vl
"}
(9,1,1) = {"
KI
Uw
qD
qD
eb
qD
qD
qD
vl
vl
vl
vl
vl
vl
vl
ag
"}
(10,1,1) = {"
nm
DB
DB
DB
DB
DB
Bi
zO
vl
vl
vl
vl
vl
vl
vl
qD
"}
