//MAP CONVERTED BY dmm2tgm.py THIS HEADER COMMENT PREVENTS RECONVERSION, DO NOT REMOVE
"aq" = (
/turf/template_noop,
/area/template_noop)
"aZ" = (
/obj/structure/reagent_dispensers/water_cooler,
/obj/effect/turf_decal/bot_white,
/obj/machinery/light/red/dim/directional/east,
/turf/open/floor/iron/dark/textured_large,
/area/ruin/space/has_grav/powered)
"ct" = (
/obj/effect/turf_decal/stripes/line{
	dir = 9
	},
/obj/structure/sign/warning/no_smoking/directional/north,
/turf/open/floor/engine,
/area/ruin/space/has_grav/powered)
"eA" = (
/obj/effect/mob_spawn/corpse/human/doctor,
/obj/effect/turf_decal/trimline/blue/filled/line,
/turf/open/floor/iron/freezer,
/area/ruin/space/has_grav/powered)
"he" = (
/obj/effect/spawner/random/structure/girder,
/turf/open/floor/plating/airless,
/area/ruin/space/has_grav/powered)
"hn" = (
/obj/effect/spawner/random/trash/mopbucket,
/obj/effect/turf_decal/bot_white,
/turf/open/floor/iron/dark/textured_large,
/area/ruin/space/has_grav/powered)
"hM" = (
/obj/effect/spawner/random/structure/chair_flipped,
/obj/effect/turf_decal/stripes/line{
	dir = 10
	},
/turf/open/floor/engine,
/area/ruin/space/has_grav/powered)
"iv" = (
/turf/open/floor/iron/smooth_large,
/area/ruin/space/has_grav/powered)
"iF" = (
/obj/effect/turf_decal/trimline/blue/filled/line{
	dir = 4
	},
/turf/open/floor/iron/freezer,
/area/ruin/space/has_grav/powered)
"jm" = (
/obj/structure/window/reinforced/spawner,
/obj/structure/table,
/obj/effect/spawner/random/engineering/tool_alien{
	pixel_y = 10;
	pixel_x = 9
	},
/obj/effect/spawner/random/engineering/toolbox,
/turf/open/floor/iron/dark/textured_large,
/area/ruin/space/has_grav/powered)
"kU" = (
/obj/effect/spawner/random/structure/chair_flipped,
/obj/effect/turf_decal/stripes/line{
	dir = 9
	},
/turf/open/floor/engine,
/area/ruin/space/has_grav/powered)
"mL" = (
/turf/closed/wall/mineral/titanium/nodiagonal,
/area/ruin/space/has_grav/powered)
"mM" = (
/obj/structure/window/reinforced/spawner/east,
/obj/effect/spawner/random/structure/closet_empty,
/obj/effect/turf_decal/bot_white,
/turf/open/floor/iron/dark/textured_large,
/area/ruin/space/has_grav/powered)
"mV" = (
/turf/open/floor/plating/airless,
/area/ruin/space/has_grav/powered)
"nc" = (
/obj/effect/spawner/random/trash/caution_sign,
/obj/machinery/light/red/dim/directional/north,
/turf/open/floor/plating/airless,
/area/ruin/space/has_grav/powered)
"on" = (
/obj/effect/spawner/random/structure/crate_abandoned,
/obj/effect/turf_decal/bot_white,
/obj/machinery/light/red/dim/directional/east,
/turf/open/floor/iron/dark/textured_large,
/area/ruin/space/has_grav/powered)
"oZ" = (
/obj/structure/bodycontainer/morgue,
/obj/machinery/light/red/dim/directional/west,
/obj/structure/sign/warning/biohazard/directional/west,
/turf/open/floor/iron/dark/textured_large,
/area/ruin/space/has_grav/powered)
"pD" = (
/obj/machinery/harvester,
/obj/effect/turf_decal/stripes/line{
	dir = 4
	},
/obj/machinery/light/red/dim/directional/east,
/turf/open/floor/engine,
/area/ruin/space/has_grav/powered)
"ql" = (
/obj/effect/spawner/random/engineering/canister,
/obj/effect/turf_decal/bot_white,
/obj/machinery/light/red/dim/directional/south,
/turf/open/floor/iron/dark/textured_large,
/area/ruin/space/has_grav/powered)
"rH" = (
/obj/structure/table,
/obj/structure/sign/warning/chem_diamond/directional/west,
/turf/open/floor/iron/dark/textured_large,
/area/ruin/space/has_grav/powered)
"rO" = (
/obj/effect/spawner/random/structure/steam_vent,
/obj/effect/turf_decal/delivery/white,
/obj/machinery/door/airlock/external/ruin,
/turf/open/floor/iron/dark/textured_large,
/area/ruin/space/has_grav/powered)
"rW" = (
/obj/effect/spawner/random/engineering/canister,
/turf/open/floor/plating/airless,
/area/ruin/space/has_grav/powered)
"sf" = (
/obj/effect/turf_decal/trimline/blue/filled/line{
	dir = 8
	},
/obj/structure/sign/clock/directional/west,
/obj/machinery/light/red/dim/directional/west,
/turf/open/floor/iron/freezer,
/area/ruin/space/has_grav/powered)
"uq" = (
/obj/structure/sink/directional/north,
/obj/effect/turf_decal/stripes/line{
	dir = 10
	},
/turf/open/floor/engine,
/area/ruin/space/has_grav/powered)
"uV" = (
/turf/closed/wall/mineral/titanium,
/area/ruin/space/has_grav/powered)
"vU" = (
/obj/machinery/iv_drip,
/obj/item/reagent_containers/chem_pack{
	pixel_x = 11;
	pixel_y = -10
	},
/obj/effect/turf_decal/trimline/blue/filled/line{
	dir = 9
	},
/turf/open/floor/iron/freezer,
/area/ruin/space/has_grav/powered)
"xv" = (
/obj/structure/window/reinforced/spawner,
/obj/structure/table,
/obj/effect/spawner/random/engineering/material_rare,
/turf/open/floor/iron/dark/textured_large,
/area/ruin/space/has_grav/powered)
"xG" = (
/obj/effect/turf_decal/stripes/line{
	dir = 4
	},
/obj/machinery/light/red/dim/directional/east,
/obj/structure/sign/warning/fire/directional/east,
/turf/open/floor/engine,
/area/ruin/space/has_grav/powered)
"xJ" = (
/obj/structure/closet/secure_closet/medical2,
/obj/effect/turf_decal/bot_white,
/turf/open/floor/iron/dark/textured_large,
/area/ruin/space/has_grav/powered)
"yg" = (
/obj/machinery/porta_turret/syndicate/energy,
/turf/closed/wall/mineral/titanium,
/area/ruin/space/has_grav/powered)
"yx" = (
/obj/structure/window/reinforced/spawner/north,
/obj/structure/table,
/obj/item/book/manual/wiki/medicine{
	pixel_x = -7;
	pixel_y = 2
	},
/obj/item/reagent_containers/spray/cleaner{
	pixel_x = -6;
	pixel_y = 6
	},
/obj/effect/spawner/random/medical/supplies{
	pixel_y = 4;
	pixel_x = 8
	},
/turf/open/floor/iron/dark/textured_large,
/area/ruin/space/has_grav/powered)
"yz" = (
/obj/effect/turf_decal/trimline/blue/filled/line{
	dir = 5
	},
/turf/open/floor/iron/freezer,
/area/ruin/space/has_grav/powered)
"yU" = (
/obj/effect/turf_decal/trimline/blue/filled/line,
/turf/open/floor/iron/freezer,
/area/ruin/space/has_grav/powered)
"AC" = (
/obj/effect/turf_decal/stripes/line{
	dir = 1
	},
/turf/open/floor/engine,
/area/ruin/space/has_grav/powered)
"Bn" = (
/obj/structure/window/reinforced/spawner/north,
/obj/effect/spawner/random/medical/memeorgans,
/obj/structure/closet/crate/freezer,
/obj/effect/turf_decal/bot_white,
/turf/open/floor/iron/dark/textured_large,
/area/ruin/space/has_grav/powered)
"CO" = (
/obj/structure/bodycontainer/morgue,
/turf/open/floor/iron/dark/textured_large,
/area/ruin/space/has_grav/powered)
"Dw" = (
/obj/effect/turf_decal/trimline/blue/filled/line{
	dir = 1
	},
/turf/open/floor/iron/freezer,
/area/ruin/space/has_grav/powered)
"DT" = (
/obj/effect/spawner/random/structure/tank_holder,
/obj/effect/turf_decal/bot_white,
/turf/open/floor/iron/dark/textured_large,
/area/ruin/space/has_grav/powered)
"Ew" = (
/obj/effect/turf_decal/stripes/line,
/turf/open/floor/engine,
/area/ruin/space/has_grav/powered)
"Ga" = (
/obj/structure/closet/l3closet/scientist,
/obj/structure/window/reinforced/spawner/east,
/obj/effect/turf_decal/bot_white,
/turf/open/floor/iron/dark/textured_large,
/area/ruin/space/has_grav/powered)
"GM" = (
/obj/machinery/computer/operating{
	dir = 8
	},
/turf/open/floor/iron/freezer,
/area/ruin/space/has_grav/powered)
"Hy" = (
/obj/effect/turf_decal/trimline/blue/filled/line{
	dir = 10
	},
/turf/open/floor/iron/freezer,
/area/ruin/space/has_grav/powered)
"HG" = (
/obj/effect/spawner/random/structure/crate_empty,
/obj/structure/sign/warning/biohazard/directional/west,
/turf/open/floor/plating/airless,
/area/ruin/space/has_grav/powered)
"HS" = (
/obj/structure/window/reinforced/spawner/north,
/obj/machinery/smartfridge/organ,
/turf/open/floor/iron/dark/textured_large,
/area/ruin/space/has_grav/powered)
"It" = (
/obj/structure/window/reinforced/spawner,
/obj/structure/filingcabinet/chestdrawer/wheeled,
/turf/open/floor/iron/dark/textured_large,
/area/ruin/space/has_grav/powered)
"Iy" = (
/obj/effect/spawner/random/structure/barricade,
/obj/structure/sign/warning/secure_area/directional/west,
/turf/open/floor/plating/airless,
/area/ruin/space/has_grav/powered)
"JL" = (
/obj/effect/turf_decal/stripes/line{
	dir = 6
	},
/obj/structure/sign/warning/electric_shock/directional/east,
/turf/open/floor/engine,
/area/ruin/space/has_grav/powered)
"Lg" = (
/obj/effect/turf_decal/stripes/line{
	dir = 8
	},
/turf/open/floor/engine,
/area/ruin/space/has_grav/powered)
"Lu" = (
/obj/effect/spawner/random/structure/barricade,
/turf/open/floor/plating/airless,
/area/ruin/space/has_grav/powered)
"LO" = (
/obj/structure/table/glass/plasmaglass,
/obj/effect/spawner/random/medical/injector{
	pixel_x = 4
	},
/obj/item/blood_filter{
	pixel_y = 11
	},
/obj/item/reagent_containers/cup/bottle/formaldehyde{
	pixel_x = -10;
	pixel_y = 3
	},
/obj/item/reagent_containers/cup/bottle/chloralhydrate{
	pixel_y = 10;
	pixel_x = 7
	},
/turf/open/floor/iron/dark/textured_large,
/area/ruin/space/has_grav/powered)
"LY" = (
/obj/effect/spawner/random/medical/organs,
/obj/structure/closet/crate/freezer,
/obj/effect/turf_decal/stripes/line{
	dir = 8
	},
/turf/open/floor/engine,
/area/ruin/space/has_grav/powered)
"Ml" = (
/obj/effect/turf_decal/stripes/line{
	dir = 5
	},
/turf/open/floor/engine,
/area/ruin/space/has_grav/powered)
"Nh" = (
/obj/structure/table/glass/plasmaglass,
/obj/item/storage/box/bodybags{
	pixel_y = 3
	},
/obj/item/storage/box/medigels{
	pixel_y = 10;
	pixel_x = -1
	},
/turf/open/floor/iron/dark/textured_large,
/area/ruin/space/has_grav/powered)
"Nz" = (
/obj/effect/spawner/random/structure/crate_loot,
/obj/effect/turf_decal/bot_white,
/turf/open/floor/iron/dark/textured_large,
/area/ruin/space/has_grav/powered)
"OH" = (
/obj/effect/turf_decal/bot_white,
/turf/open/floor/iron/dark/textured_large,
/area/ruin/space/has_grav/powered)
"PU" = (
/obj/effect/spawner/random/engineering/atmospherics_portable,
/obj/effect/turf_decal/bot_white,
/obj/machinery/light/red/dim/directional/north,
/obj/structure/sign/warning/test_chamber/directional/north,
/turf/open/floor/iron/dark/textured_large,
/area/ruin/space/has_grav/powered)
"Qt" = (
/obj/machinery/light/red/dim/directional/south,
/turf/open/floor/plating/airless,
/area/ruin/space/has_grav/powered)
"QU" = (
/obj/effect/spawner/random/engineering/tank,
/turf/open/floor/iron/dark/textured_large,
/area/ruin/space/has_grav/powered)
"RB" = (
/obj/effect/spawner/random/structure/barricade,
/obj/structure/sign/warning/no_smoking/circle/directional/west,
/turf/open/floor/plating/airless,
/area/ruin/space/has_grav/powered)
"SI" = (
/obj/machinery/destructive_scanner,
/turf/open/floor/engine,
/area/ruin/space/has_grav/powered)
"SK" = (
/obj/structure/table/glass/plasmaglass,
/obj/item/defibrillator/loaded{
	pixel_y = 8
	},
/turf/open/floor/iron/dark/textured_large,
/area/ruin/space/has_grav/powered)
"SP" = (
/obj/effect/spawner/random/medical/patient_stretcher,
/obj/effect/turf_decal/trimline/blue/filled/line{
	dir = 6
	},
/turf/open/floor/iron/freezer,
/area/ruin/space/has_grav/powered)
"TM" = (
/obj/effect/spawner/random/trash/bin,
/obj/effect/turf_decal/bot_white,
/turf/open/floor/iron/dark/textured_large,
/area/ruin/space/has_grav/powered)
"Vn" = (
/obj/structure/lattice,
/turf/template_noop,
/area/template_noop)
"Vu" = (
/obj/structure/table,
/obj/effect/spawner/random/medical/surgery_tool_advanced{
	pixel_y = -5;
	pixel_x = -3
	},
/obj/effect/spawner/random/medical/surgery_tool_advanced{
	pixel_x = 2;
	pixel_y = 13
	},
/obj/effect/spawner/random/medical/surgery_tool_alien{
	pixel_y = 5;
	pixel_x = -7
	},
/obj/structure/sign/calendar/directional/west,
/obj/machinery/light/red/dim/directional/west,
/turf/open/floor/iron/dark/textured_large,
/area/ruin/space/has_grav/powered)
"VL" = (
/obj/structure/table/optable,
/obj/effect/mob_spawn/corpse/human/abductor,
/turf/open/floor/iron/freezer,
/area/ruin/space/has_grav/powered)
"WB" = (
/obj/effect/turf_decal/stripes/line{
	dir = 6
	},
/turf/open/floor/engine,
/area/ruin/space/has_grav/powered)
"Xy" = (
/turf/open/floor/catwalk_floor/iron_dark,
/area/ruin/space/has_grav/powered)
"YP" = (
/obj/effect/mob_spawn/corpse/human/doctor,
/obj/effect/turf_decal/trimline/blue/filled/line{
	dir = 1
	},
/turf/open/floor/iron/freezer,
/area/ruin/space/has_grav/powered)

(1,1,1) = {"
aq
aq
aq
aq
yg
mL
mL
mL
mL
mL
yg
aq
aq
aq
aq
"}
(2,1,1) = {"
uV
mL
mL
mL
mL
SK
vU
sf
Hy
Nh
mL
mL
mL
mL
uV
"}
(3,1,1) = {"
mL
QU
Vu
rH
jm
LO
Dw
VL
eA
xJ
yx
CO
oZ
CO
mL
"}
(4,1,1) = {"
mL
ct
Lg
hM
xv
OH
YP
GM
yU
OH
Bn
iv
iv
iv
mL
"}
(5,1,1) = {"
mL
AC
SI
Ew
It
Ga
yz
iF
SP
mM
HS
kU
LY
uq
mL
"}
(6,1,1) = {"
mL
Ml
xG
JL
iv
iv
iv
iv
iv
iv
iv
Ml
pD
WB
mL
"}
(7,1,1) = {"
uV
mL
mL
mL
Nz
on
DT
iv
hn
aZ
TM
mL
mL
mL
uV
"}
(8,1,1) = {"
aq
aq
aq
yg
mL
mL
mL
rO
mL
mL
mL
yg
aq
aq
aq
"}
(9,1,1) = {"
aq
aq
aq
aq
aq
mL
PU
Xy
ql
mL
aq
aq
aq
aq
aq
"}
(10,1,1) = {"
aq
aq
aq
aq
uV
mL
mL
rO
mL
mL
uV
aq
aq
aq
aq
"}
(11,1,1) = {"
aq
aq
aq
aq
mL
rW
Iy
Lu
RB
HG
mL
aq
aq
aq
aq
"}
(12,1,1) = {"
aq
aq
aq
aq
mL
nc
Vn
mV
mV
Qt
mL
aq
aq
aq
aq
"}
(13,1,1) = {"
aq
aq
aq
aq
he
Vn
Vn
Vn
aq
mV
mL
uV
aq
aq
aq
"}
(14,1,1) = {"
aq
aq
aq
aq
Vn
aq
aq
aq
aq
Vn
mV
mL
aq
aq
aq
"}
(15,1,1) = {"
aq
aq
aq
aq
aq
aq
aq
aq
aq
aq
aq
aq
aq
aq
aq
"}
