//MAP CONVERTED BY dmm2tgm.py THIS HEADER COMMENT PREVENTS RECONVERSION, DO NOT REMOVE
"a" = (
/turf/template_noop,
/area/template_noop)
"y" = (
/turf/open/floor/iron/solarpanel/airless,
/area/template_noop)
"G" = (
/turf/closed/wall/mineral/plastitanium/explosive,
/area/template_noop)
"P" = (
/obj/structure/lattice,
/turf/template_noop,
/area/template_noop)
"V" = (
/obj/effect/spawner/random/structure/crate_abandoned,
/obj/item/gps/spaceruin,
/turf/open/floor/plating/airless,
/area/template_noop)

(1,1,1) = {"
a
a
a
a
a
G
V
"}
(2,1,1) = {"
y
y
y
y
P
G
G
"}
(3,1,1) = {"
a
a
a
a
a
P
a
"}
(4,1,1) = {"
a
a
a
a
a
y
a
"}
(5,1,1) = {"
a
a
a
a
a
y
a
"}
(6,1,1) = {"
a
a
a
a
a
y
a
"}
(7,1,1) = {"
a
a
a
a
a
y
a
"}
