//MAP CONVERTED BY dmm2tgm.py THIS HEADER COMMENT PREVENTS RECONVERSION, DO NOT REMOVE
"a" = (
/turf/template_noop,
/area/template_noop)
"b" = (
/turf/open/floor/plating,
/area/ruin/space/has_grav/powered/skyrat/clothing_facility)
"c" = (
/turf/closed/mineral/random,
/area/ruin/unpowered/no_grav)
"d" = (
/obj/machinery/destructive_scanner,
/turf/open/floor/iron/dark,
/area/ruin/space/has_grav/powered/skyrat/clothing_facility)
"e" = (
/turf/closed/wall,
/area/ruin/space/has_grav/powered/skyrat/clothing_facility)
"f" = (
/turf/closed/wall/r_wall,
/area/ruin/space/has_grav/powered/skyrat/clothing_facility)
"g" = (
/turf/open/floor/iron/dark/side,
/area/ruin/space/has_grav/powered/skyrat/clothing_facility)
"h" = (
/obj/structure/toilet{
	pixel_y = 12
	},
/obj/machinery/light/directional/east,
/turf/open/floor/iron/showroomfloor,
/area/ruin/space/has_grav/powered/skyrat/clothing_facility)
"i" = (
/obj/structure/chair/sofa/bench/left{
	dir = 4
	},
/obj/effect/turf_decal/siding/wood{
	dir = 4
	},
/turf/open/floor/wood,
/area/ruin/space/has_grav/powered/skyrat/clothing_facility)
"j" = (
/turf/open/floor/engine,
/area/ruin/space/has_grav/powered/skyrat/clothing_facility)
"k" = (
/obj/item/kirbyplants/random,
/obj/effect/turf_decal/siding/wood{
	dir = 4
	},
/turf/open/floor/wood,
/area/ruin/space/has_grav/powered/skyrat/clothing_facility)
"l" = (
/turf/open/floor/iron/dark/side{
	dir = 8
	},
/area/ruin/space/has_grav/powered/skyrat/clothing_facility)
"m" = (
/obj/machinery/light/directional/north,
/turf/open/floor/engine,
/area/ruin/space/has_grav/powered/skyrat/clothing_facility)
"n" = (
/obj/item/card/id/advanced/colourable{
	pixel_y = 6
	},
/obj/structure/rack,
/obj/item/card/id/advanced/colourable{
	pixel_y = 3
	},
/obj/item/card/id/advanced/colourable,
/turf/open/floor/engine,
/area/ruin/space/has_grav/powered/skyrat/clothing_facility)
"o" = (
/obj/structure/sink/directional/south,
/turf/open/floor/iron/showroomfloor,
/area/ruin/space/has_grav/powered/skyrat/clothing_facility)
"p" = (
/obj/structure/chair/sofa/bench/right{
	dir = 4
	},
/obj/effect/turf_decal/siding/wood{
	dir = 4
	},
/turf/open/floor/wood,
/area/ruin/space/has_grav/powered/skyrat/clothing_facility)
"q" = (
/obj/item/clothing/neck/cloak/colourable/veil,
/obj/structure/rack,
/obj/item/clothing/neck/cloak/colourable/veil,
/obj/item/clothing/neck/cloak/colourable/veil,
/turf/open/floor/engine,
/area/ruin/space/has_grav/powered/skyrat/clothing_facility)
"r" = (
/obj/structure/chair/sofa/bench/right{
	dir = 8
	},
/obj/effect/turf_decal/siding/wood{
	dir = 8
	},
/turf/open/floor/wood,
/area/ruin/space/has_grav/powered/skyrat/clothing_facility)
"s" = (
/obj/machinery/autolathe,
/turf/open/floor/iron/dark,
/area/ruin/space/has_grav/powered/skyrat/clothing_facility)
"t" = (
/obj/structure/window/reinforced/spawner,
/turf/open/floor/engine,
/area/ruin/space/has_grav/powered/skyrat/clothing_facility)
"u" = (
/obj/machinery/door/window/left/directional/south,
/turf/open/floor/engine,
/area/ruin/space/has_grav/powered/skyrat/clothing_facility)
"v" = (
/obj/machinery/light/directional/west,
/obj/machinery/rnd/destructive_analyzer,
/turf/open/floor/iron/dark,
/area/ruin/space/has_grav/powered/skyrat/clothing_facility)
"w" = (
/obj/effect/spawner/structure/window/reinforced,
/turf/open/floor/plating,
/area/ruin/space/has_grav/powered/skyrat/clothing_facility)
"x" = (
/turf/open/floor/iron/dark/corner{
	dir = 1
	},
/area/ruin/space/has_grav/powered/skyrat/clothing_facility)
"y" = (
/turf/open/floor/iron/dark/corner,
/area/ruin/space/has_grav/powered/skyrat/clothing_facility)
"z" = (
/turf/open/floor/iron/showroomfloor,
/area/ruin/space/has_grav/powered/skyrat/clothing_facility)
"A" = (
/obj/machinery/door/airlock,
/turf/open/floor/iron/showroomfloor,
/area/ruin/space/has_grav/powered/skyrat/clothing_facility)
"B" = (
/obj/machinery/door/airlock/research,
/turf/open/floor/iron,
/area/ruin/space/has_grav/powered/skyrat/clothing_facility)
"C" = (
/turf/open/floor/iron/dark/corner{
	dir = 8
	},
/area/ruin/space/has_grav/powered/skyrat/clothing_facility)
"D" = (
/obj/machinery/light/directional/south,
/obj/structure/toilet{
	dir = 8
	},
/turf/open/floor/iron/showroomfloor,
/area/ruin/space/has_grav/powered/skyrat/clothing_facility)
"E" = (
/obj/structure/window/reinforced/spawner/east,
/turf/open/floor/engine,
/area/ruin/space/has_grav/powered/skyrat/clothing_facility)
"F" = (
/obj/machinery/door/window/right/directional/west,
/turf/open/floor/engine,
/area/ruin/space/has_grav/powered/skyrat/clothing_facility)
"G" = (
/turf/open/floor/iron/dark,
/area/ruin/space/has_grav/powered/skyrat/clothing_facility)
"H" = (
/turf/open/floor/iron/bluespace,
/area/ruin/space/has_grav/powered/skyrat/clothing_facility)
"I" = (
/obj/structure/window/reinforced/spawner/west,
/turf/open/floor/engine,
/area/ruin/space/has_grav/powered/skyrat/clothing_facility)
"J" = (
/turf/open/floor/iron/dark/side{
	dir = 4
	},
/area/ruin/space/has_grav/powered/skyrat/clothing_facility)
"K" = (
/obj/machinery/light/directional/east,
/turf/open/floor/iron/dark/corner{
	dir = 8
	},
/area/ruin/space/has_grav/powered/skyrat/clothing_facility)
"L" = (
/obj/structure/chair/sofa/bench/left{
	dir = 8
	},
/obj/effect/turf_decal/siding/wood{
	dir = 8
	},
/turf/open/floor/wood,
/area/ruin/space/has_grav/powered/skyrat/clothing_facility)
"M" = (
/obj/machinery/door/airlock/highsecurity,
/turf/open/floor/iron/dark,
/area/ruin/space/has_grav/powered/skyrat/clothing_facility)
"N" = (
/obj/machinery/light/directional/east,
/turf/open/floor/engine,
/area/ruin/space/has_grav/powered/skyrat/clothing_facility)
"O" = (
/turf/open/floor/iron/dark/corner{
	dir = 4
	},
/area/ruin/space/has_grav/powered/skyrat/clothing_facility)
"P" = (
/turf/open/floor/iron/dark/side{
	dir = 1
	},
/area/ruin/space/has_grav/powered/skyrat/clothing_facility)
"Q" = (
/obj/item/kirbyplants/random,
/obj/effect/turf_decal/siding/wood{
	dir = 8
	},
/turf/open/floor/wood,
/area/ruin/space/has_grav/powered/skyrat/clothing_facility)
"R" = (
/obj/machinery/light/directional/west,
/turf/open/floor/engine,
/area/ruin/space/has_grav/powered/skyrat/clothing_facility)
"S" = (
/turf/open/floor/iron,
/area/ruin/space/has_grav/powered/skyrat/clothing_facility)
"T" = (
/obj/structure/rack,
/obj/item/clothing/neck/cloak/colourable/shroud,
/obj/item/clothing/neck/cloak/colourable/shroud,
/obj/item/clothing/neck/cloak/colourable/shroud,
/turf/open/floor/engine,
/area/ruin/space/has_grav/powered/skyrat/clothing_facility)
"U" = (
/obj/structure/sink/directional/east,
/turf/open/floor/iron/showroomfloor,
/area/ruin/space/has_grav/powered/skyrat/clothing_facility)
"V" = (
/obj/structure/statue/plasma/scientist,
/turf/open/floor/iron/bluespace,
/area/ruin/space/has_grav/powered/skyrat/clothing_facility)
"W" = (
/obj/machinery/door/window/right/directional/east,
/turf/open/floor/engine,
/area/ruin/space/has_grav/powered/skyrat/clothing_facility)
"Y" = (
/obj/machinery/light/directional/east,
/turf/open/floor/iron/dark/side{
	dir = 8
	},
/area/ruin/space/has_grav/powered/skyrat/clothing_facility)
"Z" = (
/obj/machinery/door/airlock/external,
/turf/open/floor/plating,
/area/ruin/space/has_grav/powered/skyrat/clothing_facility)

(1,1,1) = {"
a
a
a
a
a
a
c
c
c
c
c
c
c
c
c
c
c
c
c
a
a
a
a
a
"}
(2,1,1) = {"
a
a
a
a
a
c
c
c
c
c
c
c
c
c
c
c
c
c
c
c
c
a
a
a
"}
(3,1,1) = {"
a
a
a
a
c
c
f
f
f
f
f
e
e
e
e
e
e
e
e
e
e
e
a
a
"}
(4,1,1) = {"
a
a
c
c
c
c
f
j
R
j
f
d
v
s
e
U
z
e
k
i
p
w
a
a
"}
(5,1,1) = {"
a
c
c
c
c
c
f
j
T
j
f
G
G
G
e
h
z
A
S
S
S
w
a
a
"}
(6,1,1) = {"
a
c
c
f
f
f
f
E
W
E
f
l
l
l
e
e
e
e
S
S
S
e
a
a
"}
(7,1,1) = {"
a
c
c
f
j
j
t
G
G
G
f
y
J
O
y
J
O
e
y
J
O
w
w
w
"}
(8,1,1) = {"
c
c
c
f
m
n
u
G
S
G
M
g
H
P
g
H
P
B
g
V
P
Z
b
Z
"}
(9,1,1) = {"
c
c
c
f
j
j
t
G
G
G
f
C
l
x
K
l
x
e
C
l
x
w
w
w
"}
(10,1,1) = {"
c
c
c
f
f
f
f
I
F
I
f
y
J
O
e
e
A
e
S
S
S
e
a
a
"}
(11,1,1) = {"
a
c
c
c
c
c
f
j
q
j
f
g
H
P
e
z
z
e
S
S
S
w
a
a
"}
(12,1,1) = {"
a
a
c
c
c
c
f
j
N
j
f
C
Y
x
e
o
D
e
Q
r
L
w
a
a
"}
(13,1,1) = {"
a
a
a
a
c
c
f
f
f
f
f
e
e
e
e
e
e
e
e
e
e
e
a
a
"}
(14,1,1) = {"
a
a
a
a
a
c
c
c
c
c
c
c
c
c
c
c
c
c
c
c
c
a
a
a
"}
(15,1,1) = {"
a
a
a
a
a
a
c
c
c
c
a
a
c
c
c
c
c
c
c
c
a
a
a
a
"}
