//MAP CONVERTED BY dmm2tgm.py THIS HEADER COMMENT PREVENTS RECONVERSION, DO NOT REMOVE
"a" = (
/turf/template_noop,
/area/template_noop)
"c" = (
/turf/open/floor/iron/dark/airless,
/area/ruin/unpowered/no_grav)
"e" = (
/obj/item/storage/toolbox/syndicate,
/turf/open/floor/iron/dark/airless,
/area/ruin/unpowered/no_grav)
"g" = (
/obj/effect/decal/cleanable/blood/gibs,
/turf/open/floor/iron/dark/airless,
/area/ruin/unpowered/no_grav)
"l" = (
/obj/effect/decal/cleanable/blood,
/obj/effect/decal/cleanable/blood/gibs/down,
/turf/open/floor/iron/dark/airless,
/area/ruin/unpowered/no_grav)
"m" = (
/turf/closed/mineral/random/asteroid,
/area/ruin/space)
"t" = (
/obj/effect/decal/cleanable/blood/splatter,
/turf/open/floor/iron/dark/airless,
/area/ruin/unpowered/no_grav)
"v" = (
/turf/closed/wall/mineral/titanium/spaceship,
/area/ruin/unpowered/no_grav)
"x" = (
/obj/effect/decal/cleanable/blood,
/obj/effect/decal/cleanable/blood/gibs/up,
/turf/open/floor/iron/dark/airless,
/area/ruin/unpowered/no_grav)
"C" = (
/obj/machinery/power/shuttle_engine/propulsion{
	dir = 8
	},
/turf/template_noop,
/area/ruin/unpowered/no_grav)
"H" = (
/obj/effect/decal/cleanable/blood,
/obj/effect/decal/cleanable/blood/gibs/limb{
	dir = 4
	},
/turf/open/floor/iron/dark/airless,
/area/ruin/unpowered/no_grav)
"I" = (
/obj/effect/decal/cleanable/blood,
/obj/effect/decal/cleanable/blood/gibs/body,
/turf/open/floor/iron/dark/airless,
/area/ruin/unpowered/no_grav)
"K" = (
/obj/effect/spawner/random/engineering/flashlight,
/turf/open/floor/iron/dark/airless,
/area/ruin/unpowered/no_grav)
"L" = (
/obj/structure/closet/crate,
/obj/effect/spawner/random/engineering/material_rare,
/obj/effect/spawner/random/engineering/material_rare,
/obj/effect/spawner/random/engineering/material,
/obj/effect/spawner/random/engineering/material,
/turf/open/floor/iron/dark/airless,
/area/ruin/unpowered/no_grav)
"O" = (
/obj/structure/closet/crate,
/obj/effect/spawner/random/engineering/tool_advanced,
/turf/open/floor/iron/dark/airless,
/area/ruin/unpowered/no_grav)
"R" = (
/obj/effect/decal/cleanable/blood,
/obj/effect/decal/cleanable/blood/gibs/limb,
/turf/open/floor/iron/dark/airless,
/area/ruin/unpowered/no_grav)
"T" = (
/obj/effect/spawner/random/engineering/material_cheap,
/turf/open/floor/iron/dark/airless,
/area/ruin/unpowered/no_grav)
"V" = (
/obj/structure/closet/crate,
/obj/effect/spawner/random/engineering/toolbox,
/obj/effect/spawner/random/engineering/toolbox,
/turf/open/floor/iron/dark/airless,
/area/ruin/unpowered/no_grav)
"Y" = (
/obj/machinery/power/port_gen/pacman/super,
/turf/open/floor/iron/dark/airless,
/area/ruin/unpowered/no_grav)

(1,1,1) = {"
a
C
C
C
v
v
C
C
C
a
"}
(2,1,1) = {"
a
v
v
v
v
v
v
v
v
a
"}
(3,1,1) = {"
a
v
T
L
Y
Y
K
c
v
a
"}
(4,1,1) = {"
m
v
c
e
g
c
c
V
v
a
"}
(5,1,1) = {"
m
v
v
O
t
R
T
v
v
a
"}
(6,1,1) = {"
m
m
v
g
H
t
l
v
a
a
"}
(7,1,1) = {"
m
m
v
I
c
m
t
v
m
a
"}
(8,1,1) = {"
m
m
v
m
x
m
m
v
m
m
"}
(9,1,1) = {"
m
m
m
m
m
m
m
m
m
m
"}
(10,1,1) = {"
m
m
m
m
m
m
m
m
m
m
"}
(11,1,1) = {"
m
m
m
m
m
m
m
m
m
m
"}
(12,1,1) = {"
m
m
m
m
m
m
m
m
m
m
"}
(13,1,1) = {"
m
m
m
m
m
m
m
m
m
a
"}
(14,1,1) = {"
a
m
m
m
m
m
m
m
m
a
"}
(15,1,1) = {"
a
a
m
m
m
m
a
a
a
a
"}
(16,1,1) = {"
a
a
a
a
a
a
a
a
a
a
"}
