//MAP CONVERTED BY dmm2tgm.py THIS HEADER COMMENT PREVENTS RECONVERSION, DO NOT REMOVE
"a" = (
/turf/template_noop,
/area/template_noop)
"b" = (
/obj/structure/chair/sofa/right{
	dir = 4
	},
/mob/living/simple_animal/hostile/gorilla{
	anchored = 1;
	dir = 4;
	faction = list("neutral")
	},
/turf/open/misc/beach/sand,
/area/ruin/space/has_grav/powered)
"p" = (
/turf/open/misc/beach/sand,
/area/ruin/space/has_grav/powered)
"t" = (
/obj/structure/table/wood,
/obj/item/flashlight/lamp/bananalamp,
/turf/open/misc/beach/sand,
/area/ruin/space/has_grav/powered)
"y" = (
/obj/effect/overlay/palmtree_l,
/obj/structure/fans/tiny/invisible,
/turf/open/misc/beach/sand,
/area/ruin/space/has_grav/powered)
"C" = (
/obj/structure/showcase/machinery/tv,
/turf/open/misc/beach/sand,
/area/ruin/space/has_grav/powered)
"H" = (
/mob/living/simple_animal/pet/dog/corgi{
	anchored = 1
	},
/obj/structure/bed/dogbed,
/turf/open/misc/beach/sand,
/area/ruin/space/has_grav/powered)
"M" = (
/obj/structure/fans/tiny/invisible,
/turf/open/misc/beach/sand,
/area/ruin/space/has_grav/powered)
"O" = (
/obj/item/food/grown/banana,
/obj/item/food/grown/banana,
/obj/item/food/grown/banana,
/obj/item/food/grown/banana,
/obj/item/food/grown/banana,
/obj/item/food/grown/banana,
/obj/item/food/grown/banana,
/obj/item/food/grown/banana,
/obj/item/food/grown/banana,
/obj/item/food/grown/banana,
/obj/item/food/grown/banana,
/obj/item/food/grown/banana,
/obj/structure/closet/secure_closet/freezer/fridge/open,
/turf/open/misc/beach/sand,
/area/ruin/space/has_grav/powered)
"U" = (
/obj/structure/chair/sofa/left{
	dir = 4
	},
/turf/open/misc/beach/sand,
/area/ruin/space/has_grav/powered)
"V" = (
/obj/structure/water_source/puddle,
/obj/structure/fans/tiny/invisible,
/turf/open/misc/beach/sand,
/area/ruin/space/has_grav/powered)

(1,1,1) = {"
a
a
a
a
a
a
a
"}
(2,1,1) = {"
a
M
M
M
M
y
a
"}
(3,1,1) = {"
a
y
U
b
t
M
a
"}
(4,1,1) = {"
a
V
p
p
p
M
a
"}
(5,1,1) = {"
a
M
O
C
H
M
a
"}
(6,1,1) = {"
a
M
M
M
y
M
a
"}
(7,1,1) = {"
a
a
a
a
a
a
a
"}
