//MAP CONVERTED BY dmm2tgm.py THIS HEADER COMMENT PREVENTS RECONVERSION, DO NOT REMOVE
"cw" = (
/obj/machinery/airalarm/directional/north,
/obj/effect/mapping_helpers/airalarm/all_access,
/turf/open/floor/iron,
/area/ruin/space/has_grav/port_tarkon)
"cZ" = (
/obj/structure/fluff/empty_sleeper{
	dir = 8
	},
/turf/open/floor/iron,
/area/ruin/space/has_grav/port_tarkon)
"jD" = (
/obj/machinery/light/warm/directional/north,
/turf/open/floor/iron,
/area/ruin/space/has_grav/port_tarkon)
"kV" = (
/obj/structure/fluff/metalpole,
/turf/open/misc/asteroid/airless,
/area/space)
"mn" = (
/turf/open/misc/asteroid/airless,
/area/space)
"qo" = (
/obj/machinery/computer{
	desc = "A computer long since rendered non-functional due to lack of maintenance. Spitting out error messages.";
	dir = 1;
	name = "Broken Computer"
	},
/turf/open/floor/iron,
/area/ruin/space/has_grav/port_tarkon)
"sU" = (
/obj/structure/fluff/metalpole/end/right,
/turf/open/space/basic,
/area/space)
"tD" = (
/obj/structure/fluff/empty_sleeper{
	dir = 1
	},
/turf/open/floor/iron,
/area/ruin/space/has_grav/port_tarkon)
"ux" = (
/obj/machinery/atmospherics/components/unary/vent_scrubber/on/layer2{
	dir = 4
	},
/turf/open/floor/iron,
/area/ruin/space/has_grav/port_tarkon)
"Bx" = (
/obj/structure/fluff/metalpole,
/turf/open/space/basic,
/area/space)
"Fi" = (
/obj/effect/mob_spawn/ghost_role/human/tarkon/ensign,
/turf/open/floor/iron,
/area/ruin/space/has_grav/port_tarkon)
"Ge" = (
/obj/machinery/light_switch/directional/north,
/turf/open/floor/iron,
/area/ruin/space/has_grav/port_tarkon)
"IC" = (
/obj/machinery/light_switch/directional/east,
/obj/machinery/atmospherics/pipe/smart/manifold4w/supply/hidden/layer4,
/obj/machinery/atmospherics/pipe/smart/manifold4w/scrubbers/hidden/layer2,
/obj/structure/cable,
/turf/open/floor/iron,
/area/ruin/space/has_grav/port_tarkon)
"IX" = (
/obj/machinery/atmospherics/pipe/smart/manifold4w/supply/hidden/layer4,
/obj/machinery/atmospherics/pipe/smart/manifold4w/scrubbers/hidden/layer2,
/obj/structure/cable,
/turf/open/floor/iron,
/area/ruin/space/has_grav/port_tarkon)
"Nk" = (
/obj/structure/fluff/empty_sleeper{
	dir = 4
	},
/turf/open/floor/iron,
/area/ruin/space/has_grav/port_tarkon)
"QR" = (
/obj/item/crowbar,
/obj/machinery/atmospherics/pipe/smart/manifold4w/supply/hidden/layer4,
/obj/machinery/atmospherics/pipe/smart/manifold4w/scrubbers/hidden/layer2,
/obj/structure/cable,
/turf/open/floor/iron,
/area/ruin/space/has_grav/port_tarkon)
"Up" = (
/obj/machinery/atmospherics/components/unary/vent_pump/on/layer4,
/turf/open/floor/iron,
/area/ruin/space/has_grav/port_tarkon)
"Vb" = (
/turf/open/floor/iron,
/area/ruin/space/has_grav/port_tarkon)
"Vj" = (
/obj/structure/fluff/empty_sleeper,
/turf/open/floor/iron,
/area/ruin/space/has_grav/port_tarkon)
"ZX" = (
/obj/modular_map_root/port_tarkon{
	key = "port"
	},
/turf/open/misc/asteroid/airless,
/area/space)
"ZY" = (
/turf/open/space/basic,
/area/space)

(1,1,1) = {"
ZY
ZY
ZY
ZY
ZY
ZY
ZY
ZY
ZY
ZY
ZY
ZY
ZY
ZY
ZY
ZY
ZY
ZY
ZY
ZY
ZY
ZY
ZY
ZY
ZY
ZY
ZY
ZY
ZY
ZY
ZY
ZY
ZY
ZY
ZY
ZY
ZY
ZY
ZY
ZY
ZY
ZY
ZY
ZY
ZY
ZY
ZY
ZY
ZY
ZY
ZY
ZY
ZY
ZY
ZY
ZY
ZY
ZY
ZY
ZY
ZY
ZY
ZY
ZY
ZY
ZY
ZY
ZY
ZY
ZY
ZY
"}
(2,1,1) = {"
ZY
ZY
ZY
ZY
ZY
ZY
ZY
ZY
ZY
ZY
ZY
ZY
ZY
ZY
ZY
ZY
ZY
ZY
ZY
ZY
ZY
ZY
ZY
ZY
ZY
ZY
ZY
ZY
ZY
ZY
ZY
ZY
ZY
ZY
ZY
ZY
ZY
ZY
ZY
ZY
ZY
ZY
ZY
ZY
ZY
ZY
ZY
ZY
ZY
ZY
ZY
ZY
ZY
ZY
ZY
ZY
ZY
ZY
ZY
ZY
ZY
ZY
ZY
ZY
ZY
ZY
ZY
ZY
ZY
ZY
ZY
"}
(3,1,1) = {"
ZY
ZY
ZY
ZY
ZY
ZY
ZY
ZY
ZY
ZY
ZY
ZY
ZY
ZY
ZY
ZY
ZY
ZY
ZY
ZY
ZY
ZY
ZY
ZY
ZY
ZY
ZY
ZY
ZY
ZY
ZY
ZY
ZY
ZY
ZY
ZY
ZY
ZY
ZY
ZY
ZY
ZY
ZY
ZY
ZY
ZY
ZY
ZY
ZY
ZY
ZY
ZY
ZY
ZY
ZY
ZY
ZY
ZY
ZY
ZY
ZY
ZY
ZY
ZY
ZY
ZY
ZY
ZY
ZY
ZY
ZY
"}
(4,1,1) = {"
ZY
ZY
ZY
ZY
ZY
ZY
ZY
ZY
ZY
ZY
ZY
ZY
ZY
ZY
ZY
ZY
ZY
ZY
ZY
ZY
ZY
ZY
ZY
ZY
ZY
ZY
ZY
ZY
ZY
ZY
ZY
ZY
ZY
ZY
ZY
ZY
ZY
ZY
ZY
ZY
ZY
ZY
ZY
ZY
ZY
ZY
ZY
ZY
ZY
ZY
ZY
ZY
ZY
ZY
ZY
ZY
ZY
ZY
ZY
ZY
ZY
ZY
ZY
ZY
ZY
ZY
ZY
ZY
ZY
ZY
ZY
"}
(5,1,1) = {"
ZY
ZY
ZY
ZY
ZY
ZY
ZY
ZY
ZY
ZY
ZY
ZY
ZY
ZY
ZY
ZY
ZY
ZY
ZY
ZY
ZY
ZY
ZY
ZY
ZY
ZY
mn
mn
mn
mn
mn
mn
mn
mn
ZY
ZY
ZY
ZY
ZY
ZY
ZY
ZY
ZY
ZY
ZY
ZY
ZY
ZY
ZY
ZY
ZY
ZY
ZY
ZY
ZY
ZY
ZY
ZY
ZY
ZY
ZY
ZY
ZY
ZY
ZY
ZY
ZY
ZY
ZY
ZY
ZY
"}
(6,1,1) = {"
ZY
ZY
ZY
ZY
ZY
ZY
ZY
ZY
ZY
ZY
ZY
ZY
ZY
ZY
ZY
ZY
ZY
mn
mn
mn
mn
mn
mn
mn
mn
mn
mn
mn
mn
mn
mn
mn
mn
mn
mn
mn
mn
mn
mn
mn
mn
mn
mn
mn
mn
mn
mn
mn
mn
mn
mn
mn
mn
mn
mn
mn
mn
mn
mn
ZY
ZY
ZY
ZY
ZY
ZY
ZY
ZY
ZY
ZY
ZY
ZY
"}
(7,1,1) = {"
ZY
ZY
ZY
ZY
ZY
ZY
ZY
ZY
ZY
ZY
ZY
ZY
ZY
ZY
mn
mn
mn
mn
mn
mn
mn
mn
mn
mn
mn
mn
mn
mn
mn
mn
mn
mn
mn
mn
mn
mn
mn
mn
mn
mn
mn
mn
mn
mn
mn
mn
mn
mn
mn
mn
mn
mn
mn
mn
mn
mn
mn
mn
mn
mn
mn
ZY
ZY
ZY
ZY
ZY
ZY
ZY
ZY
ZY
ZY
"}
(8,1,1) = {"
ZY
ZY
ZY
ZY
ZY
ZY
ZY
ZY
ZY
ZY
ZY
ZY
mn
mn
mn
mn
mn
mn
mn
mn
mn
mn
mn
mn
mn
mn
mn
mn
mn
mn
mn
mn
mn
mn
mn
mn
mn
mn
mn
mn
mn
mn
mn
mn
mn
mn
mn
mn
mn
mn
mn
mn
mn
mn
mn
mn
mn
mn
mn
mn
mn
mn
mn
ZY
ZY
ZY
ZY
ZY
ZY
ZY
ZY
"}
(9,1,1) = {"
ZY
ZY
ZY
ZY
ZY
ZY
ZY
ZY
ZY
ZY
mn
mn
mn
mn
mn
mn
mn
mn
mn
mn
mn
mn
mn
mn
mn
mn
mn
mn
mn
mn
mn
mn
mn
mn
mn
mn
mn
mn
mn
mn
mn
mn
mn
mn
mn
mn
mn
mn
mn
mn
mn
mn
mn
mn
mn
mn
mn
mn
mn
mn
mn
mn
mn
mn
ZY
ZY
ZY
ZY
ZY
ZY
ZY
"}
(10,1,1) = {"
ZY
ZY
ZY
ZY
ZY
ZY
ZY
ZY
ZY
mn
mn
mn
mn
mn
mn
mn
mn
mn
mn
mn
mn
mn
mn
mn
mn
mn
mn
mn
mn
mn
mn
mn
mn
mn
mn
mn
mn
mn
mn
mn
mn
mn
mn
mn
mn
mn
mn
mn
mn
mn
mn
mn
mn
mn
mn
mn
mn
mn
mn
mn
mn
mn
mn
mn
ZY
ZY
ZY
ZY
ZY
ZY
ZY
"}
(11,1,1) = {"
ZY
ZY
ZY
ZY
ZY
ZY
ZY
ZY
mn
mn
mn
mn
mn
mn
mn
mn
mn
mn
mn
mn
mn
mn
mn
mn
mn
mn
mn
mn
mn
mn
mn
mn
mn
mn
mn
mn
mn
mn
mn
mn
mn
mn
mn
mn
mn
mn
mn
mn
mn
mn
mn
mn
mn
mn
mn
mn
mn
mn
mn
mn
mn
mn
mn
mn
mn
ZY
ZY
ZY
ZY
ZY
ZY
"}
(12,1,1) = {"
ZY
ZY
ZY
ZY
ZY
ZY
ZY
ZY
mn
mn
mn
mn
mn
mn
mn
mn
mn
mn
mn
mn
mn
mn
mn
mn
mn
mn
mn
mn
mn
mn
mn
mn
mn
mn
mn
mn
mn
mn
mn
mn
mn
mn
mn
mn
mn
mn
mn
mn
mn
mn
mn
mn
mn
mn
mn
mn
mn
mn
mn
mn
mn
mn
mn
mn
mn
ZY
ZY
ZY
ZY
ZY
ZY
"}
(13,1,1) = {"
ZY
ZY
ZY
ZY
ZY
ZY
ZY
mn
mn
mn
mn
mn
mn
mn
mn
mn
mn
mn
mn
mn
mn
mn
mn
mn
mn
mn
mn
mn
mn
mn
mn
mn
mn
mn
mn
mn
mn
mn
mn
mn
mn
mn
mn
mn
mn
mn
mn
mn
mn
mn
mn
mn
mn
mn
mn
mn
mn
mn
mn
mn
mn
mn
mn
mn
mn
mn
ZY
ZY
ZY
ZY
ZY
"}
(14,1,1) = {"
ZY
ZY
ZY
ZY
ZY
ZY
ZY
mn
mn
mn
mn
mn
mn
mn
mn
mn
mn
mn
mn
mn
mn
mn
mn
mn
mn
mn
mn
mn
mn
mn
mn
mn
mn
mn
mn
mn
mn
mn
mn
mn
mn
mn
mn
mn
mn
mn
mn
mn
mn
mn
mn
mn
mn
mn
mn
mn
mn
mn
mn
mn
mn
mn
mn
mn
mn
mn
ZY
ZY
ZY
ZY
ZY
"}
(15,1,1) = {"
ZY
ZY
ZY
ZY
ZY
ZY
mn
mn
mn
mn
mn
mn
mn
mn
mn
mn
mn
mn
mn
mn
mn
mn
mn
mn
mn
mn
mn
mn
mn
mn
mn
mn
mn
mn
mn
mn
mn
mn
mn
mn
mn
mn
mn
mn
mn
mn
mn
mn
mn
mn
mn
mn
mn
mn
mn
mn
mn
mn
mn
mn
mn
mn
mn
mn
mn
mn
ZY
ZY
ZY
ZY
ZY
"}
(16,1,1) = {"
ZY
ZY
ZY
ZY
ZY
ZY
mn
mn
mn
mn
mn
mn
mn
mn
mn
mn
mn
mn
mn
mn
mn
mn
mn
mn
mn
mn
mn
mn
mn
mn
mn
mn
mn
mn
mn
mn
mn
mn
mn
mn
mn
mn
mn
mn
mn
mn
mn
mn
mn
mn
mn
mn
mn
mn
mn
mn
mn
mn
mn
mn
mn
mn
mn
mn
mn
mn
ZY
ZY
ZY
ZY
ZY
"}
(17,1,1) = {"
ZY
ZY
ZY
ZY
ZY
ZY
mn
mn
mn
mn
mn
mn
mn
mn
mn
mn
mn
mn
mn
mn
mn
mn
mn
mn
mn
mn
mn
mn
mn
mn
mn
mn
mn
mn
mn
mn
mn
mn
mn
mn
mn
mn
mn
mn
mn
mn
mn
mn
mn
mn
mn
mn
mn
mn
mn
mn
mn
mn
mn
mn
mn
mn
mn
mn
mn
mn
ZY
ZY
ZY
ZY
ZY
"}
(18,1,1) = {"
ZY
ZY
ZY
ZY
ZY
mn
mn
mn
mn
mn
mn
mn
mn
mn
mn
mn
mn
mn
mn
mn
mn
mn
mn
mn
mn
mn
mn
mn
mn
mn
mn
mn
mn
mn
mn
mn
mn
mn
mn
mn
mn
mn
mn
mn
mn
mn
mn
mn
mn
mn
mn
mn
mn
mn
mn
mn
mn
mn
mn
mn
mn
mn
mn
mn
mn
mn
ZY
ZY
ZY
ZY
ZY
"}
(19,1,1) = {"
ZY
ZY
ZY
ZY
ZY
mn
mn
mn
mn
mn
mn
mn
mn
mn
mn
mn
mn
mn
mn
mn
mn
mn
mn
mn
mn
mn
mn
mn
mn
mn
mn
mn
mn
mn
mn
mn
mn
mn
mn
mn
mn
mn
mn
mn
mn
mn
mn
mn
mn
mn
mn
mn
mn
mn
mn
mn
mn
mn
mn
mn
mn
mn
mn
mn
mn
mn
ZY
ZY
ZY
ZY
ZY
"}
(20,1,1) = {"
ZY
ZY
ZY
ZY
ZY
mn
mn
mn
mn
mn
mn
mn
mn
mn
mn
mn
mn
mn
mn
mn
mn
mn
mn
mn
mn
mn
mn
mn
mn
mn
mn
mn
mn
mn
mn
mn
mn
mn
mn
mn
mn
mn
mn
mn
mn
mn
mn
mn
mn
mn
mn
mn
mn
mn
mn
mn
mn
mn
mn
mn
mn
mn
mn
mn
mn
mn
ZY
ZY
ZY
ZY
ZY
"}
(21,1,1) = {"
ZY
ZY
ZY
ZY
ZY
mn
mn
mn
mn
mn
mn
mn
mn
mn
mn
mn
mn
mn
mn
mn
mn
mn
mn
mn
mn
mn
mn
mn
mn
mn
mn
mn
mn
mn
mn
mn
mn
mn
mn
mn
mn
mn
mn
mn
mn
mn
mn
mn
mn
mn
mn
mn
mn
mn
mn
mn
mn
mn
mn
mn
mn
mn
mn
mn
mn
mn
ZY
ZY
ZY
ZY
ZY
"}
(22,1,1) = {"
ZY
ZY
ZY
ZY
ZY
mn
mn
mn
mn
mn
mn
mn
mn
mn
mn
mn
mn
mn
mn
mn
mn
mn
mn
mn
mn
mn
mn
mn
mn
mn
mn
mn
mn
mn
mn
mn
mn
mn
mn
mn
mn
mn
mn
mn
mn
mn
mn
mn
mn
mn
mn
mn
mn
mn
mn
mn
mn
mn
mn
mn
mn
mn
mn
mn
mn
mn
ZY
ZY
ZY
ZY
ZY
"}
(23,1,1) = {"
ZY
ZY
ZY
ZY
ZY
mn
mn
mn
mn
mn
mn
mn
mn
mn
mn
mn
mn
mn
mn
mn
mn
mn
mn
mn
mn
mn
mn
mn
mn
mn
mn
mn
mn
mn
mn
mn
mn
mn
mn
mn
mn
mn
mn
mn
mn
mn
mn
mn
mn
mn
mn
mn
mn
mn
mn
mn
mn
mn
mn
mn
mn
mn
mn
mn
mn
mn
ZY
ZY
ZY
ZY
ZY
"}
(24,1,1) = {"
ZY
ZY
ZY
ZY
ZY
mn
mn
mn
mn
mn
mn
mn
mn
mn
mn
mn
mn
mn
mn
mn
mn
mn
mn
mn
mn
mn
mn
mn
mn
mn
mn
mn
mn
mn
mn
mn
mn
mn
mn
mn
mn
mn
mn
mn
mn
mn
mn
mn
mn
mn
mn
mn
mn
mn
mn
mn
mn
mn
mn
mn
mn
mn
mn
mn
mn
mn
ZY
ZY
ZY
ZY
ZY
"}
(25,1,1) = {"
ZY
ZY
ZY
ZY
ZY
mn
mn
mn
mn
mn
mn
mn
mn
mn
mn
mn
mn
mn
mn
mn
mn
mn
mn
mn
mn
mn
mn
mn
mn
mn
mn
mn
mn
mn
mn
mn
mn
mn
mn
mn
mn
mn
mn
mn
mn
mn
mn
mn
mn
mn
mn
mn
mn
mn
mn
mn
mn
mn
mn
mn
mn
mn
mn
mn
mn
mn
ZY
ZY
ZY
ZY
ZY
"}
(26,1,1) = {"
ZY
ZY
ZY
ZY
ZY
mn
mn
mn
mn
mn
mn
mn
mn
mn
mn
mn
mn
mn
mn
mn
mn
mn
mn
mn
mn
mn
mn
mn
mn
mn
mn
mn
mn
mn
mn
mn
mn
mn
mn
mn
mn
mn
mn
mn
mn
mn
mn
mn
mn
mn
mn
mn
mn
mn
mn
mn
mn
mn
mn
mn
mn
mn
mn
mn
mn
mn
ZY
ZY
ZY
ZY
ZY
"}
(27,1,1) = {"
ZY
ZY
ZY
ZY
ZY
mn
mn
mn
mn
mn
mn
mn
mn
mn
mn
mn
mn
mn
mn
mn
mn
mn
mn
mn
mn
mn
mn
mn
mn
mn
mn
mn
mn
mn
mn
mn
mn
mn
mn
mn
mn
mn
mn
mn
mn
mn
mn
mn
mn
mn
mn
mn
mn
mn
mn
mn
mn
mn
mn
mn
mn
mn
mn
mn
mn
mn
ZY
ZY
ZY
ZY
ZY
"}
(28,1,1) = {"
ZY
ZY
ZY
ZY
ZY
mn
mn
mn
mn
mn
mn
mn
mn
mn
mn
mn
mn
mn
mn
mn
mn
mn
mn
mn
mn
mn
mn
mn
mn
mn
mn
mn
mn
mn
mn
mn
mn
mn
mn
mn
mn
mn
mn
mn
mn
mn
mn
mn
mn
mn
mn
mn
mn
mn
mn
mn
mn
mn
mn
mn
mn
mn
mn
mn
mn
mn
ZY
ZY
ZY
ZY
ZY
"}
(29,1,1) = {"
ZY
ZY
ZY
ZY
ZY
mn
mn
mn
mn
mn
mn
mn
mn
mn
mn
mn
mn
mn
mn
mn
mn
mn
mn
mn
mn
mn
mn
mn
mn
mn
mn
mn
mn
mn
mn
mn
mn
mn
mn
mn
mn
mn
mn
mn
mn
mn
mn
mn
mn
mn
mn
mn
mn
mn
mn
mn
mn
mn
mn
mn
mn
mn
mn
mn
mn
mn
ZY
ZY
ZY
ZY
ZY
"}
(30,1,1) = {"
ZY
ZY
ZY
ZY
ZY
mn
mn
mn
mn
mn
mn
mn
mn
mn
mn
mn
mn
mn
mn
mn
mn
mn
mn
mn
mn
mn
mn
mn
mn
mn
mn
mn
mn
mn
mn
mn
mn
mn
mn
mn
mn
mn
mn
mn
mn
mn
mn
mn
mn
mn
mn
mn
mn
mn
mn
mn
mn
mn
mn
mn
mn
mn
mn
mn
mn
mn
ZY
ZY
ZY
ZY
ZY
"}
(31,1,1) = {"
ZY
ZY
ZY
ZY
ZY
mn
mn
mn
mn
mn
mn
mn
mn
mn
mn
mn
mn
mn
mn
mn
mn
mn
mn
mn
mn
mn
mn
mn
mn
mn
mn
mn
mn
mn
mn
mn
mn
mn
mn
mn
mn
mn
mn
mn
mn
mn
mn
mn
mn
mn
mn
mn
mn
mn
mn
mn
mn
mn
mn
mn
mn
mn
mn
mn
mn
mn
ZY
ZY
ZY
ZY
ZY
"}
(32,1,1) = {"
ZY
ZY
ZY
ZY
ZY
mn
mn
mn
mn
mn
mn
mn
mn
mn
mn
mn
mn
mn
mn
mn
mn
mn
mn
mn
mn
mn
mn
mn
mn
mn
mn
mn
mn
mn
mn
mn
Nk
Vb
mn
mn
mn
mn
mn
mn
mn
mn
mn
mn
mn
mn
mn
mn
mn
mn
mn
mn
mn
mn
mn
mn
mn
mn
mn
mn
mn
mn
ZY
ZY
ZY
ZY
ZY
"}
(33,1,1) = {"
ZY
ZY
ZY
ZY
ZY
mn
mn
mn
mn
mn
mn
mn
mn
mn
mn
mn
mn
mn
mn
mn
mn
mn
mn
mn
mn
mn
mn
mn
mn
mn
mn
mn
mn
mn
mn
mn
Ge
Vb
tD
mn
mn
mn
mn
mn
mn
mn
mn
mn
mn
mn
mn
mn
mn
mn
mn
mn
mn
mn
mn
mn
mn
mn
mn
mn
mn
mn
ZY
ZY
ZY
ZY
ZY
"}
(34,1,1) = {"
ZY
ZY
ZY
ZY
ZY
mn
mn
mn
mn
mn
mn
mn
mn
mn
mn
mn
mn
mn
mn
mn
mn
mn
mn
mn
mn
mn
mn
mn
mn
mn
mn
mn
mn
mn
mn
mn
Fi
Vb
Vb
mn
mn
mn
mn
mn
mn
mn
mn
mn
mn
mn
mn
mn
mn
mn
mn
mn
mn
mn
mn
mn
mn
mn
mn
mn
mn
mn
ZY
ZY
ZY
ZY
ZY
"}
(35,1,1) = {"
ZY
ZY
ZY
ZY
ZY
mn
mn
mn
mn
mn
mn
mn
mn
mn
mn
mn
mn
mn
mn
mn
mn
mn
mn
mn
mn
mn
mn
mn
mn
mn
mn
mn
mn
mn
mn
mn
jD
ux
Vb
Vb
mn
mn
mn
mn
mn
mn
mn
mn
mn
mn
mn
mn
mn
mn
mn
mn
mn
mn
mn
mn
mn
mn
mn
mn
mn
mn
ZY
ZY
ZY
ZY
ZY
"}
(36,1,1) = {"
ZY
ZY
ZY
ZY
ZY
mn
mn
mn
mn
mn
mn
mn
mn
mn
mn
mn
mn
mn
mn
mn
mn
mn
mn
mn
mn
mn
mn
mn
mn
mn
mn
mn
mn
mn
mn
mn
QR
IX
IX
qo
mn
mn
mn
mn
mn
mn
mn
mn
mn
mn
mn
mn
mn
mn
mn
mn
mn
mn
mn
mn
mn
mn
mn
mn
mn
mn
ZY
ZY
ZY
ZY
ZY
"}
(37,1,1) = {"
ZY
ZY
ZY
ZY
ZY
mn
mn
mn
mn
mn
mn
mn
mn
mn
mn
mn
mn
mn
mn
mn
mn
mn
mn
mn
mn
mn
mn
mn
mn
mn
mn
mn
mn
mn
mn
mn
jD
Up
IX
IC
ZX
mn
mn
mn
mn
mn
mn
mn
mn
mn
mn
mn
mn
mn
mn
mn
mn
mn
mn
mn
mn
mn
mn
mn
mn
mn
ZY
ZY
ZY
ZY
ZY
"}
(38,1,1) = {"
ZY
ZY
ZY
ZY
ZY
mn
mn
mn
mn
mn
mn
mn
mn
mn
mn
mn
mn
mn
mn
mn
mn
mn
mn
mn
mn
mn
mn
mn
mn
mn
mn
mn
mn
mn
mn
mn
Vj
Vb
Vb
mn
mn
mn
mn
mn
mn
mn
mn
mn
mn
mn
mn
mn
mn
mn
mn
mn
mn
mn
mn
mn
mn
mn
mn
mn
mn
mn
ZY
ZY
ZY
ZY
ZY
"}
(39,1,1) = {"
ZY
ZY
ZY
ZY
ZY
mn
mn
mn
mn
mn
mn
mn
mn
mn
mn
mn
mn
mn
mn
mn
mn
mn
mn
mn
mn
mn
mn
mn
mn
mn
mn
mn
mn
mn
mn
mn
cw
Vb
tD
mn
mn
mn
mn
mn
mn
mn
mn
mn
mn
mn
mn
mn
mn
mn
mn
mn
mn
mn
mn
mn
mn
mn
mn
mn
mn
mn
ZY
ZY
ZY
ZY
ZY
"}
(40,1,1) = {"
ZY
ZY
ZY
ZY
ZY
mn
mn
mn
mn
mn
mn
mn
mn
mn
mn
mn
mn
mn
mn
mn
mn
mn
mn
mn
mn
mn
mn
mn
mn
mn
mn
mn
mn
mn
mn
mn
cZ
Vb
mn
mn
mn
mn
mn
mn
mn
mn
mn
mn
mn
mn
mn
mn
mn
mn
mn
mn
mn
mn
mn
mn
mn
mn
mn
mn
mn
mn
ZY
ZY
ZY
ZY
ZY
"}
(41,1,1) = {"
ZY
ZY
ZY
ZY
ZY
mn
mn
mn
mn
mn
mn
mn
mn
mn
mn
mn
mn
mn
mn
mn
mn
mn
mn
mn
mn
mn
mn
mn
mn
mn
mn
mn
mn
mn
mn
mn
mn
mn
mn
mn
mn
mn
mn
mn
mn
mn
mn
mn
mn
mn
mn
mn
mn
mn
mn
mn
mn
mn
mn
mn
mn
mn
mn
mn
mn
mn
ZY
ZY
ZY
ZY
ZY
"}
(42,1,1) = {"
ZY
ZY
ZY
ZY
ZY
mn
mn
mn
mn
mn
mn
mn
mn
mn
mn
mn
mn
mn
mn
mn
mn
mn
mn
mn
mn
mn
mn
mn
mn
mn
mn
mn
mn
mn
mn
mn
mn
mn
mn
mn
mn
mn
mn
mn
mn
mn
mn
mn
mn
mn
mn
mn
mn
mn
mn
mn
mn
mn
mn
mn
mn
mn
mn
mn
mn
mn
ZY
ZY
ZY
ZY
ZY
"}
(43,1,1) = {"
ZY
ZY
ZY
ZY
ZY
mn
mn
mn
mn
mn
mn
mn
mn
mn
mn
mn
mn
mn
mn
mn
mn
mn
mn
mn
mn
mn
mn
mn
mn
mn
mn
mn
mn
mn
mn
mn
mn
mn
mn
mn
mn
mn
mn
mn
mn
mn
mn
mn
mn
mn
mn
mn
mn
mn
mn
mn
mn
mn
mn
mn
mn
mn
mn
mn
mn
mn
ZY
ZY
ZY
ZY
ZY
"}
(44,1,1) = {"
ZY
ZY
ZY
ZY
ZY
mn
mn
mn
mn
mn
mn
mn
mn
mn
mn
mn
mn
mn
mn
mn
mn
mn
mn
mn
mn
mn
mn
mn
mn
mn
mn
mn
mn
mn
mn
mn
mn
mn
mn
mn
mn
mn
mn
mn
mn
mn
mn
mn
mn
mn
mn
mn
mn
mn
mn
mn
mn
mn
mn
mn
mn
mn
mn
mn
mn
mn
ZY
ZY
ZY
ZY
ZY
"}
(45,1,1) = {"
ZY
ZY
ZY
ZY
ZY
mn
mn
mn
mn
mn
mn
mn
mn
mn
mn
mn
mn
mn
mn
mn
mn
mn
mn
mn
mn
mn
mn
mn
mn
mn
mn
mn
mn
mn
mn
mn
mn
mn
mn
mn
mn
mn
mn
mn
mn
mn
mn
mn
mn
mn
mn
mn
mn
mn
mn
mn
mn
mn
mn
mn
mn
mn
mn
mn
mn
mn
ZY
ZY
ZY
ZY
ZY
"}
(46,1,1) = {"
ZY
ZY
ZY
ZY
ZY
mn
mn
mn
mn
mn
mn
mn
mn
mn
mn
mn
mn
mn
mn
mn
mn
mn
mn
mn
mn
mn
mn
mn
mn
mn
mn
mn
mn
mn
mn
mn
mn
mn
mn
mn
mn
mn
mn
mn
mn
mn
mn
mn
mn
mn
mn
mn
mn
mn
mn
mn
mn
mn
mn
mn
mn
mn
mn
mn
mn
mn
ZY
ZY
ZY
ZY
ZY
"}
(47,1,1) = {"
ZY
ZY
ZY
ZY
ZY
mn
mn
mn
mn
mn
mn
mn
mn
mn
mn
mn
mn
mn
mn
mn
mn
mn
mn
mn
mn
mn
mn
mn
mn
mn
mn
mn
mn
mn
mn
mn
mn
mn
mn
mn
mn
mn
mn
mn
mn
mn
mn
mn
mn
mn
mn
mn
mn
mn
mn
mn
mn
mn
mn
mn
mn
mn
mn
mn
mn
mn
ZY
ZY
ZY
ZY
ZY
"}
(48,1,1) = {"
ZY
ZY
ZY
ZY
ZY
mn
mn
mn
mn
mn
mn
mn
mn
mn
mn
mn
mn
mn
mn
mn
mn
mn
mn
mn
mn
mn
mn
mn
mn
mn
mn
mn
mn
mn
mn
mn
mn
mn
mn
mn
mn
mn
mn
mn
mn
mn
mn
mn
mn
mn
mn
mn
mn
mn
mn
mn
mn
mn
mn
mn
mn
mn
mn
mn
mn
mn
ZY
ZY
ZY
ZY
ZY
"}
(49,1,1) = {"
ZY
ZY
ZY
ZY
ZY
mn
mn
mn
mn
mn
mn
mn
mn
mn
mn
mn
mn
mn
mn
mn
mn
mn
mn
mn
mn
mn
mn
mn
mn
mn
mn
mn
mn
mn
mn
mn
mn
mn
mn
mn
mn
mn
mn
mn
mn
mn
mn
mn
mn
mn
mn
mn
mn
mn
mn
mn
mn
mn
mn
mn
mn
mn
mn
mn
mn
mn
ZY
ZY
ZY
ZY
ZY
"}
(50,1,1) = {"
ZY
ZY
ZY
ZY
ZY
mn
mn
mn
mn
mn
mn
mn
mn
mn
mn
mn
mn
mn
mn
mn
mn
mn
mn
mn
mn
mn
mn
mn
mn
mn
mn
mn
mn
mn
mn
mn
mn
mn
mn
mn
mn
mn
mn
mn
mn
mn
mn
mn
mn
mn
mn
mn
mn
mn
mn
mn
mn
mn
mn
mn
mn
mn
mn
mn
mn
mn
ZY
ZY
ZY
ZY
ZY
"}
(51,1,1) = {"
ZY
ZY
ZY
ZY
ZY
mn
mn
mn
mn
mn
mn
mn
mn
mn
mn
mn
mn
mn
mn
mn
mn
mn
mn
mn
mn
mn
mn
mn
mn
mn
mn
mn
mn
mn
mn
mn
mn
mn
mn
mn
mn
mn
mn
mn
mn
mn
mn
mn
mn
mn
mn
mn
mn
mn
mn
mn
mn
mn
mn
mn
mn
mn
mn
mn
mn
mn
ZY
ZY
ZY
ZY
ZY
"}
(52,1,1) = {"
ZY
ZY
ZY
ZY
ZY
mn
mn
mn
mn
mn
mn
mn
mn
mn
mn
mn
mn
mn
mn
mn
mn
mn
mn
mn
mn
mn
mn
mn
mn
mn
mn
mn
mn
mn
mn
mn
mn
mn
mn
mn
mn
mn
mn
mn
mn
mn
mn
mn
mn
mn
mn
mn
mn
mn
mn
mn
mn
mn
mn
mn
mn
mn
mn
mn
mn
mn
ZY
ZY
ZY
ZY
ZY
"}
(53,1,1) = {"
ZY
ZY
ZY
ZY
ZY
mn
mn
mn
mn
mn
mn
mn
mn
mn
mn
mn
mn
mn
mn
mn
mn
mn
mn
mn
mn
mn
mn
mn
mn
mn
mn
mn
mn
mn
mn
mn
mn
mn
mn
mn
mn
mn
mn
mn
mn
mn
mn
mn
mn
mn
mn
mn
mn
mn
mn
mn
mn
mn
mn
mn
mn
mn
mn
mn
mn
mn
ZY
ZY
ZY
ZY
ZY
"}
(54,1,1) = {"
ZY
ZY
ZY
ZY
ZY
mn
mn
mn
mn
mn
mn
mn
mn
mn
mn
mn
mn
mn
mn
mn
mn
mn
mn
mn
mn
mn
mn
mn
mn
mn
mn
mn
mn
mn
mn
mn
mn
mn
mn
mn
mn
mn
mn
mn
mn
mn
mn
mn
mn
mn
mn
mn
mn
mn
mn
mn
mn
mn
mn
mn
mn
mn
mn
mn
mn
mn
ZY
ZY
ZY
ZY
ZY
"}
(55,1,1) = {"
ZY
ZY
ZY
ZY
ZY
mn
mn
mn
mn
mn
mn
mn
mn
mn
mn
mn
mn
mn
mn
mn
mn
mn
mn
mn
mn
mn
mn
mn
mn
mn
mn
mn
mn
mn
mn
mn
mn
mn
mn
mn
mn
mn
mn
mn
mn
mn
mn
mn
mn
mn
mn
mn
mn
mn
mn
mn
mn
mn
mn
mn
mn
mn
mn
mn
mn
mn
ZY
ZY
ZY
ZY
ZY
"}
(56,1,1) = {"
ZY
ZY
ZY
ZY
ZY
mn
mn
mn
mn
mn
mn
mn
mn
mn
mn
mn
mn
mn
mn
mn
mn
mn
mn
mn
mn
mn
mn
mn
mn
mn
mn
mn
mn
mn
mn
mn
mn
mn
mn
mn
mn
mn
mn
mn
mn
mn
mn
mn
mn
mn
mn
mn
mn
mn
mn
mn
mn
mn
mn
mn
mn
mn
mn
mn
mn
mn
ZY
ZY
ZY
ZY
ZY
"}
(57,1,1) = {"
ZY
ZY
ZY
ZY
ZY
mn
mn
mn
mn
mn
mn
mn
mn
mn
mn
mn
mn
mn
mn
mn
mn
mn
mn
mn
mn
mn
mn
mn
mn
mn
mn
mn
mn
mn
mn
mn
mn
mn
mn
mn
mn
mn
mn
mn
mn
mn
mn
mn
mn
mn
mn
mn
mn
mn
mn
mn
mn
mn
mn
mn
mn
mn
mn
mn
mn
mn
ZY
ZY
ZY
ZY
ZY
"}
(58,1,1) = {"
ZY
ZY
ZY
ZY
ZY
ZY
mn
mn
mn
mn
mn
mn
mn
mn
mn
mn
mn
mn
mn
mn
mn
mn
mn
mn
mn
mn
mn
mn
mn
mn
mn
mn
mn
mn
mn
mn
mn
mn
mn
mn
mn
mn
mn
mn
mn
mn
mn
mn
mn
mn
mn
mn
mn
mn
mn
mn
mn
mn
mn
mn
mn
mn
mn
mn
mn
mn
ZY
ZY
ZY
ZY
ZY
"}
(59,1,1) = {"
ZY
ZY
ZY
ZY
ZY
ZY
mn
mn
mn
mn
mn
mn
mn
mn
mn
mn
mn
mn
mn
mn
mn
mn
mn
mn
mn
mn
mn
mn
mn
mn
mn
mn
mn
mn
mn
mn
mn
mn
mn
mn
mn
mn
mn
mn
mn
mn
mn
mn
mn
mn
mn
mn
mn
mn
mn
mn
mn
mn
mn
mn
mn
mn
mn
mn
mn
mn
ZY
ZY
ZY
ZY
ZY
"}
(60,1,1) = {"
ZY
ZY
ZY
ZY
ZY
ZY
mn
mn
mn
mn
mn
mn
mn
mn
mn
mn
mn
mn
mn
mn
mn
mn
mn
mn
mn
mn
mn
mn
mn
mn
mn
mn
mn
mn
mn
mn
mn
mn
mn
mn
mn
mn
mn
mn
mn
mn
mn
mn
mn
mn
mn
mn
mn
mn
mn
mn
mn
mn
mn
mn
mn
mn
mn
mn
mn
ZY
ZY
ZY
ZY
ZY
ZY
"}
(61,1,1) = {"
ZY
ZY
ZY
ZY
ZY
ZY
ZY
mn
mn
mn
mn
mn
mn
mn
mn
mn
mn
mn
mn
mn
mn
mn
mn
mn
mn
mn
mn
mn
mn
mn
mn
mn
mn
mn
mn
mn
mn
mn
mn
mn
mn
mn
mn
mn
mn
mn
mn
mn
mn
mn
mn
mn
mn
mn
mn
mn
mn
mn
mn
mn
mn
mn
mn
mn
mn
ZY
ZY
ZY
ZY
ZY
ZY
"}
(62,1,1) = {"
ZY
ZY
ZY
ZY
mn
ZY
ZY
mn
mn
mn
mn
mn
mn
mn
mn
mn
mn
mn
mn
mn
mn
mn
mn
mn
mn
mn
mn
mn
mn
mn
mn
mn
mn
mn
mn
mn
mn
mn
mn
mn
mn
mn
mn
mn
mn
mn
mn
mn
mn
mn
mn
mn
mn
mn
mn
mn
mn
mn
mn
mn
mn
mn
mn
mn
ZY
ZY
ZY
ZY
ZY
ZY
ZY
"}
(63,1,1) = {"
ZY
ZY
ZY
mn
mn
ZY
ZY
ZY
mn
mn
mn
mn
mn
mn
mn
mn
mn
mn
mn
mn
mn
mn
mn
mn
mn
mn
mn
mn
mn
mn
mn
mn
mn
mn
mn
mn
mn
mn
mn
mn
mn
mn
mn
mn
mn
mn
mn
mn
mn
mn
mn
mn
mn
mn
mn
mn
mn
mn
mn
mn
mn
mn
mn
ZY
ZY
ZY
ZY
ZY
ZY
ZY
ZY
"}
(64,1,1) = {"
ZY
ZY
ZY
mn
mn
ZY
ZY
ZY
ZY
mn
mn
mn
mn
mn
mn
mn
mn
mn
mn
mn
mn
mn
mn
mn
mn
mn
mn
mn
mn
mn
mn
mn
mn
mn
mn
mn
mn
mn
mn
mn
mn
mn
mn
mn
mn
mn
mn
mn
mn
mn
mn
mn
mn
mn
mn
mn
mn
mn
mn
mn
mn
mn
ZY
ZY
ZY
ZY
ZY
ZY
ZY
ZY
ZY
"}
(65,1,1) = {"
ZY
ZY
mn
mn
mn
mn
ZY
ZY
ZY
ZY
ZY
mn
mn
mn
mn
mn
mn
mn
mn
mn
mn
mn
mn
mn
mn
mn
mn
mn
mn
mn
mn
mn
mn
mn
mn
mn
mn
mn
mn
mn
mn
mn
mn
mn
mn
mn
mn
mn
mn
mn
mn
mn
mn
mn
kV
mn
mn
mn
mn
mn
mn
ZY
ZY
ZY
ZY
ZY
ZY
ZY
ZY
ZY
ZY
"}
(66,1,1) = {"
ZY
ZY
mn
mn
mn
mn
ZY
ZY
ZY
ZY
ZY
ZY
ZY
mn
mn
mn
mn
mn
mn
mn
mn
mn
mn
mn
mn
mn
mn
mn
mn
mn
mn
mn
mn
mn
mn
mn
mn
mn
mn
mn
mn
mn
mn
mn
mn
mn
mn
mn
mn
mn
mn
mn
mn
mn
kV
mn
mn
mn
mn
ZY
ZY
ZY
ZY
ZY
ZY
ZY
ZY
ZY
ZY
ZY
ZY
"}
(67,1,1) = {"
ZY
mn
mn
mn
mn
mn
ZY
ZY
ZY
ZY
ZY
ZY
ZY
ZY
ZY
ZY
ZY
ZY
ZY
ZY
ZY
ZY
ZY
ZY
ZY
ZY
ZY
ZY
ZY
ZY
ZY
ZY
ZY
ZY
ZY
ZY
ZY
ZY
ZY
ZY
ZY
ZY
ZY
ZY
ZY
ZY
ZY
ZY
ZY
ZY
ZY
ZY
ZY
ZY
Bx
ZY
ZY
ZY
ZY
ZY
ZY
ZY
ZY
ZY
ZY
ZY
ZY
ZY
ZY
ZY
ZY
"}
(68,1,1) = {"
ZY
ZY
ZY
mn
mn
mn
mn
ZY
ZY
ZY
ZY
ZY
ZY
ZY
ZY
ZY
ZY
ZY
ZY
ZY
ZY
ZY
ZY
ZY
ZY
ZY
ZY
ZY
ZY
ZY
ZY
ZY
ZY
ZY
ZY
ZY
ZY
ZY
ZY
ZY
ZY
ZY
ZY
ZY
ZY
ZY
ZY
ZY
ZY
ZY
ZY
ZY
ZY
ZY
Bx
ZY
ZY
ZY
ZY
ZY
ZY
ZY
ZY
ZY
ZY
ZY
ZY
ZY
ZY
ZY
ZY
"}
(69,1,1) = {"
ZY
ZY
ZY
ZY
ZY
ZY
ZY
ZY
ZY
ZY
ZY
ZY
ZY
ZY
ZY
ZY
ZY
ZY
ZY
ZY
ZY
ZY
ZY
ZY
ZY
ZY
ZY
ZY
ZY
ZY
ZY
ZY
ZY
ZY
ZY
ZY
ZY
ZY
ZY
ZY
ZY
ZY
ZY
ZY
ZY
ZY
ZY
ZY
ZY
ZY
ZY
ZY
ZY
ZY
Bx
ZY
ZY
ZY
ZY
ZY
ZY
ZY
ZY
ZY
ZY
ZY
ZY
ZY
ZY
ZY
ZY
"}
(70,1,1) = {"
ZY
ZY
ZY
ZY
ZY
ZY
ZY
ZY
ZY
ZY
ZY
ZY
ZY
ZY
ZY
ZY
ZY
ZY
ZY
ZY
ZY
ZY
ZY
ZY
ZY
ZY
ZY
ZY
ZY
ZY
ZY
ZY
ZY
ZY
ZY
ZY
ZY
ZY
ZY
ZY
ZY
ZY
ZY
ZY
ZY
ZY
ZY
ZY
ZY
ZY
ZY
ZY
ZY
ZY
Bx
ZY
ZY
ZY
ZY
ZY
ZY
ZY
ZY
ZY
ZY
ZY
ZY
ZY
ZY
ZY
ZY
"}
(71,1,1) = {"
ZY
ZY
ZY
ZY
ZY
ZY
ZY
ZY
ZY
ZY
ZY
ZY
ZY
ZY
ZY
ZY
ZY
ZY
ZY
ZY
ZY
ZY
ZY
ZY
ZY
ZY
ZY
ZY
ZY
ZY
ZY
ZY
ZY
ZY
ZY
ZY
ZY
ZY
ZY
ZY
ZY
ZY
ZY
ZY
ZY
ZY
ZY
ZY
ZY
ZY
ZY
ZY
ZY
ZY
Bx
ZY
ZY
ZY
ZY
ZY
ZY
ZY
ZY
ZY
ZY
ZY
ZY
ZY
ZY
ZY
ZY
"}
(72,1,1) = {"
ZY
ZY
ZY
ZY
ZY
ZY
ZY
ZY
ZY
ZY
ZY
ZY
ZY
ZY
ZY
ZY
ZY
ZY
ZY
ZY
ZY
ZY
ZY
ZY
ZY
ZY
ZY
ZY
ZY
ZY
ZY
ZY
ZY
ZY
ZY
ZY
ZY
ZY
ZY
ZY
ZY
ZY
ZY
ZY
ZY
ZY
ZY
ZY
ZY
ZY
ZY
ZY
ZY
ZY
Bx
ZY
ZY
ZY
ZY
ZY
ZY
ZY
ZY
ZY
ZY
ZY
ZY
ZY
ZY
ZY
ZY
"}
(73,1,1) = {"
ZY
ZY
ZY
ZY
ZY
ZY
ZY
ZY
ZY
ZY
ZY
ZY
ZY
ZY
ZY
ZY
ZY
ZY
ZY
ZY
ZY
ZY
ZY
ZY
ZY
ZY
ZY
ZY
ZY
ZY
ZY
ZY
ZY
ZY
ZY
ZY
ZY
ZY
ZY
ZY
ZY
ZY
ZY
ZY
ZY
ZY
ZY
ZY
ZY
ZY
ZY
ZY
ZY
ZY
Bx
ZY
ZY
ZY
ZY
ZY
ZY
ZY
ZY
ZY
ZY
ZY
ZY
ZY
ZY
ZY
ZY
"}
(74,1,1) = {"
ZY
ZY
ZY
ZY
ZY
ZY
ZY
ZY
ZY
ZY
ZY
ZY
ZY
ZY
ZY
ZY
ZY
ZY
ZY
ZY
ZY
ZY
ZY
ZY
ZY
ZY
ZY
ZY
ZY
ZY
ZY
ZY
ZY
ZY
ZY
ZY
ZY
ZY
ZY
ZY
ZY
ZY
ZY
ZY
ZY
ZY
ZY
ZY
ZY
ZY
ZY
ZY
ZY
ZY
Bx
ZY
ZY
ZY
ZY
ZY
ZY
ZY
ZY
ZY
ZY
ZY
ZY
ZY
ZY
ZY
ZY
"}
(75,1,1) = {"
ZY
ZY
ZY
ZY
ZY
ZY
ZY
ZY
ZY
ZY
ZY
ZY
ZY
ZY
ZY
ZY
ZY
ZY
ZY
ZY
ZY
ZY
ZY
ZY
ZY
ZY
ZY
ZY
ZY
ZY
ZY
ZY
ZY
ZY
ZY
ZY
ZY
ZY
ZY
ZY
ZY
ZY
ZY
ZY
ZY
ZY
ZY
ZY
ZY
ZY
ZY
ZY
ZY
ZY
Bx
ZY
ZY
ZY
ZY
ZY
ZY
ZY
ZY
ZY
ZY
ZY
ZY
ZY
ZY
ZY
ZY
"}
(76,1,1) = {"
ZY
ZY
ZY
ZY
ZY
ZY
ZY
ZY
ZY
ZY
ZY
ZY
ZY
ZY
ZY
ZY
ZY
ZY
ZY
ZY
ZY
ZY
ZY
ZY
ZY
ZY
ZY
ZY
ZY
ZY
ZY
ZY
ZY
ZY
ZY
ZY
ZY
ZY
ZY
ZY
ZY
ZY
ZY
ZY
ZY
ZY
ZY
ZY
ZY
ZY
ZY
ZY
ZY
ZY
Bx
ZY
ZY
ZY
ZY
ZY
ZY
ZY
ZY
ZY
ZY
ZY
ZY
ZY
ZY
ZY
ZY
"}
(77,1,1) = {"
ZY
ZY
ZY
ZY
ZY
ZY
ZY
ZY
ZY
ZY
ZY
ZY
ZY
ZY
ZY
ZY
ZY
ZY
ZY
ZY
ZY
ZY
ZY
ZY
ZY
ZY
ZY
ZY
ZY
ZY
ZY
ZY
ZY
ZY
ZY
ZY
ZY
ZY
ZY
ZY
ZY
ZY
ZY
ZY
ZY
ZY
ZY
ZY
ZY
ZY
ZY
ZY
ZY
ZY
Bx
ZY
ZY
ZY
ZY
ZY
ZY
ZY
ZY
ZY
ZY
ZY
ZY
ZY
ZY
ZY
ZY
"}
(78,1,1) = {"
ZY
ZY
ZY
ZY
ZY
ZY
ZY
ZY
ZY
ZY
ZY
ZY
ZY
ZY
ZY
ZY
ZY
ZY
ZY
ZY
ZY
ZY
ZY
ZY
ZY
ZY
ZY
ZY
ZY
ZY
ZY
ZY
ZY
ZY
ZY
ZY
ZY
ZY
ZY
ZY
ZY
ZY
ZY
ZY
ZY
ZY
ZY
ZY
ZY
ZY
ZY
ZY
ZY
ZY
Bx
ZY
ZY
ZY
ZY
ZY
ZY
ZY
ZY
ZY
ZY
ZY
ZY
ZY
ZY
ZY
ZY
"}
(79,1,1) = {"
ZY
ZY
ZY
ZY
ZY
ZY
ZY
ZY
ZY
ZY
ZY
ZY
ZY
ZY
ZY
ZY
ZY
ZY
ZY
ZY
ZY
ZY
ZY
ZY
ZY
ZY
ZY
ZY
ZY
ZY
ZY
ZY
ZY
ZY
ZY
ZY
ZY
ZY
ZY
ZY
ZY
ZY
ZY
ZY
ZY
ZY
ZY
ZY
ZY
ZY
ZY
ZY
ZY
ZY
Bx
ZY
ZY
ZY
ZY
ZY
ZY
ZY
ZY
ZY
ZY
ZY
ZY
ZY
ZY
ZY
ZY
"}
(80,1,1) = {"
ZY
ZY
ZY
ZY
ZY
ZY
ZY
ZY
ZY
ZY
ZY
ZY
ZY
ZY
ZY
ZY
ZY
ZY
ZY
ZY
ZY
ZY
ZY
ZY
ZY
ZY
ZY
ZY
ZY
ZY
ZY
ZY
ZY
ZY
ZY
ZY
ZY
ZY
ZY
ZY
ZY
ZY
ZY
ZY
ZY
ZY
ZY
ZY
ZY
ZY
ZY
ZY
ZY
ZY
sU
ZY
ZY
ZY
ZY
ZY
ZY
ZY
ZY
ZY
ZY
ZY
ZY
ZY
ZY
ZY
ZY
"}
