//MAP CONVERTED BY dmm2tgm.py THIS HEADER COMMENT PREVENTS RECONVERSION, DO NOT REMOVE
"br" = (
/obj/machinery/light/small/directional/east,
/mob/living/basic/trooper/russian/ranged,
/turf/open/floor/mineral/plastitanium,
/area/ruin/space/has_grav/powered/prison_shuttle)
"bA" = (
/turf/closed/wall/mineral/plastitanium/nodiagonal,
/area/ruin/space/has_grav/powered/prison_shuttle)
"cP" = (
/obj/structure/chair/office{
	dir = 8
	},
/obj/effect/turf_decal/siding/yellow{
	dir = 2
	},
/turf/open/floor/mineral/plastitanium,
/area/ruin/space/has_grav/powered/prison_shuttle)
"da" = (
/turf/template_noop,
/area/template_noop)
"dj" = (
/obj/structure/chair/office{
	dir = 1
	},
/turf/open/floor/mineral/plastitanium,
/area/ruin/space/has_grav/powered/prison_shuttle)
"dI" = (
/turf/open/floor/plating/airless,
/area/ruin/space/has_grav/powered/prison_shuttle)
"ev" = (
/obj/structure/table,
/obj/item/food/meat/steak/bear,
/turf/open/floor/mineral/plastitanium,
/area/ruin/space/has_grav/powered/prison_shuttle)
"eC" = (
/obj/machinery/computer{
	desc = "A computer long since rendered non-functional due to lack of maintenance. Spitting out error messages.";
	dir = 8;
	name = "Broken Computer"
	},
/obj/effect/turf_decal/siding/yellow{
	dir = 4
	},
/obj/effect/turf_decal/tile/dark_red/half{
	dir = 8
	},
/turf/open/floor/mineral/plastitanium,
/area/ruin/space/has_grav/powered/prison_shuttle)
"fg" = (
/obj/effect/turf_decal/stripes/white{
	dir = 8
	},
/turf/open/floor/mineral/plastitanium,
/area/ruin/space/has_grav/powered/prison_shuttle)
"fV" = (
/obj/structure/table,
/obj/item/food/meat/steak/bear,
/obj/machinery/light/small/directional/north,
/turf/open/floor/mineral/plastitanium,
/area/ruin/space/has_grav/powered/prison_shuttle)
"fZ" = (
/obj/machinery/computer{
	desc = "A computer long since rendered non-functional due to lack of maintenance. Spitting out error messages.";
	dir = 4;
	name = "Broken Computer"
	},
/obj/effect/turf_decal/siding/yellow{
	dir = 8
	},
/obj/effect/turf_decal/tile/green/half{
	dir = 4
	},
/turf/open/floor/mineral/plastitanium,
/area/ruin/space/has_grav/powered/prison_shuttle)
"hG" = (
/obj/machinery/computer{
	desc = "A computer long since rendered non-functional due to lack of maintenance. Spitting out error messages.";
	dir = 4;
	name = "Broken Computer"
	},
/obj/machinery/light/small/directional/west,
/turf/open/floor/mineral/plastitanium/red,
/area/ruin/space/has_grav/powered/prison_shuttle)
"io" = (
/obj/effect/spawner/structure/window/reinforced/shuttle,
/obj/effect/spawner/structure/window/reinforced/plasma/plastitanium,
/turf/open/floor/plating,
/area/ruin/space/has_grav/powered/prison_shuttle)
"is" = (
/obj/structure/rack,
/obj/item/gun/ballistic/automatic/surplus,
/obj/item/gun/ballistic/automatic/surplus{
	pixel_y = -7
	},
/obj/item/ammo_box/magazine/m10mm/rifle{
	pixel_x = 6;
	pixel_y = 9
	},
/obj/item/ammo_box/magazine/m10mm/rifle{
	pixel_x = 1;
	pixel_y = 9
	},
/obj/item/ammo_box/magazine/m10mm/rifle{
	pixel_x = -4;
	pixel_y = 9
	},
/obj/item/ammo_box/magazine/m10mm/rifle{
	pixel_x = -9;
	pixel_y = 9
	},
/turf/open/floor/mineral/plastitanium,
/area/ruin/space/has_grav/powered/prison_shuttle)
"kx" = (
/mob/living/basic/trooper/russian,
/turf/open/floor/mineral/plastitanium,
/area/ruin/space/has_grav/powered/prison_shuttle)
"lk" = (
/obj/machinery/power/shuttle_engine/huge,
/turf/template_noop,
/area/ruin/space/has_grav/powered/prison_shuttle)
"lT" = (
/turf/template_noop,
/area/ruin/space/has_grav/powered/prison_shuttle)
"nr" = (
/obj/structure/table,
/obj/item/food/burger/bearger,
/obj/machinery/light/small/directional/south,
/turf/open/floor/mineral/plastitanium,
/area/ruin/space/has_grav/powered/prison_shuttle)
"nG" = (
/turf/open/floor/iron/stairs/left,
/area/ruin/space/has_grav/powered/prison_shuttle)
"nH" = (
/obj/structure/table,
/obj/item/food/bearsteak,
/turf/open/floor/mineral/plastitanium,
/area/ruin/space/has_grav/powered/prison_shuttle)
"oI" = (
/obj/structure/table,
/obj/item/food/meat/steak/bear,
/obj/machinery/light/small/directional/south,
/turf/open/floor/mineral/plastitanium,
/area/ruin/space/has_grav/powered/prison_shuttle)
"oY" = (
/obj/structure/chair/office,
/turf/open/floor/mineral/plastitanium,
/area/ruin/space/has_grav/powered/prison_shuttle)
"qg" = (
/obj/machinery/computer{
	desc = "A computer long since rendered non-functional due to lack of maintenance. Spitting out error messages.";
	dir = 8;
	name = "Broken Computer"
	},
/obj/effect/turf_decal/siding/yellow{
	dir = 6
	},
/obj/effect/turf_decal/tile/purple/half{
	dir = 8
	},
/turf/open/floor/mineral/plastitanium,
/area/ruin/space/has_grav/powered/prison_shuttle)
"qU" = (
/obj/machinery/power/shuttle_engine/heater,
/turf/closed/wall/mineral/plastitanium,
/area/ruin/space/has_grav/powered/prison_shuttle)
"rZ" = (
/obj/effect/turf_decal/tile/green/half{
	dir = 8
	},
/turf/open/floor/mineral/plastitanium,
/area/ruin/space/has_grav/powered/prison_shuttle)
"ta" = (
/obj/machinery/porta_turret/syndicate/energy{
	dir = 4
	},
/turf/closed/wall/mineral/plastitanium,
/area/ruin/space/has_grav/powered/prison_shuttle)
"tm" = (
/turf/open/floor/mineral/plastitanium,
/area/ruin/space/has_grav/powered/prison_shuttle)
"uu" = (
/obj/structure/table,
/obj/item/food/bearsteak,
/turf/open/floor/mineral/plastitanium/red,
/area/ruin/space/has_grav/powered/prison_shuttle)
"uU" = (
/obj/machinery/power/shuttle_engine/large,
/turf/template_noop,
/area/ruin/space/has_grav/powered/prison_shuttle)
"vq" = (
/obj/effect/turf_decal/siding/yellow/end{
	dir = 1
	},
/turf/open/floor/mineral/plastitanium,
/area/ruin/space/has_grav/powered/prison_shuttle)
"vA" = (
/obj/structure/table,
/obj/item/food/burger/bearger,
/obj/machinery/light/small/directional/west,
/turf/open/floor/mineral/plastitanium,
/area/ruin/space/has_grav/powered/prison_shuttle)
"vM" = (
/obj/effect/turf_decal/tile/blue/half{
	dir = 8
	},
/turf/open/floor/mineral/plastitanium,
/area/ruin/space/has_grav/powered/prison_shuttle)
"wx" = (
/obj/machinery/porta_turret/syndicate/energy{
	dir = 6
	},
/turf/closed/wall/mineral/plastitanium,
/area/ruin/space/has_grav/powered/prison_shuttle)
"wO" = (
/obj/structure/chair/office{
	dir = 4
	},
/turf/open/floor/mineral/plastitanium,
/area/ruin/space/has_grav/powered/prison_shuttle)
"xb" = (
/obj/effect/turf_decal/tile/dark_red/half{
	dir = 4
	},
/turf/open/floor/mineral/plastitanium,
/area/ruin/space/has_grav/powered/prison_shuttle)
"xo" = (
/obj/machinery/light/small/directional/west,
/turf/open/floor/mineral/plastitanium,
/area/ruin/space/has_grav/powered/prison_shuttle)
"xp" = (
/obj/machinery/light/small/directional/south,
/turf/open/floor/mineral/plastitanium,
/area/ruin/space/has_grav/powered/prison_shuttle)
"xI" = (
/obj/machinery/computer{
	desc = "A computer long since rendered non-functional due to lack of maintenance. Spitting out error messages.";
	dir = 8;
	name = "Broken Computer"
	},
/obj/effect/turf_decal/siding/yellow{
	dir = 5
	},
/obj/effect/turf_decal/tile/dark_green/half{
	dir = 8
	},
/turf/open/floor/mineral/plastitanium,
/area/ruin/space/has_grav/powered/prison_shuttle)
"ys" = (
/turf/closed/wall/mineral/plastitanium,
/area/ruin/space/has_grav/powered/prison_shuttle)
"yE" = (
/obj/effect/turf_decal/tile/yellow/half{
	dir = 8
	},
/turf/open/floor/mineral/plastitanium,
/area/ruin/space/has_grav/powered/prison_shuttle)
"yQ" = (
/obj/structure/table,
/obj/item/food/meat/cutlet/bear,
/obj/machinery/light/small/directional/west,
/turf/open/floor/mineral/plastitanium,
/area/ruin/space/has_grav/powered/prison_shuttle)
"zu" = (
/obj/machinery/light/small/directional/west,
/mob/living/basic/trooper/russian/ranged{
	loot = list(/obj/effect/mob_spawn/corpse/human/russian/ranged/officer,/obj/item/gun/ballistic/rifle/boltaction)
	},
/turf/open/floor/mineral/plastitanium,
/area/ruin/space/has_grav/powered/prison_shuttle)
"zy" = (
/obj/structure/table,
/turf/open/floor/mineral/plastitanium,
/area/ruin/space/has_grav/powered/prison_shuttle)
"Bh" = (
/obj/machinery/porta_turret/syndicate/energy{
	dir = 10
	},
/turf/closed/wall/mineral/plastitanium,
/area/ruin/space/has_grav/powered/prison_shuttle)
"Bx" = (
/obj/machinery/computer{
	desc = "A computer long since rendered non-functional due to lack of maintenance. Spitting out error messages.";
	dir = 4;
	name = "Broken Computer"
	},
/obj/effect/turf_decal/siding/yellow{
	dir = 9
	},
/obj/effect/turf_decal/tile/blue/half{
	dir = 4
	},
/turf/open/floor/mineral/plastitanium,
/area/ruin/space/has_grav/powered/prison_shuttle)
"BZ" = (
/obj/machinery/computer{
	desc = "A computer long since rendered non-functional due to lack of maintenance. Spitting out error messages.";
	name = "Broken Computer"
	},
/turf/open/floor/mineral/plastitanium/red,
/area/ruin/space/has_grav/powered/prison_shuttle)
"Cv" = (
/obj/effect/decal/cleanable/blood,
/obj/effect/decal/hammerandsickle,
/turf/open/floor/mineral/plastitanium,
/area/ruin/space/has_grav/powered/prison_shuttle)
"Cw" = (
/mob/living/basic/bear/russian,
/turf/open/floor/mineral/plastitanium,
/area/ruin/space/has_grav/powered/prison_shuttle)
"CX" = (
/obj/structure/chair{
	dir = 8
	},
/obj/effect/mob_spawn/corpse/human/assistant,
/obj/machinery/light/small/directional/east,
/turf/open/floor/mineral/plastitanium,
/area/ruin/space/has_grav/powered/prison_shuttle)
"DD" = (
/obj/effect/decal/cleanable/blood/splatter,
/obj/machinery/light/small/directional/east,
/turf/open/floor/mineral/plastitanium,
/area/ruin/space/has_grav/powered/prison_shuttle)
"DZ" = (
/obj/effect/turf_decal/tile/purple/half{
	dir = 4
	},
/turf/open/floor/mineral/plastitanium,
/area/ruin/space/has_grav/powered/prison_shuttle)
"ED" = (
/mob/living/basic/trooper/russian,
/turf/open/floor/mineral/plastitanium/red,
/area/ruin/space/has_grav/powered/prison_shuttle)
"ET" = (
/obj/machinery/porta_turret/syndicate/energy{
	dir = 8
	},
/turf/closed/wall/mineral/plastitanium,
/area/ruin/space/has_grav/powered/prison_shuttle)
"Fa" = (
/obj/effect/turf_decal/stripes/white{
	dir = 4
	},
/turf/open/floor/mineral/plastitanium,
/area/ruin/space/has_grav/powered/prison_shuttle)
"Hc" = (
/obj/machinery/light/small/directional/north,
/turf/open/floor/mineral/plastitanium,
/area/ruin/space/has_grav/powered/prison_shuttle)
"Hq" = (
/obj/machinery/door/airlock/external,
/obj/structure/fans/tiny,
/turf/open/floor/plating,
/area/ruin/space/has_grav/powered/prison_shuttle)
"Hy" = (
/obj/machinery/door/airlock/security/glass,
/turf/open/floor/mineral/plastitanium,
/area/ruin/space/has_grav/powered/prison_shuttle)
"HQ" = (
/obj/structure/table,
/obj/item/food/meat/cutlet/bear,
/turf/open/floor/mineral/plastitanium,
/area/ruin/space/has_grav/powered/prison_shuttle)
"HZ" = (
/obj/machinery/power/shuttle_engine/propulsion{
	dir = 1
	},
/turf/template_noop,
/area/ruin/space/has_grav/powered/prison_shuttle)
"IR" = (
/obj/structure/chair{
	dir = 4
	},
/obj/effect/mob_spawn/corpse/human/cargo_tech,
/obj/machinery/light/small/directional/west,
/turf/open/floor/mineral/plastitanium,
/area/ruin/space/has_grav/powered/prison_shuttle)
"IU" = (
/obj/machinery/computer{
	desc = "A computer long since rendered non-functional due to lack of maintenance. Spitting out error messages.";
	dir = 4;
	name = "Broken Computer"
	},
/obj/effect/turf_decal/siding/yellow{
	dir = 10
	},
/obj/effect/turf_decal/tile/yellow/half{
	dir = 4
	},
/turf/open/floor/mineral/plastitanium,
/area/ruin/space/has_grav/powered/prison_shuttle)
"Jn" = (
/obj/structure/table,
/obj/item/food/meat/steak/bear,
/turf/open/floor/mineral/plastitanium/red,
/area/ruin/space/has_grav/powered/prison_shuttle)
"Jo" = (
/obj/effect/decal/cleanable/blood/splatter,
/turf/open/floor/mineral/plastitanium,
/area/ruin/space/has_grav/powered/prison_shuttle)
"JG" = (
/obj/effect/decal/hammerandsickle,
/turf/open/floor/mineral/plastitanium,
/area/ruin/space/has_grav/powered/prison_shuttle)
"Ku" = (
/obj/structure/chair/office{
	dir = 8
	},
/obj/effect/turf_decal/siding/yellow/corner{
	dir = 1
	},
/obj/effect/turf_decal/siding/yellow/corner{
	dir = 4
	},
/turf/open/floor/mineral/plastitanium,
/area/ruin/space/has_grav/powered/prison_shuttle)
"Lc" = (
/obj/machinery/power/shuttle_engine/heater{
	dir = 1
	},
/turf/open/floor/plating,
/area/ruin/space/has_grav/powered/prison_shuttle)
"LU" = (
/obj/machinery/light/small/directional/east,
/turf/open/floor/mineral/plastitanium,
/area/ruin/space/has_grav/powered/prison_shuttle)
"MR" = (
/obj/structure/chair{
	dir = 8
	},
/obj/effect/mob_spawn/corpse/human/cargo_tech,
/obj/machinery/light/small/directional/east,
/turf/open/floor/mineral/plastitanium,
/area/ruin/space/has_grav/powered/prison_shuttle)
"NJ" = (
/turf/open/floor/iron/stairs/right,
/area/ruin/space/has_grav/powered/prison_shuttle)
"NS" = (
/obj/machinery/door/poddoor,
/obj/effect/spawner/structure/window/reinforced/plasma/plastitanium,
/turf/open/floor/plating,
/area/ruin/space/has_grav/powered/prison_shuttle)
"NZ" = (
/obj/effect/turf_decal/siding/yellow{
	dir = 4
	},
/turf/open/floor/mineral/plastitanium,
/area/ruin/space/has_grav/powered/prison_shuttle)
"OX" = (
/turf/open/floor/mineral/plastitanium/red,
/area/ruin/space/has_grav/powered/prison_shuttle)
"Qg" = (
/obj/effect/decal/cleanable/blood,
/turf/open/floor/mineral/plastitanium,
/area/ruin/space/has_grav/powered/prison_shuttle)
"QP" = (
/obj/machinery/power/shuttle_engine/propulsion{
	dir = 1
	},
/turf/template_noop,
/area/template_noop)
"Rj" = (
/obj/effect/decal/cleanable/blood,
/obj/machinery/light/small/directional/east,
/turf/open/floor/mineral/plastitanium,
/area/ruin/space/has_grav/powered/prison_shuttle)
"Sb" = (
/obj/machinery/computer{
	desc = "A computer long since rendered non-functional due to lack of maintenance. Spitting out error messages.";
	dir = 1;
	name = "Broken Computer"
	},
/turf/open/floor/mineral/plastitanium/red,
/area/ruin/space/has_grav/powered/prison_shuttle)
"Us" = (
/obj/structure/chair{
	dir = 4
	},
/obj/effect/mob_spawn/corpse/human/assistant,
/obj/machinery/light/small/directional/west,
/turf/open/floor/mineral/plastitanium,
/area/ruin/space/has_grav/powered/prison_shuttle)
"UX" = (
/obj/effect/turf_decal/siding/yellow{
	dir = 8
	},
/turf/open/floor/mineral/plastitanium,
/area/ruin/space/has_grav/powered/prison_shuttle)
"Vq" = (
/obj/effect/turf_decal/tile/dark_green/half{
	dir = 4
	},
/turf/open/floor/mineral/plastitanium,
/area/ruin/space/has_grav/powered/prison_shuttle)
"Vw" = (
/turf/open/floor/iron/stairs/medium,
/area/ruin/space/has_grav/powered/prison_shuttle)
"Vy" = (
/mob/living/basic/trooper/russian/ranged{
	loot = list(/obj/effect/mob_spawn/corpse/human/russian/ranged/officer,/obj/item/gun/ballistic/rifle/boltaction)
	},
/turf/open/floor/mineral/plastitanium,
/area/ruin/space/has_grav/powered/prison_shuttle)
"Xa" = (
/obj/structure/table,
/obj/item/food/burger/bearger,
/turf/open/floor/mineral/plastitanium,
/area/ruin/space/has_grav/powered/prison_shuttle)
"XH" = (
/obj/structure/table,
/obj/item/food/meat/steak/bear,
/obj/machinery/light/small/directional/east,
/turf/open/floor/mineral/plastitanium,
/area/ruin/space/has_grav/powered/prison_shuttle)
"Yp" = (
/obj/machinery/power/shuttle_engine/heater{
	dir = 1
	},
/turf/closed/wall/mineral/plastitanium,
/area/ruin/space/has_grav/powered/prison_shuttle)
"ZG" = (
/obj/item/gps/spaceruin,
/turf/open/floor/mineral/plastitanium,
/area/ruin/space/has_grav/powered/prison_shuttle)

(1,1,1) = {"
da
da
da
da
da
da
da
da
da
da
da
QP
Yp
ys
ys
ys
ys
ys
ys
ys
da
da
da
da
da
da
da
da
da
da
"}
(2,1,1) = {"
da
da
da
da
da
HZ
Lc
Bh
ys
ys
Hq
ys
bA
IR
bA
Us
bA
Us
bA
ys
ys
ys
ys
ys
ys
ys
ys
ET
ys
da
"}
(3,1,1) = {"
da
da
da
da
HZ
Lc
ys
ys
bA
hG
fg
tm
bA
Hy
bA
Hy
bA
Hy
bA
nH
yQ
ev
tm
tm
ev
nr
qU
dI
dI
lk
"}
(4,1,1) = {"
ys
ys
NS
NS
ys
ys
bA
bA
bA
Qg
tm
Jo
tm
vM
tm
rZ
tm
yE
tm
tm
kx
tm
tm
Qg
tm
ev
qU
dI
dI
lT
"}
(5,1,1) = {"
ys
vA
ev
ev
tm
zu
uu
ev
bA
Xa
kx
tm
tm
tm
tm
Jo
tm
tm
tm
tm
tm
tm
tm
tm
tm
HQ
qU
dI
dI
lT
"}
(6,1,1) = {"
NS
BZ
tm
tm
tm
tm
ED
Xa
bA
ev
tm
tm
Rj
tm
tm
tm
tm
tm
tm
tm
tm
tm
LU
tm
tm
tm
bA
ys
ys
da
"}
(7,1,1) = {"
NS
BZ
dj
tm
tm
tm
OX
xp
bA
fV
tm
tm
ys
io
io
io
io
io
ys
Hc
tm
ys
ys
ys
tm
oY
Sb
qU
dI
uU
"}
(8,1,1) = {"
NS
BZ
tm
tm
tm
tm
OX
tm
nG
tm
tm
tm
io
Bx
UX
fZ
UX
IU
io
tm
tm
ys
ZG
io
tm
tm
tm
qU
dI
lT
"}
(9,1,1) = {"
NS
Hc
tm
tm
JG
tm
OX
tm
Vw
tm
tm
tm
vq
Ku
Vy
wO
Vy
cP
io
tm
tm
ys
Cw
Hy
tm
Cv
xp
ys
ys
da
"}
(10,1,1) = {"
NS
BZ
tm
tm
tm
tm
OX
Jo
NJ
tm
tm
tm
io
xI
NZ
eC
NZ
qg
io
tm
tm
ys
is
io
tm
tm
tm
qU
dI
uU
"}
(11,1,1) = {"
NS
BZ
dj
tm
tm
tm
OX
xp
bA
fV
Qg
tm
ys
io
io
io
io
io
ys
Hc
tm
ys
ys
ys
tm
oY
Sb
qU
dI
lT
"}
(12,1,1) = {"
NS
BZ
tm
tm
tm
tm
ED
HQ
bA
nH
tm
tm
xo
tm
tm
tm
tm
tm
tm
tm
tm
tm
xo
tm
tm
tm
bA
ys
ys
da
"}
(13,1,1) = {"
ys
XH
nH
ev
tm
br
Jn
Xa
bA
ev
kx
tm
tm
Qg
tm
tm
tm
tm
tm
tm
tm
tm
tm
tm
tm
HQ
qU
dI
dI
lk
"}
(14,1,1) = {"
ys
ys
NS
NS
ys
ys
bA
bA
bA
tm
tm
tm
tm
Vq
tm
xb
tm
DZ
tm
tm
kx
tm
tm
tm
tm
ev
qU
dI
dI
lT
"}
(15,1,1) = {"
da
da
da
da
HZ
Lc
ys
bA
bA
DD
Fa
tm
bA
Hy
bA
Hy
bA
Hy
bA
zy
XH
Xa
tm
tm
nH
oI
qU
dI
dI
lT
"}
(16,1,1) = {"
da
da
da
da
da
HZ
Lc
wx
ys
ys
Hq
ys
bA
CX
bA
MR
bA
MR
bA
ys
ys
ys
ys
ys
ys
ys
ys
ta
ys
da
"}
(17,1,1) = {"
da
da
da
da
da
da
da
da
da
da
da
QP
Yp
ys
ys
ys
ys
ys
ys
ys
da
da
da
da
da
da
da
da
da
da
"}
