//MAP CONVERTED BY dmm2tgm.py THIS HEADER COMMENT PREVENTS RECONVERSION, DO NOT REMOVE
"a" = (
/turf/template_noop,
/area/template_noop)
"c" = (
/obj/machinery/door/airlock/medical,
/obj/effect/mapping_helpers/airlock/access/all,
/turf/open/floor/iron,
/area/ruin/space/has_grav/powered/skyrat/smugglies)
"d" = (
/obj/item/reagent_containers/cocainebrick{
	pixel_x = 7;
	pixel_y = 8
	},
/obj/item/reagent_containers/cocaine{
	pixel_y = 4
	},
/obj/structure/table,
/turf/open/floor/iron,
/area/ruin/space/has_grav/powered/skyrat/smugglies)
"e" = (
/obj/machinery/hydroponics/constructable,
/turf/open/floor/grass,
/area/ruin/space/has_grav/powered/skyrat/smugglies)
"g" = (
/obj/effect/spawner/structure/window/reinforced/tinted,
/turf/open/floor/plating,
/area/ruin/space/has_grav/powered/skyrat/smugglies)
"h" = (
/obj/effect/turf_decal/stripes/asteroid/corner{
	dir = 4
	},
/turf/open/misc/asteroid/airless,
/area/ruin/unpowered/no_grav)
"k" = (
/obj/effect/turf_decal/stripes/asteroid/line{
	dir = 1
	},
/turf/open/misc/asteroid/airless,
/area/ruin/unpowered/no_grav)
"m" = (
/turf/open/floor/iron/grimy,
/area/ruin/space/has_grav/powered/skyrat/smugglies)
"o" = (
/turf/open/floor/iron,
/area/ruin/space/has_grav/powered/skyrat/smugglies)
"t" = (
/obj/machinery/light/directional/east,
/turf/open/floor/iron,
/area/ruin/space/has_grav/powered/skyrat/smugglies)
"u" = (
/obj/machinery/door/airlock/mining{
	name = "Backroom"
	},
/obj/effect/turf_decal/siding/thinplating/dark/corner{
	dir = 1
	},
/obj/effect/mapping_helpers/airlock/access/all,
/turf/open/floor/iron,
/area/ruin/space/has_grav/powered/skyrat/smugglies)
"v" = (
/obj/effect/turf_decal/siding/thinplating/dark,
/turf/open/floor/iron,
/area/ruin/space/has_grav/powered/skyrat/smugglies)
"w" = (
/obj/structure/lattice/catwalk,
/obj/structure/marker_beacon/burgundy,
/turf/template_noop,
/area/template_noop)
"y" = (
/obj/structure/table,
/obj/effect/spawner/random/entertainment/money,
/obj/effect/spawner/random/entertainment/money,
/turf/open/floor/iron,
/area/ruin/space/has_grav/powered/skyrat/smugglies)
"z" = (
/turf/closed/mineral/random,
/area/ruin/unpowered/no_grav)
"A" = (
/obj/structure/chair/office,
/turf/open/floor/iron/dark,
/area/ruin/space/has_grav/powered/skyrat/smugglies)
"B" = (
/obj/machinery/door/airlock/external,
/obj/effect/mapping_helpers/airlock/access/all,
/turf/open/floor/plating,
/area/ruin/space/has_grav/powered/skyrat/smugglies)
"C" = (
/obj/effect/turf_decal/stripes/asteroid/corner{
	dir = 1
	},
/turf/open/misc/asteroid/airless,
/area/ruin/unpowered/no_grav)
"E" = (
/obj/machinery/vending/hydronutrients,
/turf/open/floor/iron,
/area/ruin/space/has_grav/powered/skyrat/smugglies)
"F" = (
/turf/open/misc/asteroid/airless,
/area/ruin/unpowered/no_grav)
"H" = (
/obj/machinery/light/directional/north,
/turf/open/floor/iron/grimy,
/area/ruin/space/has_grav/powered/skyrat/smugglies)
"I" = (
/obj/structure/closet/secure_closet/hydroponics{
	req_access = null
	},
/obj/item/gun/energy/floragun,
/turf/open/floor/iron,
/area/ruin/space/has_grav/powered/skyrat/smugglies)
"K" = (
/turf/open/floor/plating,
/area/ruin/space/has_grav/powered/skyrat/smugglies)
"L" = (
/obj/structure/table/reinforced,
/obj/machinery/door/firedoor,
/obj/machinery/door/window/left/directional/north,
/turf/open/floor/plating,
/area/ruin/space/has_grav/powered/skyrat/smugglies)
"N" = (
/obj/structure/sink/directional/west,
/turf/open/floor/iron,
/area/ruin/space/has_grav/powered/skyrat/smugglies)
"O" = (
/turf/closed/wall/mineral/iron,
/area/ruin/space/has_grav/powered/skyrat/smugglies)
"Q" = (
/obj/machinery/light/directional/north,
/obj/structure/table,
/turf/open/floor/iron,
/area/ruin/space/has_grav/powered/skyrat/smugglies)
"R" = (
/obj/structure/sign/poster/contraband/random/directional/north,
/obj/structure/table,
/turf/open/floor/iron,
/area/ruin/space/has_grav/powered/skyrat/smugglies)
"S" = (
/obj/effect/turf_decal/siding/thinplating,
/turf/open/floor/iron,
/area/ruin/space/has_grav/powered/skyrat/smugglies)
"U" = (
/obj/effect/turf_decal/siding/thinplating/dark{
	dir = 8
	},
/turf/open/floor/iron,
/area/ruin/space/has_grav/powered/skyrat/smugglies)
"V" = (
/obj/machinery/vending/hydroseeds,
/turf/open/floor/iron,
/area/ruin/space/has_grav/powered/skyrat/smugglies)
"W" = (
/obj/structure/table,
/obj/item/seeds/cocoapod,
/obj/item/folded_navigation_gigabeacon,
/turf/open/floor/iron,
/area/ruin/space/has_grav/powered/skyrat/smugglies)
"Y" = (
/obj/machinery/computer/crew/syndie{
	dir = 8
	},
/turf/open/floor/iron/dark,
/area/ruin/space/has_grav/powered/skyrat/smugglies)
"Z" = (
/obj/effect/turf_decal/siding/thinplating/dark/corner{
	dir = 8
	},
/turf/open/floor/iron,
/area/ruin/space/has_grav/powered/skyrat/smugglies)

(1,1,1) = {"
a
a
a
a
z
z
a
a
a
z
a
a
a
a
a
"}
(2,1,1) = {"
a
a
z
z
z
z
a
a
z
z
z
a
a
a
a
"}
(3,1,1) = {"
a
a
z
z
z
z
z
a
z
z
z
z
a
a
a
"}
(4,1,1) = {"
a
z
z
z
z
z
z
z
z
z
z
z
z
a
a
"}
(5,1,1) = {"
a
z
z
O
O
O
O
O
O
O
O
O
z
z
w
"}
(6,1,1) = {"
z
z
z
O
R
v
A
L
m
m
o
O
O
O
h
"}
(7,1,1) = {"
z
z
z
O
Q
v
Y
O
H
m
o
B
K
B
k
"}
(8,1,1) = {"
z
z
z
O
y
Z
U
u
o
o
o
O
O
O
C
"}
(9,1,1) = {"
z
z
z
O
g
c
g
O
O
O
O
O
z
z
w
"}
(10,1,1) = {"
z
z
z
O
I
o
W
d
o
S
e
O
z
z
F
"}
(11,1,1) = {"
z
z
z
O
V
o
o
o
o
S
e
O
z
z
z
"}
(12,1,1) = {"
z
z
z
O
E
o
o
t
N
S
e
O
z
z
z
"}
(13,1,1) = {"
z
z
z
O
O
O
O
O
O
O
O
O
z
z
a
"}
(14,1,1) = {"
a
z
z
z
z
z
z
z
z
z
z
z
z
a
a
"}
(15,1,1) = {"
a
a
z
z
z
z
z
z
z
z
z
a
a
a
a
"}
(16,1,1) = {"
a
a
a
z
z
z
z
z
z
z
a
a
a
a
a
"}
