"a" = (/turf/template_noop,/area/template_noop)
"b" = (/obj/effect/turf_decal/sand/plating,/turf/open/floor/plating/ashplanet/rocky,/area/template_noop)
"c" = (/obj/effect/turf_decal/sand/plating,/obj/structure/chair/sofa/bench/left{dir = 8},/turf/open/floor/plating/ashplanet/rocky,/area/template_noop)
"f" = (/obj/effect/turf_decal/trimline/yellow/warning{dir = 4},/obj/effect/turf_decal/sand/plating,/turf/open/floor/iron/dark/smooth_large,/area/template_noop)
"n" = (/obj/effect/turf_decal/trimline/yellow/line{dir = 4},/obj/effect/turf_decal/sand/plating,/turf/open/floor/plating,/area/template_noop)
"q" = (/obj/effect/turf_decal/sand/plating,/obj/structure/water_source/puddle,/turf/open/floor/plating/ashplanet/rocky,/area/template_noop)
"r" = (/obj/effect/turf_decal/trimline/yellow/line,/obj/effect/turf_decal/sand/plating,/turf/open/floor/plating,/area/template_noop)
"x" = (/obj/effect/turf_decal/trimline/yellow/line{dir = 8},/obj/effect/turf_decal/sand/plating,/turf/open/floor/plating,/area/template_noop)
"y" = (/obj/effect/turf_decal/trimline/yellow/warning{dir = 10},/obj/effect/turf_decal/sand/plating,/turf/open/floor/iron/dark/smooth_large,/area/template_noop)
"B" = (/obj/effect/turf_decal/trimline/yellow/line{dir = 1},/obj/effect/turf_decal/sand/plating,/turf/open/floor/plating,/area/template_noop)
"G" = (/obj/effect/turf_decal/sand/plating,/obj/structure/chair/sofa/bench/corner,/turf/open/floor/plating/ashplanet/rocky,/area/template_noop)
"J" = (/obj/effect/turf_decal/trimline/yellow/warning{dir = 4},/obj/effect/turf_decal/sand/plating,/turf/open/floor/plating,/area/template_noop)
"K" = (/obj/effect/turf_decal/sand/plating,/obj/structure/chair/sofa/bench,/turf/open/floor/plating/ashplanet/rocky,/area/template_noop)
"L" = (/obj/effect/turf_decal/sand/plating,/obj/structure/chair/sofa/bench{dir = 8},/turf/open/floor/plating/ashplanet/rocky,/area/template_noop)
"M" = (/obj/effect/turf_decal/trimline/yellow/line,/obj/effect/turf_decal/sand/plating,/turf/open/floor/iron/dark/smooth_large,/area/template_noop)
"N" = (/obj/effect/turf_decal/trimline/yellow/line{dir = 1},/obj/effect/turf_decal/sand/plating,/turf/open/floor/iron/dark/smooth_large,/area/template_noop)
"O" = (/obj/effect/turf_decal/sand/plating,/obj/structure/chair/sofa/bench/right,/turf/open/floor/plating/ashplanet/rocky,/area/template_noop)
"P" = (/obj/effect/turf_decal/trimline/yellow/line{dir = 8},/obj/effect/turf_decal/sand/plating,/turf/open/floor/iron/dark/smooth_large,/area/template_noop)
"W" = (/obj/effect/turf_decal/trimline/yellow/line{dir = 4},/obj/effect/turf_decal/sand/plating,/turf/open/floor/iron/dark/smooth_large,/area/template_noop)
"X" = (/obj/effect/turf_decal/sand/plating,/turf/open/floor/plating/rust,/area/template_noop)

(1,1,1) = {"
aaaaaaaaaaa
abWxbaaaaaa
abaPbbbXaaa
aXfyMrMMraa
aXJaNNBaNaa
aXnPbXXbbaa
abWxbOKGaaa
aaWPXbqLbaa
aaWxXXXcaaa
aXWxXbaaaaa
abWxbbaaaaa
abaxbaaaaaa
aaaaaaaaaaa
"}
