//MAP CONVERTED BY dmm2tgm.py THIS HEADER COMMENT PREVENTS RECONVERSION, DO NOT REMOVE
"a" = (
/obj/docking_port/stationary{
	dir = 8;
	dwidth = 5;
	height = 7;
	id = "supply_home";
	name = "Cargo Bay";
	width = 12
	},
/turf/template_noop,
/area/template_noop)

(1,1,1) = {"
a
"}
