//MAP CONVERTED BY dmm2tgm.py THIS HEADER COMMENT PREVENTS RECONVERSION, DO NOT REMOVE
"a" = (
/obj/docking_port/stationary{
	dir = 8;
	dwidth = 11;
	height = 18;
	id = "emergency_home";
	name = "DeltaStation emergency evac bay";
	width = 30
	},
/turf/template_noop,
/area/template_noop)

(1,1,1) = {"
a
"}
