//MAP CONVERTED BY dmm2tgm.py THIS HEADER COMMENT PREVENTS RECONVERSION, DO NOT REMOVE
"a" = (
/obj/effect/turf_decal/siding/wood,
/turf/open/floor/holofloor/wood,
/area/template_noop)
"c" = (
/obj/structure/window/reinforced/tinted/fulltile,
/turf/open/floor/holofloor/dark,
/area/template_noop)
"d" = (
/obj/effect/turf_decal/siding/wood,
/obj/structure/railing,
/turf/open/floor/holofloor/wood,
/area/template_noop)
"f" = (
/obj/effect/turf_decal/siding/wood/end{
	dir = 4
	},
/turf/open/floor/holofloor/wood,
/area/template_noop)
"g" = (
/obj/item/wargame_projector/terrain,
/turf/open/floor/holofloor/space,
/area/template_noop)
"j" = (
/obj/effect/turf_decal/stripes/end{
	dir = 1
	},
/obj/structure/curtain/bounty,
/turf/open/floor/holofloor/dark,
/area/template_noop)
"k" = (
/obj/effect/turf_decal/siding/wood{
	dir = 10
	},
/obj/structure/railing{
	dir = 10
	},
/turf/open/floor/holofloor/wood,
/area/template_noop)
"l" = (
/obj/effect/turf_decal/siding/wood{
	dir = 6
	},
/obj/structure/railing,
/turf/open/floor/holofloor/wood,
/area/template_noop)
"m" = (
/obj/effect/turf_decal/siding/wood{
	dir = 5
	},
/obj/structure/railing{
	dir = 5
	},
/turf/open/floor/holofloor/wood,
/area/template_noop)
"o" = (
/obj/effect/turf_decal/siding/wood{
	dir = 1
	},
/obj/structure/railing{
	dir = 1
	},
/obj/structure/chair/wood{
	dir = 1
	},
/turf/open/floor/holofloor/wood,
/area/template_noop)
"p" = (
/turf/open/floor/holofloor{
	icon_state = "stairs"
	},
/area/template_noop)
"r" = (
/obj/effect/turf_decal/siding/wood/corner,
/obj/effect/turf_decal/siding/wood{
	dir = 1
	},
/turf/open/floor/holofloor/wood,
/area/template_noop)
"s" = (
/obj/effect/turf_decal/siding/wood/end{
	dir = 8
	},
/turf/open/floor/holofloor/wood,
/area/template_noop)
"t" = (
/obj/effect/turf_decal/siding/wood{
	dir = 5
	},
/obj/structure/table/wood,
/obj/item/binoculars,
/turf/open/floor/holofloor/wood,
/area/template_noop)
"v" = (
/obj/item/dice/d20,
/turf/open/floor/holofloor/space,
/area/template_noop)
"w" = (
/obj/effect/turf_decal/siding/wood{
	dir = 10
	},
/obj/structure/railing,
/turf/open/floor/holofloor/wood,
/area/template_noop)
"x" = (
/obj/item/storage/secure/briefcase/white/wargame_kit,
/turf/open/floor/holofloor/space,
/area/template_noop)
"y" = (
/obj/effect/turf_decal/siding/wood{
	dir = 9
	},
/obj/structure/table/wood,
/obj/item/storage/fancy/cigarettes/cigars/cohiba,
/obj/item/lighter,
/turf/open/floor/holofloor/wood,
/area/template_noop)
"z" = (
/obj/effect/turf_decal/siding/wood{
	dir = 5
	},
/obj/structure/railing{
	dir = 1
	},
/obj/structure/chair/wood{
	dir = 1
	},
/turf/open/floor/holofloor/wood,
/area/template_noop)
"A" = (
/obj/effect/turf_decal/stripes/line{
	dir = 4
	},
/obj/effect/turf_decal/stripes/line{
	dir = 8
	},
/obj/structure/curtain/bounty,
/turf/open/floor/holofloor/dark,
/area/template_noop)
"B" = (
/obj/structure/curtain/bounty,
/turf/open/floor/holofloor/dark,
/area/template_noop)
"C" = (
/obj/effect/turf_decal/siding/wood{
	dir = 1
	},
/obj/structure/chair/comfy/black,
/turf/open/floor/holofloor/wood,
/area/template_noop)
"E" = (
/turf/open/floor/holofloor{
	icon_state = "stairs";
	dir = 1
	},
/area/template_noop)
"F" = (
/obj/effect/turf_decal/siding/wood/corner{
	dir = 1
	},
/obj/effect/turf_decal/siding/wood,
/turf/open/floor/holofloor/wood,
/area/template_noop)
"G" = (
/obj/effect/turf_decal/siding/wood{
	dir = 6
	},
/obj/structure/closet/cabinet,
/obj/item/clothing/under/rank/captain/skyrat/imperial/generic/pants,
/obj/item/clothing/head/imperial/white,
/turf/open/floor/holofloor/wood,
/area/template_noop)
"H" = (
/obj/effect/turf_decal/siding/wood{
	dir = 9
	},
/obj/structure/railing{
	dir = 1
	},
/turf/open/floor/holofloor/wood,
/area/template_noop)
"I" = (
/obj/effect/turf_decal/siding/wood,
/obj/structure/closet/cabinet,
/obj/item/clothing/under/rank/captain/skyrat/imperial/generic/red,
/obj/item/clothing/head/imperial/red,
/turf/open/floor/holofloor/wood,
/area/template_noop)
"J" = (
/obj/effect/turf_decal/siding/wood{
	dir = 9
	},
/obj/structure/railing{
	dir = 9
	},
/turf/open/floor/holofloor/wood,
/area/template_noop)
"L" = (
/obj/item/wargame_projector/ships,
/turf/open/floor/holofloor/space,
/area/template_noop)
"M" = (
/obj/effect/turf_decal/siding/wood/corner{
	dir = 8
	},
/obj/effect/turf_decal/siding/wood{
	dir = 1
	},
/turf/open/floor/holofloor/wood,
/area/template_noop)
"Q" = (
/obj/effect/turf_decal/siding/wood{
	dir = 10
	},
/obj/structure/table/wood,
/obj/item/storage/secure/briefcase/white/wargame_kit,
/turf/open/floor/holofloor/wood,
/area/template_noop)
"T" = (
/obj/effect/turf_decal/siding/wood/corner{
	dir = 4
	},
/obj/effect/turf_decal/siding/wood,
/turf/open/floor/holofloor/wood,
/area/template_noop)
"V" = (
/obj/effect/turf_decal/siding/wood{
	dir = 6
	},
/obj/structure/railing{
	dir = 6
	},
/turf/open/floor/holofloor/wood,
/area/template_noop)
"X" = (
/turf/open/floor/holofloor/space,
/area/template_noop)
"Z" = (
/obj/effect/turf_decal/stripes/end,
/obj/structure/curtain/bounty,
/turf/open/floor/holofloor/dark,
/area/template_noop)

(1,1,1) = {"
y
w
X
X
X
X
X
X
H
Q
"}
(2,1,1) = {"
C
d
X
X
X
X
X
X
o
I
"}
(3,1,1) = {"
r
V
X
X
X
X
X
X
m
T
"}
(4,1,1) = {"
f
p
X
X
X
X
X
X
E
f
"}
(5,1,1) = {"
B
c
j
A
A
A
A
Z
c
B
"}
(6,1,1) = {"
s
p
x
X
X
X
X
X
E
s
"}
(7,1,1) = {"
M
k
L
g
v
X
X
X
J
F
"}
(8,1,1) = {"
C
d
X
X
X
X
X
X
o
a
"}
(9,1,1) = {"
t
l
X
X
X
X
X
X
z
G
"}
