//MAP CONVERTED BY dmm2tgm.py THIS HEADER COMMENT PREVENTS RECONVERSION, DO NOT REMOVE
"a" = (
/obj/effect/turf_decal/sand/volcanic,
/turf/open/floor/plating{
	initial_gas_mix = "hydrogen=5;helium=3;TEMP=94"
	},
/area/thefuckinmoon)
"c" = (
/obj/structure/closet/crate/hydroponics,
/obj/item/storage/bag/plants/portaseeder,
/obj/item/quickdeploy/barricade/plasteel/hydroponics,
/obj/item/quickdeploy/barricade/plasteel/hydroponics,
/obj/item/quickdeploy/barricade/plasteel/hydroponics,
/obj/item/reagent_containers/glass/bottle/nutrient/rh,
/obj/item/reagent_containers/glass/bottle/nutrient/rh,
/obj/item/circuitboard/machine/biogenerator,
/obj/effect/turf_decal/sand/volcanic,
/turf/open/floor/plating{
	initial_gas_mix = "hydrogen=5;helium=3;TEMP=94"
	},
/area/thefuckinmoon)
"g" = (
/obj/structure/closet/crate/science,
/obj/item/circuitboard/machine/circuit_imprinter/offstation,
/obj/item/circuitboard/machine/protolathe/offstation,
/obj/effect/turf_decal/sand/volcanic,
/turf/open/floor/plating{
	initial_gas_mix = "hydrogen=5;helium=3;TEMP=94"
	},
/area/thefuckinmoon)
"i" = (
/obj/structure/closet/crate/cardboard,
/obj/item/storage/box/lights/mixed,
/obj/item/survivalcapsule/tent,
/obj/effect/turf_decal/siding/thinplating_new/dark{
	dir = 6
	},
/obj/effect/turf_decal/sand/volcanic,
/turf/open/floor/plating{
	initial_gas_mix = "hydrogen=5;helium=3;TEMP=94"
	},
/area/thefuckinmoon)
"j" = (
/obj/effect/turf_decal/caution/white{
	dir = 8
	},
/obj/structure/closet/crate/solarpanel_small,
/obj/effect/turf_decal/siding/thinplating_new/dark{
	dir = 4
	},
/obj/effect/turf_decal/sand/volcanic,
/turf/open/floor/plating{
	initial_gas_mix = "hydrogen=5;helium=3;TEMP=94"
	},
/area/thefuckinmoon)
"k" = (
/obj/effect/turf_decal/siding/thinplating_new/dark{
	dir = 1
	},
/obj/effect/turf_decal/sand/volcanic,
/turf/open/floor/plating{
	initial_gas_mix = "hydrogen=5;helium=3;TEMP=94"
	},
/area/thefuckinmoon)
"l" = (
/obj/structure/closet/crate/large,
/obj/machinery/portable_atmospherics/canister/oxygen,
/obj/effect/turf_decal/siding/thinplating_new/dark{
	dir = 10
	},
/obj/effect/turf_decal/sand/volcanic,
/turf/open/floor/plating{
	initial_gas_mix = "hydrogen=5;helium=3;TEMP=94"
	},
/area/thefuckinmoon)
"p" = (
/obj/effect/turf_decal/caution/white{
	dir = 4
	},
/obj/structure/closet/crate/solarpanel_small,
/obj/effect/turf_decal/siding/thinplating_new/dark{
	dir = 8
	},
/obj/effect/turf_decal/sand/volcanic,
/turf/open/floor/plating{
	initial_gas_mix = "hydrogen=5;helium=3;TEMP=94"
	},
/area/thefuckinmoon)
"q" = (
/obj/structure/closet/crate/engineering,
/obj/item/stack/sheet/iron/fifty,
/obj/item/stack/sheet/iron/fifty,
/obj/item/stack/sheet/glass/fifty,
/obj/item/stack/sheet/glass/fifty,
/obj/item/quickdeploy/barricade/plasteel/autolathe,
/obj/effect/turf_decal/sand/volcanic,
/turf/open/floor/plating{
	initial_gas_mix = "hydrogen=5;helium=3;TEMP=94"
	},
/area/thefuckinmoon)
"t" = (
/obj/item/defibrillator/loaded,
/obj/structure/closet/crate/medical,
/obj/item/storage/medkit/surgery,
/obj/item/storage/medkit/surgery,
/obj/item/storage/box/medipens,
/obj/item/storage/box/medipens,
/obj/effect/turf_decal/siding/thinplating_new/dark{
	dir = 1
	},
/obj/effect/turf_decal/sand/volcanic,
/turf/open/floor/plating{
	initial_gas_mix = "hydrogen=5;helium=3;TEMP=94"
	},
/area/thefuckinmoon)
"z" = (
/obj/structure/closet/crate/large,
/obj/structure/reagent_dispensers/watertank,
/obj/effect/turf_decal/siding/thinplating_new/dark{
	dir = 4
	},
/obj/effect/turf_decal/sand/volcanic,
/turf/open/floor/plating{
	initial_gas_mix = "hydrogen=5;helium=3;TEMP=94"
	},
/area/thefuckinmoon)
"A" = (
/obj/structure/closet/crate/solarpanel_small,
/obj/effect/turf_decal/siding/thinplating_new/dark{
	dir = 8
	},
/obj/effect/turf_decal/sand/volcanic,
/turf/open/floor/plating{
	initial_gas_mix = "hydrogen=5;helium=3;TEMP=94"
	},
/area/thefuckinmoon)
"C" = (
/obj/structure/shipping_container/donk_co,
/obj/effect/turf_decal/siding/thinplating_new/dark{
	dir = 8
	},
/obj/effect/turf_decal/sand/volcanic,
/turf/open/floor/plating{
	initial_gas_mix = "hydrogen=5;helium=3;TEMP=94"
	},
/area/thefuckinmoon)
"D" = (
/obj/structure/closet/crate/large,
/obj/machinery/power/port_gen/pacman/pre_loaded,
/obj/effect/turf_decal/siding/thinplating_new/dark{
	dir = 4
	},
/obj/effect/turf_decal/sand/volcanic,
/turf/open/floor/plating{
	initial_gas_mix = "hydrogen=5;helium=3;TEMP=94"
	},
/area/thefuckinmoon)
"E" = (
/turf/open/misc/asteroid/basalt/moon,
/area/thefuckinmoon)
"F" = (
/obj/effect/turf_decal/caution/white{
	dir = 1
	},
/obj/effect/turf_decal/siding/thinplating_new/dark,
/obj/effect/turf_decal/sand/volcanic,
/turf/open/floor/plating{
	initial_gas_mix = "hydrogen=5;helium=3;TEMP=94"
	},
/area/thefuckinmoon)
"H" = (
/obj/structure/closet/crate/cardboard/mothic,
/obj/item/storage/box/mothic_rations,
/obj/item/storage/box/mothic_rations,
/obj/item/storage/box/mothic_rations,
/obj/effect/turf_decal/sand/volcanic,
/turf/open/floor/plating{
	initial_gas_mix = "hydrogen=5;helium=3;TEMP=94"
	},
/area/thefuckinmoon)
"I" = (
/obj/structure/marker_beacon/burgundy,
/turf/open/misc/asteroid/basalt/moon,
/area/thefuckinmoon)
"J" = (
/obj/structure/closet/crate/medical,
/obj/item/quickdeploy/barricade/plasteel/sleeper,
/obj/item/quickdeploy/barricade/plasteel/cryo,
/obj/effect/turf_decal/sand/volcanic,
/turf/open/floor/plating{
	initial_gas_mix = "hydrogen=5;helium=3;TEMP=94"
	},
/area/thefuckinmoon)
"M" = (
/obj/effect/turf_decal/siding/thinplating_new/dark{
	dir = 9
	},
/obj/effect/turf_decal/sand/volcanic,
/turf/open/floor/plating{
	initial_gas_mix = "hydrogen=5;helium=3;TEMP=94"
	},
/area/thefuckinmoon)
"N" = (
/obj/effect/mob_spawn/ghost_role/human/ds2/syndicate/event_colonizer{
	dir = 8
	},
/turf/open/misc/asteroid/basalt/moon,
/area/thefuckinmoon)
"O" = (
/obj/structure/closet/crate/large,
/obj/machinery/power/floodlight,
/obj/effect/turf_decal/siding/thinplating_new/dark{
	dir = 5
	},
/obj/effect/turf_decal/sand/volcanic,
/turf/open/floor/plating{
	initial_gas_mix = "hydrogen=5;helium=3;TEMP=94"
	},
/area/thefuckinmoon)
"P" = (
/obj/structure/closet/crate/hydroponics,
/obj/item/seeds/potato,
/obj/item/seeds/potato,
/obj/item/seeds/potato,
/obj/item/seeds/greenbean,
/obj/item/seeds/greenbean,
/obj/item/seeds/greenbean,
/obj/item/seeds/coffee,
/obj/item/seeds/coffee,
/obj/item/seeds/coffee,
/obj/item/seeds/carrot,
/obj/item/seeds/carrot,
/obj/item/seeds/carrot,
/obj/item/seeds/carrot/parsnip,
/obj/item/seeds/carrot/parsnip,
/obj/item/seeds/carrot/parsnip,
/obj/item/seeds/plump,
/obj/item/seeds/plump,
/obj/item/seeds/plump,
/obj/effect/turf_decal/sand/volcanic,
/turf/open/floor/plating{
	initial_gas_mix = "hydrogen=5;helium=3;TEMP=94"
	},
/area/thefuckinmoon)
"Q" = (
/obj/structure/closet/crate/radiation,
/obj/item/quickdeploy/barricade/plasteel/rtg,
/obj/item/quickdeploy/barricade/plasteel/rtg,
/obj/item/quickdeploy/barricade/plasteel/rtg,
/obj/effect/turf_decal/sand/volcanic,
/turf/open/floor/plating{
	initial_gas_mix = "hydrogen=5;helium=3;TEMP=94"
	},
/area/thefuckinmoon)
"T" = (
/obj/structure/closet/crate/cardboard/tiziran,
/obj/item/quickdeploy/barricade/plasteel/orm,
/obj/item/circuitboard/machine/bluespace_miner,
/obj/item/circuitboard/computer/cargo/express,
/obj/effect/turf_decal/siding/thinplating_new/dark,
/obj/effect/turf_decal/sand/volcanic,
/turf/open/floor/plating{
	initial_gas_mix = "hydrogen=5;helium=3;TEMP=94"
	},
/area/thefuckinmoon)
"U" = (
/obj/structure/closet/crate/internals,
/obj/item/bodybag/environmental,
/obj/item/bodybag/environmental,
/obj/item/bodybag/environmental,
/obj/item/bodybag/environmental,
/obj/item/bodybag/environmental,
/obj/item/bodybag/environmental,
/obj/item/bodybag/environmental,
/obj/item/bodybag/environmental,
/obj/item/bodybag/environmental,
/obj/effect/turf_decal/siding/thinplating_new/dark,
/obj/effect/turf_decal/sand/volcanic,
/turf/open/floor/plating{
	initial_gas_mix = "hydrogen=5;helium=3;TEMP=94"
	},
/area/thefuckinmoon)
"Z" = (
/obj/effect/turf_decal/caution/white,
/obj/effect/turf_decal/siding/thinplating_new/dark{
	dir = 1
	},
/obj/effect/turf_decal/sand/volcanic,
/turf/open/floor/plating{
	initial_gas_mix = "hydrogen=5;helium=3;TEMP=94"
	},
/area/thefuckinmoon)

(1,1,1) = {"
I
N
N
I
E
E
I
"}
(2,1,1) = {"
E
M
C
p
A
l
E
"}
(3,1,1) = {"
E
k
a
g
H
T
E
"}
(4,1,1) = {"
I
Z
a
Q
P
F
I
"}
(5,1,1) = {"
E
t
J
c
q
U
E
"}
(6,1,1) = {"
E
O
D
j
z
i
E
"}
(7,1,1) = {"
I
E
E
I
E
E
I
"}
