//MAP CONVERTED BY dmm2tgm.py THIS HEADER COMMENT PREVENTS RECONVERSION, DO NOT REMOVE
"a" = (
/obj/effect/turf_decal/siding/thinplating_new/light/end{
	dir = 8
	},
/obj/item/radio/intercom/directional/west,
/obj/machinery/newscaster/directional/north,
/obj/machinery/cryopod,
/turf/open/floor/iron/dark,
/area/station/commons/dorms)
"d" = (
/obj/effect/turf_decal/siding/thinplating_new/light,
/obj/effect/turf_decal/siding/thinplating_new/light{
	dir = 1
	},
/obj/machinery/time_clock/directional/north,
/obj/machinery/cryopod,
/obj/machinery/light/warm/directional/north,
/turf/open/floor/iron/dark,
/area/station/commons/dorms)
"W" = (
/obj/effect/turf_decal/siding/thinplating_new/light/end{
	dir = 4
	},
/obj/machinery/computer/cryopod/directional/north,
/obj/machinery/cryopod,
/turf/open/floor/iron/dark,
/area/station/commons/dorms)

(1,1,1) = {"
a
"}
(2,1,1) = {"
d
"}
(3,1,1) = {"
W
"}
