"aI" = (/obj/machinery/atmospherics/components/unary/vent_pump/on/layer4{dir = 8},/turf/open/floor/iron,/area/station/hallway/secondary/entry)
"bg" = (/obj/effect/mapping_helpers/broken_floor,/obj/structure/chair/sofa/bench{dir = 4},/obj/effect/turf_decal/tile/blue{dir = 8},/turf/open/floor/iron/white/corner{dir = 1},/area/station/hallway/secondary/entry)
"bt" = (/obj/effect/decal/cleanable/dirt/dust,/obj/structure/chair/sofa/bench/right{dir = 4},/obj/item/radio/intercom/directional/south,/obj/effect/turf_decal/tile/blue{dir = 8},/turf/open/floor/iron/white/corner{dir = 1},/area/station/hallway/secondary/entry)
"bv" = (/obj/structure/hedge,/obj/machinery/status_display/evac/directional/east,/turf/open/floor/iron,/area/station/hallway/secondary/entry)
"bK" = (/obj/machinery/atmospherics/pipe/smart/manifold4w/supply/hidden/layer4,/turf/open/floor/iron,/area/station/hallway/secondary/entry)
"bX" = (/obj/structure/lattice/catwalk,/obj/structure/marker_beacon/cerulean,/turf/open/space/basic,/area/space/nearstation)
"cN" = (/obj/machinery/atmospherics/pipe/smart/manifold4w/supply/hidden/layer4,/obj/machinery/atmospherics/pipe/smart/manifold4w/scrubbers/hidden/layer2,/obj/effect/landmark/start/hangover,/turf/open/floor/iron,/area/station/hallway/secondary/entry)
"da" = (/obj/machinery/atmospherics/pipe/smart/manifold4w/supply/hidden/layer4,/obj/machinery/atmospherics/pipe/smart/manifold4w/scrubbers/hidden/layer2,/obj/machinery/holopad,/turf/open/floor/iron,/area/station/hallway/secondary/entry)
"dh" = (/obj/structure/lattice/catwalk,/turf/open/space/basic,/area/space/nearstation)
"dn" = (/obj/machinery/atmospherics/components/unary/vent_scrubber/on/layer2{dir = 4},/obj/machinery/firealarm/directional/west,/turf/open/floor/iron,/area/station/hallway/secondary/entry)
"ed" = (/obj/machinery/light/cold/directional/east,/obj/machinery/atmospherics/components/unary/vent_scrubber/on/layer2{dir = 8},/turf/open/floor/iron,/area/station/hallway/secondary/entry)
"ex" = (/obj/structure/chair/sofa/bench{dir = 8},/obj/effect/turf_decal/tile/blue,/obj/effect/landmark/start/assistant,/turf/open/floor/iron/white/corner{dir = 4},/area/station/hallway/secondary/entry)
"fK" = (/obj/machinery/door/airlock/external{name = "Primary Docking Bay"},/obj/effect/mapping_helpers/airlock/cyclelink_helper{dir = 8},/turf/open/floor/noslip,/area/station/hallway/secondary/entry)
"gn" = (/obj/machinery/atmospherics/pipe/smart/manifold4w/supply/hidden/layer4,/obj/machinery/atmospherics/pipe/smart/manifold4w/scrubbers/hidden/layer2,/turf/open/floor/iron,/area/station/hallway/secondary/entry)
"hh" = (/obj/structure/cable,/obj/structure/disposalpipe/segment{dir = 4},/obj/machinery/atmospherics/pipe/smart/manifold4w/supply/hidden/layer4,/obj/machinery/atmospherics/pipe/smart/manifold4w/scrubbers/hidden/layer2,/obj/machinery/door/airlock/public/glass{name = "Docking Corridor"},/obj/machinery/door/firedoor,/turf/open/floor/iron/textured_half{dir = 8},/area/station/hallway/secondary/entry)
"js" = (/obj/docking_port/stationary{dwidth = 1; height = 13; shuttle_id = "arrivals_stationary"; name = "arrivals"; width = 5},/turf/open/space/basic,/area/space)
"jN" = (/obj/structure/chair/sofa/bench/left{dir = 4},/obj/effect/turf_decal/tile/blue{dir = 8},/turf/open/floor/iron/white/corner{dir = 1},/area/station/hallway/secondary/entry)
"jW" = (/obj/machinery/airalarm/directional/east,/turf/open/floor/iron,/area/station/hallway/secondary/entry)
"kz" = (/obj/machinery/atmospherics/pipe/smart/manifold4w/supply/hidden/layer4,/obj/machinery/atmospherics/pipe/smart/manifold4w/scrubbers/hidden/layer2,/obj/machinery/firealarm/directional/west,/turf/open/floor/iron,/area/station/hallway/secondary/entry)
"nF" = (/obj/structure/chair/sofa/bench/left{dir = 8},/obj/item/radio/intercom/directional/south,/obj/effect/turf_decal/tile/blue,/turf/open/floor/iron/white/corner{dir = 4},/area/station/hallway/secondary/entry)
"nN" = (/obj/structure/chair/sofa/bench/right{dir = 8},/obj/effect/turf_decal/tile/blue,/turf/open/floor/iron/white/corner{dir = 4},/area/station/hallway/secondary/entry)
"pu" = (/obj/effect/decal/cleanable/dirt/dust,/obj/machinery/door/airlock/public/glass{name = "Docking Corridor"},/obj/machinery/door/firedoor,/turf/open/floor/iron/textured_half{dir = 8},/area/station/hallway/secondary/entry)
"qa" = (/obj/machinery/light/cold/directional/east,/obj/machinery/computer/shuttle/arrivals/recall{dir = 8},/obj/effect/turf_decal/delivery/blue,/turf/open/floor/iron,/area/station/hallway/secondary/entry)
"qd" = (/turf/open/floor/iron,/area/station/hallway/secondary/entry)
"qr" = (/obj/effect/spawner/structure/window/reinforced,/turf/open/floor/plating,/area/station/hallway/secondary/entry)
"rl" = (/obj/machinery/atmospherics/components/unary/vent_pump/on/layer4{dir = 4},/obj/effect/landmark/start/hangover,/turf/open/floor/iron,/area/station/hallway/secondary/entry)
"rX" = (/obj/effect/decal/cleanable/dirt/dust,/turf/open/floor/iron,/area/station/hallway/secondary/entry)
"sN" = (/obj/machinery/light/cold/directional/east,/turf/open/floor/iron,/area/station/hallway/secondary/entry)
"ub" = (/obj/structure/hedge,/obj/machinery/status_display/evac/directional/west,/turf/open/floor/iron,/area/station/hallway/secondary/entry)
"uu" = (/obj/machinery/door/firedoor,/turf/open/floor/iron,/area/station/hallway/secondary/entry)
"vN" = (/obj/structure/chair/sofa/bench/left{dir = 4},/obj/effect/turf_decal/tile/blue{dir = 8},/obj/effect/landmark/start/hangover,/turf/open/floor/iron/white/corner{dir = 1},/area/station/hallway/secondary/entry)
"xo" = (/obj/machinery/status_display/ai/directional/east,/turf/open/floor/iron,/area/station/hallway/secondary/entry)
"yi" = (/obj/machinery/light/cold/directional/west,/turf/open/floor/iron,/area/station/hallway/secondary/entry)
"yD" = (/turf/open/space/basic,/area/space)
"Ae" = (/obj/machinery/status_display/ai/directional/west,/turf/open/floor/iron,/area/station/hallway/secondary/entry)
"CE" = (/obj/structure/lattice,/turf/open/space/basic,/area/space/nearstation)
"Du" = (/turf/closed/wall,/area/station/hallway/secondary/entry)
"DH" = (/obj/machinery/light/cold/directional/west,/obj/machinery/atmospherics/components/unary/vent_scrubber/on/layer2{dir = 4},/turf/open/floor/iron,/area/station/hallway/secondary/entry)
"EA" = (/obj/machinery/camera/autoname/directional/east,/turf/open/floor/iron,/area/station/hallway/secondary/entry)
"EK" = (/obj/machinery/camera/autoname/directional/east,/obj/machinery/newscaster/directional/east,/turf/open/floor/iron,/area/station/hallway/secondary/entry)
"Fx" = (/obj/effect/decal/cleanable/dirt/dust,/obj/item/radio/intercom/directional/east,/obj/machinery/atmospherics/components/unary/vent_pump/on/layer4{dir = 8},/turf/open/floor/iron,/area/station/hallway/secondary/entry)
"FQ" = (/obj/machinery/atmospherics/pipe/smart/manifold4w/supply/hidden/layer4,/obj/machinery/atmospherics/pipe/smart/manifold4w/scrubbers/hidden/layer2,/obj/machinery/firealarm/directional/east,/turf/open/floor/iron,/area/station/hallway/secondary/entry)
"GV" = (/obj/structure/disposalpipe/trunk{dir = 1},/obj/machinery/disposal/bin,/obj/effect/turf_decal/bot,/obj/machinery/camera/directional/east,/turf/open/floor/iron,/area/station/hallway/secondary/entry)
"Iu" = (/obj/machinery/atmospherics/components/unary/vent_scrubber/on/layer2{dir = 8},/turf/open/floor/iron,/area/station/hallway/secondary/entry)
"JF" = (/obj/machinery/atmospherics/pipe/smart/manifold4w/supply/hidden/layer4,/obj/machinery/atmospherics/pipe/smart/manifold4w/scrubbers/hidden/layer2,/obj/effect/decal/cleanable/dirt/dust,/obj/machinery/holopad,/turf/open/floor/iron,/area/station/hallway/secondary/entry)
"JS" = (/obj/machinery/atmospherics/components/unary/vent_pump/on/layer4{dir = 4},/turf/open/floor/iron,/area/station/hallway/secondary/entry)
"Kl" = (/obj/structure/cable,/obj/structure/disposalpipe/segment{dir = 5},/obj/machinery/atmospherics/pipe/smart/manifold4w/supply/hidden/layer4,/obj/machinery/atmospherics/pipe/smart/manifold4w/scrubbers/hidden/layer2,/turf/open/floor/iron,/area/station/hallway/secondary/entry)
"KQ" = (/obj/machinery/airalarm/directional/west,/turf/open/floor/iron,/area/station/hallway/secondary/entry)
"Ll" = (/obj/structure/chair/sofa/bench/right{dir = 4},/obj/effect/turf_decal/tile/blue{dir = 8},/obj/machinery/newscaster/directional/west,/turf/open/floor/iron/white/corner{dir = 1},/area/station/hallway/secondary/entry)
"Mr" = (/obj/item/kirbyplants/random,/obj/machinery/light/cold/directional/west,/obj/effect/turf_decal/tile/blue{dir = 8},/obj/structure/extinguisher_cabinet/directional/west,/turf/open/floor/iron/white/corner{dir = 1},/area/station/hallway/secondary/entry)
"MC" = (/obj/structure/chair/sofa/bench{dir = 4},/obj/item/radio/intercom/directional/west,/obj/effect/turf_decal/tile/blue{dir = 8},/turf/open/floor/iron/white/corner{dir = 1},/area/station/hallway/secondary/entry)
"MI" = (/obj/machinery/light/cold/directional/north{pixel_x = 16},/turf/open/floor/noslip,/area/station/hallway/secondary/entry)
"MR" = (/obj/structure/chair/sofa/bench{dir = 4},/obj/effect/turf_decal/tile/blue{dir = 8},/obj/effect/landmark/start/assistant,/turf/open/floor/iron/white/corner{dir = 1},/area/station/hallway/secondary/entry)
"Nj" = (/obj/structure/closet/firecloset,/obj/machinery/status_display/evac/directional/south,/turf/open/floor/iron,/area/station/hallway/secondary/entry)
"Nz" = (/obj/structure/closet/emcloset,/obj/machinery/newscaster/directional/south,/turf/open/floor/iron,/area/station/hallway/secondary/entry)
"Px" = (/obj/structure/closet/emcloset,/obj/effect/turf_decal/tile/blue,/turf/open/floor/iron/white/corner{dir = 4},/area/station/hallway/secondary/entry)
"Rc" = (/obj/effect/decal/cleanable/dirt/dust,/obj/machinery/firealarm/directional/east,/turf/open/floor/iron,/area/station/hallway/secondary/entry)
"Tc" = (/obj/machinery/camera/autoname/directional/west,/turf/open/floor/iron,/area/station/hallway/secondary/entry)
"Tv" = (/obj/machinery/atmospherics/pipe/smart/manifold4w/supply/hidden/layer4,/obj/machinery/atmospherics/pipe/smart/manifold4w/scrubbers/hidden/layer2,/obj/effect/decal/cleanable/dirt/dust,/turf/open/floor/iron,/area/station/hallway/secondary/entry)
"Ur" = (/obj/machinery/door/airlock/external{name = "Primary Docking Bay"},/obj/effect/mapping_helpers/airlock/cyclelink_helper{dir = 4},/turf/open/floor/noslip,/area/station/hallway/secondary/entry)
"UF" = (/turf/open/floor/noslip,/area/station/hallway/secondary/entry)
"UH" = (/obj/machinery/atmospherics/pipe/smart/manifold4w/supply/hidden/layer4,/obj/machinery/atmospherics/pipe/smart/manifold4w/scrubbers/hidden/layer2,/obj/machinery/door/firedoor,/turf/open/floor/iron,/area/station/hallway/secondary/entry)
"WZ" = (/obj/structure/reagent_dispensers/water_cooler,/obj/machinery/camera/directional/west,/turf/open/floor/iron,/area/station/hallway/secondary/entry)
"Xw" = (/obj/structure/chair/sofa/bench/right{dir = 4},/obj/effect/turf_decal/tile/blue{dir = 8},/turf/open/floor/iron/white/corner{dir = 1},/area/station/hallway/secondary/entry)

(1,1,1) = {"
DuqdgnqdGVDuqrqrqrDuqrqrqrDuWZrXgnKlhh
DuKQdaqdbvDubXCECECECECEbXDuubqdJFqdpu
DuAegnqaDuDuCEyDyDyDyDyDCEDuDuMrTvxoDu
jNqdgnqrqrqrqryDyDyDyDyDCEyDqrvNTvIuPx
MCqdgnUrMIUFfKyDyDyDyDyDCEyDqrbgcNrXPx
LlrlgnqrqrqrqryDyDyDyDyDCEyDqrXwgnFxDu
DuTcgnqryDyDCEyDyDyDyDyDCEyDqrqrgnEKDu
DudngnqryDyDCEyDyDyDyDyDCEyDyDqrgnRcDu
DuuuUHDuCECECECECECECECECECECEDuUHuuDu
qrqdgnqryDyDCEyDyDyDyDyDCEyDyDqrgnqdqr
qryignqryDyDCEyDyDyDyDyDCEyDyDqrgnsNqr
DuAegnqrqrqrqryDyDyDyDyDCEyDyDqrgnxoDu
qrqdgnUrMIUFfKyDyDyDyDyDCEyDyDqrgnqdqr
qrqdgnqrqrqrqryDyDyDyDyDCEyDyDqrgnqdqr
qrTcgnqryDyDCEyDjsyDyDyDCEyDyDqrgnEAqr
DuKQFQDuCECEbXCECECECECEbXCECEDukzjWDu
qrDHgnqrqryDyDyDyDCEyDyDyDyDqrqrgnedqr
qrqdbKnNqryDyDyDyDCEyDyDyDyDqrjNgnqdqr
qrJSbKexqryDyDyDyDCEyDyDyDyDqrMRgnaIqr
qrqdqdnFqryDyDyDyDCEyDyDyDyDqrbtqdqdqr
DuNjNzDuDuCECEdhdhdhdhdhCECEDuDuNzNjDu
DuDuDuDuyDyDyDyDyDyDyDyDyDyDyDDuDuDuDu
"}
