//MAP CONVERTED BY dmm2tgm.py THIS HEADER COMMENT PREVENTS RECONVERSION, DO NOT REMOVE
"ae" = (
/obj/machinery/airalarm/directional/north,
/turf/template_noop,
/area/template_noop)
"au" = (
/obj/structure/table/wood,
/obj/machinery/fax{
	fax_name = "Nanotrasen Consultant's Office";
	name = "Nanotrasen Consultant's Fax Machine"
	},
/turf/open/floor/carpet/executive,
/area/command/heads_quarters/captain/private/nt_rep)
"aU" = (
/obj/machinery/light/directional/west,
/obj/machinery/light_switch/directional/west,
/turf/open/floor/carpet/executive,
/area/command/heads_quarters/captain/private/nt_rep)
"bD" = (
/obj/structure/closet/secure_closet/nanotrasen_consultant/station,
/turf/open/floor/carpet/executive,
/area/command/heads_quarters/captain/private/nt_rep)
"ca" = (
/obj/structure/chair/comfy/black{
	dir = 4
	},
/turf/open/floor/carpet/executive,
/area/command/heads_quarters/captain/private/nt_rep)
"cP" = (
/obj/machinery/atmospherics/pipe/smart/manifold4w/scrubbers/hidden/layer2,
/obj/machinery/atmospherics/pipe/smart/manifold4w/supply/hidden/layer4,
/obj/structure/cable,
/obj/machinery/light/directional/south,
/turf/open/floor/wood,
/area/command/heads_quarters/captain/private/nt_rep)
"eD" = (
/obj/structure/cable,
/obj/structure/disposalpipe/segment{
	dir = 4
	},
/turf/open/floor/plating/rust,
/area/station/maintenance/fore/lesser)
"gh" = (
/obj/effect/decal/cleanable/dirt/dust,
/obj/item/radio/intercom/directional/west,
/turf/open/floor/iron,
/area/station/maintenance/hallway/abandoned_command)
"ii" = (
/obj/structure/cable,
/obj/machinery/door/airlock{
	name = "Maintenance"
	},
/obj/effect/mapping_helpers/airlock/access/any/command/maintenance,
/obj/effect/mapping_helpers/airlock/unres{
	dir = 8
	},
/obj/structure/disposalpipe/segment{
	dir = 4
	},
/turf/open/floor/plating,
/area/station/maintenance/fore/lesser)
"ix" = (
/obj/machinery/atmospherics/pipe/smart/manifold4w/scrubbers/hidden/layer2,
/obj/machinery/atmospherics/pipe/smart/manifold4w/supply/hidden/layer4,
/obj/structure/cable,
/obj/machinery/light_switch/directional/south,
/turf/open/floor/wood,
/area/command/heads_quarters/captain/private/nt_rep)
"iC" = (
/obj/effect/mapping_helpers/broken_floor,
/obj/structure/cable,
/obj/structure/disposalpipe/segment{
	dir = 10
	},
/turf/open/floor/iron,
/area/station/maintenance/hallway/abandoned_command)
"iD" = (
/obj/structure/disposalpipe/segment{
	dir = 4
	},
/obj/structure/cable,
/obj/effect/spawner/random/trash,
/turf/open/floor/plating,
/area/station/maintenance/fore/lesser)
"iS" = (
/obj/structure/disposalpipe/segment{
	dir = 5
	},
/obj/structure/cable,
/obj/effect/mapping_helpers/broken_floor,
/turf/open/floor/plating,
/area/station/maintenance/fore/lesser)
"jh" = (
/obj/machinery/atmospherics/pipe/smart/manifold4w/supply/hidden/layer4,
/obj/structure/chair/comfy/black{
	dir = 8
	},
/turf/open/floor/carpet/executive,
/area/command/heads_quarters/captain/private/nt_rep)
"lJ" = (
/obj/machinery/power/apc/auto_name/directional/north,
/obj/structure/cable,
/obj/structure/disposalpipe/segment{
	dir = 4
	},
/turf/open/floor/plating,
/area/station/maintenance/fore/lesser)
"nh" = (
/obj/machinery/button/door/directional/west{
	id = "nt_rep_priv";
	name = "Privacy Shutters Control"
	},
/obj/structure/sign/calendar/directional/west,
/turf/open/floor/carpet/executive,
/area/command/heads_quarters/captain/private/nt_rep)
"nw" = (
/turf/template_noop,
/area/template_noop)
"nM" = (
/obj/structure/cable,
/obj/structure/disposalpipe/segment{
	dir = 4
	},
/turf/open/floor/plating,
/area/station/maintenance/fore/lesser)
"pV" = (
/obj/machinery/atmospherics/components/unary/vent_pump/on/layer4{
	dir = 1
	},
/turf/open/floor/carpet/executive,
/area/command/heads_quarters/captain/private/nt_rep)
"rA" = (
/obj/machinery/modular_computer/console/preset/command,
/turf/open/floor/carpet/executive,
/area/command/heads_quarters/captain/private/nt_rep)
"sZ" = (
/turf/closed/wall/r_wall,
/area/command/heads_quarters/captain/private/nt_rep)
"ti" = (
/obj/structure/filingcabinet/chestdrawer,
/turf/open/floor/wood,
/area/command/heads_quarters/captain/private/nt_rep)
"vK" = (
/obj/structure/extinguisher_cabinet/directional/east,
/obj/machinery/camera/autoname/directional/east,
/obj/effect/turf_decal/siding/wood{
	dir = 8
	},
/obj/effect/landmark/start/nanotrasen_consultant,
/turf/open/floor/wood,
/area/command/heads_quarters/captain/private/nt_rep)
"wx" = (
/obj/structure/cable,
/turf/open/floor/plating,
/area/station/maintenance/fore/lesser)
"xH" = (
/obj/structure/table/wood,
/obj/item/paper_bin/carbon{
	pixel_y = 4;
	pixel_x = -4
	},
/obj/item/pen/fountain{
	pixel_x = -4;
	pixel_y = 6
	},
/obj/item/stamp{
	pixel_x = 8;
	pixel_y = 8
	},
/obj/item/stamp/denied{
	pixel_x = 8
	},
/obj/machinery/button/door/directional/west{
	id = "nt_rep_priv";
	name = "Privacy Shutters Control"
	},
/obj/item/radio/intercom/directional/north,
/turf/open/floor/carpet/executive,
/area/command/heads_quarters/captain/private/nt_rep)
"xL" = (
/obj/machinery/atmospherics/pipe/smart/manifold4w/supply/hidden/layer4,
/obj/structure/cable,
/obj/effect/turf_decal/siding/wood{
	dir = 8
	},
/turf/open/floor/wood,
/area/command/heads_quarters/captain/private/nt_rep)
"yC" = (
/turf/open/floor/carpet/executive,
/area/command/heads_quarters/captain/private/nt_rep)
"Ab" = (
/turf/closed/wall,
/area/station/maintenance/hallway/abandoned_command)
"Bv" = (
/obj/machinery/door/poddoor/preopen{
	id = "nt_rep_priv";
	name = "Privacy Shutter"
	},
/obj/effect/spawner/structure/window/reinforced,
/turf/open/floor/plating,
/area/station/maintenance/hallway/abandoned_command)
"Bw" = (
/obj/structure/extinguisher_cabinet/directional/west,
/obj/structure/disposalpipe/segment,
/obj/machinery/atmospherics/components/unary/vent_scrubber/on/layer2{
	dir = 4
	},
/turf/open/floor/plating,
/area/station/maintenance/hallway/abandoned_command)
"Dp" = (
/obj/structure/reagent_dispensers/fueltank,
/turf/open/floor/plating,
/area/station/maintenance/fore/lesser)
"Ds" = (
/obj/machinery/door/airlock/maintenance,
/obj/effect/mapping_helpers/airlock/access/all/command/captain,
/obj/effect/mapping_helpers/airlock/locked,
/obj/machinery/door/firedoor,
/obj/structure/cable,
/turf/open/floor/plating,
/area/station/maintenance/fore/lesser)
"Et" = (
/obj/machinery/door/airlock/corporate{
	name = "NT Consultant's Office"
	},
/obj/machinery/door/firedoor,
/obj/machinery/atmospherics/pipe/smart/manifold4w/scrubbers/hidden/layer2,
/obj/machinery/atmospherics/pipe/smart/manifold4w/supply/hidden/layer4,
/obj/structure/cable,
/obj/effect/mapping_helpers/airlock/access/all/cent_com/rep_door,
/turf/open/floor/iron,
/area/station/maintenance/hallway/abandoned_command)
"EK" = (
/obj/machinery/atmospherics/components/unary/vent_scrubber/on/layer2,
/obj/machinery/newscaster/directional/north,
/turf/open/floor/wood,
/area/command/heads_quarters/captain/private/nt_rep)
"FF" = (
/obj/structure/cable,
/turf/template_noop,
/area/station/command/heads_quarters/captain/private)
"FO" = (
/obj/effect/mapping_helpers/broken_floor,
/obj/machinery/atmospherics/pipe/smart/manifold4w/scrubbers/hidden/layer2,
/obj/machinery/atmospherics/pipe/smart/manifold4w/supply/hidden/layer4,
/obj/structure/cable,
/turf/open/floor/iron,
/area/station/maintenance/hallway/abandoned_command)
"Ht" = (
/obj/effect/spawner/random/maintenance,
/obj/structure/reagent_dispensers/watertank,
/turf/open/floor/plating/rust,
/area/station/maintenance/fore/lesser)
"HH" = (
/obj/structure/cable,
/obj/structure/displaycase/captain{
	pixel_y = 5
	},
/turf/open/floor/iron/dark/small,
/area/station/command/heads_quarters/captain/private)
"HS" = (
/obj/structure/table/wood,
/obj/item/camera{
	pixel_x = 6;
	pixel_y = 3
	},
/obj/item/camera_film{
	pixel_x = -5;
	pixel_y = 3
	},
/obj/item/camera_film{
	pixel_x = -4;
	pixel_y = 7
	},
/turf/open/floor/carpet/executive,
/area/command/heads_quarters/captain/private/nt_rep)
"Ll" = (
/obj/machinery/firealarm/directional/north,
/turf/open/floor/carpet/executive,
/area/command/heads_quarters/captain/private/nt_rep)
"Nt" = (
/turf/open/floor/iron,
/area/station/maintenance/hallway/abandoned_command)
"OS" = (
/obj/structure/filingcabinet/employment,
/turf/open/floor/carpet/executive,
/area/command/heads_quarters/captain/private/nt_rep)
"Pd" = (
/obj/structure/disposalpipe/segment{
	dir = 5
	},
/turf/open/floor/plating,
/area/station/maintenance/hallway/abandoned_command)
"Pf" = (
/turf/closed/wall/r_wall,
/area/station/maintenance/hallway/abandoned_command)
"QJ" = (
/obj/structure/disposalpipe/segment{
	dir = 4
	},
/obj/structure/cable,
/turf/open/floor/plating,
/area/station/maintenance/fore/lesser)
"Rb" = (
/obj/machinery/power/apc/auto_name/directional/north,
/obj/structure/cable,
/obj/effect/turf_decal/siding/wood{
	dir = 8
	},
/turf/open/floor/wood,
/area/command/heads_quarters/captain/private/nt_rep)
"Rk" = (
/turf/closed/wall,
/area/command/heads_quarters/captain/private/nt_rep)
"TT" = (
/obj/machinery/photocopier,
/turf/open/floor/carpet/executive,
/area/command/heads_quarters/captain/private/nt_rep)
"VM" = (
/obj/structure/table/wood,
/obj/item/stamp/centcom{
	pixel_y = 13;
	pixel_x = -7
	},
/turf/open/floor/carpet/executive,
/area/command/heads_quarters/captain/private/nt_rep)
"Yp" = (
/turf/closed/wall/r_wall,
/area/station/maintenance/fore/lesser)
"Zf" = (
/obj/structure/hedge,
/obj/machinery/camera/autoname/directional/east,
/obj/structure/cable,
/turf/open/floor/iron/dark/small,
/area/station/command/heads_quarters/captain/private)
"ZQ" = (
/obj/effect/spawner/random/structure/crate_abandoned,
/turf/open/floor/plating,
/area/station/maintenance/fore/lesser)

(1,1,1) = {"
iS
wx
Ds
HH
FF
nw
"}
(2,1,1) = {"
QJ
Ht
Yp
nw
FF
nw
"}
(3,1,1) = {"
QJ
Dp
Yp
ae
FF
FF
"}
(4,1,1) = {"
eD
ZQ
Yp
nw
nw
Zf
"}
(5,1,1) = {"
QJ
sZ
sZ
sZ
sZ
sZ
"}
(6,1,1) = {"
QJ
Rk
xH
nh
aU
bD
"}
(7,1,1) = {"
lJ
Rk
rA
ca
yC
au
"}
(8,1,1) = {"
nM
Rk
HS
VM
yC
OS
"}
(9,1,1) = {"
iD
Rk
Ll
jh
pV
TT
"}
(10,1,1) = {"
QJ
Rk
Rb
xL
vK
sZ
"}
(11,1,1) = {"
nM
Rk
EK
cP
sZ
nw
"}
(12,1,1) = {"
eD
Rk
ti
ix
sZ
nw
"}
(13,1,1) = {"
ii
Ab
Bv
Et
Pf
Pf
"}
(14,1,1) = {"
iC
Bw
Pd
FO
Nt
gh
"}
