//MAP CONVERTED BY dmm2tgm.py THIS HEADER COMMENT PREVENTS RECONVERSION, DO NOT REMOVE
"a" = (
/turf/closed/wall,
/area/station/commons/vacant_room)
"b" = (
/obj/machinery/door/airlock/public/glass{
	name = "Lockers"
	},
/obj/structure/cable,
/obj/machinery/atmospherics/pipe/smart/manifold4w/supply/hidden/layer4,
/obj/machinery/atmospherics/pipe/smart/manifold4w/scrubbers/hidden/layer2,
/turf/open/floor/iron/textured_half,
/area/station/commons/vacant_room)
"c" = (
/obj/effect/spawner/structure/window,
/turf/open/floor/plating,
/area/station/commons/vacant_room)
"e" = (
/obj/effect/decal/cleanable/dirt,
/turf/open/floor/iron/showroomfloor,
/area/station/commons/vacant_room)
"m" = (
/obj/effect/turf_decal/siding/wideplating/dark{
	dir = 5
	},
/obj/item/radio/intercom/directional/north,
/turf/open/floor/iron/small,
/area/station/commons/vacant_room)
"n" = (
/obj/effect/turf_decal/siding/wideplating/dark{
	dir = 1
	},
/obj/machinery/power/apc/auto_name/directional/north,
/obj/structure/cable,
/obj/effect/decal/cleanable/dirt,
/obj/structure/chair/wood,
/turf/open/floor/iron/small,
/area/station/commons/vacant_room)
"q" = (
/obj/effect/turf_decal/siding/wideplating/dark,
/obj/structure/cable,
/obj/machinery/atmospherics/pipe/smart/manifold4w/supply/hidden/layer4,
/obj/machinery/atmospherics/pipe/smart/manifold4w/scrubbers/hidden/layer2,
/turf/open/floor/iron/small,
/area/station/commons/vacant_room)
"v" = (
/obj/structure/table,
/obj/machinery/camera/autoname/directional/east,
/turf/open/floor/iron/showroomfloor,
/area/station/commons/vacant_room)
"y" = (
/obj/structure/sign/poster/official/random/directional/north,
/turf/open/floor/iron/showroomfloor,
/area/station/commons/vacant_room)
"z" = (
/obj/effect/turf_decal/siding/wideplating/dark{
	dir = 8
	},
/obj/structure/table/wood,
/obj/machinery/computer/security/telescreen/entertainment/directional/west,
/obj/effect/spawner/random/entertainment/coin,
/turf/open/floor/iron/small,
/area/station/commons/vacant_room)
"E" = (
/obj/effect/turf_decal/siding/wideplating/dark{
	dir = 4
	},
/obj/machinery/atmospherics/components/unary/vent_scrubber/on/layer2{
	dir = 8
	},
/turf/open/floor/iron/small,
/area/station/commons/vacant_room)
"I" = (
/obj/machinery/light/small/directional/south,
/obj/item/stack/sheet/iron/fifty,
/turf/open/floor/iron/showroomfloor,
/area/station/commons/vacant_room)
"J" = (
/obj/effect/turf_decal/siding/wideplating/dark{
	dir = 9
	},
/obj/machinery/light/small/directional/north,
/obj/structure/sign/poster/official/random/directional/north,
/obj/structure/chair/wood,
/turf/open/floor/iron/small,
/area/station/commons/vacant_room)
"L" = (
/obj/effect/turf_decal/siding/wideplating/dark{
	dir = 4
	},
/obj/machinery/atmospherics/components/unary/vent_pump/on/layer4{
	dir = 8
	},
/turf/open/floor/iron/small,
/area/station/commons/vacant_room)
"Q" = (
/obj/structure/cable,
/obj/machinery/atmospherics/pipe/smart/manifold4w/supply/hidden/layer4,
/obj/machinery/atmospherics/pipe/smart/manifold4w/scrubbers/hidden/layer2,
/turf/open/floor/iron/small,
/area/station/commons/vacant_room)
"R" = (
/obj/structure/table/wood,
/obj/structure/cable,
/obj/machinery/atmospherics/pipe/smart/manifold4w/scrubbers/hidden/layer2,
/obj/machinery/atmospherics/pipe/smart/manifold4w/supply/hidden/layer4,
/turf/open/floor/iron/small,
/area/station/commons/vacant_room)
"S" = (
/obj/effect/turf_decal/siding/wideplating/dark{
	dir = 8
	},
/turf/open/floor/iron/small,
/area/station/commons/vacant_room)
"T" = (
/obj/effect/turf_decal/siding/wideplating/dark{
	dir = 10
	},
/obj/machinery/light/small/directional/south,
/obj/machinery/airalarm/directional/west,
/obj/effect/spawner/random/contraband,
/turf/open/floor/iron/small,
/area/station/commons/vacant_room)
"U" = (
/turf/open/floor/iron/showroomfloor,
/area/station/commons/vacant_room)
"V" = (
/obj/machinery/light/small/directional/north,
/obj/item/kirbyplants/random,
/turf/open/floor/iron/showroomfloor,
/area/station/commons/vacant_room)
"X" = (
/obj/effect/turf_decal/siding/wideplating/dark{
	dir = 6
	},
/turf/open/floor/iron/small,
/area/station/commons/vacant_room)

(1,1,1) = {"
a
a
a
a
a
a
"}
(2,1,1) = {"
a
J
z
S
T
a
"}
(3,1,1) = {"
a
n
R
Q
q
b
"}
(4,1,1) = {"
a
m
L
E
X
c
"}
(5,1,1) = {"
a
y
U
U
e
c
"}
(6,1,1) = {"
a
V
v
U
I
a
"}
(7,1,1) = {"
a
a
a
a
a
a
"}
