//MAP CONVERTED BY dmm2tgm.py THIS HEADER COMMENT PREVENTS RECONVERSION, DO NOT REMOVE
"a" = (
/obj/effect/turf_decal/tile/neutral{
	dir = 4
	},
/obj/effect/turf_decal/tile/neutral{
	dir = 1
	},
/obj/structure/rack/gunrack,
/obj/effect/spawner/armory_spawn/microfusion,
/obj/effect/decal/cleanable/dirt/dust,
/obj/machinery/airalarm/directional/west,
/turf/open/floor/iron/dark/small,
/area/station/ai_monitored/security/armory)
"f" = (
/obj/structure/rack/gunrack,
/obj/effect/spawner/armory_spawn/shotguns,
/obj/item/radio/intercom/directional/west,
/turf/open/floor/iron/dark/small,
/area/station/ai_monitored/security/armory)
"z" = (
/obj/effect/turf_decal/tile/neutral{
	dir = 8
	},
/obj/effect/turf_decal/tile/neutral{
	dir = 4
	},
/obj/effect/turf_decal/tile/neutral{
	dir = 1
	},
/obj/structure/rack/gunrack,
/obj/effect/spawner/armory_spawn/cmg,
/obj/effect/decal/cleanable/dirt/dust,
/turf/open/floor/iron/dark/small,
/area/station/ai_monitored/security/armory)
"A" = (
/obj/structure/rack,
/obj/item/clothing/head/helmet/sec{
	pixel_x = -3;
	pixel_y = 3
	},
/obj/item/clothing/head/helmet/sec,
/obj/item/clothing/head/helmet/sec{
	pixel_x = 3;
	pixel_y = -3
	},
/obj/item/clothing/suit/armor/vest/alt/sec{
	pixel_x = -3;
	pixel_y = 3
	},
/obj/item/clothing/suit/armor/vest/alt/sec,
/obj/item/clothing/suit/armor/vest/alt/sec{
	pixel_x = 3;
	pixel_y = -3
	},
/obj/structure/cable,
/turf/open/floor/iron/dark/small,
/area/station/ai_monitored/security/armory)
"B" = (
/obj/item/clothing/mask/gas/sechailer{
	pixel_x = -3;
	pixel_y = 3
	},
/obj/item/clothing/mask/gas/sechailer,
/obj/item/clothing/mask/gas/sechailer{
	pixel_x = 3;
	pixel_y = -3
	},
/obj/item/flashlight/seclite,
/obj/item/flashlight/seclite,
/obj/item/flashlight/seclite,
/obj/structure/table,
/obj/item/storage/barricade{
	pixel_y = -5
	},
/obj/item/storage/barricade,
/obj/item/storage/barricade{
	pixel_y = 5
	},
/turf/open/floor/iron/dark/small,
/area/station/ai_monitored/security/armory)
"Q" = (
/obj/structure/closet/ammunitionlocker/useful,
/obj/item/storage/box/lethalshot,
/obj/item/storage/box/lethalshot,
/obj/item/storage/box/lethalshot,
/obj/item/storage/box/lethalshot,
/turf/open/floor/iron/dark/small,
/area/station/ai_monitored/security/armory)
"R" = (
/turf/template_noop,
/area/template_noop)

(1,1,1) = {"
B
z
a
f
R
R
"}
(2,1,1) = {"
R
R
R
R
R
R
"}
(3,1,1) = {"
Q
R
R
R
R
R
"}
(4,1,1) = {"
R
R
R
R
R
A
"}
