//MAP CONVERTED BY dmm2tgm.py THIS HEADER COMMENT PREVENTS RECONVERSION, DO NOT REMOVE
"a" = (
/obj/docking_port/stationary{
	dheight = 3;
	dir = 2;
	dwidth = 8;
	height = 11;
	shuttle_id = "ferry_home";
	name = "Port Bay 2";
	width = 20
	},
/turf/template_noop,
/area/template_noop)

(1,1,1) = {"
a
"}
