//MAP CONVERTED BY dmm2tgm.py THIS HEADER COMMENT PREVENTS RECONVERSION, DO NOT REMOVE
"ac" = (
/obj/structure/rack,
/obj/item/clothing/suit/armor/bulletproof{
	pixel_x = -3;
	pixel_y = 3
	},
/obj/item/clothing/suit/armor/bulletproof,
/obj/item/clothing/suit/armor/bulletproof{
	pixel_x = 3;
	pixel_y = -3
	},
/obj/item/clothing/head/helmet/alt{
	layer = 3.00001;
	pixel_x = -3;
	pixel_y = 3
	},
/obj/item/clothing/head/helmet/alt{
	layer = 3.00001
	},
/obj/item/clothing/head/helmet/alt{
	layer = 3.00001;
	pixel_x = 3;
	pixel_y = -3
	},
/obj/machinery/light/directional/north,
/obj/effect/turf_decal/tile/neutral/fourcorners,
/turf/open/floor/iron/dark,
/area/station/ai_monitored/security/armory)
"au" = (
/obj/machinery/newscaster/directional/north,
/obj/machinery/modular_computer/console/preset/id,
/turf/open/floor/carpet,
/area/station/command/heads_quarters/hos)
"aX" = (
/obj/machinery/modular_computer/console/preset/cargochat/security{
	dir = 4
	},
/obj/machinery/newscaster/directional/west,
/obj/effect/turf_decal/trimline/red/filled/line{
	dir = 8
	},
/obj/effect/turf_decal/trimline/red/filled/warning{
	dir = 6
	},
/turf/open/floor/iron,
/area/station/security/office)
"bu" = (
/turf/open/misc/asteroid/airless,
/area/mine/explored)
"cy" = (
/obj/structure/window/reinforced,
/obj/structure/window/reinforced{
	dir = 1
	},
/obj/structure/rack/gunrack,
/obj/effect/spawner/armory_spawn/cmg,
/turf/open/floor/iron,
/area/station/ai_monitored/security/armory)
"cQ" = (
/turf/closed/wall/r_wall,
/area/station/command/heads_quarters/hos)
"cR" = (
/obj/vehicle/ridden/secway,
/obj/effect/turf_decal/tile/neutral/fourcorners,
/turf/open/floor/iron/dark,
/area/station/ai_monitored/security/armory)
"fc" = (
/obj/structure/table,
/obj/item/storage/box/teargas{
	pixel_x = -3;
	pixel_y = 3
	},
/obj/item/storage/box/handcuffs,
/obj/item/storage/box/flashbangs{
	pixel_x = 3;
	pixel_y = -3
	},
/obj/effect/turf_decal/tile/neutral/fourcorners,
/obj/item/gun/grenadelauncher,
/turf/open/floor/iron/dark,
/area/station/ai_monitored/security/armory)
"fx" = (
/obj/structure/table/wood,
/obj/item/storage/box/seccarts{
	pixel_x = 3;
	pixel_y = 2
	},
/obj/item/storage/box/deputy,
/obj/item/radio/intercom/directional/west,
/obj/machinery/button/door/directional/west{
	id = "HOSOffice";
	name = "Emergency Blast Doors";
	pixel_y = -8;
	req_access = list("hos")
	},
/turf/open/floor/carpet,
/area/station/command/heads_quarters/hos)
"gK" = (
/obj/machinery/door/window/left/directional/south{
	name = "Armory";
	req_access = list("armory")
	},
/obj/structure/cable,
/obj/effect/turf_decal/tile/neutral/fourcorners,
/turf/open/floor/iron/dark,
/area/station/ai_monitored/security/armory)
"hx" = (
/obj/effect/spawner/structure/window/reinforced,
/obj/structure/cable,
/turf/open/floor/plating,
/area/station/ai_monitored/security/armory)
"jD" = (
/obj/machinery/computer/department_orders/security{
	dir = 4
	},
/obj/effect/turf_decal/trimline/red/filled/line{
	dir = 9
	},
/obj/machinery/status_display/evac/directional/west,
/obj/effect/turf_decal/trimline/red/filled/warning{
	dir = 4
	},
/turf/open/floor/iron,
/area/station/security/office)
"ko" = (
/obj/machinery/atmospherics/pipe/smart/manifold4w/scrubbers/hidden/layer2,
/obj/machinery/atmospherics/pipe/smart/manifold4w/supply/hidden/layer4,
/obj/effect/turf_decal/tile/neutral/fourcorners,
/turf/open/floor/iron/dark,
/area/station/ai_monitored/security/armory)
"kS" = (
/obj/effect/turf_decal/stripes/line{
	dir = 10
	},
/turf/open/floor/iron,
/area/station/ai_monitored/security/armory)
"kT" = (
/obj/structure/table,
/obj/item/grenade/barrier{
	pixel_x = 4
	},
/obj/item/grenade/barrier,
/obj/item/grenade/barrier{
	pixel_x = -4
	},
/obj/effect/turf_decal/tile/neutral/fourcorners,
/turf/open/floor/iron/dark,
/area/station/ai_monitored/security/armory)
"lp" = (
/obj/effect/turf_decal/stripes/end{
	dir = 8
	},
/turf/open/floor/iron,
/area/station/ai_monitored/security/armory)
"nh" = (
/turf/closed/mineral/random/stationside/asteroid/porus,
/area/mine/explored)
"sS" = (
/obj/machinery/suit_storage_unit/security,
/obj/effect/turf_decal/tile/neutral/fourcorners,
/turf/open/floor/iron/dark,
/area/station/ai_monitored/security/armory)
"wj" = (
/obj/effect/landmark/event_spawn,
/obj/effect/turf_decal/stripes/corner{
	dir = 8
	},
/obj/item/storage/toolbox/drone,
/turf/open/floor/iron,
/area/station/ai_monitored/security/armory)
"wo" = (
/obj/machinery/airalarm/directional/east,
/obj/machinery/light_switch/directional/north,
/obj/structure/closet/emcloset,
/obj/effect/turf_decal/tile/neutral/fourcorners,
/turf/open/floor/iron/dark,
/area/station/security/processing)
"wr" = (
/obj/machinery/door/poddoor/shutters{
	id = "armory";
	name = "Armoury Shutter"
	},
/obj/effect/turf_decal/trimline/red/filled/line,
/obj/effect/turf_decal/trimline/red/filled/line{
	dir = 1
	},
/obj/effect/turf_decal/delivery,
/obj/machinery/atmospherics/pipe/smart/manifold4w/supply/hidden/layer4,
/obj/machinery/atmospherics/pipe/smart/manifold4w/scrubbers/hidden/layer2,
/turf/open/floor/iron/dark,
/area/station/ai_monitored/security/armory)
"ww" = (
/obj/effect/turf_decal/stripes/corner{
	dir = 1
	},
/obj/effect/turf_decal/stripes/corner{
	dir = 8
	},
/turf/open/floor/iron,
/area/station/ai_monitored/security/armory)
"wJ" = (
/obj/structure/table,
/obj/item/storage/box/rubbershot{
	pixel_x = -3;
	pixel_y = 3
	},
/obj/item/storage/box/rubbershot,
/obj/item/storage/box/rubbershot{
	pixel_x = 3;
	pixel_y = -3
	},
/obj/effect/turf_decal/tile/neutral/fourcorners,
/turf/open/floor/iron/dark,
/area/station/ai_monitored/security/armory)
"yt" = (
/obj/effect/turf_decal/stripes/end{
	dir = 4
	},
/obj/machinery/atmospherics/pipe/smart/manifold4w/scrubbers/hidden/layer2,
/obj/machinery/atmospherics/pipe/smart/manifold4w/supply/hidden/layer4,
/turf/open/floor/iron,
/area/station/ai_monitored/security/armory)
"zL" = (
/obj/structure/closet/secure_closet/contraband/armory,
/obj/effect/spawner/random/contraband/armory,
/obj/effect/spawner/random/maintenance/three,
/obj/effect/turf_decal/tile/neutral/fourcorners,
/turf/open/floor/iron/dark,
/area/station/ai_monitored/security/armory)
"BF" = (
/obj/structure/table,
/obj/machinery/recharger,
/obj/machinery/status_display/evac/directional/north,
/obj/effect/turf_decal/tile/neutral/fourcorners,
/turf/open/floor/iron/dark,
/area/station/ai_monitored/security/armory)
"BX" = (
/obj/structure/chair/office{
	dir = 4
	},
/obj/effect/turf_decal/tile/neutral/fourcorners,
/turf/open/floor/iron/dark,
/area/station/ai_monitored/security/armory)
"Df" = (
/obj/machinery/atmospherics/components/unary/vent_pump/on/layer4{
	dir = 4
	},
/obj/effect/turf_decal/tile/neutral/fourcorners,
/turf/open/floor/iron/dark,
/area/station/ai_monitored/security/armory)
"Fl" = (
/obj/structure/table,
/obj/item/storage/box/chemimp{
	pixel_x = 6
	},
/obj/item/storage/box/trackimp{
	pixel_x = -3
	},
/obj/item/storage/lockbox/loyalty,
/obj/effect/turf_decal/tile/neutral/fourcorners,
/turf/open/floor/iron/dark,
/area/station/ai_monitored/security/armory)
"Gk" = (
/obj/effect/turf_decal/stripes/corner,
/turf/open/floor/iron,
/area/station/ai_monitored/security/armory)
"GO" = (
/obj/structure/table,
/obj/structure/reagent_dispensers/wall/peppertank/directional/west,
/obj/machinery/recharger,
/obj/effect/turf_decal/tile/neutral/fourcorners,
/turf/open/floor/iron/dark,
/area/station/ai_monitored/security/armory)
"Hv" = (
/obj/structure/window/reinforced{
	dir = 4
	},
/obj/structure/window/reinforced{
	dir = 8
	},
/obj/machinery/camera/directional/north{
	c_tag = "Security - Armory";
	network = list("ss13","Security")
	},
/obj/structure/rack/gunrack,
/obj/effect/spawner/armory_spawn/shotguns,
/turf/open/floor/iron,
/area/station/ai_monitored/security/armory)
"HT" = (
/obj/effect/turf_decal/stripes/line{
	dir = 6
	},
/turf/open/floor/iron,
/area/station/ai_monitored/security/armory)
"Kc" = (
/obj/structure/table/wood,
/obj/item/paper_bin{
	pixel_x = -3;
	pixel_y = 7
	},
/obj/item/flashlight/lamp/green{
	on = 0;
	pixel_x = -3;
	pixel_y = 8
	},
/turf/open/floor/carpet,
/area/station/command/heads_quarters/hos)
"KC" = (
/obj/machinery/button/door/directional/east{
	id = "armory";
	name = "Armory Shutters";
	req_access = list("armory")
	},
/obj/machinery/status_display/ai/directional/north,
/obj/effect/turf_decal/tile/neutral/fourcorners,
/turf/open/floor/iron/dark,
/area/station/ai_monitored/security/armory)
"LV" = (
/obj/structure/rack,
/obj/item/clothing/suit/hooded/ablative,
/obj/item/gun/energy/ionrifle,
/obj/item/gun/energy/temperature/security,
/obj/structure/reagent_dispensers/wall/peppertank/directional/north,
/obj/effect/turf_decal/tile/neutral/fourcorners,
/turf/open/floor/iron/dark,
/area/station/ai_monitored/security/armory)
"LX" = (
/obj/structure/rack,
/obj/item/gun/energy/e_gun/dragnet,
/obj/item/gun/energy/e_gun/dragnet,
/obj/item/radio/intercom/directional/north,
/obj/effect/turf_decal/tile/neutral/fourcorners,
/obj/item/melee/hammer,
/obj/item/melee/hammer,
/obj/item/melee/hammer,
/obj/item/melee/hammer,
/turf/open/floor/iron/dark,
/area/station/ai_monitored/security/armory)
"Mf" = (
/obj/machinery/flasher/portable,
/obj/effect/turf_decal/tile/neutral/fourcorners,
/turf/open/floor/iron/dark,
/area/station/ai_monitored/security/armory)
"Mj" = (
/obj/structure/window/reinforced{
	dir = 4
	},
/obj/structure/window/reinforced{
	dir = 8
	},
/obj/effect/turf_decal/stripes/line{
	dir = 1
	},
/obj/structure/rack/gunrack,
/obj/effect/spawner/armory_spawn/microfusion,
/turf/open/floor/iron,
/area/station/ai_monitored/security/armory)
"Mp" = (
/obj/structure/window/reinforced{
	dir = 1;
	layer = 2.9
	},
/obj/structure/window/reinforced,
/obj/structure/closet/secure_closet/smartgun,
/turf/open/floor/iron,
/area/station/ai_monitored/security/armory)
"NW" = (
/obj/structure/table,
/obj/item/storage/box/firingpins,
/obj/item/storage/box/firingpins,
/obj/item/key/security,
/obj/effect/turf_decal/tile/neutral/fourcorners,
/turf/open/floor/iron/dark,
/area/station/ai_monitored/security/armory)
"OF" = (
/obj/effect/turf_decal/stripes/line{
	dir = 1
	},
/obj/machinery/atmospherics/pipe/smart/manifold4w/supply/hidden/layer4,
/turf/open/floor/iron,
/area/station/ai_monitored/security/armory)
"OH" = (
/obj/effect/turf_decal/stripes/line,
/mob/living/simple_animal/bot/secbot/beepsky/armsky,
/turf/open/floor/iron,
/area/station/ai_monitored/security/armory)
"SD" = (
/obj/structure/rack,
/obj/item/storage/barricade{
	pixel_y = -5
	},
/obj/item/storage/barricade,
/obj/item/storage/barricade{
	pixel_y = 5
	},
/obj/effect/turf_decal/tile/neutral{
	dir = 1
	},
/obj/effect/turf_decal/tile/neutral{
	dir = 4
	},
/obj/effect/turf_decal/tile/neutral{
	dir = 8
	},
/obj/effect/turf_decal/tile/neutral,
/turf/open/floor/iron/dark,
/area/station/ai_monitored/security/armory)
"Tw" = (
/obj/machinery/power/apc/auto_name/directional/east,
/obj/structure/cable,
/obj/machinery/firealarm/directional/south,
/obj/item/kirbyplants/random,
/obj/effect/turf_decal/tile/neutral/fourcorners,
/turf/open/floor/iron/dark,
/area/station/security/processing)
"Tz" = (
/obj/machinery/atmospherics/components/unary/vent_scrubber/on/layer2{
	dir = 8
	},
/obj/effect/turf_decal/tile/neutral/fourcorners,
/turf/open/floor/iron/dark,
/area/station/ai_monitored/security/armory)
"TA" = (
/obj/effect/turf_decal/stripes/line{
	dir = 9
	},
/obj/machinery/atmospherics/pipe/smart/manifold4w/supply/hidden/layer4,
/turf/open/floor/iron,
/area/station/ai_monitored/security/armory)
"TG" = (
/obj/structure/table/reinforced,
/obj/machinery/door/window/left/directional/west{
	name = "Armoury Desk";
	req_access = list("armory")
	},
/obj/machinery/door/window/left/directional/east{
	name = "Armoury Desk";
	req_access = list("security")
	},
/turf/open/floor/plating,
/area/station/ai_monitored/security/armory)
"TP" = (
/obj/effect/spawner/structure/window/reinforced,
/turf/open/floor/plating,
/area/station/ai_monitored/security/armory)
"UG" = (
/obj/effect/turf_decal/stripes/line{
	dir = 5
	},
/obj/machinery/atmospherics/pipe/smart/manifold4w/scrubbers/hidden/layer2,
/obj/machinery/atmospherics/pipe/smart/manifold4w/supply/hidden/layer4,
/turf/open/floor/iron,
/area/station/ai_monitored/security/armory)
"UW" = (
/turf/closed/wall/r_wall,
/area/station/ai_monitored/security/armory)
"Vr" = (
/obj/effect/turf_decal/stripes/corner,
/obj/effect/turf_decal/stripes/corner{
	dir = 4
	},
/obj/machinery/atmospherics/pipe/smart/manifold4w/scrubbers/hidden/layer2,
/obj/machinery/atmospherics/pipe/smart/manifold4w/supply/hidden/layer4,
/turf/open/floor/iron,
/area/station/ai_monitored/security/armory)
"VJ" = (
/obj/effect/turf_decal/stripes/line{
	dir = 1
	},
/obj/machinery/atmospherics/pipe/smart/manifold4w/scrubbers/hidden/layer2,
/obj/machinery/atmospherics/pipe/smart/manifold4w/supply/hidden/layer4,
/turf/open/floor/iron,
/area/station/ai_monitored/security/armory)
"VK" = (
/obj/machinery/suit_storage_unit/security,
/obj/machinery/light/directional/south,
/obj/effect/turf_decal/tile/neutral/fourcorners,
/turf/open/floor/iron/dark,
/area/station/ai_monitored/security/armory)
"Xn" = (
/obj/effect/turf_decal/tile/neutral/fourcorners,
/turf/open/floor/iron/dark,
/area/station/ai_monitored/security/armory)
"XE" = (
/obj/structure/rack,
/obj/item/clothing/suit/armor/riot{
	pixel_x = -3;
	pixel_y = 3
	},
/obj/item/clothing/suit/armor/riot,
/obj/item/clothing/suit/armor/riot{
	pixel_x = 3;
	pixel_y = -3
	},
/obj/item/clothing/head/helmet/riot{
	pixel_x = -3;
	pixel_y = 3
	},
/obj/item/clothing/head/helmet/riot,
/obj/item/clothing/head/helmet/riot{
	pixel_x = 3;
	pixel_y = -3
	},
/obj/item/shield/riot{
	pixel_x = -3;
	pixel_y = 3
	},
/obj/item/shield/riot,
/obj/item/shield/riot{
	pixel_x = 3;
	pixel_y = -3
	},
/obj/effect/turf_decal/tile/neutral/fourcorners,
/turf/open/floor/iron/dark,
/area/station/ai_monitored/security/armory)
"YX" = (
/obj/machinery/atmospherics/pipe/smart/manifold4w/supply/hidden/layer4,
/obj/effect/turf_decal/tile/neutral/fourcorners,
/turf/open/floor/iron/dark,
/area/station/ai_monitored/security/armory)

(1,1,1) = {"
bu
bu
bu
bu
UW
UW
UW
UW
UW
wo
Tw
"}
(2,1,1) = {"
nh
nh
nh
UW
UW
BF
GO
zL
UW
UW
UW
"}
(3,1,1) = {"
nh
nh
nh
UW
XE
Df
lp
Xn
cR
wJ
UW
"}
(4,1,1) = {"
UW
UW
UW
UW
ac
TA
ww
kS
Xn
fc
UW
"}
(5,1,1) = {"
UW
Mf
Mf
Mf
YX
OF
Mp
wj
kS
SD
hx
"}
(6,1,1) = {"
UW
Xn
Xn
Xn
ko
Mj
TP
Hv
OH
Xn
gK
"}
(7,1,1) = {"
UW
kT
Fl
NW
ko
VJ
cy
Gk
HT
Xn
hx
"}
(8,1,1) = {"
UW
UW
UW
UW
LV
UG
Vr
HT
Xn
VK
UW
"}
(9,1,1) = {"
nh
nh
nh
UW
LX
Tz
yt
Xn
Xn
sS
UW
"}
(10,1,1) = {"
cQ
cQ
cQ
UW
UW
KC
ko
BX
UW
UW
UW
"}
(11,1,1) = {"
au
fx
Kc
cQ
UW
UW
wr
TG
UW
jD
aX
"}
