//MAP CONVERTED BY dmm2tgm.py THIS HEADER COMMENT PREVENTS RECONVERSION, DO NOT REMOVE
"af" = (
/obj/machinery/firealarm/directional/west,
/obj/effect/turf_decal/stripes/corner{
	dir = 8
	},
/turf/open/floor/iron,
/area/station/hallway/secondary/entry)
"bz" = (
/obj/effect/turf_decal/stripes/line,
/obj/effect/landmark/navigate_destination/dockescpod,
/turf/open/floor/iron,
/area/station/hallway/secondary/entry)
"bP" = (
/obj/structure/closet/emcloset,
/obj/effect/turf_decal/stripes/line{
	dir = 1
	},
/turf/open/floor/iron,
/area/station/hallway/secondary/entry)
"cG" = (
/obj/effect/turf_decal/stripes/line{
	dir = 1
	},
/obj/machinery/atmospherics/pipe/smart/manifold4w/supply/hidden/layer4,
/obj/machinery/atmospherics/pipe/smart/manifold4w/scrubbers/hidden/layer2,
/turf/open/floor/iron,
/area/station/hallway/secondary/entry)
"cS" = (
/obj/effect/turf_decal/tile/blue,
/obj/machinery/light/directional/south,
/obj/machinery/camera/directional/south{
	c_tag = "Arrivals - Central Docking Wing"
	},
/obj/effect/landmark/event_spawn,
/obj/effect/turf_decal/tile/neutral{
	dir = 8
	},
/turf/open/floor/iron,
/area/station/hallway/secondary/entry)
"dl" = (
/obj/effect/turf_decal/trimline/neutral/filled/line{
	dir = 4
	},
/obj/machinery/atmospherics/pipe/smart/manifold4w/scrubbers/hidden/layer2,
/obj/machinery/atmospherics/pipe/smart/manifold4w/supply/hidden/layer4,
/turf/open/floor/iron,
/area/station/hallway/secondary/entry)
"dn" = (
/obj/machinery/light/directional/west,
/obj/effect/turf_decal/stripes/line{
	dir = 8
	},
/turf/open/floor/iron,
/area/station/hallway/secondary/entry)
"du" = (
/obj/effect/turf_decal/stripes/line{
	dir = 8
	},
/turf/open/floor/iron,
/area/station/hallway/secondary/entry)
"ed" = (
/obj/machinery/atmospherics/pipe/smart/manifold4w/supply/hidden/layer4,
/obj/effect/turf_decal/stripes/line{
	dir = 1
	},
/turf/open/floor/iron,
/area/station/hallway/secondary/entry)
"ep" = (
/obj/effect/turf_decal/trimline/neutral/filled/corner{
	dir = 4
	},
/obj/effect/turf_decal/trimline/neutral/filled/corner,
/obj/machinery/atmospherics/pipe/smart/manifold4w/supply/hidden/layer4,
/obj/machinery/atmospherics/pipe/smart/manifold4w/scrubbers/hidden/layer2,
/obj/structure/cable,
/turf/open/floor/iron,
/area/station/hallway/secondary/entry)
"eX" = (
/turf/closed/wall,
/area/station/maintenance/port/aft)
"fm" = (
/obj/effect/turf_decal/trimline/neutral/filled/line{
	dir = 6
	},
/turf/open/floor/iron,
/area/station/hallway/secondary/entry)
"fK" = (
/obj/effect/turf_decal/tile/blue{
	dir = 4
	},
/obj/machinery/atmospherics/pipe/smart/manifold4w/supply/hidden/layer4,
/obj/machinery/atmospherics/pipe/smart/manifold4w/scrubbers/hidden/layer2,
/obj/effect/turf_decal/tile/neutral{
	dir = 1
	},
/turf/open/floor/iron,
/area/station/hallway/secondary/entry)
"gh" = (
/obj/effect/turf_decal/tile/blue{
	dir = 4
	},
/obj/structure/cable,
/obj/machinery/atmospherics/pipe/smart/manifold4w/supply/hidden/layer4,
/obj/machinery/atmospherics/pipe/smart/manifold4w/scrubbers/hidden/layer2,
/turf/open/floor/iron,
/area/station/hallway/secondary/entry)
"hz" = (
/obj/docking_port/stationary{
	dir = 8;
	dwidth = 1;
	height = 13;
	shuttle_id = "arrivals_stationary";
	name = "arrivals";
	width = 5
	},
/turf/open/space/openspace,
/area/space)
"hN" = (
/obj/effect/turf_decal/trimline/neutral/filled/corner,
/obj/machinery/atmospherics/pipe/smart/manifold4w/supply/hidden/layer4,
/obj/machinery/atmospherics/pipe/smart/manifold4w/scrubbers/hidden/layer2,
/obj/structure/cable,
/turf/open/floor/iron,
/area/station/hallway/secondary/entry)
"ir" = (
/obj/effect/turf_decal/trimline/neutral/filled/corner,
/turf/open/floor/iron,
/area/station/hallway/secondary/entry)
"kq" = (
/obj/effect/turf_decal/stripes/line{
	dir = 1
	},
/obj/machinery/atmospherics/pipe/smart/manifold4w/supply/hidden/layer4,
/turf/open/floor/iron,
/area/station/hallway/secondary/entry)
"kr" = (
/obj/machinery/door/airlock/external{
	name = "Port Docking Bay 2"
	},
/obj/effect/mapping_helpers/airlock/cyclelink_helper_multi{
	cycle_id = "ferry_upper"
	},
/turf/open/floor/iron/dark/textured_large,
/area/station/hallway/secondary/entry)
"mz" = (
/obj/machinery/door/airlock/external{
	name = "Port Docking Bay 2";
	space_dir = 1
	},
/obj/effect/mapping_helpers/airlock/cyclelink_helper_multi{
	cycle_id = "ferry_lower"
	},
/turf/open/floor/iron/dark/textured_large,
/area/station/hallway/secondary/entry)
"mK" = (
/obj/effect/turf_decal/tile/blue{
	dir = 4
	},
/obj/machinery/camera{
	c_tag = "Arrivals - North Docking Hall";
	dir = 6
	},
/obj/structure/cable,
/obj/machinery/atmospherics/pipe/smart/manifold4w/supply/hidden/layer4,
/obj/machinery/atmospherics/pipe/smart/manifold4w/scrubbers/hidden/layer2,
/turf/open/floor/iron,
/area/station/hallway/secondary/entry)
"nD" = (
/obj/machinery/holopad,
/obj/effect/turf_decal/bot,
/obj/machinery/atmospherics/pipe/smart/manifold4w/supply/hidden/layer4,
/obj/machinery/atmospherics/pipe/smart/manifold4w/scrubbers/hidden/layer2,
/turf/open/floor/iron,
/area/station/hallway/secondary/entry)
"nM" = (
/obj/machinery/atmospherics/pipe/smart/manifold4w/supply/hidden/layer4,
/turf/open/floor/iron,
/area/station/hallway/secondary/entry)
"ps" = (
/obj/effect/turf_decal/stripes/corner{
	dir = 4
	},
/obj/machinery/atmospherics/pipe/smart/manifold4w/supply/hidden/layer4,
/turf/open/floor/iron,
/area/station/hallway/secondary/entry)
"qA" = (
/obj/effect/turf_decal/stripes/line,
/turf/open/floor/iron,
/area/station/hallway/secondary/entry)
"rv" = (
/obj/effect/turf_decal/stripes/line,
/obj/machinery/atmospherics/components/unary/vent_scrubber/on/layer2{
	dir = 1
	},
/turf/open/floor/iron,
/area/station/hallway/secondary/entry)
"sl" = (
/obj/effect/turf_decal/trimline/neutral/filled/corner,
/obj/effect/turf_decal/stripes/corner{
	dir = 8
	},
/obj/machinery/airalarm/directional/south,
/turf/open/floor/iron,
/area/station/hallway/secondary/entry)
"sR" = (
/obj/machinery/door/airlock/external{
	name = "Port Docking Bay 4"
	},
/obj/effect/mapping_helpers/airlock/cyclelink_helper,
/turf/open/floor/plating,
/area/station/hallway/secondary/entry)
"tm" = (
/obj/effect/mapping_helpers/airlock/cyclelink_helper{
	dir = 1
	},
/obj/machinery/door/airlock/external{
	name = "Port Docking Bay 1"
	},
/turf/open/floor/plating,
/area/station/hallway/secondary/entry)
"uq" = (
/obj/effect/turf_decal/stripes/line{
	dir = 1
	},
/obj/machinery/computer/shuttle/arrivals/recall,
/turf/open/floor/iron,
/area/station/hallway/secondary/entry)
"vu" = (
/obj/effect/landmark/navigate_destination/dockarrival,
/turf/open/floor/iron,
/area/station/hallway/secondary/entry)
"vI" = (
/turf/closed/wall,
/area/station/construction/mining/aux_base)
"vL" = (
/obj/machinery/door/airlock/external{
	name = "Port Docking Bay 3"
	},
/obj/effect/mapping_helpers/airlock/cyclelink_helper,
/turf/open/floor/plating,
/area/station/hallway/secondary/entry)
"wz" = (
/obj/effect/turf_decal/stripes/line{
	dir = 8
	},
/obj/machinery/light/directional/west,
/turf/open/floor/iron,
/area/station/hallway/secondary/entry)
"xq" = (
/obj/item/beacon,
/obj/effect/turf_decal/stripes/line{
	dir = 1
	},
/turf/open/floor/iron,
/area/station/hallway/secondary/entry)
"xB" = (
/obj/effect/turf_decal/stripes/line{
	dir = 9
	},
/obj/effect/spawner/random/vending/snackvend,
/turf/open/floor/iron,
/area/station/hallway/secondary/entry)
"yf" = (
/obj/structure/cable,
/obj/machinery/atmospherics/pipe/smart/manifold4w/supply/hidden/layer4,
/obj/machinery/atmospherics/pipe/smart/manifold4w/scrubbers/hidden/layer2,
/turf/open/floor/iron,
/area/station/hallway/secondary/entry)
"yi" = (
/obj/effect/turf_decal/tile/blue,
/obj/machinery/light/directional/west,
/obj/effect/turf_decal/tile/neutral{
	dir = 8
	},
/turf/open/floor/iron,
/area/station/hallway/secondary/entry)
"yF" = (
/obj/effect/turf_decal/trimline/neutral/filled/line,
/turf/open/floor/iron,
/area/station/hallway/secondary/entry)
"za" = (
/obj/machinery/atmospherics/pipe/smart/manifold4w/supply/hidden/layer4,
/obj/machinery/atmospherics/pipe/smart/manifold4w/scrubbers/hidden/layer2,
/obj/structure/cable,
/turf/open/floor/iron,
/area/station/hallway/secondary/entry)
"zx" = (
/turf/closed/wall/r_wall,
/area/station/hallway/secondary/entry)
"zA" = (
/obj/effect/turf_decal/trimline/neutral/filled/line{
	dir = 4
	},
/obj/effect/landmark/start/hangover,
/obj/machinery/atmospherics/pipe/smart/manifold4w/supply/hidden/layer4,
/obj/machinery/atmospherics/pipe/smart/manifold4w/scrubbers/hidden/layer2,
/obj/structure/cable,
/turf/open/floor/iron,
/area/station/hallway/secondary/entry)
"zT" = (
/obj/effect/turf_decal/stripes/line{
	dir = 10
	},
/turf/closed/wall/r_wall,
/area/station/hallway/secondary/entry)
"Ab" = (
/obj/effect/mapping_helpers/airlock/cyclelink_helper{
	dir = 1
	},
/obj/machinery/door/airlock/external{
	name = "Port Docking Bay 1"
	},
/obj/effect/landmark/navigate_destination{
	location = "Arrival Shuttle"
	},
/turf/open/floor/plating,
/area/station/hallway/secondary/entry)
"AO" = (
/obj/effect/turf_decal/trimline/neutral/filled/corner{
	dir = 4
	},
/obj/effect/landmark/event_spawn,
/obj/structure/cable,
/obj/machinery/atmospherics/pipe/smart/manifold4w/supply/hidden/layer4,
/obj/machinery/atmospherics/pipe/smart/manifold4w/scrubbers/hidden/layer2,
/turf/open/floor/iron,
/area/station/hallway/secondary/entry)
"BM" = (
/obj/effect/turf_decal/stripes/line{
	dir = 1
	},
/obj/item/radio/intercom/directional/north,
/turf/open/floor/iron,
/area/station/hallway/secondary/entry)
"CS" = (
/obj/machinery/atmospherics/pipe/smart/manifold4w/supply/hidden/layer4,
/obj/machinery/atmospherics/pipe/smart/manifold4w/scrubbers/hidden/layer2,
/obj/effect/turf_decal/tile/neutral{
	dir = 1
	},
/turf/open/floor/iron,
/area/station/hallway/secondary/entry)
"Da" = (
/obj/effect/turf_decal/trimline/neutral/filled/line{
	dir = 5
	},
/turf/open/floor/iron,
/area/station/hallway/secondary/entry)
"Dp" = (
/obj/effect/turf_decal/stripes/line{
	dir = 4
	},
/turf/open/floor/iron,
/area/station/hallway/secondary/entry)
"Du" = (
/obj/effect/turf_decal/tile/blue,
/obj/machinery/atmospherics/components/unary/vent_scrubber/on/layer2{
	dir = 1
	},
/obj/effect/turf_decal/tile/neutral{
	dir = 8
	},
/turf/open/floor/iron,
/area/station/hallway/secondary/entry)
"Dz" = (
/obj/machinery/atmospherics/pipe/smart/manifold4w/supply/hidden/layer4,
/obj/effect/turf_decal/stripes/corner{
	dir = 1
	},
/turf/open/floor/iron,
/area/station/hallway/secondary/entry)
"EO" = (
/obj/effect/turf_decal/tile/neutral{
	dir = 8
	},
/turf/open/floor/iron,
/area/station/hallway/secondary/entry)
"Gx" = (
/obj/effect/turf_decal/trimline/neutral/filled/corner{
	dir = 4
	},
/turf/open/floor/iron,
/area/station/hallway/secondary/entry)
"GC" = (
/obj/effect/turf_decal/stripes/white/line{
	dir = 4
	},
/obj/structure/window/reinforced/spawner/directional/west,
/turf/open/floor/plating/airless,
/area/space/nearstation)
"Hp" = (
/turf/open/floor/plating,
/area/station/hallway/secondary/entry)
"HC" = (
/obj/structure/lattice,
/turf/open/space/openspace,
/area/space/nearstation)
"Il" = (
/obj/effect/turf_decal/stripes/corner{
	dir = 1
	},
/obj/effect/landmark/start/hangover,
/obj/machinery/atmospherics/pipe/smart/manifold4w/supply/hidden/layer4,
/obj/machinery/atmospherics/pipe/smart/manifold4w/scrubbers/hidden/layer2,
/turf/open/floor/iron,
/area/station/hallway/secondary/entry)
"IU" = (
/obj/machinery/door/airlock/external{
	name = "Port Docking Bay 3"
	},
/obj/effect/mapping_helpers/airlock/cyclelink_helper{
	dir = 1
	},
/turf/open/floor/plating,
/area/station/hallway/secondary/entry)
"JD" = (
/obj/machinery/door/airlock/external{
	name = "Port Docking Bay 1";
	space_dir = 1
	},
/obj/effect/mapping_helpers/airlock/cyclelink_helper,
/turf/open/floor/plating,
/area/station/hallway/secondary/entry)
"KO" = (
/turf/open/misc/asteroid/airless,
/area/station/asteroid)
"Mn" = (
/obj/machinery/door/airlock/external{
	name = "Port Docking Bay 4"
	},
/obj/effect/mapping_helpers/airlock/cyclelink_helper{
	dir = 1
	},
/turf/open/floor/plating,
/area/station/hallway/secondary/entry)
"MH" = (
/obj/machinery/door/airlock/external{
	name = "Port Docking Bay 2"
	},
/obj/effect/mapping_helpers/airlock/cyclelink_helper_multi{
	cycle_id = "ferry_lower"
	},
/turf/open/floor/iron/dark/textured_large,
/area/station/hallway/secondary/entry)
"NA" = (
/obj/effect/turf_decal/tile/blue{
	dir = 4
	},
/obj/machinery/light/directional/west,
/obj/machinery/atmospherics/components/unary/vent_pump/on/layer4{
	dir = 4
	},
/obj/effect/turf_decal/tile/neutral{
	dir = 1
	},
/turf/open/floor/iron,
/area/station/hallway/secondary/entry)
"NG" = (
/obj/effect/turf_decal/tile/blue{
	dir = 4
	},
/obj/machinery/light/directional/north,
/obj/machinery/camera{
	c_tag = "Arrivals - South Docking Wing";
	dir = 9
	},
/obj/effect/landmark/event_spawn,
/obj/structure/extinguisher_cabinet/directional/north,
/obj/machinery/atmospherics/pipe/smart/manifold4w/supply/hidden/layer4,
/obj/effect/turf_decal/tile/neutral{
	dir = 1
	},
/turf/open/floor/iron,
/area/station/hallway/secondary/entry)
"NV" = (
/obj/effect/turf_decal/stripes/white/line{
	dir = 8
	},
/obj/structure/window/reinforced/spawner/directional/east,
/turf/open/floor/plating/airless,
/area/space/nearstation)
"Os" = (
/obj/machinery/atmospherics/pipe/smart/manifold4w/supply/hidden/layer4,
/obj/machinery/atmospherics/pipe/smart/manifold4w/scrubbers/hidden/layer2,
/turf/open/floor/iron,
/area/station/hallway/secondary/entry)
"Ox" = (
/obj/machinery/door/airlock/maintenance_hatch{
	name = "Arrivals Maintenance Hatch"
	},
/obj/effect/decal/cleanable/dirt,
/obj/structure/cable,
/turf/open/floor/catwalk_floor,
/area/station/maintenance/port/aft)
"Pb" = (
/turf/open/floor/glass/reinforced,
/area/station/hallway/secondary/entry)
"Pc" = (
/obj/effect/mapping_helpers/airlock/cyclelink_helper,
/obj/machinery/door/airlock/external{
	name = "Port Docking Bay 1";
	space_dir = 1
	},
/turf/open/floor/plating,
/area/station/hallway/secondary/entry)
"Pv" = (
/obj/effect/spawner/structure/window/reinforced,
/turf/open/floor/plating,
/area/station/hallway/secondary/entry)
"Qc" = (
/obj/effect/turf_decal/tile/blue{
	dir = 4
	},
/obj/effect/turf_decal/trimline/neutral/filled/corner,
/obj/structure/cable,
/obj/machinery/atmospherics/pipe/smart/manifold4w/supply/hidden/layer4,
/obj/machinery/atmospherics/pipe/smart/manifold4w/scrubbers/hidden/layer2,
/turf/open/floor/iron,
/area/station/hallway/secondary/entry)
"Ql" = (
/obj/structure/closet/emcloset,
/obj/effect/turf_decal/stripes/line{
	dir = 5
	},
/obj/effect/landmark/start/hangover/closet,
/turf/open/floor/iron,
/area/station/hallway/secondary/entry)
"QL" = (
/obj/docking_port/stationary{
	dheight = 3;
	dir = 2;
	dwidth = 8;
	height = 11;
	shuttle_id = "ferry_home";
	name = "Port Bay 2";
	width = 20
	},
/turf/open/space/openspace,
/area/space)
"Rh" = (
/obj/effect/turf_decal/tile/blue{
	dir = 4
	},
/obj/machinery/atmospherics/pipe/smart/manifold4w/supply/hidden/layer4,
/obj/effect/turf_decal/tile/neutral{
	dir = 1
	},
/turf/open/floor/iron,
/area/station/hallway/secondary/entry)
"Se" = (
/obj/effect/turf_decal/stripes/line,
/obj/effect/landmark/start/hangover,
/turf/open/floor/iron,
/area/station/hallway/secondary/entry)
"Ss" = (
/obj/effect/turf_decal/trimline/neutral/filled/corner{
	dir = 4
	},
/obj/structure/cable,
/obj/machinery/atmospherics/pipe/smart/manifold4w/supply/hidden/layer4,
/obj/machinery/atmospherics/pipe/smart/manifold4w/scrubbers/hidden/layer2,
/turf/open/floor/iron,
/area/station/hallway/secondary/entry)
"SP" = (
/obj/machinery/door/airlock/external{
	name = "Port Docking Bay 2";
	space_dir = 2
	},
/obj/effect/mapping_helpers/airlock/cyclelink_helper_multi{
	cycle_id = "ferry_upper"
	},
/turf/open/floor/iron/dark/textured_large,
/area/station/hallway/secondary/entry)
"Uf" = (
/obj/effect/turf_decal/trimline/neutral/filled/line{
	dir = 4
	},
/turf/open/floor/iron,
/area/station/hallway/secondary/entry)
"Us" = (
/turf/closed/wall,
/area/station/hallway/secondary/entry)
"Ux" = (
/obj/effect/turf_decal/stripes/line{
	dir = 9
	},
/turf/closed/wall/r_wall,
/area/station/hallway/secondary/entry)
"VR" = (
/obj/structure/marker_beacon/burgundy,
/turf/open/floor/plating/airless,
/area/space/nearstation)
"VZ" = (
/obj/effect/turf_decal/trimline/neutral/filled/line{
	dir = 4
	},
/obj/machinery/atmospherics/pipe/smart/manifold4w/supply/hidden/layer4,
/obj/machinery/atmospherics/pipe/smart/manifold4w/scrubbers/hidden/layer2,
/obj/structure/cable,
/turf/open/floor/iron,
/area/station/hallway/secondary/entry)
"Wa" = (
/obj/effect/turf_decal/stripes/line{
	dir = 9
	},
/turf/open/floor/iron,
/area/station/hallway/secondary/entry)
"WD" = (
/obj/effect/turf_decal/tile/blue,
/obj/effect/turf_decal/tile/neutral{
	dir = 8
	},
/turf/open/floor/iron,
/area/station/hallway/secondary/entry)
"WZ" = (
/obj/docking_port/stationary{
	dir = 2;
	dwidth = 11;
	height = 22;
	name = "SS13: Auxiliary Dock, Station-Port";
	shuttle_id = "whiteship_home";
	width = 35
	},
/turf/open/space/openspace,
/area/space)
"Yr" = (
/obj/effect/turf_decal/stripes/corner{
	dir = 1
	},
/turf/open/floor/iron,
/area/station/hallway/secondary/entry)
"YC" = (
/obj/effect/turf_decal/trimline/neutral/filled/line{
	dir = 4
	},
/obj/machinery/camera{
	c_tag = "Arrivals - South Docking Hall";
	dir = 6
	},
/obj/machinery/atmospherics/pipe/smart/manifold4w/supply/hidden/layer4,
/obj/machinery/atmospherics/pipe/smart/manifold4w/scrubbers/hidden/layer2,
/obj/structure/cable,
/turf/open/floor/iron,
/area/station/hallway/secondary/entry)
"Zg" = (
/obj/effect/turf_decal/stripes/line{
	dir = 1
	},
/obj/machinery/atmospherics/components/unary/vent_pump/on/layer4{
	dir = 4
	},
/turf/open/floor/iron,
/area/station/hallway/secondary/entry)
"ZB" = (
/obj/machinery/atmospherics/pipe/smart/manifold4w/scrubbers/hidden/layer2,
/obj/machinery/atmospherics/pipe/smart/manifold4w/supply/hidden/layer4,
/turf/open/floor/iron,
/area/station/hallway/secondary/entry)
"ZH" = (
/turf/open/floor/iron,
/area/station/hallway/secondary/entry)
"ZU" = (
/turf/open/space/openspace,
/area/space)

(1,1,1) = {"
ZU
ZU
ZU
ZU
ZU
ZU
ZU
ZU
ZU
ZU
ZU
ZU
ZU
ZU
ZU
ZU
ZU
ZU
ZU
ZU
ZU
ZU
ZU
ZU
ZU
ZU
ZU
ZU
ZU
ZU
ZU
ZU
"}
(2,1,1) = {"
ZU
ZU
ZU
ZU
ZU
ZU
ZU
ZU
VR
ZU
ZU
ZU
ZU
ZU
ZU
ZU
ZU
ZU
ZU
ZU
ZU
ZU
ZU
ZU
ZU
ZU
ZU
ZU
ZU
ZU
ZU
ZU
"}
(3,1,1) = {"
ZU
ZU
ZU
ZU
ZU
ZU
ZU
ZU
HC
ZU
ZU
ZU
ZU
ZU
ZU
ZU
ZU
ZU
ZU
ZU
ZU
ZU
ZU
ZU
ZU
ZU
ZU
ZU
ZU
ZU
ZU
ZU
"}
(4,1,1) = {"
ZU
ZU
ZU
ZU
ZU
ZU
ZU
ZU
HC
ZU
VR
ZU
ZU
ZU
ZU
ZU
ZU
ZU
ZU
ZU
ZU
ZU
ZU
ZU
ZU
ZU
ZU
ZU
ZU
ZU
ZU
ZU
"}
(5,1,1) = {"
ZU
ZU
ZU
ZU
ZU
ZU
ZU
ZU
HC
ZU
HC
ZU
ZU
ZU
ZU
ZU
ZU
ZU
ZU
ZU
ZU
ZU
ZU
ZU
ZU
ZU
ZU
ZU
ZU
ZU
ZU
ZU
"}
(6,1,1) = {"
ZU
ZU
ZU
ZU
ZU
ZU
ZU
ZU
HC
HC
HC
ZU
ZU
ZU
ZU
ZU
ZU
ZU
ZU
ZU
ZU
ZU
ZU
ZU
ZU
ZU
ZU
ZU
ZU
ZU
ZU
ZU
"}
(7,1,1) = {"
ZU
ZU
ZU
ZU
ZU
ZU
ZU
ZU
HC
ZU
ZU
ZU
ZU
ZU
ZU
ZU
ZU
ZU
ZU
ZU
ZU
ZU
ZU
ZU
ZU
ZU
ZU
ZU
ZU
ZU
ZU
ZU
"}
(8,1,1) = {"
ZU
ZU
ZU
ZU
ZU
ZU
ZU
ZU
HC
ZU
ZU
ZU
ZU
ZU
ZU
ZU
ZU
ZU
ZU
ZU
ZU
ZU
ZU
ZU
ZU
ZU
ZU
ZU
ZU
ZU
ZU
ZU
"}
(9,1,1) = {"
ZU
ZU
ZU
ZU
ZU
ZU
ZU
ZU
HC
ZU
ZU
ZU
ZU
ZU
ZU
ZU
ZU
ZU
ZU
ZU
ZU
ZU
ZU
ZU
ZU
ZU
ZU
ZU
ZU
ZU
ZU
ZU
"}
(10,1,1) = {"
ZU
ZU
ZU
ZU
ZU
ZU
ZU
ZU
HC
ZU
ZU
ZU
ZU
ZU
ZU
ZU
ZU
ZU
ZU
ZU
ZU
ZU
ZU
ZU
ZU
ZU
ZU
ZU
ZU
ZU
ZU
ZU
"}
(11,1,1) = {"
ZU
ZU
ZU
ZU
ZU
ZU
ZU
ZU
HC
ZU
ZU
ZU
ZU
ZU
ZU
ZU
ZU
ZU
ZU
ZU
ZU
ZU
ZU
ZU
ZU
ZU
ZU
ZU
ZU
ZU
ZU
ZU
"}
(12,1,1) = {"
ZU
ZU
ZU
ZU
ZU
ZU
ZU
ZU
HC
ZU
ZU
ZU
ZU
ZU
ZU
ZU
ZU
ZU
ZU
ZU
ZU
ZU
ZU
ZU
ZU
ZU
ZU
ZU
ZU
ZU
ZU
ZU
"}
(13,1,1) = {"
ZU
ZU
ZU
ZU
ZU
ZU
ZU
ZU
HC
ZU
ZU
ZU
ZU
ZU
ZU
ZU
ZU
ZU
ZU
ZU
ZU
ZU
ZU
ZU
ZU
ZU
ZU
ZU
ZU
ZU
ZU
ZU
"}
(14,1,1) = {"
ZU
ZU
ZU
ZU
ZU
ZU
ZU
ZU
HC
ZU
ZU
ZU
ZU
ZU
ZU
ZU
ZU
ZU
ZU
ZU
ZU
ZU
ZU
ZU
ZU
ZU
ZU
ZU
ZU
ZU
ZU
ZU
"}
(15,1,1) = {"
ZU
ZU
ZU
ZU
ZU
ZU
ZU
ZU
HC
ZU
ZU
ZU
ZU
ZU
ZU
ZU
ZU
ZU
ZU
ZU
ZU
ZU
ZU
ZU
ZU
ZU
ZU
ZU
ZU
ZU
ZU
ZU
"}
(16,1,1) = {"
ZU
ZU
ZU
ZU
ZU
ZU
ZU
ZU
HC
ZU
ZU
ZU
ZU
ZU
ZU
ZU
ZU
ZU
ZU
ZU
ZU
ZU
ZU
ZU
ZU
ZU
ZU
ZU
ZU
ZU
ZU
ZU
"}
(17,1,1) = {"
ZU
ZU
ZU
ZU
ZU
ZU
ZU
ZU
HC
ZU
ZU
ZU
ZU
ZU
ZU
ZU
ZU
ZU
ZU
ZU
ZU
ZU
ZU
ZU
ZU
ZU
ZU
ZU
ZU
ZU
ZU
ZU
"}
(18,1,1) = {"
ZU
ZU
ZU
ZU
ZU
ZU
ZU
ZU
HC
ZU
ZU
ZU
ZU
ZU
ZU
ZU
ZU
ZU
ZU
ZU
ZU
ZU
ZU
ZU
ZU
ZU
ZU
ZU
ZU
ZU
ZU
ZU
"}
(19,1,1) = {"
ZU
ZU
ZU
ZU
ZU
ZU
ZU
ZU
HC
ZU
ZU
ZU
ZU
ZU
ZU
ZU
ZU
ZU
ZU
ZU
ZU
ZU
ZU
ZU
ZU
ZU
ZU
ZU
ZU
ZU
ZU
ZU
"}
(20,1,1) = {"
ZU
ZU
ZU
ZU
ZU
ZU
ZU
ZU
HC
ZU
ZU
ZU
ZU
ZU
ZU
ZU
ZU
ZU
ZU
ZU
ZU
ZU
ZU
ZU
ZU
ZU
ZU
ZU
ZU
ZU
ZU
ZU
"}
(21,1,1) = {"
ZU
ZU
ZU
ZU
ZU
ZU
ZU
ZU
HC
ZU
ZU
ZU
ZU
ZU
ZU
ZU
ZU
ZU
ZU
ZU
ZU
ZU
ZU
ZU
ZU
ZU
ZU
ZU
ZU
ZU
ZU
ZU
"}
(22,1,1) = {"
ZU
ZU
ZU
ZU
ZU
ZU
ZU
Us
Us
Us
Us
ZU
ZU
ZU
ZU
ZU
ZU
ZU
ZU
ZU
ZU
ZU
ZU
ZU
ZU
ZU
ZU
ZU
ZU
ZU
ZU
ZU
"}
(23,1,1) = {"
ZU
ZU
ZU
ZU
ZU
Pv
Pv
Pv
Zg
yi
Us
ZU
ZU
ZU
ZU
ZU
ZU
ZU
ZU
ZU
ZU
ZU
Us
Us
Us
Us
ZU
ZU
ZU
ZU
ZU
ZU
"}
(24,1,1) = {"
ZU
ZU
ZU
ZU
ZU
JD
Hp
tm
kq
WD
Us
NV
NV
Us
ZU
ZU
ZU
ZU
ZU
Us
NV
NV
Us
NA
bz
Pv
Pv
Pv
ZU
ZU
ZU
ZU
"}
(25,1,1) = {"
ZU
ZU
ZU
ZU
ZU
Pv
Pv
Pv
ed
ZH
kr
Pb
Pb
SP
ZU
ZU
ZU
ZU
ZU
mz
Pb
Pb
MH
nM
qA
sR
Hp
Mn
WZ
ZU
ZU
ZU
"}
(26,1,1) = {"
ZU
ZU
ZU
ZU
ZU
Pv
xB
du
Dz
ZH
kr
Pb
Pb
SP
QL
ZU
ZU
ZU
ZU
mz
Pb
Pb
MH
nM
qA
Pv
Pv
Pv
ZU
ZU
ZU
ZU
"}
(27,1,1) = {"
ZU
ZU
ZU
ZU
ZU
Pv
uq
ZH
nM
WD
Us
GC
GC
Us
ZU
ZU
ZU
ZU
ZU
Us
GC
GC
Us
Rh
qA
Pv
ZU
ZU
ZU
ZU
ZU
ZU
"}
(28,1,1) = {"
ZU
ZU
ZU
ZU
ZU
Pv
xq
ZH
nM
WD
Pv
ZU
ZU
ZU
ZU
ZU
ZU
ZU
ZU
ZU
ZU
ZU
Pv
Rh
qA
Pv
ZU
ZU
ZU
ZU
ZU
ZU
"}
(29,1,1) = {"
ZU
ZU
ZU
ZU
ZU
Pv
bP
ZH
nM
cS
Us
ZU
ZU
ZU
ZU
ZU
ZU
ZU
ZU
ZU
ZU
ZU
Us
NG
qA
Pv
ZU
ZU
ZU
ZU
ZU
ZU
"}
(30,1,1) = {"
ZU
ZU
ZU
ZU
ZU
Pv
Ql
Dp
ps
WD
Pv
ZU
ZU
ZU
ZU
ZU
ZU
ZU
ZU
ZU
ZU
ZU
Pv
Rh
Se
Pv
ZU
ZU
ZU
ZU
ZU
ZU
"}
(31,1,1) = {"
ZU
ZU
ZU
ZU
ZU
Pv
Pv
Pv
kq
WD
Pv
ZU
ZU
ZU
ZU
ZU
ZU
ZU
ZU
ZU
ZU
ZU
Pv
Rh
qA
Pv
Pv
Pv
ZU
ZU
ZU
ZU
"}
(32,1,1) = {"
ZU
ZU
ZU
ZU
ZU
Pc
Hp
Ab
nM
WD
Pv
ZU
ZU
ZU
ZU
ZU
ZU
ZU
ZU
ZU
ZU
ZU
Pv
Rh
qA
vL
Hp
IU
ZU
ZU
ZU
ZU
"}
(33,1,1) = {"
ZU
ZU
ZU
ZU
ZU
Pv
Pv
Pv
cG
Du
Pv
ZU
ZU
ZU
ZU
ZU
ZU
ZU
ZU
ZU
ZU
ZU
Pv
fK
rv
Pv
Pv
Pv
ZU
ZU
ZU
ZU
"}
(34,1,1) = {"
ZU
ZU
ZU
hz
ZU
ZU
Pv
Wa
Il
WD
Pv
ZU
ZU
ZU
ZU
ZU
ZU
ZU
ZU
ZU
ZU
ZU
Pv
fK
sl
Us
ZU
ZU
ZU
ZU
ZU
ZU
"}
(35,1,1) = {"
Pv
Pv
Pv
Pv
zx
zx
zx
BM
Os
EO
zx
Pv
Pv
Pv
zT
Pv
Pv
Pv
Ux
Pv
Pv
Pv
zx
CS
yF
Us
ZU
ZU
ZU
ZU
ZU
ZU
"}
(36,1,1) = {"
du
du
du
du
du
wz
du
Yr
Os
ZH
af
du
dn
du
du
du
du
du
du
du
dn
du
Yr
ZB
yF
Us
KO
KO
KO
KO
KO
KO
"}
(37,1,1) = {"
gh
mK
Qc
AO
yf
ZH
ZH
vu
nD
Os
Os
Os
za
hN
VZ
VZ
zA
VZ
YC
VZ
VZ
ep
dl
dl
fm
Us
KO
KO
KO
KO
KO
KO
"}
(38,1,1) = {"
vI
vI
vI
Da
Ss
ir
Uf
Uf
Uf
Uf
Uf
Gx
hN
fm
Us
Us
Us
Us
Us
eX
eX
Ox
eX
eX
eX
eX
eX
eX
KO
KO
KO
KO
"}
