//MAP CONVERTED BY dmm2tgm.py THIS HEADER COMMENT PREVENTS RECONVERSION, DO NOT REMOVE
"a" = (
/turf/template_noop,
/area/template_noop)
"e" = (
/obj/machinery/door/airlock/security/glass{
	id_tag = "prisondorm";
	name = "Prison Dorm 2"
	},
/obj/effect/turf_decal/trimline/red/filled/line,
/obj/effect/turf_decal/trimline/red/filled/line{
	dir = 1
	},
/obj/machinery/atmospherics/pipe/smart/manifold4w/supply/hidden/layer4,
/obj/machinery/atmospherics/pipe/smart/manifold4w/scrubbers/hidden/layer2,
/obj/structure/curtain/cloth{
	name = "Prisoner Privacy Curtains"
	},
/turf/open/floor/iron,
/area/station/security/prison/safe)
"m" = (
/obj/machinery/door/firedoor,
/obj/machinery/door/airlock/security/glass{
	id_tag = "prisondorm";
	name = "Prison Dorm 6"
	},
/obj/effect/turf_decal/trimline/red/filled/line,
/obj/effect/turf_decal/trimline/red/filled/line{
	dir = 1
	},
/obj/machinery/atmospherics/pipe/smart/manifold4w/supply/hidden/layer4,
/obj/machinery/atmospherics/pipe/smart/manifold4w/scrubbers/hidden/layer2,
/obj/structure/curtain/cloth{
	name = "Prisoner Privacy Curtains"
	},
/turf/open/floor/iron,
/area/station/security/prison/safe)
"H" = (
/obj/machinery/door/airlock/security/glass{
	id_tag = "prisondorm";
	name = "Prison Dorm 4"
	},
/obj/effect/turf_decal/trimline/red/filled/line,
/obj/effect/turf_decal/trimline/red/filled/line{
	dir = 1
	},
/obj/machinery/atmospherics/pipe/smart/manifold4w/supply/hidden/layer4,
/obj/machinery/atmospherics/pipe/smart/manifold4w/scrubbers/hidden/layer2,
/obj/structure/curtain/cloth{
	name = "Prisoner Privacy Curtains"
	},
/turf/open/floor/iron,
/area/station/security/prison/safe)
"J" = (
/obj/machinery/door/airlock/security/glass{
	id_tag = "prisondorm";
	name = "Prison Dorm 3"
	},
/obj/effect/turf_decal/trimline/red/filled/line,
/obj/effect/turf_decal/trimline/red/filled/line{
	dir = 1
	},
/obj/machinery/atmospherics/pipe/smart/manifold4w/supply/hidden/layer4,
/obj/machinery/atmospherics/pipe/smart/manifold4w/scrubbers/hidden/layer2,
/obj/structure/curtain/cloth{
	name = "Prisoner Privacy Curtains"
	},
/turf/open/floor/iron,
/area/station/security/prison/safe)
"M" = (
/obj/machinery/door/airlock/security/glass{
	id_tag = "prisondorm";
	name = "Prison Dorm 5"
	},
/obj/effect/turf_decal/trimline/red/filled/line,
/obj/effect/turf_decal/trimline/red/filled/line{
	dir = 1
	},
/obj/machinery/atmospherics/pipe/smart/manifold4w/supply/hidden/layer4,
/obj/machinery/atmospherics/pipe/smart/manifold4w/scrubbers/hidden/layer2,
/obj/structure/curtain/cloth{
	name = "Prisoner Privacy Curtains"
	},
/turf/open/floor/iron,
/area/station/security/prison/safe)
"Z" = (
/obj/machinery/door/airlock/security/glass{
	id_tag = "prisondorm";
	name = "Prison Dorm 1"
	},
/obj/effect/turf_decal/trimline/red/filled/line,
/obj/effect/turf_decal/trimline/red/filled/line{
	dir = 1
	},
/obj/machinery/atmospherics/pipe/smart/manifold4w/supply/hidden/layer4,
/obj/machinery/atmospherics/pipe/smart/manifold4w/scrubbers/hidden/layer2,
/obj/structure/curtain/cloth{
	name = "Prisoner Privacy Curtains"
	},
/turf/open/floor/iron,
/area/station/security/prison/safe)

(1,1,1) = {"
M
a
a
a
J
a
a
a
Z
"}
(2,1,1) = {"
a
a
a
a
a
a
a
a
a
"}
(3,1,1) = {"
a
a
a
a
a
a
a
a
a
"}
(4,1,1) = {"
m
a
a
a
H
a
a
a
e
"}
