//MAP CONVERTED BY dmm2tgm.py THIS HEADER COMMENT PREVENTS RECONVERSION, DO NOT REMOVE
"ab" = (
/obj/machinery/vending/tool,
/obj/machinery/airalarm/directional/east,
/obj/effect/turf_decal/trimline/neutral/filled/line{
	dir = 4
	},
/obj/machinery/camera/directional/east{
	c_tag = "Civilian - Primary Tool Storage"
	},
/turf/open/floor/iron,
/area/station/commons/storage/primary)
"az" = (
/obj/machinery/light/directional/south,
/obj/structure/cable,
/obj/machinery/atmospherics/pipe/smart/manifold4w/supply/hidden/layer4,
/obj/machinery/atmospherics/pipe/smart/manifold4w/scrubbers/hidden/layer2,
/turf/open/floor/wood,
/area/command/heads_quarters/captain/private/nt_rep)
"bG" = (
/obj/effect/spawner/structure/window,
/turf/open/floor/plating,
/area/station/commons/storage/primary)
"bL" = (
/obj/effect/turf_decal/trimline/green/filled/line{
	dir = 4
	},
/obj/effect/turf_decal/siding/thinplating/corner,
/turf/open/floor/iron/dark,
/area/station/service/hydroponics)
"ci" = (
/obj/effect/turf_decal/trimline/green/corner{
	dir = 8
	},
/turf/open/floor/iron,
/area/station/hallway/primary/central)
"cl" = (
/obj/effect/turf_decal/trimline/neutral/filled/line{
	dir = 8
	},
/obj/effect/turf_decal/trimline/green/filled/warning{
	dir = 8
	},
/obj/machinery/duct,
/obj/effect/turf_decal/siding/thinplating{
	dir = 8
	},
/turf/open/floor/iron,
/area/station/hallway/primary/central)
"dz" = (
/obj/structure/cable,
/obj/machinery/atmospherics/pipe/smart/manifold4w/supply/hidden/layer4,
/obj/machinery/atmospherics/pipe/smart/manifold4w/scrubbers/hidden/layer2,
/obj/machinery/light_switch/directional/south,
/turf/open/floor/wood,
/area/command/heads_quarters/captain/private/nt_rep)
"fw" = (
/obj/effect/spawner/structure/window/reinforced,
/obj/machinery/door/poddoor/preopen{
	id = "nt_rep_priv";
	name = "Privacy Shutter"
	},
/obj/structure/cable,
/turf/open/floor/plating,
/area/command/heads_quarters/captain/private/nt_rep)
"gI" = (
/obj/effect/turf_decal/trimline/neutral/filled/line{
	dir = 1
	},
/obj/item/radio/intercom/directional/north,
/turf/open/floor/iron,
/area/station/hallway/primary/central)
"ie" = (
/obj/effect/turf_decal/siding/wood{
	dir = 4
	},
/obj/machinery/atmospherics/pipe/smart/manifold4w/supply/hidden/layer4,
/turf/open/floor/wood,
/area/command/heads_quarters/captain/private/nt_rep)
"iA" = (
/obj/machinery/modular_computer/console/preset/command,
/obj/machinery/power/apc/auto_name/directional/north,
/obj/structure/cable,
/turf/open/floor/wood,
/area/command/heads_quarters/captain/private/nt_rep)
"iN" = (
/obj/structure/table,
/obj/item/storage/toolbox/electrical{
	pixel_x = 1;
	pixel_y = -1
	},
/obj/effect/turf_decal/trimline/neutral/filled/line{
	dir = 8
	},
/turf/open/floor/iron,
/area/station/commons/storage/primary)
"jd" = (
/obj/machinery/door/airlock/corporate{
	name = "NT Consultant's Office"
	},
/obj/effect/mapping_helpers/airlock/access/all/cent_com/rep_door,
/obj/effect/turf_decal/siding/wood{
	dir = 4
	},
/obj/structure/cable,
/obj/machinery/atmospherics/pipe/smart/manifold4w/supply/hidden/layer4,
/obj/machinery/atmospherics/pipe/smart/manifold4w/scrubbers/hidden/layer2,
/obj/machinery/door/firedoor,
/turf/open/floor/iron,
/area/command/heads_quarters/captain/private/nt_rep)
"jz" = (
/obj/structure/table,
/obj/item/stack/cable_coil{
	pixel_x = 2;
	pixel_y = -2
	},
/obj/item/stack/cable_coil{
	pixel_x = 3;
	pixel_y = -7
	},
/obj/item/screwdriver{
	pixel_y = 16
	},
/obj/effect/turf_decal/trimline/neutral/filled/line{
	dir = 8
	},
/obj/machinery/firealarm/directional/west,
/obj/item/storage/belt/utility,
/turf/open/floor/iron,
/area/station/commons/storage/primary)
"jS" = (
/obj/effect/turf_decal/trimline/neutral/filled/line{
	dir = 5
	},
/turf/open/floor/iron,
/area/station/commons/storage/primary)
"lj" = (
/obj/effect/turf_decal/siding/wood{
	dir = 4
	},
/obj/machinery/atmospherics/components/unary/vent_pump/on/layer4,
/turf/open/floor/wood,
/area/command/heads_quarters/captain/private/nt_rep)
"ll" = (
/obj/machinery/atmospherics/pipe/smart/manifold4w/supply/hidden/layer4,
/obj/machinery/atmospherics/pipe/smart/manifold4w/scrubbers/hidden/layer2,
/obj/machinery/status_display/ai/directional/south,
/turf/open/floor/wood,
/area/command/heads_quarters/captain/private/nt_rep)
"mh" = (
/obj/structure/sink/directional/south,
/obj/effect/turf_decal/trimline/green/filled/line{
	dir = 5
	},
/obj/machinery/newscaster/directional/east,
/turf/open/floor/iron/dark,
/area/station/service/hydroponics)
"mH" = (
/obj/machinery/atmospherics/pipe/smart/manifold4w/supply/hidden/layer4,
/turf/open/floor/iron,
/area/station/commons/storage/primary)
"nH" = (
/obj/structure/table,
/obj/item/analyzer,
/obj/item/wrench,
/obj/effect/turf_decal/trimline/neutral/filled/line{
	dir = 8
	},
/turf/open/floor/iron,
/area/station/commons/storage/primary)
"pm" = (
/obj/structure/cable,
/turf/open/floor/wood,
/area/command/heads_quarters/captain/private/nt_rep)
"qb" = (
/turf/closed/wall/r_wall,
/area/station/commons/storage/primary)
"qe" = (
/obj/effect/turf_decal/trimline/neutral/filled/corner{
	dir = 4
	},
/obj/effect/turf_decal/trimline/neutral/filled/corner,
/obj/machinery/atmospherics/pipe/smart/manifold4w/supply/hidden/layer4,
/obj/structure/disposalpipe/segment{
	dir = 6
	},
/obj/structure/cable,
/obj/machinery/atmospherics/pipe/smart/manifold4w/scrubbers/hidden/layer2,
/turf/open/floor/iron,
/area/station/hallway/primary/central)
"qu" = (
/obj/machinery/status_display/ai/directional/north,
/turf/open/floor/carpet/executive,
/area/command/heads_quarters/captain/private/nt_rep)
"rn" = (
/obj/machinery/vending/assist,
/obj/machinery/requests_console/directional/east{
	department = "Tool Storage";
	name = "Tool Department Requests Console"
	},
/obj/effect/turf_decal/trimline/neutral/filled/line{
	dir = 4
	},
/turf/open/floor/iron,
/area/station/commons/storage/primary)
"rP" = (
/obj/structure/table/wood,
/obj/item/taperecorder{
	pixel_x = 5;
	pixel_y = 5
	},
/obj/item/camera_film{
	pixel_x = 6
	},
/obj/item/camera_film{
	pixel_x = 6;
	pixel_y = 4
	},
/obj/item/camera{
	pixel_x = -4
	},
/turf/open/floor/carpet/executive,
/area/command/heads_quarters/captain/private/nt_rep)
"sL" = (
/obj/effect/turf_decal/trimline/neutral/filled/line{
	dir = 8
	},
/obj/structure/disposalpipe/segment,
/turf/open/floor/iron,
/area/station/commons/storage/primary)
"tB" = (
/turf/closed/wall,
/area/station/hallway/primary/central)
"tQ" = (
/obj/effect/turf_decal/trimline/neutral/filled/corner{
	dir = 1
	},
/obj/effect/turf_decal/trimline/neutral/filled/corner{
	dir = 8
	},
/obj/structure/disposalpipe/segment{
	dir = 9
	},
/turf/open/floor/iron,
/area/station/commons/storage/primary)
"tS" = (
/obj/effect/turf_decal/trimline/neutral/filled/line{
	dir = 8
	},
/obj/effect/turf_decal/trimline/green/filled/warning{
	dir = 8
	},
/obj/machinery/duct,
/obj/machinery/atmospherics/components/unary/vent_pump/on/layer4{
	dir = 4
	},
/turf/open/floor/iron,
/area/station/hallway/primary/central)
"uL" = (
/obj/effect/turf_decal/trimline/neutral/filled/line{
	dir = 4
	},
/turf/open/floor/iron,
/area/station/hallway/primary/central)
"vg" = (
/obj/effect/turf_decal/trimline/green/filled/corner{
	dir = 4
	},
/obj/effect/turf_decal/trimline/green/filled/corner,
/obj/effect/turf_decal/siding/thinplating{
	dir = 4
	},
/turf/open/floor/iron/dark,
/area/station/service/hydroponics)
"vt" = (
/obj/effect/turf_decal/trimline/neutral/filled/corner{
	dir = 4
	},
/turf/open/floor/iron,
/area/station/commons/storage/primary)
"vJ" = (
/obj/effect/turf_decal/siding/wood{
	dir = 1
	},
/obj/structure/chair/office{
	dir = 1
	},
/obj/item/radio/intercom/directional/east,
/obj/effect/landmark/start/nanotrasen_consultant,
/turf/open/floor/wood,
/area/command/heads_quarters/captain/private/nt_rep)
"vN" = (
/obj/machinery/status_display/evac/directional/east,
/obj/machinery/camera/directional/east{
	c_tag = "Hallway - Service Wing Right Upper Hall"
	},
/obj/effect/turf_decal/trimline/neutral/filled/line{
	dir = 4
	},
/obj/structure/cable,
/obj/machinery/atmospherics/pipe/smart/manifold4w/supply/hidden/layer4,
/obj/machinery/atmospherics/pipe/smart/manifold4w/scrubbers/hidden/layer2,
/turf/open/floor/iron,
/area/station/hallway/primary/central)
"wc" = (
/obj/structure/table/wood,
/obj/item/paper_bin{
	pixel_y = 4
	},
/obj/item/pen/fountain,
/turf/open/floor/carpet/executive,
/area/command/heads_quarters/captain/private/nt_rep)
"wf" = (
/obj/effect/turf_decal/trimline/neutral/filled/line{
	dir = 5
	},
/turf/open/floor/iron,
/area/station/hallway/primary/central)
"wy" = (
/turf/closed/wall,
/area/station/service/hydroponics)
"yP" = (
/turf/closed/wall/r_wall,
/area/command/heads_quarters/captain/private/nt_rep)
"zj" = (
/obj/structure/chair/sofa/bench/right{
	dir = 4
	},
/turf/open/floor/iron,
/area/station/hallway/primary/central)
"zl" = (
/obj/machinery/door/window/left/directional/west{
	name = "Hydroponics Desk";
	req_access = list("hydroponics")
	},
/obj/machinery/door/firedoor,
/obj/structure/table/reinforced,
/turf/open/floor/iron/dark,
/area/station/service/hydroponics)
"zH" = (
/obj/structure/table/wood,
/obj/item/stamp/centcom{
	pixel_y = 5
	},
/turf/open/floor/carpet/executive,
/area/command/heads_quarters/captain/private/nt_rep)
"Aa" = (
/turf/open/floor/iron,
/area/station/commons/storage/primary)
"Ab" = (
/obj/effect/turf_decal/trimline/neutral/filled/line{
	dir = 4
	},
/obj/machinery/atmospherics/pipe/smart/manifold4w/supply/hidden/layer4,
/obj/structure/disposalpipe/junction,
/obj/structure/cable,
/obj/machinery/atmospherics/pipe/smart/manifold4w/scrubbers/hidden/layer2,
/turf/open/floor/iron,
/area/station/hallway/primary/central)
"Af" = (
/obj/structure/chair/office{
	dir = 1
	},
/obj/structure/cable,
/obj/effect/landmark/start/nanotrasen_consultant,
/turf/open/floor/wood,
/area/command/heads_quarters/captain/private/nt_rep)
"CZ" = (
/obj/machinery/photocopier,
/turf/open/floor/wood,
/area/command/heads_quarters/captain/private/nt_rep)
"Ev" = (
/obj/structure/chair/sofa/bench{
	dir = 4
	},
/obj/machinery/light/directional/west,
/turf/open/floor/iron,
/area/station/hallway/primary/central)
"EE" = (
/obj/structure/rack,
/obj/item/storage/toolbox/mechanical{
	pixel_x = -2;
	pixel_y = -1
	},
/obj/item/t_scanner,
/obj/effect/turf_decal/trimline/neutral/filled/line{
	dir = 5
	},
/turf/open/floor/iron,
/area/station/commons/storage/primary)
"Fh" = (
/obj/machinery/atmospherics/pipe/smart/manifold4w/supply/hidden/layer4,
/obj/machinery/atmospherics/pipe/smart/manifold4w/scrubbers/hidden/layer2,
/turf/open/floor/wood,
/area/command/heads_quarters/captain/private/nt_rep)
"Ft" = (
/obj/item/kirbyplants/random,
/turf/open/floor/wood,
/area/command/heads_quarters/captain/private/nt_rep)
"Hb" = (
/obj/effect/turf_decal/delivery,
/obj/structure/reagent_dispensers/watertank,
/obj/effect/turf_decal/trimline/neutral/filled/line{
	dir = 1
	},
/obj/machinery/light/directional/north,
/turf/open/floor/iron,
/area/station/commons/storage/primary)
"Hl" = (
/obj/structure/table/wood,
/obj/item/stamp/denied{
	pixel_x = -6
	},
/obj/item/stamp{
	pixel_x = 6
	},
/obj/machinery/newscaster/directional/east,
/turf/open/floor/carpet/executive,
/area/command/heads_quarters/captain/private/nt_rep)
"Hq" = (
/obj/machinery/light/directional/north,
/turf/open/floor/carpet/executive,
/area/command/heads_quarters/captain/private/nt_rep)
"Hx" = (
/obj/effect/turf_decal/trimline/neutral/filled/corner{
	dir = 1
	},
/obj/structure/chair/sofa/bench/left{
	dir = 4
	},
/turf/open/floor/iron,
/area/station/hallway/primary/central)
"HI" = (
/obj/machinery/vending/modularpc,
/obj/item/radio/intercom/directional/east,
/obj/effect/turf_decal/trimline/neutral/filled/line{
	dir = 4
	},
/turf/open/floor/iron,
/area/station/commons/storage/primary)
"Ij" = (
/obj/effect/turf_decal/bot,
/obj/machinery/holopad,
/obj/machinery/atmospherics/pipe/smart/manifold4w/supply/hidden/layer4,
/turf/open/floor/iron,
/area/station/commons/storage/primary)
"JN" = (
/obj/effect/turf_decal/trimline/neutral/filled/line{
	dir = 4
	},
/obj/structure/cable,
/obj/machinery/atmospherics/pipe/smart/manifold4w/supply/hidden/layer4,
/obj/machinery/atmospherics/pipe/smart/manifold4w/scrubbers/hidden/layer2,
/turf/open/floor/iron,
/area/station/hallway/primary/central)
"Kq" = (
/obj/effect/turf_decal/siding/wood/corner{
	dir = 4
	},
/obj/machinery/holopad,
/obj/machinery/atmospherics/pipe/smart/manifold4w/supply/hidden/layer4,
/turf/open/floor/wood,
/area/command/heads_quarters/captain/private/nt_rep)
"Lf" = (
/obj/effect/turf_decal/trimline/green/filled/line,
/obj/effect/turf_decal/trimline/green/filled/line{
	dir = 1
	},
/obj/machinery/door/airlock/hydroponics/glass{
	name = "Hydroponics"
	},
/obj/effect/mapping_helpers/airlock/access/all/service/hydroponics,
/obj/machinery/door/firedoor,
/obj/effect/mapping_helpers/airlock/cyclelink_helper{
	dir = 8
	},
/obj/structure/disposalpipe/segment{
	dir = 4
	},
/turf/open/floor/iron/dark,
/area/station/service/hydroponics)
"Mb" = (
/obj/effect/turf_decal/siding/wood{
	dir = 1
	},
/obj/structure/chair/office{
	dir = 1
	},
/obj/effect/landmark/start/nanotrasen_consultant,
/turf/open/floor/wood,
/area/command/heads_quarters/captain/private/nt_rep)
"Mj" = (
/turf/open/floor/iron,
/area/station/hallway/primary/central)
"Mt" = (
/obj/machinery/atmospherics/pipe/smart/manifold4w/scrubbers/hidden/layer2,
/turf/open/floor/wood,
/area/command/heads_quarters/captain/private/nt_rep)
"Ng" = (
/obj/effect/turf_decal/trimline/green/filled/line,
/obj/effect/turf_decal/trimline/green/filled/line{
	dir = 1
	},
/obj/machinery/door/airlock/hydroponics/glass{
	name = "Hydroponics"
	},
/obj/effect/mapping_helpers/airlock/access/all/service/hydroponics,
/obj/machinery/door/firedoor,
/obj/effect/mapping_helpers/airlock/cyclelink_helper{
	dir = 8
	},
/obj/machinery/duct,
/turf/open/floor/iron/dark,
/area/station/service/hydroponics)
"Nt" = (
/obj/machinery/disposal/bin,
/obj/effect/turf_decal/trimline/neutral/filled/line{
	dir = 9
	},
/obj/machinery/light_switch/directional/west,
/obj/structure/disposalpipe/trunk,
/turf/open/floor/iron,
/area/station/commons/storage/primary)
"NA" = (
/obj/structure/filingcabinet/chestdrawer,
/turf/open/floor/wood,
/area/command/heads_quarters/captain/private/nt_rep)
"NT" = (
/obj/effect/turf_decal/trimline/neutral/filled/line,
/obj/effect/turf_decal/trimline/neutral/filled/line{
	dir = 1
	},
/obj/machinery/door/airlock/public/glass{
	name = "Primary Tool Storage"
	},
/obj/machinery/door/firedoor,
/obj/structure/disposalpipe/segment{
	dir = 4
	},
/turf/open/floor/iron,
/area/station/commons/storage/primary)
"Ot" = (
/obj/structure/table,
/obj/item/crowbar,
/obj/item/clothing/gloves/color/fyellow,
/obj/item/assembly/prox_sensor{
	pixel_x = -8;
	pixel_y = 4
	},
/turf/open/floor/iron,
/area/station/commons/storage/primary)
"Pk" = (
/obj/effect/spawner/random/vending/snackvend,
/turf/open/floor/iron/dark,
/area/station/hallway/primary/central)
"Qz" = (
/obj/effect/turf_decal/trimline/neutral/filled/line{
	dir = 8
	},
/obj/effect/turf_decal/trimline/green/filled/warning{
	dir = 8
	},
/obj/machinery/duct,
/obj/effect/turf_decal/siding/thinplating/corner{
	dir = 8
	},
/turf/open/floor/iron,
/area/station/hallway/primary/central)
"Ry" = (
/obj/effect/turf_decal/trimline/neutral/filled/corner{
	dir = 8
	},
/obj/effect/turf_decal/trimline/neutral/filled/corner{
	dir = 1
	},
/obj/effect/turf_decal/trimline/green/corner{
	dir = 8
	},
/obj/effect/turf_decal/trimline/green/corner{
	dir = 1
	},
/obj/machinery/duct,
/obj/structure/disposalpipe/segment{
	dir = 4
	},
/turf/open/floor/iron,
/area/station/hallway/primary/central)
"SF" = (
/turf/open/floor/wood,
/area/command/heads_quarters/captain/private/nt_rep)
"SW" = (
/obj/effect/spawner/structure/window/reinforced,
/turf/open/floor/plating,
/area/station/service/hydroponics)
"Tg" = (
/obj/structure/chair/office,
/obj/effect/landmark/start/nanotrasen_consultant,
/turf/open/floor/carpet/executive,
/area/command/heads_quarters/captain/private/nt_rep)
"Tk" = (
/obj/machinery/atmospherics/components/unary/vent_pump/on/layer4{
	dir = 8
	},
/obj/effect/turf_decal/trimline/neutral/filled/line{
	dir = 4
	},
/turf/open/floor/iron,
/area/station/commons/storage/primary)
"Tq" = (
/turf/closed/wall,
/area/station/commons/storage/primary)
"UO" = (
/obj/structure/closet/secure_closet/nanotrasen_consultant/station,
/obj/item/assembly/flash/handheld,
/turf/open/floor/carpet/executive,
/area/command/heads_quarters/captain/private/nt_rep)
"UR" = (
/obj/machinery/atmospherics/components/unary/vent_scrubber/on/layer2{
	dir = 8
	},
/turf/open/floor/wood,
/area/command/heads_quarters/captain/private/nt_rep)
"Vq" = (
/obj/effect/turf_decal/trimline/neutral/filled/line{
	dir = 9
	},
/turf/open/floor/iron,
/area/station/hallway/primary/central)
"VN" = (
/obj/effect/turf_decal/siding/wood{
	dir = 4
	},
/obj/structure/filingcabinet/employment,
/obj/machinery/camera/directional/north{
	c_tag = "NT Consultant's Office";
	name = "command camera"
	},
/turf/open/floor/wood,
/area/command/heads_quarters/captain/private/nt_rep)
"Wd" = (
/obj/machinery/button/door/directional/west{
	id = "nt_rep_priv";
	name = "Privacy Shutters Control";
	pixel_y = 8
	},
/obj/structure/table/wood,
/obj/machinery/fax{
	fax_name = "Nanotrasen Consultant's Office";
	name = "Nanotrasen Consultant's Fax Machine"
	},
/turf/open/floor/wood,
/area/command/heads_quarters/captain/private/nt_rep)
"Wi" = (
/obj/effect/turf_decal/delivery,
/obj/structure/reagent_dispensers/fueltank,
/obj/effect/turf_decal/trimline/neutral/filled/line{
	dir = 1
	},
/turf/open/floor/iron,
/area/station/commons/storage/primary)
"WQ" = (
/obj/effect/turf_decal/trimline/green/filled/corner{
	dir = 4
	},
/obj/effect/turf_decal/trimline/green/filled/corner,
/obj/structure/disposalpipe/segment{
	dir = 4
	},
/turf/open/floor/iron/dark,
/area/station/service/hydroponics)
"WW" = (
/obj/effect/turf_decal/trimline/neutral/filled/line{
	dir = 4
	},
/obj/machinery/atmospherics/pipe/smart/manifold4w/supply/hidden/layer4,
/obj/structure/disposalpipe/segment,
/obj/structure/cable,
/obj/machinery/atmospherics/pipe/smart/manifold4w/scrubbers/hidden/layer2,
/turf/open/floor/iron,
/area/station/hallway/primary/central)
"XG" = (
/turf/open/floor/carpet/executive,
/area/command/heads_quarters/captain/private/nt_rep)
"YI" = (
/obj/machinery/airalarm/directional/west,
/turf/open/floor/iron,
/area/station/hallway/primary/central)
"YN" = (
/obj/effect/turf_decal/trimline/green/filled/corner{
	dir = 4
	},
/obj/effect/turf_decal/trimline/green/filled/corner,
/obj/machinery/duct,
/turf/open/floor/iron/dark,
/area/station/service/hydroponics)
"YW" = (
/obj/effect/turf_decal/trimline/neutral/filled/corner{
	dir = 8
	},
/obj/effect/turf_decal/trimline/green/corner{
	dir = 8
	},
/obj/effect/turf_decal/trimline/green/corner{
	dir = 1
	},
/obj/machinery/duct,
/turf/open/floor/iron,
/area/station/hallway/primary/central)
"ZD" = (
/obj/effect/turf_decal/trimline/green/filled/line{
	dir = 4
	},
/turf/open/floor/iron/dark,
/area/station/service/hydroponics)
"ZG" = (
/turf/closed/mineral/random/stationside/asteroid/porus,
/area/mine/explored)

(1,1,1) = {"
ZG
ZG
tB
Pk
wy
wy
wy
wy
mh
YN
ZD
WQ
bL
vg
"}
(2,1,1) = {"
ZG
ZG
tB
Vq
Hx
Ev
zj
wy
wy
Ng
SW
Lf
SW
zl
"}
(3,1,1) = {"
ZG
ZG
tB
gI
Mj
Mj
Mj
YI
ci
YW
tS
Ry
Qz
cl
"}
(4,1,1) = {"
ZG
ZG
tB
wf
uL
uL
JN
vN
JN
JN
qe
Ab
WW
WW
"}
(5,1,1) = {"
ZG
yP
yP
fw
fw
fw
jd
qb
Tq
bG
NT
bG
Tq
bG
"}
(6,1,1) = {"
ZG
yP
Wd
SF
CZ
NA
dz
qb
Nt
sL
tQ
iN
jz
nH
"}
(7,1,1) = {"
yP
yP
iA
Af
pm
pm
az
qb
Wi
Aa
Aa
Aa
Ot
Aa
"}
(8,1,1) = {"
yP
VN
lj
ie
Kq
Fh
ll
qb
Hb
mH
mH
mH
Ij
mH
"}
(9,1,1) = {"
yP
Hq
XG
rP
Mb
Mt
SF
qb
jS
Tk
vt
Aa
Aa
Aa
"}
(10,1,1) = {"
yP
qu
Tg
zH
vJ
UR
Ft
qb
Tq
Tq
EE
HI
ab
rn
"}
(11,1,1) = {"
yP
UO
Hl
wc
yP
yP
yP
yP
ZG
Tq
Tq
Tq
Tq
Tq
"}
(12,1,1) = {"
yP
yP
yP
yP
yP
ZG
ZG
ZG
ZG
ZG
ZG
ZG
ZG
ZG
"}
