//MAP CONVERTED BY dmm2tgm.py THIS HEADER COMMENT PREVENTS RECONVERSION, DO NOT REMOVE
"eX" = (
/obj/effect/turf_decal/tile/purple/opposingcorners,
/turf/open/floor/iron,
/area/station/service/barber)
"hO" = (
/obj/structure/sink/directional/east,
/obj/effect/turf_decal/tile/purple/opposingcorners,
/turf/open/floor/iron,
/area/station/service/barber)
"hT" = (
/obj/effect/turf_decal/tile/purple/opposingcorners,
/obj/machinery/atmospherics/pipe/smart/manifold4w/supply/hidden/layer4,
/obj/item/radio/intercom/directional/south,
/turf/open/floor/iron/white,
/area/station/service/barber)
"hZ" = (
/turf/closed/wall,
/area/station/security/courtroom)
"iD" = (
/obj/effect/turf_decal/tile/purple/opposingcorners,
/obj/machinery/light/warm/directional/west,
/obj/effect/landmark/start/barber,
/turf/open/floor/iron,
/area/station/service/barber)
"iX" = (
/turf/closed/wall,
/area/station/service/barber)
"ob" = (
/obj/machinery/atmospherics/components/unary/vent_scrubber/on/layer2,
/turf/open/floor/iron/dark,
/area/station/service/barber)
"oG" = (
/obj/structure/chair/sofa/bench/left{
	dir = 8
	},
/obj/machinery/light_switch/directional/south,
/obj/effect/turf_decal/tile/purple/opposingcorners,
/obj/item/radio/intercom/directional/east,
/obj/effect/landmark/start/barber,
/turf/open/floor/iron,
/area/station/service/barber)
"qi" = (
/obj/effect/turf_decal/tile/purple/opposingcorners,
/obj/machinery/disposal/bin,
/obj/structure/disposalpipe/trunk{
	dir = 8
	},
/obj/machinery/firealarm/directional/east,
/turf/open/floor/iron,
/area/station/service/barber)
"qn" = (
/obj/effect/turf_decal/tile/purple/opposingcorners,
/obj/structure/rack,
/obj/item/lipstick/random{
	pixel_x = 2;
	pixel_y = 2
	},
/obj/item/lipstick/random,
/obj/item/lipstick/random{
	pixel_x = -2;
	pixel_y = -2
	},
/obj/structure/window/reinforced/spawner/north,
/turf/open/floor/iron,
/area/station/service/barber)
"qs" = (
/obj/structure/chair/comfy/barber_chair{
	dir = 1
	},
/turf/open/floor/iron/dark,
/area/station/service/barber)
"rW" = (
/obj/effect/turf_decal/tile/purple/opposingcorners,
/obj/machinery/door/window/left/directional/east{
	name = "Massasge Parlor"
	},
/obj/machinery/atmospherics/pipe/smart/manifold4w/supply/hidden/layer4,
/turf/open/floor/iron,
/area/station/service/barber)
"uK" = (
/obj/effect/turf_decal/tile/purple/opposingcorners,
/obj/machinery/atmospherics/components/unary/vent_pump/on/layer4{
	dir = 8
	},
/turf/open/floor/iron,
/area/station/service/barber)
"vE" = (
/obj/effect/spawner/structure/window,
/obj/structure/curtain/cloth/fancy/mechanical{
	id = "barbershopcurtains"
	},
/turf/open/floor/plating,
/area/station/service/barber)
"vU" = (
/obj/effect/turf_decal/trimline/neutral/filled/line{
	dir = 1
	},
/obj/effect/turf_decal/trimline/green/corner,
/obj/machinery/airalarm/directional/east,
/obj/structure/cable,
/obj/machinery/atmospherics/pipe/smart/manifold4w/supply/hidden/layer4,
/obj/machinery/atmospherics/pipe/smart/manifold4w/scrubbers/hidden/layer2,
/obj/structure/disposalpipe/segment,
/turf/open/floor/iron,
/area/station/hallway/primary/central)
"xA" = (
/obj/effect/turf_decal/trimline/neutral/filled/line{
	dir = 9
	},
/obj/machinery/status_display/ai/directional/west,
/obj/machinery/camera/directional/west{
	c_tag = "Hallway - Service Wing Left Upper Hall"
	},
/turf/open/floor/iron,
/area/station/hallway/primary/central)
"Au" = (
/obj/structure/table/glass,
/obj/structure/mirror/directional/north,
/obj/item/hairbrush,
/turf/open/floor/iron/dark,
/area/station/service/barber)
"AB" = (
/obj/effect/turf_decal/tile/purple/opposingcorners,
/obj/structure/cable,
/obj/machinery/atmospherics/pipe/smart/manifold4w/supply/hidden/layer4,
/obj/machinery/atmospherics/pipe/smart/manifold4w/scrubbers/hidden/layer2,
/obj/structure/disposalpipe/segment,
/turf/open/floor/iron,
/area/station/service/barber)
"AK" = (
/obj/structure/table/glass,
/obj/effect/turf_decal/tile/purple/opposingcorners,
/obj/item/clothing/gloves/color/latex,
/obj/machinery/light/warm/directional/north,
/turf/open/floor/iron/white,
/area/station/service/barber)
"Bj" = (
/turf/template_noop,
/area/template_noop)
"BZ" = (
/obj/machinery/holopad,
/obj/effect/turf_decal/box/white{
	color = "#D381C9"
	},
/obj/structure/cable,
/obj/machinery/atmospherics/pipe/smart/manifold4w/supply/hidden/layer4,
/obj/machinery/atmospherics/pipe/smart/manifold4w/scrubbers/hidden/layer2,
/obj/structure/disposalpipe/segment{
	dir = 6
	},
/turf/open/floor/iron/large,
/area/station/service/barber)
"CC" = (
/obj/effect/turf_decal/tile/purple/opposingcorners,
/turf/open/floor/iron/white,
/area/station/service/barber)
"CE" = (
/obj/machinery/dryer{
	dir = 4;
	pixel_x = -6;
	pixel_y = -6
	},
/obj/effect/turf_decal/tile/purple/opposingcorners,
/turf/open/floor/iron,
/area/station/service/barber)
"Do" = (
/obj/machinery/airalarm/directional/east,
/obj/structure/chair/sofa/bench/right{
	dir = 8
	},
/obj/effect/turf_decal/tile/purple/opposingcorners,
/obj/effect/landmark/start/barber,
/turf/open/floor/iron,
/area/station/service/barber)
"Fl" = (
/obj/machinery/button/curtain{
	id = "barbershopcurtains";
	pixel_x = -24;
	pixel_y = -7
	},
/obj/effect/turf_decal/tile/purple/opposingcorners,
/obj/item/kirbyplants/random,
/turf/open/floor/iron,
/area/station/service/barber)
"Gj" = (
/obj/effect/turf_decal/tile/purple/opposingcorners,
/obj/machinery/atmospherics/components/unary/vent_pump/on/layer4{
	dir = 8
	},
/obj/machinery/camera/directional/east{
	c_tag = "Salon - Massage Parlor"
	},
/turf/open/floor/iron/white,
/area/station/service/barber)
"Hj" = (
/obj/effect/turf_decal/tile/purple/opposingcorners,
/obj/machinery/atmospherics/pipe/smart/manifold4w/supply/hidden/layer4,
/obj/machinery/atmospherics/pipe/smart/manifold4w/scrubbers/hidden/layer2,
/obj/effect/landmark/start/barber,
/turf/open/floor/iron,
/area/station/service/barber)
"IE" = (
/obj/structure/table/glass,
/obj/structure/mirror/directional/north,
/obj/item/hairbrush/comb{
	pixel_y = 11
	},
/obj/item/reagent_containers/dropper,
/turf/open/floor/iron/dark,
/area/station/service/barber)
"Kg" = (
/obj/effect/turf_decal/tile/purple/opposingcorners,
/obj/machinery/newscaster/directional/west,
/obj/machinery/atmospherics/components/unary/vent_scrubber/on/layer2{
	dir = 4
	},
/turf/open/floor/iron,
/area/station/service/barber)
"Lr" = (
/obj/effect/turf_decal/tile/purple/opposingcorners,
/obj/machinery/camera/directional/west{
	c_tag = "Salon"
	},
/turf/open/floor/iron,
/area/station/service/barber)
"Mp" = (
/obj/machinery/vending/barbervend,
/turf/open/floor/iron/dark,
/area/station/service/barber)
"Nb" = (
/obj/effect/turf_decal/tile/purple/opposingcorners,
/obj/machinery/atmospherics/components/unary/vent_pump/on/layer4,
/turf/open/floor/iron,
/area/station/service/barber)
"Ng" = (
/obj/structure/chair/sofa/bench{
	dir = 8
	},
/obj/effect/turf_decal/tile/purple/opposingcorners,
/obj/machinery/light/warm/directional/east,
/obj/effect/landmark/start/barber,
/turf/open/floor/iron,
/area/station/service/barber)
"NA" = (
/obj/effect/turf_decal/tile/purple/opposingcorners,
/obj/machinery/atmospherics/pipe/smart/manifold4w/supply/hidden/layer4,
/obj/machinery/atmospherics/pipe/smart/manifold4w/scrubbers/hidden/layer2,
/obj/structure/disposalpipe/segment{
	dir = 4
	},
/turf/open/floor/iron,
/area/station/service/barber)
"NE" = (
/obj/effect/turf_decal/tile/purple/opposingcorners,
/obj/machinery/power/apc/auto_name/directional/west,
/obj/structure/cable,
/turf/open/floor/iron,
/area/station/service/barber)
"Oa" = (
/turf/closed/wall,
/area/station/maintenance/central/greater)
"Oi" = (
/obj/machinery/door/airlock/public/glass{
	name = "Barbershop"
	},
/obj/machinery/door/firedoor,
/obj/effect/turf_decal/tile/purple/opposingcorners,
/obj/structure/cable,
/obj/machinery/atmospherics/pipe/smart/manifold4w/supply/hidden/layer4,
/obj/machinery/atmospherics/pipe/smart/manifold4w/scrubbers/hidden/layer2,
/obj/structure/disposalpipe/segment,
/turf/open/floor/iron,
/area/station/service/barber)
"OI" = (
/obj/effect/turf_decal/trimline/neutral/filled/line{
	dir = 4
	},
/obj/effect/turf_decal/trimline/green/filled/warning{
	dir = 4
	},
/obj/machinery/atmospherics/components/unary/vent_scrubber/on/layer2,
/obj/structure/cable,
/obj/machinery/atmospherics/pipe/smart/manifold4w/supply/hidden/layer4,
/obj/structure/disposalpipe/segment,
/turf/open/floor/iron,
/area/station/hallway/primary/central)
"Py" = (
/obj/effect/turf_decal/trimline/neutral/filled/corner,
/obj/effect/turf_decal/trimline/green/corner,
/obj/effect/turf_decal/trimline/green/corner{
	dir = 4
	},
/obj/structure/cable,
/obj/machinery/atmospherics/pipe/smart/manifold4w/supply/hidden/layer4,
/obj/machinery/atmospherics/pipe/smart/manifold4w/scrubbers/hidden/layer2,
/obj/structure/disposalpipe/segment,
/turf/open/floor/iron,
/area/station/hallway/primary/central)
"Pz" = (
/obj/effect/turf_decal/tile/purple/opposingcorners,
/obj/structure/chair/stool/bar/directional/west,
/obj/effect/landmark/start/barber,
/turf/open/floor/iron/white,
/area/station/service/barber)
"Qh" = (
/obj/structure/bed/pod{
	dir = 4
	},
/obj/machinery/newscaster/directional/north,
/obj/effect/turf_decal/tile/purple/opposingcorners,
/obj/machinery/button/curtain{
	pixel_x = -26;
	pixel_y = -3;
	id = "barbershopcurtains"
	},
/turf/open/floor/iron/white,
/area/station/service/barber)
"RE" = (
/obj/effect/spawner/structure/window,
/obj/structure/curtain/cloth/fancy/mechanical{
	id = "massage_curtains"
	},
/turf/open/floor/plating,
/area/station/service/barber)
"Sc" = (
/obj/effect/turf_decal/tile/purple/opposingcorners,
/obj/machinery/atmospherics/pipe/smart/manifold4w/supply/hidden/layer4,
/obj/machinery/atmospherics/pipe/smart/manifold4w/scrubbers/hidden/layer2,
/turf/open/floor/iron,
/area/station/service/barber)
"SE" = (
/obj/effect/turf_decal/trimline/neutral/filled/line{
	dir = 8
	},
/obj/machinery/atmospherics/pipe/smart/manifold4w/scrubbers/hidden/layer2,
/turf/open/floor/iron,
/area/station/hallway/primary/central)
"Uq" = (
/turf/open/floor/iron/dark,
/area/station/service/barber)
"Wa" = (
/obj/structure/table/glass,
/obj/item/razor{
	pixel_x = -10;
	pixel_y = 5
	},
/obj/item/reagent_containers/spray/barbers_aid{
	pixel_x = 6;
	pixel_y = 11
	},
/obj/machinery/light/warm/directional/north,
/turf/open/floor/iron/dark,
/area/station/service/barber)
"Xf" = (
/obj/machinery/atmospherics/pipe/smart/manifold4w/scrubbers/hidden/layer2,
/obj/machinery/atmospherics/pipe/smart/manifold4w/supply/hidden/layer4,
/obj/structure/cable,
/obj/effect/turf_decal/trimline/neutral/filled/corner{
	dir = 4
	},
/obj/effect/turf_decal/trimline/neutral/filled/corner,
/obj/effect/turf_decal/trimline/green/corner,
/obj/effect/turf_decal/trimline/green/corner{
	dir = 4
	},
/obj/structure/disposalpipe/junction/flip{
	dir = 4
	},
/turf/open/floor/iron,
/area/station/hallway/primary/central)
"Xj" = (
/turf/closed/wall,
/area/station/service/hydroponics)
"Xo" = (
/obj/machinery/atmospherics/pipe/smart/manifold4w/scrubbers/hidden/layer2,
/obj/machinery/atmospherics/pipe/smart/manifold4w/supply/hidden/layer4,
/obj/structure/cable,
/obj/effect/turf_decal/trimline/neutral/filled/corner{
	dir = 1
	},
/obj/effect/turf_decal/trimline/neutral/filled/corner{
	dir = 8
	},
/obj/structure/disposalpipe/junction{
	dir = 4
	},
/turf/open/floor/iron,
/area/station/hallway/primary/central)
"XN" = (
/obj/effect/turf_decal/tile/purple/opposingcorners,
/obj/structure/closet/secure_closet/barber,
/turf/open/floor/iron,
/area/station/service/barber)

(1,1,1) = {"
iX
iX
iX
Oa
Oa
Oa
Oa
Oa
Oa
Oa
hZ
Bj
Bj
Bj
Bj
"}
(2,1,1) = {"
iX
IE
qs
iD
NE
hO
CE
Lr
Kg
Fl
RE
xA
SE
SE
Xo
"}
(3,1,1) = {"
iX
Wa
Uq
Nb
BZ
AB
AB
AB
AB
AB
Oi
vU
Py
OI
Xf
"}
(4,1,1) = {"
iX
Au
qs
Hj
NA
eX
uK
Do
Ng
oG
Xj
Bj
Bj
Bj
Bj
"}
(5,1,1) = {"
iX
Mp
ob
Sc
qi
qn
XN
Xj
Xj
Xj
Xj
Bj
Bj
Bj
Bj
"}
(6,1,1) = {"
iX
iX
vE
rW
Xj
Xj
Xj
Xj
Bj
Bj
Bj
Bj
Bj
Bj
Bj
"}
(7,1,1) = {"
iX
Qh
CC
hT
Xj
Bj
Bj
Bj
Bj
Bj
Bj
Bj
Bj
Bj
Bj
"}
(8,1,1) = {"
iX
AK
Pz
Gj
Xj
Bj
Bj
Bj
Bj
Bj
Bj
Bj
Bj
Bj
Bj
"}
(9,1,1) = {"
iX
iX
iX
iX
Xj
Bj
Bj
Bj
Bj
Bj
Bj
Bj
Bj
Bj
Bj
"}
