//MAP CONVERTED BY dmm2tgm.py THIS HEADER COMMENT PREVENTS RECONVERSION, DO NOT REMOVE
"ad" = (
/obj/effect/spawner/structure/window{
	polarizer_id = "bshop2"
	},
/turf/open/floor/plating,
/area/station/service/barber)
"cm" = (
/obj/structure/cable,
/obj/machinery/atmospherics/pipe/smart/manifold4w/scrubbers/hidden/layer2,
/obj/machinery/atmospherics/pipe/smart/manifold4w/supply/hidden/layer4,
/obj/effect/turf_decal/siding/wood{
	dir = 4
	},
/obj/effect/turf_decal/tile/purple{
	dir = 8
	},
/turf/open/floor/iron/dark,
/area/station/service/barber)
"dO" = (
/obj/structure/disposalpipe/segment{
	dir = 4
	},
/obj/structure/cable,
/obj/machinery/atmospherics/pipe/smart/manifold4w/scrubbers/hidden/layer2,
/obj/machinery/atmospherics/pipe/smart/manifold4w/supply/hidden/layer4,
/obj/effect/turf_decal/tile/purple{
	dir = 4
	},
/turf/open/floor/iron/dark,
/area/station/service/barber)
"gi" = (
/obj/machinery/light/directional/north,
/obj/structure/sign/poster/official/random/directional/north,
/obj/effect/turf_decal/tile/purple,
/turf/open/floor/iron/dark,
/area/station/service/barber)
"hc" = (
/obj/structure/mirror/directional/east,
/obj/structure/table/glass,
/obj/item/hairbrush/comb{
	pixel_y = 10
	},
/obj/item/reagent_containers/dropper,
/obj/item/reagent_containers/spray/barbers_aid{
	pixel_x = 6
	},
/turf/open/floor/wood/large,
/area/station/service/barber)
"jP" = (
/obj/machinery/firealarm/directional/north{
	pixel_x = 5
	},
/obj/machinery/light_switch/directional/north{
	pixel_x = -8;
	pixel_y = 24
	},
/obj/structure/closet/secure_closet/barber,
/obj/effect/turf_decal/tile/purple,
/turf/open/floor/iron/dark,
/area/station/service/barber)
"ke" = (
/obj/structure/disposalpipe/segment{
	dir = 5
	},
/turf/open/floor/wood/large,
/area/station/service/barber)
"kt" = (
/turf/template_noop,
/area/template_noop)
"lN" = (
/obj/effect/turf_decal/siding/wood{
	dir = 4
	},
/obj/effect/turf_decal/tile/purple{
	dir = 1
	},
/turf/open/floor/iron/dark,
/area/station/service/barber)
"mp" = (
/obj/effect/spawner/structure/window{
	polarizer_id = "bshop"
	},
/turf/open/floor/plating,
/area/station/service/barber)
"nY" = (
/obj/structure/chair/comfy/barber_chair{
	dir = 4
	},
/obj/effect/landmark/start/barber,
/obj/effect/landmark/start/hangover,
/turf/open/floor/wood/large,
/area/station/service/barber)
"oY" = (
/obj/machinery/disposal/bin,
/obj/structure/disposalpipe/trunk{
	dir = 8
	},
/obj/machinery/light/directional/east,
/turf/open/floor/wood/large,
/area/station/service/barber)
"pe" = (
/obj/machinery/atmospherics/components/unary/vent_scrubber/on/layer2,
/obj/item/radio/intercom/directional/north,
/obj/item/kirbyplants/random,
/obj/effect/turf_decal/tile/purple{
	dir = 8
	},
/turf/open/floor/iron/dark,
/area/station/service/barber)
"px" = (
/obj/machinery/power/apc/auto_name/directional/south,
/obj/structure/cable,
/obj/effect/turf_decal/siding/wood{
	dir = 8
	},
/obj/structure/table/glass,
/obj/item/reagent_containers/medigel/aiuri{
	pixel_y = 10;
	pixel_x = -10;
	list_reagents = list(/datum/reagent/water = 60);
	name = "Unscented Massage Oil";
	desc = "A gel applicator bottle, designed for precision application with an unscrewable cap. This one contains an unscented basic water-based lotion, meant for those with common allergies to scents."
	},
/obj/item/reagent_containers/medigel/sterilizine{
	pixel_y = 10;
	pixel_x = -3;
	list_reagents = list(/datum/reagent/water = 60);
	desc = "A gel applicator bottle, designed for precision application with an unscrewable cap. This one contains a water-based Cooling gel, meant for inflammation relief.";
	name = "Cooling Massage Gel"
	},
/obj/item/reagent_containers/medigel/libital{
	pixel_y = 10;
	pixel_x = 11;
	list_reagents = list(/datum/reagent/water = 60);
	name = "Tension Relief Massage Lotion";
	desc = "A gel applicator bottle, designed for precision application with an unscrewable cap. This one contains a water-based tension relief lotion, meant for helping loosen up and relax."
	},
/obj/item/reagent_containers/medigel/synthflesh{
	pixel_y = 10;
	pixel_x = 4;
	list_reagents = list(/datum/reagent/water = 60);
	desc = "A gel applicator bottle, designed for precision application with an unscrewable cap. This one contains a water-based Warming gel, meant for sore muscles.";
	name = "Warming Massage Gel"
	},
/obj/machinery/button/polarizer{
	id = "bshop2";
	pixel_x = 23
	},
/obj/item/hairbrush{
	pixel_y = -2
	},
/turf/open/floor/iron/dark,
/area/station/service/barber)
"pP" = (
/obj/structure/cable,
/obj/machinery/atmospherics/pipe/smart/manifold4w/supply/hidden/layer4,
/obj/machinery/atmospherics/pipe/smart/manifold4w/scrubbers/hidden/layer2,
/turf/open/floor/iron/dark,
/area/station/service/barber)
"pQ" = (
/obj/structure/bed/pod{
	dir = 1;
	pixel_y = 24
	},
/turf/open/floor/wood/large,
/area/station/service/barber)
"qd" = (
/obj/structure/cable,
/obj/machinery/atmospherics/pipe/smart/manifold4w/supply/hidden/layer4,
/obj/machinery/atmospherics/pipe/smart/manifold4w/scrubbers/hidden/layer2,
/obj/effect/turf_decal/tile/purple,
/turf/open/floor/iron/dark,
/area/station/service/barber)
"tA" = (
/obj/machinery/atmospherics/pipe/smart/manifold4w/scrubbers/hidden/layer2,
/obj/structure/disposalpipe/segment{
	dir = 4
	},
/obj/effect/turf_decal/tile/purple{
	dir = 1
	},
/turf/open/floor/iron/dark,
/area/station/service/barber)
"tQ" = (
/obj/structure/cable,
/obj/machinery/atmospherics/pipe/smart/manifold4w/supply/hidden/layer4,
/obj/machinery/atmospherics/pipe/smart/manifold4w/scrubbers/hidden/layer2,
/turf/open/floor/wood/large,
/area/station/service/barber)
"uO" = (
/obj/machinery/atmospherics/components/unary/vent_scrubber/on/layer2{
	dir = 4
	},
/obj/effect/landmark/start/barber,
/obj/effect/landmark/start/hangover,
/obj/machinery/dryer{
	pixel_y = 24
	},
/turf/open/floor/wood/large,
/area/station/service/barber)
"wf" = (
/obj/structure/cable,
/obj/machinery/atmospherics/pipe/smart/manifold4w/supply/hidden/layer4,
/obj/machinery/atmospherics/pipe/smart/manifold4w/scrubbers/hidden/layer2,
/obj/machinery/door/airlock{
	id_tag = "commissarydoor";
	name = "Barber Storage"
	},
/obj/effect/turf_decal/siding/wood,
/turf/open/floor/iron/dark,
/area/station/service/barber)
"Bh" = (
/obj/machinery/vending/barbervend,
/turf/open/floor/iron/dark,
/area/station/service/barber)
"Bj" = (
/turf/template_noop,
/area/station/hallway/secondary/service)
"DR" = (
/obj/structure/disposalpipe/segment{
	dir = 4
	},
/obj/effect/turf_decal/tile/purple{
	dir = 4
	},
/turf/open/floor/iron/dark,
/area/station/service/barber)
"Hw" = (
/obj/structure/chair{
	dir = 4;
	name = "Prosecution"
	},
/turf/open/floor/iron/dark,
/area/station/service/barber)
"HE" = (
/obj/machinery/airalarm/directional/north,
/turf/open/floor/wood/large,
/area/station/service/barber)
"HN" = (
/obj/structure/cable,
/obj/machinery/light/very_dim/directional/south,
/turf/open/floor/wood/large,
/area/station/service/barber)
"Jv" = (
/obj/structure/cable,
/obj/machinery/atmospherics/pipe/smart/manifold4w/supply/hidden/layer4,
/obj/machinery/atmospherics/pipe/smart/manifold4w/scrubbers/hidden/layer2,
/obj/effect/turf_decal/tile/purple{
	dir = 4
	},
/turf/open/floor/iron/dark,
/area/station/service/barber)
"Jx" = (
/obj/structure/disposalpipe/segment{
	dir = 10
	},
/obj/structure/chair/comfy/barber_chair{
	dir = 4
	},
/obj/effect/landmark/start/barber,
/obj/effect/landmark/start/hangover,
/turf/open/floor/wood/large,
/area/station/service/barber)
"LZ" = (
/obj/machinery/atmospherics/components/unary/vent_pump/on/layer4{
	dir = 1
	},
/obj/effect/turf_decal/siding/wood{
	dir = 4
	},
/obj/effect/turf_decal/tile/purple{
	dir = 8
	},
/turf/open/floor/iron/dark,
/area/station/service/barber)
"MX" = (
/obj/machinery/door/firedoor,
/obj/structure/disposalpipe/segment{
	dir = 4
	},
/obj/machinery/door/airlock/public/glass{
	name = "Barber Shop"
	},
/turf/open/floor/iron/dark,
/area/station/service/barber)
"PD" = (
/obj/machinery/atmospherics/pipe/smart/manifold4w/supply/hidden/layer4,
/obj/effect/landmark/event_spawn,
/obj/effect/turf_decal/siding/wood{
	dir = 4
	},
/turf/open/floor/iron/dark,
/area/station/service/barber)
"TA" = (
/obj/machinery/button/polarizer{
	pixel_y = -22;
	id = "bshop"
	},
/turf/open/floor/wood/large,
/area/station/service/barber)
"TO" = (
/obj/item/reagent_containers/cup/rag{
	pixel_x = 8;
	pixel_y = 15
	},
/obj/machinery/computer/security/telescreen/entertainment/directional/east,
/obj/structure/table/glass,
/obj/item/lipstick/random,
/obj/item/razor,
/obj/item/reagent_containers/spray/cleaner{
	pixel_y = 4;
	pixel_x = 9
	},
/turf/open/floor/wood/large,
/area/station/service/barber)
"VC" = (
/obj/machinery/atmospherics/pipe/smart/manifold4w/supply/hidden/layer4,
/obj/structure/disposalpipe/segment{
	dir = 4
	},
/obj/structure/cable,
/obj/machinery/atmospherics/pipe/smart/manifold4w/scrubbers/hidden/layer2,
/obj/effect/turf_decal/siding/wood{
	dir = 4
	},
/obj/effect/turf_decal/tile/purple{
	dir = 1
	},
/turf/open/floor/iron/dark,
/area/station/service/barber)
"Xf" = (
/turf/closed/wall,
/area/station/service/barber)
"Xo" = (
/obj/item/razor{
	pixel_x = 9;
	pixel_y = 5
	},
/obj/item/reagent_containers/cup/rag{
	pixel_x = -6;
	pixel_y = 2
	},
/obj/machinery/computer/security/telescreen/entertainment/directional/east,
/obj/structure/table/glass,
/obj/item/reagent_containers/spray/quantum_hair_dye{
	pixel_y = 9
	},
/turf/open/floor/wood/large,
/area/station/service/barber)
"Yt" = (
/obj/machinery/door/airlock{
	id_tag = "commissarydoor";
	name = "Barber Maintenance"
	},
/obj/effect/mapping_helpers/airlock/access/all/engineering/maintenance,
/obj/effect/decal/cleanable/dirt,
/obj/structure/cable,
/obj/machinery/atmospherics/pipe/smart/manifold4w/supply/hidden/layer4,
/obj/machinery/atmospherics/pipe/smart/manifold4w/scrubbers/hidden/layer2,
/turf/open/floor/catwalk_floor,
/area/station/service/barber)
"ZN" = (
/obj/machinery/atmospherics/components/unary/vent_pump/on/layer4{
	dir = 8
	},
/obj/effect/turf_decal/siding/wood{
	dir = 8
	},
/obj/structure/sink/directional/west,
/turf/open/floor/iron/dark,
/area/station/service/barber)

(1,1,1) = {"
Xf
mp
MX
mp
Bj
Bj
Bj
Bj
Bj
Bj
"}
(2,1,1) = {"
Xf
jP
DR
mp
mp
mp
Xf
Xf
Xf
Xf
"}
(3,1,1) = {"
Xf
pe
tA
Hw
Hw
Bh
Xf
uO
pQ
Xf
"}
(4,1,1) = {"
Xf
gi
dO
pP
qd
Jv
wf
tQ
HN
Xf
"}
(5,1,1) = {"
Yt
cm
VC
PD
LZ
lN
ad
ZN
px
Xf
"}
(6,1,1) = {"
Xf
HE
Jx
ke
nY
TA
Xf
Xf
Xf
Xf
"}
(7,1,1) = {"
Xf
TO
hc
oY
hc
Xo
Xf
kt
kt
kt
"}
(8,1,1) = {"
Xf
Xf
Xf
Xf
Xf
Xf
Xf
kt
kt
kt
"}
