//MAP CONVERTED BY dmm2tgm.py THIS HEADER COMMENT PREVENTS RECONVERSION, DO NOT REMOVE
"a" = (
/turf/closed/wall,
/area/station/command/heads_quarters/nt_rep)
"b" = (
/obj/machinery/modular_computer/preset/command{
	dir = 1
	},
/turf/open/floor/carpet/executive,
/area/station/command/heads_quarters/nt_rep)
"c" = (
/obj/structure/table/wood,
/obj/item/paper_bin/carbon{
	pixel_y = 4;
	pixel_x = -4
	},
/obj/item/pen/fountain{
	pixel_x = -4;
	pixel_y = 6
	},
/obj/item/stamp{
	pixel_x = 8;
	pixel_y = 8
	},
/obj/item/stamp/denied{
	pixel_x = 8
	},
/obj/machinery/newscaster/directional/south,
/obj/item/radio/intercom/directional/west,
/turf/open/floor/carpet/executive,
/area/station/command/heads_quarters/nt_rep)
"e" = (
/obj/structure/closet/secure_closet/nanotrasen_consultant,
/turf/open/floor/wood,
/area/station/command/heads_quarters/nt_rep)
"f" = (
/obj/effect/spawner/structure/window/reinforced,
/obj/machinery/door/poddoor/preopen{
	id = "nt_rep_priv";
	name = "Privacy Shutter"
	},
/obj/structure/cable,
/turf/open/floor/plating,
/area/station/command/heads_quarters/nt_rep)
"g" = (
/obj/effect/turf_decal/siding/wood{
	dir = 4
	},
/obj/machinery/firealarm/directional/north,
/turf/open/floor/wood,
/area/station/command/heads_quarters/nt_rep)
"h" = (
/obj/effect/turf_decal/siding/wood,
/obj/machinery/atmospherics/components/unary/vent_pump/on/layer4{
	dir = 4
	},
/turf/open/floor/wood,
/area/station/command/heads_quarters/nt_rep)
"i" = (
/obj/structure/cable,
/obj/machinery/power/apc/auto_name/directional/north,
/obj/structure/chair/comfy/black,
/obj/effect/turf_decal/siding/wood/corner{
	dir = 8
	},
/turf/open/floor/carpet/executive,
/area/station/command/heads_quarters/nt_rep)
"j" = (
/obj/effect/turf_decal/siding/wood{
	dir = 1
	},
/turf/open/floor/carpet/executive,
/area/station/command/heads_quarters/nt_rep)
"k" = (
/obj/effect/turf_decal/siding/wood{
	dir = 8
	},
/obj/machinery/atmospherics/pipe/smart/manifold4w/supply/hidden/layer4,
/turf/open/floor/wood,
/area/station/command/heads_quarters/nt_rep)
"l" = (
/obj/structure/cable,
/obj/structure/chair/comfy/black{
	dir = 1
	},
/obj/effect/turf_decal/siding/wood/corner{
	dir = 1
	},
/turf/open/floor/carpet/executive,
/area/station/command/heads_quarters/nt_rep)
"m" = (
/obj/effect/turf_decal/siding/wood,
/obj/structure/sign/flag/nanotrasen/directional/north,
/turf/open/floor/carpet/executive,
/area/station/command/heads_quarters/nt_rep)
"n" = (
/obj/effect/turf_decal/siding/wood{
	dir = 1
	},
/obj/machinery/atmospherics/components/unary/vent_scrubber/on/layer2{
	dir = 4
	},
/turf/open/floor/wood,
/area/station/command/heads_quarters/nt_rep)
"o" = (
/obj/structure/cable,
/obj/structure/table/wood,
/obj/effect/turf_decal/siding/wood{
	dir = 8
	},
/turf/open/floor/carpet/executive,
/area/station/command/heads_quarters/nt_rep)
"p" = (
/obj/structure/filingcabinet/employment,
/obj/effect/turf_decal/siding/wood,
/turf/open/floor/wood,
/area/station/command/heads_quarters/nt_rep)
"q" = (
/obj/structure/table/wood,
/turf/open/floor/carpet/executive,
/area/station/command/heads_quarters/nt_rep)
"r" = (
/obj/structure/cable,
/obj/machinery/door/airlock/corporate{
	name = "NT Consultant's Office"
	},
/obj/machinery/atmospherics/pipe/smart/manifold4w/scrubbers/hidden/layer2,
/obj/machinery/atmospherics/pipe/smart/manifold4w/supply/hidden/layer4,
/obj/machinery/door/firedoor,
/turf/open/floor/iron/dark/textured_large,
/area/station/command/heads_quarters/nt_rep)
"s" = (
/turf/open/floor/carpet/executive,
/area/station/command/heads_quarters/nt_rep)
"t" = (
/obj/structure/table/wood,
/obj/item/stamp/centcom{
	pixel_y = 18;
	pixel_x = -7
	},
/turf/open/floor/carpet/executive,
/area/station/command/heads_quarters/nt_rep)
"u" = (
/obj/machinery/button/door/directional/west{
	id = "nt_rep_priv";
	name = "Privacy Shutters Control"
	},
/turf/open/floor/carpet/executive,
/area/station/command/heads_quarters/nt_rep)
"v" = (
/obj/item/kirbyplants/random,
/obj/machinery/airalarm/directional/north,
/turf/open/floor/wood,
/area/station/command/heads_quarters/nt_rep)
"w" = (
/obj/item/radio/intercom/directional/east,
/turf/open/floor/carpet/executive,
/area/station/command/heads_quarters/nt_rep)
"x" = (
/obj/effect/turf_decal/siding/wood/corner{
	dir = 4
	},
/obj/effect/turf_decal/siding/wood{
	dir = 8
	},
/obj/machinery/atmospherics/pipe/smart/manifold4w/supply/hidden/layer4,
/turf/open/floor/wood,
/area/station/command/heads_quarters/nt_rep)
"y" = (
/obj/effect/turf_decal/siding/wood,
/obj/machinery/atmospherics/pipe/smart/manifold4w/supply/hidden/layer4,
/turf/open/floor/wood,
/area/station/command/heads_quarters/nt_rep)
"A" = (
/obj/effect/turf_decal/siding/wood{
	dir = 1
	},
/obj/machinery/atmospherics/components/unary/vent_pump/on/layer4{
	dir = 8
	},
/turf/open/floor/wood,
/area/station/command/heads_quarters/nt_rep)
"B" = (
/turf/open/floor/wood,
/area/station/command/heads_quarters/nt_rep)
"C" = (
/obj/structure/table/wood,
/obj/item/camera{
	pixel_x = 6;
	pixel_y = 3
	},
/obj/item/camera_film{
	pixel_x = -5;
	pixel_y = 3
	},
/obj/item/camera_film{
	pixel_x = -4;
	pixel_y = 7
	},
/turf/open/floor/carpet/executive,
/area/station/command/heads_quarters/nt_rep)
"E" = (
/obj/structure/table/wood,
/obj/machinery/fax{
	fax_name = "Nanotrasen Consultant's Office";
	name = "Nanotrasen Consultant's Fax Machine"
	},
/turf/open/floor/carpet/executive,
/area/station/command/heads_quarters/nt_rep)
"F" = (
/obj/item/kirbyplants/random,
/obj/machinery/atmospherics/pipe/smart/manifold4w/supply/hidden/layer4,
/obj/machinery/light_switch/directional/south,
/turf/open/floor/wood,
/area/station/command/heads_quarters/nt_rep)
"G" = (
/obj/effect/turf_decal/siding/wood{
	dir = 4
	},
/obj/effect/turf_decal/siding/wood{
	dir = 8
	},
/obj/machinery/atmospherics/pipe/smart/manifold4w/supply/hidden/layer4,
/turf/open/floor/wood,
/area/station/command/heads_quarters/nt_rep)
"H" = (
/obj/machinery/light/warm/directional/west,
/obj/structure/sign/calendar/directional/west,
/turf/open/floor/carpet/executive,
/area/station/command/heads_quarters/nt_rep)
"J" = (
/obj/machinery/status_display/evac/directional/north,
/obj/machinery/light/warm/directional/north,
/turf/open/floor/wood,
/area/station/command/heads_quarters/nt_rep)
"K" = (
/obj/machinery/photocopier,
/turf/open/floor/wood,
/area/station/command/heads_quarters/nt_rep)
"M" = (
/obj/structure/cable,
/obj/machinery/atmospherics/pipe/smart/manifold4w/scrubbers/hidden/layer2,
/obj/machinery/atmospherics/pipe/smart/manifold4w/supply/hidden/layer4,
/turf/open/floor/wood,
/area/station/command/heads_quarters/nt_rep)
"N" = (
/obj/effect/turf_decal/siding/wood{
	dir = 4
	},
/obj/effect/turf_decal/siding/wood/corner{
	dir = 8
	},
/obj/machinery/atmospherics/pipe/smart/manifold4w/supply/hidden/layer4,
/turf/open/floor/wood,
/area/station/command/heads_quarters/nt_rep)
"O" = (
/obj/structure/chair/office,
/obj/effect/landmark/start/nanotrasen_consultant,
/turf/open/floor/carpet/executive,
/area/station/command/heads_quarters/nt_rep)
"Q" = (
/obj/structure/cable,
/obj/effect/turf_decal/siding/wood{
	dir = 1
	},
/obj/machinery/atmospherics/pipe/smart/manifold4w/scrubbers/hidden/layer2,
/obj/machinery/atmospherics/pipe/smart/manifold4w/supply/hidden/layer4,
/turf/open/floor/wood,
/area/station/command/heads_quarters/nt_rep)
"T" = (
/obj/structure/sign/clock/directional/east,
/turf/open/floor/carpet/executive,
/area/station/command/heads_quarters/nt_rep)
"U" = (
/obj/machinery/status_display/ai/directional/east,
/obj/structure/chair/comfy/black{
	dir = 8
	},
/turf/open/floor/carpet/executive,
/area/station/command/heads_quarters/nt_rep)
"V" = (
/obj/structure/filingcabinet/chestdrawer,
/obj/effect/turf_decal/siding/wood{
	dir = 1
	},
/obj/machinery/light/warm/directional/east,
/obj/structure/extinguisher_cabinet/directional/east,
/turf/open/floor/wood,
/area/station/command/heads_quarters/nt_rep)
"W" = (
/obj/structure/chair/comfy/black,
/obj/machinery/newscaster/directional/north,
/obj/machinery/light/warm/directional/north,
/turf/open/floor/carpet/executive,
/area/station/command/heads_quarters/nt_rep)
"Z" = (
/obj/machinery/holopad,
/obj/effect/turf_decal/bot,
/turf/open/floor/iron/dark/textured_large,
/area/station/command/heads_quarters/nt_rep)

(1,1,1) = {"
a
a
a
a
a
a
a
"}
(2,1,1) = {"
a
e
p
u
H
c
a
"}
(3,1,1) = {"
a
J
h
s
O
b
f
"}
(4,1,1) = {"
a
v
y
E
t
C
f
"}
(5,1,1) = {"
a
g
N
G
x
k
f
"}
(6,1,1) = {"
a
m
Z
j
n
F
a
"}
(7,1,1) = {"
a
i
o
l
Q
M
r
"}
(8,1,1) = {"
a
W
q
s
A
B
f
"}
(9,1,1) = {"
a
T
U
w
V
K
a
"}
(10,1,1) = {"
a
a
a
a
a
a
a
"}
