//MAP CONVERTED BY dmm2tgm.py THIS HEADER COMMENT PREVENTS RECONVERSION, DO NOT REMOVE
"cg" = (
/obj/structure/filingcabinet/chestdrawer,
/obj/effect/mapping_helpers/corporate_diplomat/regular_floor,
/turf/open/floor/wood,
/area/command/heads_quarters/captain/private/corp_diplomat)
"cl" = (
/obj/effect/turf_decal/trimline/neutral/filled/line{
	dir = 8
	},
/obj/effect/turf_decal/trimline/green/filled/warning{
	dir = 8
	},
/obj/machinery/duct,
/obj/effect/turf_decal/siding/thinplating{
	dir = 8
	},
/turf/open/floor/iron,
/area/station/hallway/primary/central)
"cw" = (
/obj/machinery/atmospherics/pipe/smart/manifold4w/scrubbers/hidden/layer2,
/obj/effect/mapping_helpers/corporate_diplomat/regular_floor,
/turf/open/floor/wood,
/area/command/heads_quarters/captain/private/corp_diplomat)
"cE" = (
/obj/structure/table/wood,
/obj/item/paper_bin{
	pixel_y = 4
	},
/obj/item/pen/fountain,
/obj/effect/mapping_helpers/corporate_diplomat/good_floor,
/turf/open/floor/carpet/executive,
/area/command/heads_quarters/captain/private/corp_diplomat)
"cK" = (
/obj/machinery/atmospherics/components/unary/vent_scrubber/on/layer2{
	dir = 8
	},
/obj/effect/mapping_helpers/corporate_diplomat/regular_floor,
/turf/open/floor/wood,
/area/command/heads_quarters/captain/private/corp_diplomat)
"da" = (
/turf/closed/wall/r_wall,
/area/command/heads_quarters/captain/private/corp_diplomat)
"eo" = (
/obj/effect/turf_decal/siding/wood{
	dir = 4
	},
/obj/machinery/camera/directional/north{
	c_tag = "NT Consultant's Office";
	name = "command camera"
	},
/obj/effect/mapping_helpers/corporate_diplomat/regular_floor,
/obj/effect/spawner/corporate_diplomat/filing_cabinet,
/turf/open/floor/wood,
/area/command/heads_quarters/captain/private/corp_diplomat)
"eN" = (
/obj/effect/mapping_helpers/airlock/access/all/corp_diplomat,
/obj/effect/turf_decal/siding/wood{
	dir = 4
	},
/obj/structure/cable,
/obj/machinery/atmospherics/pipe/smart/manifold4w/supply/hidden/layer4,
/obj/machinery/atmospherics/pipe/smart/manifold4w/scrubbers/hidden/layer2,
/obj/machinery/door/firedoor,
/obj/machinery/door/airlock/corporate/corp_diplomat,
/turf/open/floor/iron,
/area/command/heads_quarters/captain/private/corp_diplomat)
"eT" = (
/obj/structure/chair/sofa/bench/right{
	dir = 4
	},
/obj/effect/turf_decal/trimline/neutral/filled/line{
	dir = 10
	},
/turf/open/floor/iron,
/area/station/hallway/primary/central)
"gG" = (
/obj/structure/chair/sofa/bench/left{
	dir = 4
	},
/obj/effect/turf_decal/trimline/neutral/filled/line{
	dir = 8
	},
/turf/open/floor/iron,
/area/station/hallway/primary/central)
"gI" = (
/obj/effect/turf_decal/trimline/neutral/filled/line{
	dir = 1
	},
/obj/item/radio/intercom/directional/north,
/turf/open/floor/iron,
/area/station/hallway/primary/central)
"gP" = (
/obj/structure/chair/office{
	dir = 1
	},
/obj/structure/cable,
/obj/effect/spawner/corporate_diplomat/spawn_landmark,
/obj/effect/mapping_helpers/corporate_diplomat/regular_floor,
/turf/open/floor/wood,
/area/command/heads_quarters/captain/private/corp_diplomat)
"hf" = (
/obj/machinery/atmospherics/pipe/smart/manifold4w/supply/hidden/layer4,
/obj/machinery/atmospherics/pipe/smart/manifold4w/scrubbers/hidden/layer2,
/obj/machinery/status_display/ai/directional/south,
/obj/effect/mapping_helpers/corporate_diplomat/regular_floor,
/turf/open/floor/wood,
/area/command/heads_quarters/captain/private/corp_diplomat)
"hj" = (
/obj/effect/turf_decal/siding/wood{
	dir = 4
	},
/obj/machinery/atmospherics/components/unary/vent_pump/on/layer4,
/obj/effect/mapping_helpers/corporate_diplomat/regular_floor,
/turf/open/floor/wood,
/area/command/heads_quarters/captain/private/corp_diplomat)
"iK" = (
/obj/structure/table/wood,
/obj/item/stamp/denied{
	pixel_x = -6
	},
/obj/item/stamp{
	pixel_x = 6
	},
/obj/machinery/newscaster/directional/east,
/obj/effect/mapping_helpers/corporate_diplomat/good_floor,
/turf/open/floor/carpet/executive,
/area/command/heads_quarters/captain/private/corp_diplomat)
"lg" = (
/obj/item/kirbyplants/random,
/obj/effect/mapping_helpers/corporate_diplomat/regular_floor,
/turf/open/floor/wood,
/area/command/heads_quarters/captain/private/corp_diplomat)
"lo" = (
/obj/effect/turf_decal/siding/wood{
	dir = 1
	},
/obj/structure/chair/office{
	dir = 1
	},
/obj/item/radio/intercom/directional/east,
/obj/effect/spawner/corporate_diplomat/spawn_landmark,
/obj/effect/mapping_helpers/corporate_diplomat/regular_floor,
/turf/open/floor/wood,
/area/command/heads_quarters/captain/private/corp_diplomat)
"oJ" = (
/obj/machinery/airalarm/directional/west,
/obj/effect/turf_decal/trimline/neutral/filled/line{
	dir = 8
	},
/turf/open/floor/iron,
/area/station/hallway/primary/central)
"pY" = (
/obj/machinery/light/directional/south,
/obj/structure/cable,
/obj/machinery/atmospherics/pipe/smart/manifold4w/supply/hidden/layer4,
/obj/machinery/atmospherics/pipe/smart/manifold4w/scrubbers/hidden/layer2,
/obj/effect/mapping_helpers/corporate_diplomat/regular_floor,
/turf/open/floor/wood,
/area/command/heads_quarters/captain/private/corp_diplomat)
"qe" = (
/obj/effect/turf_decal/trimline/neutral/filled/corner{
	dir = 4
	},
/obj/effect/turf_decal/trimline/neutral/filled/corner,
/obj/machinery/atmospherics/pipe/smart/manifold4w/supply/hidden/layer4,
/obj/structure/disposalpipe/segment{
	dir = 6
	},
/obj/structure/cable,
/obj/machinery/atmospherics/pipe/smart/manifold4w/scrubbers/hidden/layer2,
/turf/open/floor/iron,
/area/station/hallway/primary/central)
"sb" = (
/obj/effect/mapping_helpers/corporate_diplomat/regular_floor,
/turf/open/floor/wood,
/area/command/heads_quarters/captain/private/corp_diplomat)
"sA" = (
/obj/effect/spawner/structure/window/reinforced,
/obj/machinery/door/poddoor/preopen{
	id = "nt_rep_priv";
	name = "Privacy Shutter"
	},
/obj/structure/cable,
/turf/open/floor/plating,
/area/command/heads_quarters/captain/private/corp_diplomat)
"ta" = (
/obj/machinery/button/door/directional/west{
	id = "nt_rep_priv";
	name = "Privacy Shutters Control";
	pixel_y = 8
	},
/obj/structure/table/wood,
/obj/effect/mapping_helpers/corporate_diplomat/regular_floor,
/obj/effect/spawner/corporate_diplomat/fax,
/turf/open/floor/wood,
/area/command/heads_quarters/captain/private/corp_diplomat)
"tc" = (
/obj/machinery/status_display/ai/directional/north,
/obj/effect/mapping_helpers/corporate_diplomat/good_floor,
/turf/open/floor/carpet/executive,
/area/command/heads_quarters/captain/private/corp_diplomat)
"tB" = (
/turf/closed/wall,
/area/station/hallway/primary/central)
"tS" = (
/obj/effect/turf_decal/trimline/neutral/filled/line{
	dir = 8
	},
/obj/effect/turf_decal/trimline/green/filled/warning{
	dir = 8
	},
/obj/machinery/duct,
/obj/machinery/atmospherics/components/unary/vent_pump/on/layer4{
	dir = 4
	},
/turf/open/floor/iron,
/area/station/hallway/primary/central)
"uL" = (
/obj/effect/turf_decal/trimline/neutral/filled/line{
	dir = 4
	},
/turf/open/floor/iron,
/area/station/hallway/primary/central)
"vg" = (
/turf/template_noop,
/area/template_noop)
"vI" = (
/obj/effect/turf_decal/siding/wood{
	dir = 1
	},
/obj/structure/chair/office{
	dir = 1
	},
/obj/effect/spawner/corporate_diplomat/spawn_landmark,
/obj/effect/mapping_helpers/corporate_diplomat/regular_floor,
/turf/open/floor/wood,
/area/command/heads_quarters/captain/private/corp_diplomat)
"vN" = (
/obj/machinery/status_display/evac/directional/east,
/obj/machinery/camera/directional/east{
	c_tag = "Hallway - Service Wing Right Upper Hall"
	},
/obj/effect/turf_decal/trimline/neutral/filled/line{
	dir = 4
	},
/obj/structure/cable,
/obj/machinery/atmospherics/pipe/smart/manifold4w/supply/hidden/layer4,
/obj/machinery/atmospherics/pipe/smart/manifold4w/scrubbers/hidden/layer2,
/turf/open/floor/iron,
/area/station/hallway/primary/central)
"wf" = (
/obj/effect/turf_decal/trimline/neutral/filled/line{
	dir = 5
	},
/turf/open/floor/iron,
/area/station/hallway/primary/central)
"wy" = (
/turf/closed/wall,
/area/station/service/hydroponics)
"yE" = (
/obj/structure/chair/sofa/bench{
	dir = 4
	},
/obj/machinery/light/directional/west,
/obj/effect/turf_decal/trimline/neutral/filled/line{
	dir = 8
	},
/turf/open/floor/iron,
/area/station/hallway/primary/central)
"zG" = (
/obj/effect/mapping_helpers/corporate_diplomat/good_floor,
/turf/open/floor/carpet/executive,
/area/command/heads_quarters/captain/private/corp_diplomat)
"Ab" = (
/obj/effect/turf_decal/trimline/neutral/filled/line{
	dir = 4
	},
/obj/machinery/atmospherics/pipe/smart/manifold4w/supply/hidden/layer4,
/obj/structure/disposalpipe/junction,
/obj/structure/cable,
/obj/machinery/atmospherics/pipe/smart/manifold4w/scrubbers/hidden/layer2,
/turf/open/floor/iron,
/area/station/hallway/primary/central)
"Ae" = (
/obj/structure/table/wood,
/obj/effect/mapping_helpers/corporate_diplomat/good_floor,
/obj/effect/spawner/corporate_diplomat/stamp,
/turf/open/floor/carpet/executive,
/area/command/heads_quarters/captain/private/corp_diplomat)
"DR" = (
/obj/effect/turf_decal/siding/wood{
	dir = 4
	},
/obj/machinery/atmospherics/pipe/smart/manifold4w/supply/hidden/layer4,
/obj/effect/mapping_helpers/corporate_diplomat/regular_floor,
/turf/open/floor/wood,
/area/command/heads_quarters/captain/private/corp_diplomat)
"FR" = (
/obj/structure/cable,
/obj/effect/mapping_helpers/corporate_diplomat/regular_floor,
/turf/open/floor/wood,
/area/command/heads_quarters/captain/private/corp_diplomat)
"Hc" = (
/obj/effect/turf_decal/trimline/green/corner{
	dir = 8
	},
/obj/effect/turf_decal/trimline/green/corner{
	dir = 1
	},
/obj/machinery/duct,
/obj/effect/turf_decal/trimline/neutral/filled/line{
	dir = 8
	},
/turf/open/floor/iron,
/area/station/hallway/primary/central)
"JN" = (
/obj/effect/turf_decal/trimline/neutral/filled/line{
	dir = 4
	},
/obj/structure/cable,
/obj/machinery/atmospherics/pipe/smart/manifold4w/supply/hidden/layer4,
/obj/machinery/atmospherics/pipe/smart/manifold4w/scrubbers/hidden/layer2,
/turf/open/floor/iron,
/area/station/hallway/primary/central)
"Kr" = (
/obj/structure/chair/office,
/obj/effect/mapping_helpers/corporate_diplomat/good_floor,
/obj/effect/spawner/corporate_diplomat/spawn_landmark,
/turf/open/floor/carpet/executive,
/area/command/heads_quarters/captain/private/corp_diplomat)
"Lf" = (
/obj/machinery/photocopier,
/obj/effect/mapping_helpers/corporate_diplomat/regular_floor,
/turf/open/floor/wood,
/area/command/heads_quarters/captain/private/corp_diplomat)
"Lq" = (
/obj/effect/mapping_helpers/corporate_diplomat/good_floor,
/obj/effect/spawner/corporate_diplomat/locker,
/turf/open/floor/carpet/executive,
/area/command/heads_quarters/captain/private/corp_diplomat)
"Mj" = (
/turf/open/floor/iron,
/area/station/hallway/primary/central)
"Mp" = (
/obj/effect/turf_decal/trimline/neutral/filled/corner{
	dir = 8
	},
/turf/open/floor/iron,
/area/station/hallway/primary/central)
"MZ" = (
/obj/structure/cable,
/obj/machinery/atmospherics/pipe/smart/manifold4w/supply/hidden/layer4,
/obj/machinery/atmospherics/pipe/smart/manifold4w/scrubbers/hidden/layer2,
/obj/machinery/light_switch/directional/south,
/obj/effect/mapping_helpers/corporate_diplomat/regular_floor,
/turf/open/floor/wood,
/area/command/heads_quarters/captain/private/corp_diplomat)
"NI" = (
/obj/machinery/light/directional/north,
/obj/effect/mapping_helpers/corporate_diplomat/good_floor,
/turf/open/floor/carpet/executive,
/area/command/heads_quarters/captain/private/corp_diplomat)
"Pk" = (
/obj/effect/spawner/random/vending/snackvend,
/turf/open/floor/iron/dark,
/area/station/hallway/primary/central)
"Qz" = (
/obj/effect/turf_decal/trimline/neutral/filled/line{
	dir = 8
	},
/obj/effect/turf_decal/trimline/green/filled/warning{
	dir = 8
	},
/obj/machinery/duct,
/obj/effect/turf_decal/siding/thinplating/corner{
	dir = 8
	},
/turf/open/floor/iron,
/area/station/hallway/primary/central)
"QR" = (
/obj/machinery/atmospherics/pipe/smart/manifold4w/supply/hidden/layer4,
/obj/machinery/atmospherics/pipe/smart/manifold4w/scrubbers/hidden/layer2,
/obj/effect/mapping_helpers/corporate_diplomat/regular_floor,
/turf/open/floor/wood,
/area/command/heads_quarters/captain/private/corp_diplomat)
"Rd" = (
/obj/effect/turf_decal/trimline/green/corner{
	dir = 8
	},
/obj/effect/turf_decal/trimline/neutral/filled/line{
	dir = 8
	},
/turf/open/floor/iron,
/area/station/hallway/primary/central)
"Ry" = (
/obj/effect/turf_decal/trimline/neutral/filled/corner{
	dir = 8
	},
/obj/effect/turf_decal/trimline/neutral/filled/corner{
	dir = 1
	},
/obj/effect/turf_decal/trimline/green/corner{
	dir = 8
	},
/obj/effect/turf_decal/trimline/green/corner{
	dir = 1
	},
/obj/machinery/duct,
/obj/structure/disposalpipe/segment{
	dir = 4
	},
/turf/open/floor/iron,
/area/station/hallway/primary/central)
"So" = (
/obj/effect/turf_decal/siding/wood/corner{
	dir = 4
	},
/obj/machinery/holopad,
/obj/machinery/atmospherics/pipe/smart/manifold4w/supply/hidden/layer4,
/obj/effect/mapping_helpers/corporate_diplomat/regular_floor,
/turf/open/floor/wood,
/area/command/heads_quarters/captain/private/corp_diplomat)
"TM" = (
/obj/machinery/modular_computer/console/preset/command,
/obj/machinery/power/apc/auto_name/directional/north,
/obj/structure/cable,
/obj/effect/mapping_helpers/corporate_diplomat/regular_floor,
/turf/open/floor/wood,
/area/command/heads_quarters/captain/private/corp_diplomat)
"Vq" = (
/obj/effect/turf_decal/trimline/neutral/filled/line{
	dir = 9
	},
/turf/open/floor/iron,
/area/station/hallway/primary/central)
"WW" = (
/obj/effect/turf_decal/trimline/neutral/filled/line{
	dir = 4
	},
/obj/machinery/atmospherics/pipe/smart/manifold4w/supply/hidden/layer4,
/obj/structure/disposalpipe/segment,
/obj/structure/cable,
/obj/machinery/atmospherics/pipe/smart/manifold4w/scrubbers/hidden/layer2,
/turf/open/floor/iron,
/area/station/hallway/primary/central)
"ZK" = (
/obj/structure/table/wood,
/obj/item/taperecorder{
	pixel_x = 5;
	pixel_y = 5
	},
/obj/item/camera_film{
	pixel_x = 6
	},
/obj/item/camera_film{
	pixel_x = 6;
	pixel_y = 4
	},
/obj/item/camera{
	pixel_x = -4
	},
/obj/effect/mapping_helpers/corporate_diplomat/good_floor,
/turf/open/floor/carpet/executive,
/area/command/heads_quarters/captain/private/corp_diplomat)

(1,1,1) = {"
vg
vg
tB
Pk
wy
wy
wy
wy
vg
vg
vg
vg
vg
vg
"}
(2,1,1) = {"
vg
vg
tB
Vq
gG
yE
eT
wy
wy
vg
vg
vg
vg
vg
"}
(3,1,1) = {"
vg
vg
tB
gI
Mj
Mj
Mp
oJ
Rd
Hc
tS
Ry
Qz
cl
"}
(4,1,1) = {"
vg
vg
tB
wf
uL
uL
JN
vN
JN
JN
qe
Ab
WW
WW
"}
(5,1,1) = {"
vg
da
da
sA
sA
sA
eN
da
vg
vg
vg
vg
vg
vg
"}
(6,1,1) = {"
vg
da
ta
sb
Lf
cg
MZ
da
vg
vg
vg
vg
vg
vg
"}
(7,1,1) = {"
da
da
TM
gP
FR
FR
pY
da
vg
vg
vg
vg
vg
vg
"}
(8,1,1) = {"
da
eo
hj
DR
So
QR
hf
da
vg
vg
vg
vg
vg
vg
"}
(9,1,1) = {"
da
NI
zG
ZK
vI
cw
sb
da
vg
vg
vg
vg
vg
vg
"}
(10,1,1) = {"
da
tc
Kr
Ae
lo
cK
lg
da
vg
vg
vg
vg
vg
vg
"}
(11,1,1) = {"
da
Lq
iK
cE
da
da
da
da
vg
vg
vg
vg
vg
vg
"}
(12,1,1) = {"
da
da
da
da
da
vg
vg
vg
vg
vg
vg
vg
vg
vg
"}
