//MAP CONVERTED BY dmm2tgm.py THIS HEADER COMMENT PREVENTS RECONVERSION, DO NOT REMOVE
"az" = (
/obj/machinery/light/directional/south,
/obj/structure/cable,
/obj/machinery/atmospherics/pipe/smart/manifold4w/supply/hidden/layer4,
/obj/machinery/atmospherics/pipe/smart/manifold4w/scrubbers/hidden/layer2,
/turf/open/floor/wood,
/area/command/heads_quarters/captain/private/nt_rep)
"ci" = (
/obj/effect/turf_decal/trimline/green/corner{
	dir = 8
	},
/obj/effect/turf_decal/trimline/neutral/filled/line{
	dir = 8
	},
/turf/open/floor/iron,
/area/station/hallway/primary/central)
"cl" = (
/obj/effect/turf_decal/trimline/neutral/filled/line{
	dir = 8
	},
/obj/effect/turf_decal/trimline/green/filled/warning{
	dir = 8
	},
/obj/machinery/duct,
/obj/effect/turf_decal/siding/thinplating{
	dir = 8
	},
/turf/open/floor/iron,
/area/station/hallway/primary/central)
"dz" = (
/obj/structure/cable,
/obj/machinery/atmospherics/pipe/smart/manifold4w/supply/hidden/layer4,
/obj/machinery/atmospherics/pipe/smart/manifold4w/scrubbers/hidden/layer2,
/obj/machinery/light_switch/directional/south,
/turf/open/floor/wood,
/area/command/heads_quarters/captain/private/nt_rep)
"fw" = (
/obj/effect/spawner/structure/window/reinforced,
/obj/machinery/door/poddoor/preopen{
	id = "nt_rep_priv";
	name = "Privacy Shutter"
	},
/obj/structure/cable,
/turf/open/floor/plating,
/area/command/heads_quarters/captain/private/nt_rep)
"gI" = (
/obj/effect/turf_decal/trimline/neutral/filled/line{
	dir = 1
	},
/obj/item/radio/intercom/directional/north,
/turf/open/floor/iron,
/area/station/hallway/primary/central)
"ie" = (
/obj/effect/turf_decal/siding/wood{
	dir = 4
	},
/obj/machinery/atmospherics/pipe/smart/manifold4w/supply/hidden/layer4,
/turf/open/floor/wood,
/area/command/heads_quarters/captain/private/nt_rep)
"iA" = (
/obj/machinery/modular_computer/console/preset/command,
/obj/machinery/power/apc/auto_name/directional/north,
/obj/structure/cable,
/turf/open/floor/wood,
/area/command/heads_quarters/captain/private/nt_rep)
"jd" = (
/obj/machinery/door/airlock/corporate{
	name = "NT Consultant's Office"
	},
/obj/effect/mapping_helpers/airlock/access/all/cent_com/rep_door,
/obj/effect/turf_decal/siding/wood{
	dir = 4
	},
/obj/structure/cable,
/obj/machinery/atmospherics/pipe/smart/manifold4w/supply/hidden/layer4,
/obj/machinery/atmospherics/pipe/smart/manifold4w/scrubbers/hidden/layer2,
/obj/machinery/door/firedoor,
/turf/open/floor/iron,
/area/command/heads_quarters/captain/private/nt_rep)
"lj" = (
/obj/effect/turf_decal/siding/wood{
	dir = 4
	},
/obj/machinery/atmospherics/components/unary/vent_pump/on/layer4,
/turf/open/floor/wood,
/area/command/heads_quarters/captain/private/nt_rep)
"ll" = (
/obj/machinery/atmospherics/pipe/smart/manifold4w/supply/hidden/layer4,
/obj/machinery/atmospherics/pipe/smart/manifold4w/scrubbers/hidden/layer2,
/obj/machinery/status_display/ai/directional/south,
/turf/open/floor/wood,
/area/command/heads_quarters/captain/private/nt_rep)
"pm" = (
/obj/structure/cable,
/turf/open/floor/wood,
/area/command/heads_quarters/captain/private/nt_rep)
"qe" = (
/obj/effect/turf_decal/trimline/neutral/filled/corner{
	dir = 4
	},
/obj/effect/turf_decal/trimline/neutral/filled/corner,
/obj/machinery/atmospherics/pipe/smart/manifold4w/supply/hidden/layer4,
/obj/structure/disposalpipe/segment{
	dir = 6
	},
/obj/structure/cable,
/obj/machinery/atmospherics/pipe/smart/manifold4w/scrubbers/hidden/layer2,
/turf/open/floor/iron,
/area/station/hallway/primary/central)
"qu" = (
/obj/machinery/status_display/ai/directional/north,
/turf/open/floor/carpet/executive,
/area/command/heads_quarters/captain/private/nt_rep)
"rP" = (
/obj/structure/table/wood,
/obj/item/taperecorder{
	pixel_x = 5;
	pixel_y = 5
	},
/obj/item/camera_film{
	pixel_x = 6
	},
/obj/item/camera_film{
	pixel_x = 6;
	pixel_y = 4
	},
/obj/item/camera{
	pixel_x = -4
	},
/turf/open/floor/carpet/executive,
/area/command/heads_quarters/captain/private/nt_rep)
"tB" = (
/turf/closed/wall,
/area/station/hallway/primary/central)
"tS" = (
/obj/effect/turf_decal/trimline/neutral/filled/line{
	dir = 8
	},
/obj/effect/turf_decal/trimline/green/filled/warning{
	dir = 8
	},
/obj/machinery/duct,
/obj/machinery/atmospherics/components/unary/vent_pump/on/layer4{
	dir = 4
	},
/turf/open/floor/iron,
/area/station/hallway/primary/central)
"uL" = (
/obj/effect/turf_decal/trimline/neutral/filled/line{
	dir = 4
	},
/turf/open/floor/iron,
/area/station/hallway/primary/central)
"vg" = (
/turf/template_noop,
/area/template_noop)
"vJ" = (
/obj/effect/turf_decal/siding/wood{
	dir = 1
	},
/obj/structure/chair/office{
	dir = 1
	},
/obj/item/radio/intercom/directional/east,
/obj/effect/landmark/start/nanotrasen_consultant,
/turf/open/floor/wood,
/area/command/heads_quarters/captain/private/nt_rep)
"vN" = (
/obj/machinery/status_display/evac/directional/east,
/obj/machinery/camera/directional/east{
	c_tag = "Hallway - Service Wing Right Upper Hall"
	},
/obj/effect/turf_decal/trimline/neutral/filled/line{
	dir = 4
	},
/obj/structure/cable,
/obj/machinery/atmospherics/pipe/smart/manifold4w/supply/hidden/layer4,
/obj/machinery/atmospherics/pipe/smart/manifold4w/scrubbers/hidden/layer2,
/turf/open/floor/iron,
/area/station/hallway/primary/central)
"wc" = (
/obj/structure/table/wood,
/obj/item/paper_bin{
	pixel_y = 4
	},
/obj/item/pen/fountain,
/turf/open/floor/carpet/executive,
/area/command/heads_quarters/captain/private/nt_rep)
"wf" = (
/obj/effect/turf_decal/trimline/neutral/filled/line{
	dir = 5
	},
/turf/open/floor/iron,
/area/station/hallway/primary/central)
"wy" = (
/turf/closed/wall,
/area/station/service/hydroponics)
"yP" = (
/turf/closed/wall/r_wall,
/area/command/heads_quarters/captain/private/nt_rep)
"zj" = (
/obj/structure/chair/sofa/bench/right{
	dir = 4
	},
/obj/effect/turf_decal/trimline/neutral/filled/line{
	dir = 10
	},
/turf/open/floor/iron,
/area/station/hallway/primary/central)
"zH" = (
/obj/structure/table/wood,
/obj/item/stamp/centcom{
	pixel_y = 5
	},
/turf/open/floor/carpet/executive,
/area/command/heads_quarters/captain/private/nt_rep)
"Ab" = (
/obj/effect/turf_decal/trimline/neutral/filled/line{
	dir = 4
	},
/obj/machinery/atmospherics/pipe/smart/manifold4w/supply/hidden/layer4,
/obj/structure/disposalpipe/junction,
/obj/structure/cable,
/obj/machinery/atmospherics/pipe/smart/manifold4w/scrubbers/hidden/layer2,
/turf/open/floor/iron,
/area/station/hallway/primary/central)
"Af" = (
/obj/structure/chair/office{
	dir = 1
	},
/obj/structure/cable,
/obj/effect/landmark/start/nanotrasen_consultant,
/turf/open/floor/wood,
/area/command/heads_quarters/captain/private/nt_rep)
"CZ" = (
/obj/machinery/photocopier,
/turf/open/floor/wood,
/area/command/heads_quarters/captain/private/nt_rep)
"Ev" = (
/obj/structure/chair/sofa/bench{
	dir = 4
	},
/obj/machinery/light/directional/west,
/obj/effect/turf_decal/trimline/neutral/filled/line{
	dir = 8
	},
/turf/open/floor/iron,
/area/station/hallway/primary/central)
"Fh" = (
/obj/machinery/atmospherics/pipe/smart/manifold4w/supply/hidden/layer4,
/obj/machinery/atmospherics/pipe/smart/manifold4w/scrubbers/hidden/layer2,
/turf/open/floor/wood,
/area/command/heads_quarters/captain/private/nt_rep)
"Ft" = (
/obj/item/kirbyplants/random,
/turf/open/floor/wood,
/area/command/heads_quarters/captain/private/nt_rep)
"Hl" = (
/obj/structure/table/wood,
/obj/item/stamp/denied{
	pixel_x = -6
	},
/obj/item/stamp{
	pixel_x = 6
	},
/obj/machinery/newscaster/directional/east,
/turf/open/floor/carpet/executive,
/area/command/heads_quarters/captain/private/nt_rep)
"Hq" = (
/obj/machinery/light/directional/north,
/turf/open/floor/carpet/executive,
/area/command/heads_quarters/captain/private/nt_rep)
"Hx" = (
/obj/structure/chair/sofa/bench/left{
	dir = 4
	},
/obj/effect/turf_decal/trimline/neutral/filled/line{
	dir = 8
	},
/turf/open/floor/iron,
/area/station/hallway/primary/central)
"JN" = (
/obj/effect/turf_decal/trimline/neutral/filled/line{
	dir = 4
	},
/obj/structure/cable,
/obj/machinery/atmospherics/pipe/smart/manifold4w/supply/hidden/layer4,
/obj/machinery/atmospherics/pipe/smart/manifold4w/scrubbers/hidden/layer2,
/turf/open/floor/iron,
/area/station/hallway/primary/central)
"Kq" = (
/obj/effect/turf_decal/siding/wood/corner{
	dir = 4
	},
/obj/machinery/holopad,
/obj/machinery/atmospherics/pipe/smart/manifold4w/supply/hidden/layer4,
/turf/open/floor/wood,
/area/command/heads_quarters/captain/private/nt_rep)
"Lb" = (
/obj/effect/turf_decal/trimline/neutral/filled/corner{
	dir = 8
	},
/turf/open/floor/iron,
/area/station/hallway/primary/central)
"Mb" = (
/obj/effect/turf_decal/siding/wood{
	dir = 1
	},
/obj/structure/chair/office{
	dir = 1
	},
/obj/effect/landmark/start/nanotrasen_consultant,
/turf/open/floor/wood,
/area/command/heads_quarters/captain/private/nt_rep)
"Mj" = (
/turf/open/floor/iron,
/area/station/hallway/primary/central)
"Mt" = (
/obj/machinery/atmospherics/pipe/smart/manifold4w/scrubbers/hidden/layer2,
/turf/open/floor/wood,
/area/command/heads_quarters/captain/private/nt_rep)
"NA" = (
/obj/structure/filingcabinet/chestdrawer,
/turf/open/floor/wood,
/area/command/heads_quarters/captain/private/nt_rep)
"Pk" = (
/obj/effect/spawner/random/vending/snackvend,
/turf/open/floor/iron/dark,
/area/station/hallway/primary/central)
"Qz" = (
/obj/effect/turf_decal/trimline/neutral/filled/line{
	dir = 8
	},
/obj/effect/turf_decal/trimline/green/filled/warning{
	dir = 8
	},
/obj/machinery/duct,
/obj/effect/turf_decal/siding/thinplating/corner{
	dir = 8
	},
/turf/open/floor/iron,
/area/station/hallway/primary/central)
"Ry" = (
/obj/effect/turf_decal/trimline/neutral/filled/corner{
	dir = 8
	},
/obj/effect/turf_decal/trimline/neutral/filled/corner{
	dir = 1
	},
/obj/effect/turf_decal/trimline/green/corner{
	dir = 8
	},
/obj/effect/turf_decal/trimline/green/corner{
	dir = 1
	},
/obj/machinery/duct,
/obj/structure/disposalpipe/segment{
	dir = 4
	},
/turf/open/floor/iron,
/area/station/hallway/primary/central)
"SF" = (
/turf/open/floor/wood,
/area/command/heads_quarters/captain/private/nt_rep)
"Tg" = (
/obj/structure/chair/office,
/obj/effect/landmark/start/nanotrasen_consultant,
/turf/open/floor/carpet/executive,
/area/command/heads_quarters/captain/private/nt_rep)
"UO" = (
/obj/structure/closet/secure_closet/nanotrasen_consultant/station,
/obj/item/assembly/flash/handheld,
/turf/open/floor/carpet/executive,
/area/command/heads_quarters/captain/private/nt_rep)
"UR" = (
/obj/machinery/atmospherics/components/unary/vent_scrubber/on/layer2{
	dir = 8
	},
/turf/open/floor/wood,
/area/command/heads_quarters/captain/private/nt_rep)
"Vq" = (
/obj/effect/turf_decal/trimline/neutral/filled/line{
	dir = 9
	},
/turf/open/floor/iron,
/area/station/hallway/primary/central)
"VN" = (
/obj/effect/turf_decal/siding/wood{
	dir = 4
	},
/obj/structure/filingcabinet/employment,
/obj/machinery/camera/directional/north{
	c_tag = "NT Consultant's Office";
	name = "command camera"
	},
/turf/open/floor/wood,
/area/command/heads_quarters/captain/private/nt_rep)
"Wd" = (
/obj/machinery/button/door/directional/west{
	id = "nt_rep_priv";
	name = "Privacy Shutters Control";
	pixel_y = 8
	},
/obj/structure/table/wood,
/obj/machinery/fax{
	fax_name = "Nanotrasen Consultant's Office";
	name = "Nanotrasen Consultant's Fax Machine"
	},
/turf/open/floor/wood,
/area/command/heads_quarters/captain/private/nt_rep)
"WW" = (
/obj/effect/turf_decal/trimline/neutral/filled/line{
	dir = 4
	},
/obj/machinery/atmospherics/pipe/smart/manifold4w/supply/hidden/layer4,
/obj/structure/disposalpipe/segment,
/obj/structure/cable,
/obj/machinery/atmospherics/pipe/smart/manifold4w/scrubbers/hidden/layer2,
/turf/open/floor/iron,
/area/station/hallway/primary/central)
"XG" = (
/turf/open/floor/carpet/executive,
/area/command/heads_quarters/captain/private/nt_rep)
"YI" = (
/obj/machinery/airalarm/directional/west,
/obj/effect/turf_decal/trimline/neutral/filled/line{
	dir = 8
	},
/turf/open/floor/iron,
/area/station/hallway/primary/central)
"YW" = (
/obj/effect/turf_decal/trimline/green/corner{
	dir = 8
	},
/obj/effect/turf_decal/trimline/green/corner{
	dir = 1
	},
/obj/machinery/duct,
/obj/effect/turf_decal/trimline/neutral/filled/line{
	dir = 8
	},
/turf/open/floor/iron,
/area/station/hallway/primary/central)

(1,1,1) = {"
vg
vg
tB
Pk
wy
wy
wy
wy
vg
vg
vg
vg
vg
vg
"}
(2,1,1) = {"
vg
vg
tB
Vq
Hx
Ev
zj
wy
wy
vg
vg
vg
vg
vg
"}
(3,1,1) = {"
vg
vg
tB
gI
Mj
Mj
Lb
YI
ci
YW
tS
Ry
Qz
cl
"}
(4,1,1) = {"
vg
vg
tB
wf
uL
uL
JN
vN
JN
JN
qe
Ab
WW
WW
"}
(5,1,1) = {"
vg
yP
yP
fw
fw
fw
jd
yP
vg
vg
vg
vg
vg
vg
"}
(6,1,1) = {"
vg
yP
Wd
SF
CZ
NA
dz
yP
vg
vg
vg
vg
vg
vg
"}
(7,1,1) = {"
yP
yP
iA
Af
pm
pm
az
yP
vg
vg
vg
vg
vg
vg
"}
(8,1,1) = {"
yP
VN
lj
ie
Kq
Fh
ll
yP
vg
vg
vg
vg
vg
vg
"}
(9,1,1) = {"
yP
Hq
XG
rP
Mb
Mt
SF
yP
vg
vg
vg
vg
vg
vg
"}
(10,1,1) = {"
yP
qu
Tg
zH
vJ
UR
Ft
yP
vg
vg
vg
vg
vg
vg
"}
(11,1,1) = {"
yP
UO
Hl
wc
yP
yP
yP
yP
vg
vg
vg
vg
vg
vg
"}
(12,1,1) = {"
yP
yP
yP
yP
yP
vg
vg
vg
vg
vg
vg
vg
vg
vg
"}
