//MAP CONVERTED BY dmm2tgm.py THIS HEADER COMMENT PREVENTS RECONVERSION, DO NOT REMOVE
"bN" = (
/obj/structure/filingcabinet/chestdrawer,
/obj/machinery/power/apc/auto_name/directional/north,
/obj/structure/cable,
/turf/open/floor/wood,
/area/command/heads_quarters/captain/private/nt_rep)
"bZ" = (
/obj/effect/turf_decal/trimline/neutral/filled/corner{
	dir = 1
	},
/obj/effect/turf_decal/trimline/neutral/filled/corner{
	dir = 8
	},
/obj/structure/disposalpipe/segment{
	dir = 9
	},
/turf/open/floor/iron,
/area/station/commons/storage/primary)
"cL" = (
/obj/structure/table/wood,
/obj/item/folder/yellow{
	pixel_x = 8;
	pixel_y = -1
	},
/obj/item/folder/red{
	pixel_x = -4;
	pixel_y = -2
	},
/obj/item/folder/white{
	pixel_x = 4;
	pixel_y = 3
	},
/obj/item/folder/blue{
	pixel_y = 6;
	pixel_x = -2
	},
/turf/open/floor/wood,
/area/command/heads_quarters/captain/private/nt_rep)
"cU" = (
/obj/structure/table/wood,
/obj/item/paper_bin{
	pixel_y = 4
	},
/obj/item/pen/fountain,
/obj/item/radio/intercom/directional/north,
/turf/open/floor/carpet/executive,
/area/command/heads_quarters/captain/private/nt_rep)
"dP" = (
/obj/effect/turf_decal/trimline/neutral/filled/line,
/obj/effect/turf_decal/trimline/neutral/filled/line{
	dir = 1
	},
/obj/machinery/door/airlock/public/glass{
	name = "Primary Tool Storage"
	},
/obj/machinery/door/firedoor,
/obj/structure/disposalpipe/segment{
	dir = 4
	},
/turf/open/floor/iron,
/area/station/commons/storage/primary)
"eh" = (
/obj/machinery/atmospherics/pipe/smart/manifold4w/supply/hidden/layer4,
/obj/structure/disposalpipe/segment,
/obj/structure/cable,
/obj/machinery/atmospherics/pipe/smart/manifold4w/scrubbers/hidden/layer2,
/turf/open/floor/iron,
/area/station/hallway/primary/central)
"es" = (
/turf/open/floor/carpet/executive,
/area/command/heads_quarters/captain/private/nt_rep)
"eM" = (
/obj/effect/turf_decal/delivery,
/obj/structure/reagent_dispensers/fueltank,
/obj/effect/turf_decal/trimline/neutral/filled/line{
	dir = 1
	},
/turf/open/floor/iron,
/area/station/commons/storage/primary)
"fN" = (
/obj/effect/turf_decal/siding/wood{
	dir = 4
	},
/turf/open/floor/wood,
/area/command/heads_quarters/captain/private/nt_rep)
"gG" = (
/obj/effect/turf_decal/trimline/neutral/filled/line{
	dir = 8
	},
/obj/structure/disposalpipe/segment,
/turf/open/floor/iron,
/area/station/commons/storage/primary)
"gL" = (
/obj/machinery/atmospherics/pipe/smart/manifold4w/supply/hidden/layer4,
/obj/effect/landmark/event_spawn,
/obj/structure/disposalpipe/segment,
/obj/structure/cable,
/obj/machinery/atmospherics/pipe/smart/manifold4w/scrubbers/hidden/layer2,
/turf/open/floor/iron,
/area/station/hallway/primary/central)
"gO" = (
/obj/structure/filingcabinet/employment,
/turf/open/floor/carpet/executive,
/area/command/heads_quarters/captain/private/nt_rep)
"hP" = (
/obj/structure/closet/secure_closet/nanotrasen_consultant/station,
/obj/item/assembly/flash/handheld,
/obj/machinery/status_display/ai/directional/east,
/turf/open/floor/carpet/executive,
/area/command/heads_quarters/captain/private/nt_rep)
"iq" = (
/obj/machinery/button/door/directional/west{
	id = "nt_rep_priv";
	name = "Privacy Shutters Control";
	pixel_y = 8
	},
/obj/machinery/atmospherics/components/unary/vent_pump/on/layer4{
	dir = 4
	},
/obj/machinery/camera/directional/west{
	name = "command camera";
	c_tag = "NT Consultant's Office"
	},
/turf/open/floor/wood,
/area/command/heads_quarters/captain/private/nt_rep)
"jA" = (
/obj/structure/cable,
/obj/machinery/atmospherics/pipe/smart/manifold4w/supply/hidden/layer4,
/obj/machinery/atmospherics/pipe/smart/manifold4w/scrubbers/hidden/layer2,
/turf/open/floor/wood,
/area/command/heads_quarters/captain/private/nt_rep)
"kp" = (
/obj/structure/table/wood,
/obj/item/stamp/centcom{
	pixel_x = 8
	},
/turf/open/floor/carpet/executive,
/area/command/heads_quarters/captain/private/nt_rep)
"ln" = (
/obj/effect/turf_decal/siding/thinplating/dark{
	dir = 1
	},
/obj/machinery/newscaster/directional/north,
/obj/machinery/disposal/bin,
/obj/structure/disposalpipe/trunk,
/obj/machinery/camera{
	c_tag = "Hallway - Top Right Service";
	dir = 9
	},
/obj/effect/turf_decal/tile/neutral/fourcorners,
/turf/open/floor/iron/dark,
/area/station/hallway/primary/central)
"ms" = (
/obj/structure/table,
/obj/item/storage/toolbox/electrical{
	pixel_x = 1;
	pixel_y = -1
	},
/obj/effect/turf_decal/trimline/neutral/filled/line{
	dir = 8
	},
/turf/open/floor/iron,
/area/station/commons/storage/primary)
"mt" = (
/obj/structure/disposalpipe/segment,
/obj/structure/cable,
/obj/machinery/atmospherics/pipe/smart/manifold4w/supply/hidden/layer4,
/obj/machinery/atmospherics/pipe/smart/manifold4w/scrubbers/hidden/layer2,
/turf/open/floor/iron,
/area/station/hallway/primary/central)
"na" = (
/turf/closed/mineral/random/stationside/asteroid/porus,
/area/mine/explored)
"nn" = (
/obj/machinery/door/airlock/corporate{
	name = "NT Consultant's Office"
	},
/obj/effect/mapping_helpers/airlock/access/all/cent_com/rep_door,
/obj/structure/cable,
/obj/machinery/atmospherics/pipe/smart/manifold4w/supply/hidden/layer4,
/obj/machinery/atmospherics/pipe/smart/manifold4w/scrubbers/hidden/layer2,
/obj/machinery/door/firedoor,
/turf/open/floor/iron,
/area/command/heads_quarters/captain/private/nt_rep)
"ob" = (
/obj/effect/turf_decal/trimline/neutral/filled/line{
	dir = 4
	},
/turf/open/floor/iron,
/area/station/hallway/primary/central)
"oj" = (
/obj/effect/spawner/structure/window,
/turf/open/floor/plating,
/area/station/commons/storage/primary)
"pF" = (
/obj/structure/cable,
/obj/machinery/atmospherics/pipe/smart/manifold4w/scrubbers/hidden/layer2,
/turf/open/floor/wood,
/area/command/heads_quarters/captain/private/nt_rep)
"qF" = (
/obj/effect/turf_decal/trimline/neutral/filled/line{
	dir = 1
	},
/obj/structure/disposalpipe/segment,
/obj/structure/cable,
/obj/machinery/atmospherics/pipe/smart/manifold4w/supply/hidden/layer4,
/obj/machinery/atmospherics/pipe/smart/manifold4w/scrubbers/hidden/layer2,
/turf/open/floor/iron,
/area/station/hallway/primary/central)
"sq" = (
/obj/effect/turf_decal/siding/wood/corner{
	dir = 4
	},
/obj/machinery/atmospherics/pipe/smart/manifold4w/scrubbers/hidden/layer2,
/turf/open/floor/wood,
/area/command/heads_quarters/captain/private/nt_rep)
"wp" = (
/obj/structure/rack,
/obj/item/storage/toolbox/mechanical{
	pixel_x = -2;
	pixel_y = -1
	},
/obj/item/t_scanner,
/obj/effect/turf_decal/trimline/neutral/filled/line{
	dir = 4
	},
/turf/open/floor/iron,
/area/station/commons/storage/primary)
"wI" = (
/obj/machinery/door/poddoor/preopen{
	name = "Privacy Shutter";
	id = "nt_rep_priv"
	},
/obj/effect/spawner/structure/window/reinforced,
/turf/open/floor/plating,
/area/command/heads_quarters/captain/private/nt_rep)
"wP" = (
/obj/structure/cable,
/turf/open/floor/wood,
/area/command/heads_quarters/captain/private/nt_rep)
"wT" = (
/obj/machinery/photocopier,
/turf/open/floor/wood,
/area/command/heads_quarters/captain/private/nt_rep)
"xU" = (
/obj/structure/table,
/obj/item/crowbar,
/obj/item/clothing/gloves/color/fyellow,
/obj/item/assembly/prox_sensor{
	pixel_x = -8;
	pixel_y = 4
	},
/turf/open/floor/iron,
/area/station/commons/storage/primary)
"zT" = (
/obj/effect/turf_decal/siding/thinplating/dark{
	dir = 5
	},
/obj/item/kirbyplants/random,
/obj/machinery/status_display/evac/directional/north,
/obj/effect/landmark/start/hangover,
/obj/effect/turf_decal/tile/neutral/fourcorners,
/turf/open/floor/iron/dark,
/area/station/hallway/primary/central)
"Bg" = (
/obj/effect/turf_decal/trimline/neutral/filled/corner{
	dir = 4
	},
/obj/effect/turf_decal/trimline/neutral/filled/corner,
/obj/structure/disposalpipe/segment{
	dir = 4
	},
/turf/open/floor/iron,
/area/station/hallway/primary/central)
"Dc" = (
/obj/effect/turf_decal/siding/wood{
	dir = 1
	},
/obj/machinery/atmospherics/components/unary/vent_scrubber/on/layer2{
	dir = 8
	},
/turf/open/floor/wood,
/area/command/heads_quarters/captain/private/nt_rep)
"Dd" = (
/obj/machinery/atmospherics/pipe/smart/manifold4w/supply/hidden/layer4,
/obj/structure/disposalpipe/junction/flip,
/obj/structure/cable,
/obj/machinery/atmospherics/pipe/smart/manifold4w/scrubbers/hidden/layer2,
/turf/open/floor/iron,
/area/station/hallway/primary/central)
"DC" = (
/obj/effect/turf_decal/delivery,
/obj/structure/reagent_dispensers/watertank,
/obj/effect/turf_decal/trimline/neutral/filled/line{
	dir = 1
	},
/obj/machinery/light/directional/north,
/turf/open/floor/iron,
/area/station/commons/storage/primary)
"EP" = (
/turf/closed/wall/r_wall,
/area/command/heads_quarters/captain/private/nt_rep)
"FI" = (
/obj/machinery/vending/modularpc,
/obj/item/radio/intercom/directional/east,
/obj/effect/turf_decal/trimline/neutral/filled/line{
	dir = 4
	},
/turf/open/floor/iron,
/area/station/commons/storage/primary)
"FN" = (
/obj/structure/cable,
/obj/machinery/atmospherics/pipe/smart/manifold4w/supply/hidden/layer4,
/obj/machinery/atmospherics/pipe/smart/manifold4w/scrubbers/hidden/layer2,
/obj/machinery/status_display/ai/directional/south,
/obj/machinery/light/directional/south,
/turf/open/floor/wood,
/area/command/heads_quarters/captain/private/nt_rep)
"Gq" = (
/obj/effect/turf_decal/trimline/neutral/filled/line{
	dir = 4
	},
/turf/open/floor/iron,
/area/station/commons/storage/primary)
"GD" = (
/obj/machinery/disposal/bin,
/obj/effect/turf_decal/trimline/neutral/filled/line{
	dir = 9
	},
/obj/machinery/light_switch/directional/west,
/obj/structure/disposalpipe/trunk,
/turf/open/floor/iron,
/area/station/commons/storage/primary)
"Iu" = (
/obj/machinery/atmospherics/pipe/smart/manifold4w/supply/hidden/layer4,
/turf/open/floor/wood,
/area/command/heads_quarters/captain/private/nt_rep)
"Jx" = (
/obj/machinery/airalarm/directional/east,
/turf/open/floor/carpet/executive,
/area/command/heads_quarters/captain/private/nt_rep)
"Mc" = (
/turf/closed/wall/r_wall,
/area/station/commons/storage/primary)
"MM" = (
/obj/effect/turf_decal/trimline/neutral/filled/line{
	dir = 4
	},
/obj/machinery/light/directional/east,
/turf/open/floor/iron,
/area/station/hallway/primary/central)
"Ng" = (
/obj/structure/table/wood,
/obj/item/taperecorder{
	pixel_y = 5;
	pixel_x = 5
	},
/obj/item/camera_film{
	pixel_x = 6
	},
/obj/item/camera_film{
	pixel_x = 6;
	pixel_y = 4
	},
/obj/item/camera{
	pixel_x = -4
	},
/obj/machinery/newscaster/directional/north,
/turf/open/floor/carpet/executive,
/area/command/heads_quarters/captain/private/nt_rep)
"Nk" = (
/turf/closed/wall,
/area/station/hallway/primary/central)
"Ok" = (
/obj/machinery/light/directional/north,
/turf/open/floor/carpet/executive,
/area/command/heads_quarters/captain/private/nt_rep)
"Oy" = (
/turf/closed/wall,
/area/station/commons/storage/primary)
"QM" = (
/obj/structure/table,
/obj/item/stack/cable_coil{
	pixel_x = 2;
	pixel_y = -2
	},
/obj/item/stack/cable_coil{
	pixel_x = 3;
	pixel_y = -7
	},
/obj/item/screwdriver{
	pixel_y = 16
	},
/obj/effect/turf_decal/trimline/neutral/filled/line{
	dir = 8
	},
/obj/machinery/firealarm/directional/west,
/obj/item/storage/belt/utility,
/turf/open/floor/iron,
/area/station/commons/storage/primary)
"Rl" = (
/obj/structure/chair/office{
	dir = 1
	},
/obj/machinery/atmospherics/pipe/smart/manifold4w/supply/hidden/layer4,
/obj/effect/landmark/start/nanotrasen_consultant,
/turf/open/floor/wood,
/area/command/heads_quarters/captain/private/nt_rep)
"RW" = (
/obj/effect/turf_decal/trimline/neutral/filled/line{
	dir = 5
	},
/obj/structure/cable,
/obj/machinery/atmospherics/pipe/smart/manifold4w/supply/hidden/layer4,
/obj/machinery/atmospherics/pipe/smart/manifold4w/scrubbers/hidden/layer2,
/turf/open/floor/iron,
/area/station/hallway/primary/central)
"Sa" = (
/obj/effect/turf_decal/trimline/neutral/filled/line{
	dir = 5
	},
/turf/open/floor/iron,
/area/station/commons/storage/primary)
"Tj" = (
/obj/machinery/modular_computer/console/preset/command,
/turf/open/floor/wood,
/area/command/heads_quarters/captain/private/nt_rep)
"UM" = (
/obj/effect/turf_decal/siding/wood{
	dir = 4
	},
/obj/structure/chair/office{
	dir = 4
	},
/obj/effect/landmark/start/nanotrasen_consultant,
/turf/open/floor/wood,
/area/command/heads_quarters/captain/private/nt_rep)
"UX" = (
/obj/structure/table/wood,
/obj/item/stamp/denied{
	pixel_x = -6
	},
/obj/item/stamp{
	pixel_x = 6
	},
/turf/open/floor/carpet/executive,
/area/command/heads_quarters/captain/private/nt_rep)
"VH" = (
/obj/machinery/vending/tool,
/obj/machinery/airalarm/directional/east,
/obj/machinery/camera{
	c_tag = "Civilian - Primary Tool Storage";
	dir = 6
	},
/obj/effect/turf_decal/trimline/neutral/filled/line{
	dir = 4
	},
/turf/open/floor/iron,
/area/station/commons/storage/primary)
"We" = (
/obj/effect/turf_decal/trimline/neutral/filled/line{
	dir = 1
	},
/turf/open/floor/iron,
/area/station/commons/storage/primary)
"Ww" = (
/obj/machinery/atmospherics/components/unary/vent_pump/on/layer4{
	dir = 8
	},
/turf/open/floor/iron,
/area/station/commons/storage/primary)
"WY" = (
/obj/effect/turf_decal/bot,
/obj/machinery/holopad,
/obj/machinery/atmospherics/pipe/smart/manifold4w/supply/hidden/layer4,
/turf/open/floor/iron,
/area/station/commons/storage/primary)
"Xt" = (
/turf/open/floor/iron,
/area/station/commons/storage/primary)
"XM" = (
/obj/structure/cable,
/obj/machinery/holopad,
/turf/open/floor/wood,
/area/command/heads_quarters/captain/private/nt_rep)
"Zr" = (
/obj/machinery/atmospherics/pipe/smart/manifold4w/supply/hidden/layer4,
/turf/open/floor/iron,
/area/station/commons/storage/primary)
"ZC" = (
/obj/effect/turf_decal/siding/wood/corner{
	dir = 4
	},
/obj/effect/turf_decal/siding/wood{
	dir = 1
	},
/obj/machinery/atmospherics/pipe/smart/manifold4w/scrubbers/hidden/layer2,
/turf/open/floor/wood,
/area/command/heads_quarters/captain/private/nt_rep)
"ZS" = (
/obj/structure/chair/office{
	dir = 8
	},
/obj/effect/landmark/start/nanotrasen_consultant,
/turf/open/floor/carpet/executive,
/area/command/heads_quarters/captain/private/nt_rep)

(1,1,1) = {"
na
na
Nk
ln
qF
mt
eh
gL
Dd
eh
eh
"}
(2,1,1) = {"
na
na
Nk
zT
RW
MM
ob
ob
Bg
ob
ob
"}
(3,1,1) = {"
EP
EP
EP
wI
nn
Mc
Oy
oj
dP
oj
Oy
"}
(4,1,1) = {"
EP
cL
iq
wT
jA
Mc
GD
gG
bZ
ms
QM
"}
(5,1,1) = {"
EP
Tj
Rl
Iu
FN
Mc
eM
Xt
Xt
Xt
xU
"}
(6,1,1) = {"
EP
bN
wP
XM
pF
Mc
DC
Zr
Zr
Zr
WY
"}
(7,1,1) = {"
EP
UM
UM
fN
sq
Mc
We
Ww
Xt
Xt
Xt
"}
(8,1,1) = {"
EP
cU
kp
UX
ZC
Mc
Sa
Gq
wp
FI
VH
"}
(9,1,1) = {"
EP
Ng
ZS
Jx
Dc
Mc
Oy
Oy
Oy
Oy
Oy
"}
(10,1,1) = {"
EP
Ok
es
EP
EP
EP
na
na
na
na
na
"}
(11,1,1) = {"
EP
hP
gO
EP
na
na
na
na
na
na
na
"}
(12,1,1) = {"
EP
EP
EP
EP
na
na
na
na
na
na
na
"}
