//MAP CONVERTED BY dmm2tgm.py THIS HEADER COMMENT PREVENTS RECONVERSION, DO NOT REMOVE
"a" = (
/obj/machinery/light/small/directional/south,
/turf/open/floor/plating,
/area/station/service/barber)
"b" = (
/obj/machinery/power/apc/auto_name/directional/south,
/obj/structure/cable,
/obj/effect/turf_decal/tile/purple/opposingcorners,
/turf/open/floor/iron/dark,
/area/station/service/barber)
"d" = (
/turf/open/floor/plating,
/area/station/service/barber)
"f" = (
/obj/effect/turf_decal/tile/purple/opposingcorners,
/obj/structure/chair/sofa/bench/right{
	dir = 4
	},
/turf/open/floor/iron/dark,
/area/station/service/barber)
"g" = (
/obj/structure/disposalpipe/segment{
	dir = 9
	},
/obj/effect/turf_decal/tile/purple/opposingcorners,
/turf/open/floor/iron/dark,
/area/station/service/barber)
"h" = (
/obj/machinery/atmospherics/pipe/smart/manifold4w/supply/hidden/layer4,
/obj/structure/cable,
/obj/machinery/atmospherics/pipe/smart/manifold4w/scrubbers/hidden/layer2,
/obj/effect/turf_decal/tile/purple/opposingcorners,
/turf/open/floor/iron/dark,
/area/station/service/barber)
"i" = (
/obj/machinery/light/directional/north,
/obj/structure/sign/poster/official/random/directional/north,
/obj/effect/turf_decal/tile/purple/opposingcorners,
/obj/machinery/vending/barbervend,
/turf/open/floor/iron/dark,
/area/station/service/barber)
"l" = (
/obj/machinery/door/firedoor,
/obj/structure/disposalpipe/segment{
	dir = 4
	},
/obj/machinery/door/airlock/public/glass{
	name = "Barber Shop"
	},
/turf/open/floor/iron/dark,
/area/station/service/barber)
"m" = (
/obj/machinery/light/directional/east,
/obj/effect/turf_decal/tile/purple/opposingcorners,
/obj/structure/table/reinforced/rglass,
/obj/item/reagent_containers/spray/barbers_aid,
/obj/item/hairbrush/comb,
/turf/open/floor/iron/dark,
/area/station/service/barber)
"o" = (
/obj/machinery/atmospherics/pipe/smart/manifold4w/supply/hidden/layer4,
/obj/effect/landmark/event_spawn,
/obj/effect/turf_decal/tile/purple/opposingcorners,
/turf/open/floor/iron/dark,
/area/station/service/barber)
"r" = (
/obj/structure/mirror/directional/east,
/obj/effect/turf_decal/tile/purple/opposingcorners,
/obj/structure/table/reinforced/rglass,
/obj/item/reagent_containers/spray/quantum_hair_dye,
/obj/item/reagent_containers/dropper,
/turf/open/floor/iron/dark,
/area/station/service/barber)
"s" = (
/obj/machinery/computer/security/telescreen/entertainment/directional/east,
/obj/effect/turf_decal/tile/purple/opposingcorners,
/obj/item/kirbyplants/random,
/turf/open/floor/iron/dark,
/area/station/service/barber)
"t" = (
/obj/machinery/airalarm/directional/north,
/obj/effect/turf_decal/tile/purple/opposingcorners,
/obj/machinery/atmospherics/components/unary/vent_scrubber/on/layer2{
	dir = 8
	},
/obj/machinery/dryer{
	pixel_y = 14
	},
/turf/open/floor/iron/dark,
/area/station/service/barber)
"u" = (
/obj/machinery/firealarm/directional/north{
	pixel_x = 5
	},
/obj/machinery/light_switch/directional/north{
	pixel_x = -8;
	pixel_y = 24
	},
/obj/structure/disposalpipe/trunk,
/obj/machinery/disposal/bin,
/obj/effect/turf_decal/tile/purple/opposingcorners,
/turf/open/floor/iron/dark,
/area/station/service/barber)
"w" = (
/obj/effect/turf_decal/tile/purple/opposingcorners,
/turf/open/floor/iron/dark,
/area/station/service/barber)
"A" = (
/turf/template_noop,
/area/template_noop)
"B" = (
/turf/closed/wall,
/area/station/service/barber)
"C" = (
/obj/effect/turf_decal/tile/purple/opposingcorners,
/obj/structure/chair/comfy/barber_chair{
	dir = 4
	},
/turf/open/floor/iron/dark,
/area/station/service/barber)
"G" = (
/obj/structure/cable,
/obj/effect/turf_decal/tile/purple/opposingcorners,
/turf/open/floor/iron/dark,
/area/station/service/barber)
"K" = (
/obj/machinery/door/airlock{
	id_tag = "commissarydoor";
	name = "Barber Storage"
	},
/turf/open/floor/plating,
/area/station/service/barber)
"M" = (
/obj/machinery/atmospherics/components/unary/vent_pump/on/layer4{
	dir = 1
	},
/obj/effect/turf_decal/tile/purple/opposingcorners,
/turf/open/floor/iron/dark,
/area/station/service/barber)
"N" = (
/obj/effect/turf_decal/tile/purple/opposingcorners,
/obj/item/kirbyplants/random,
/turf/open/floor/iron/dark,
/area/station/service/barber)
"O" = (
/obj/machinery/atmospherics/pipe/smart/manifold4w/supply/hidden/layer4,
/obj/machinery/atmospherics/pipe/smart/manifold4w/scrubbers/hidden/layer2,
/obj/effect/turf_decal/tile/purple/opposingcorners,
/turf/open/floor/iron/dark,
/area/station/service/barber)
"Q" = (
/obj/machinery/door/airlock{
	id_tag = "commissarydoor";
	name = "Barber Maintenance"
	},
/obj/effect/mapping_helpers/airlock/access/all/engineering/maintenance,
/obj/effect/decal/cleanable/dirt,
/obj/structure/cable,
/obj/machinery/atmospherics/pipe/smart/manifold4w/supply/hidden/layer4,
/obj/machinery/atmospherics/pipe/smart/manifold4w/scrubbers/hidden/layer2,
/turf/open/floor/catwalk_floor,
/area/station/service/barber)
"R" = (
/obj/effect/turf_decal/tile/purple/opposingcorners,
/obj/structure/chair/sofa/bench/left{
	dir = 4
	},
/turf/open/floor/iron/dark,
/area/station/service/barber)
"S" = (
/obj/effect/spawner/structure/window,
/turf/open/floor/plating,
/area/station/service/barber)
"V" = (
/obj/item/radio/intercom/directional/north,
/obj/effect/turf_decal/tile/purple/opposingcorners,
/obj/structure/closet/secure_closet/barber,
/turf/open/floor/iron/dark,
/area/station/service/barber)
"W" = (
/obj/structure/cable,
/obj/machinery/atmospherics/pipe/smart/manifold4w/scrubbers/hidden/layer2,
/obj/machinery/atmospherics/pipe/smart/manifold4w/supply/hidden/layer4,
/obj/effect/turf_decal/tile/purple/opposingcorners,
/turf/open/floor/iron/dark,
/area/station/service/barber)
"Y" = (
/obj/structure/mirror/directional/east,
/obj/effect/turf_decal/tile/purple/opposingcorners,
/obj/structure/table/reinforced/rglass,
/obj/item/lipstick/random,
/obj/item/razor,
/turf/open/floor/iron/dark,
/area/station/service/barber)

(1,1,1) = {"
B
S
l
S
A
A
A
A
A
A
"}
(2,1,1) = {"
B
u
g
S
S
S
B
B
B
B
"}
(3,1,1) = {"
B
V
O
R
f
N
B
d
d
B
"}
(4,1,1) = {"
B
i
h
G
G
b
B
d
a
B
"}
(5,1,1) = {"
Q
W
h
o
M
w
K
d
d
B
"}
(6,1,1) = {"
B
t
C
w
C
w
B
B
B
B
"}
(7,1,1) = {"
B
s
Y
m
r
s
B
A
A
A
"}
(8,1,1) = {"
B
B
B
B
B
B
B
A
A
A
"}
