//MAP CONVERTED BY dmm2tgm.py THIS HEADER COMMENT PREVENTS RECONVERSION, DO NOT REMOVE
"a" = (
/turf/closed/mineral/random/stationside/asteroid/porus,
/area/mine/explored)
"c" = (
/obj/item/storage/secure/safe/directional/south,
/obj/machinery/light/directional/south,
/obj/machinery/atmospherics/components/unary/vent_scrubber/on/layer2{
	dir = 1
	},
/obj/structure/disposalpipe/segment{
	dir = 4
	},
/obj/effect/turf_decal/tile/purple,
/obj/effect/turf_decal/tile/purple{
	dir = 1
	},
/obj/structure/closet/secure_closet/barber,
/turf/open/floor/iron,
/area/station/service/salon)
"d" = (
/obj/effect/turf_decal/tile/purple{
	dir = 1
	},
/obj/effect/turf_decal/tile/purple,
/obj/structure/bed/pod,
/obj/structure/window,
/turf/open/floor/iron,
/area/station/service/salon)
"e" = (
/obj/effect/turf_decal/siding/thinplating/dark{
	dir = 9
	},
/obj/item/kirbyplants/random,
/obj/machinery/status_display/ai/directional/north,
/obj/effect/landmark/start/hangover,
/obj/effect/turf_decal/tile/neutral/fourcorners,
/turf/open/floor/iron/dark,
/area/station/hallway/primary/central)
"f" = (
/obj/effect/turf_decal/tile/purple,
/obj/effect/turf_decal/tile/purple{
	dir = 1
	},
/obj/machinery/vending/barbervend,
/obj/structure/disposalpipe/segment{
	dir = 4
	},
/turf/open/floor/iron,
/area/station/service/salon)
"h" = (
/obj/machinery/power/apc/auto_name/directional/south,
/obj/structure/cable,
/obj/machinery/atmospherics/pipe/smart/manifold4w/supply/hidden/layer4,
/obj/machinery/atmospherics/pipe/smart/manifold4w/scrubbers/hidden/layer2,
/obj/structure/disposalpipe/segment{
	dir = 4
	},
/obj/effect/turf_decal/tile/purple,
/obj/effect/turf_decal/tile/purple{
	dir = 1
	},
/obj/structure/chair{
	dir = 1
	},
/turf/open/floor/iron,
/area/station/service/salon)
"i" = (
/obj/machinery/atmospherics/pipe/smart/manifold4w/scrubbers/hidden/layer2,
/obj/machinery/atmospherics/pipe/smart/manifold4w/supply/hidden/layer4,
/obj/effect/turf_decal/tile/purple,
/obj/effect/turf_decal/tile/purple{
	dir = 1
	},
/turf/open/floor/iron,
/area/station/service/salon)
"j" = (
/obj/machinery/airalarm/directional/north,
/obj/effect/turf_decal/tile/purple{
	dir = 1
	},
/obj/effect/turf_decal/tile/purple,
/obj/machinery/light/warm/directional/north,
/obj/item/kirbyplants/random,
/turf/open/floor/iron,
/area/station/service/salon)
"k" = (
/obj/effect/turf_decal/tile/purple{
	dir = 1
	},
/obj/effect/turf_decal/tile/purple,
/obj/effect/landmark/start/barber,
/turf/open/floor/iron,
/area/station/service/salon)
"l" = (
/obj/effect/turf_decal/tile/purple,
/obj/effect/turf_decal/tile/purple{
	dir = 1
	},
/obj/machinery/door/airlock/public/glass{
	name = "Barbershop"
	},
/obj/machinery/door/firedoor,
/turf/open/floor/iron,
/area/station/service/salon)
"m" = (
/turf/closed/wall,
/area/station/hallway/primary/central)
"p" = (
/obj/effect/turf_decal/tile/purple{
	dir = 1
	},
/obj/effect/turf_decal/tile/purple,
/obj/structure/chair/comfy/barber_chair{
	dir = 8
	},
/obj/effect/landmark/start/hangover,
/turf/open/floor/iron,
/area/station/service/salon)
"q" = (
/obj/effect/turf_decal/tile/purple{
	dir = 1
	},
/obj/effect/turf_decal/tile/purple,
/obj/machinery/holopad,
/turf/open/floor/iron,
/area/station/service/salon)
"r" = (
/obj/effect/turf_decal/tile/purple{
	dir = 1
	},
/obj/effect/turf_decal/tile/purple,
/obj/effect/landmark/start/barber,
/obj/machinery/button/curtain{
	id = "barbershopcurtains1";
	pixel_x = 25;
	pixel_y = 24
	},
/turf/open/floor/iron,
/area/station/service/salon)
"s" = (
/obj/effect/turf_decal/tile/purple{
	dir = 1
	},
/obj/effect/turf_decal/tile/purple,
/obj/structure/table/reinforced/rglass,
/obj/structure/window,
/obj/item/hairbrush,
/obj/item/lipstick/random,
/turf/open/floor/iron,
/area/station/service/salon)
"t" = (
/obj/effect/turf_decal/trimline/neutral/filled/line{
	dir = 8
	},
/obj/machinery/atmospherics/pipe/smart/manifold4w/scrubbers/hidden/layer2,
/obj/machinery/atmospherics/pipe/smart/manifold4w/supply/hidden/layer4,
/obj/structure/cable,
/obj/structure/disposalpipe/segment{
	dir = 4
	},
/turf/open/floor/iron,
/area/station/hallway/primary/central)
"u" = (
/obj/machinery/newscaster/directional/north,
/obj/effect/turf_decal/tile/purple{
	dir = 1
	},
/obj/effect/turf_decal/tile/purple,
/obj/structure/chair/office/light{
	dir = 4
	},
/obj/structure/window{
	dir = 8
	},
/obj/machinery/camera/directional/north{
	c_tag = "Salon"
	},
/turf/open/floor/iron,
/area/station/service/salon)
"v" = (
/obj/effect/turf_decal/tile/purple{
	dir = 1
	},
/obj/effect/turf_decal/tile/purple,
/obj/structure/chair/office/light{
	dir = 4
	},
/obj/structure/window,
/obj/structure/window{
	dir = 8
	},
/turf/open/floor/iron,
/area/station/service/salon)
"w" = (
/obj/effect/turf_decal/tile/purple{
	dir = 1
	},
/obj/effect/turf_decal/tile/purple,
/obj/structure/sink{
	dir = 4;
	pixel_x = -12
	},
/turf/open/floor/iron,
/area/station/service/salon)
"x" = (
/turf/closed/wall,
/area/station/security/courtroom)
"y" = (
/obj/machinery/atmospherics/pipe/smart/manifold4w/supply/hidden/layer4,
/obj/effect/turf_decal/tile/purple,
/obj/effect/turf_decal/tile/purple{
	dir = 1
	},
/turf/open/floor/iron,
/area/station/service/salon)
"z" = (
/obj/machinery/disposal/bin,
/obj/effect/turf_decal/tile/purple,
/obj/effect/turf_decal/tile/purple{
	dir = 1
	},
/obj/structure/disposalpipe/trunk{
	dir = 4
	},
/turf/open/floor/iron,
/area/station/service/salon)
"A" = (
/obj/effect/turf_decal/tile/purple{
	dir = 1
	},
/obj/effect/turf_decal/tile/purple,
/obj/structure/table/reinforced/rglass,
/obj/item/hairbrush,
/turf/open/floor/iron,
/area/station/service/salon)
"B" = (
/obj/effect/turf_decal/tile/purple{
	dir = 1
	},
/obj/effect/turf_decal/tile/purple,
/obj/structure/chair/comfy/barber_chair{
	dir = 8
	},
/turf/open/floor/iron,
/area/station/service/salon)
"C" = (
/obj/effect/turf_decal/trimline/neutral/filled/line{
	dir = 9
	},
/turf/open/floor/iron,
/area/station/hallway/primary/central)
"D" = (
/obj/structure/mirror/directional/west,
/obj/structure/table/reinforced/rglass,
/obj/item/razor{
	pixel_x = -6
	},
/obj/item/reagent_containers/spray/barbers_aid{
	pixel_x = 6
	},
/turf/open/floor/iron,
/area/station/service/salon)
"F" = (
/obj/machinery/light_switch/directional/west,
/obj/effect/turf_decal/tile/purple{
	dir = 1
	},
/obj/effect/turf_decal/tile/purple,
/obj/machinery/dryer{
	dir = 4;
	pixel_x = -6;
	pixel_y = -6
	},
/turf/open/floor/iron,
/area/station/service/salon)
"G" = (
/obj/structure/mirror/directional/west,
/obj/structure/table/reinforced/rglass,
/obj/item/hairbrush/comb{
	pixel_y = 10
	},
/obj/item/reagent_containers/dropper,
/obj/machinery/dryer{
	pixel_y = 14
	},
/turf/open/floor/iron,
/area/station/service/salon)
"H" = (
/obj/effect/turf_decal/tile/neutral,
/obj/machinery/atmospherics/pipe/smart/manifold4w/supply/hidden/layer4,
/obj/effect/turf_decal/tile/purple{
	dir = 1
	},
/obj/effect/turf_decal/tile/purple,
/turf/open/floor/iron,
/area/station/service/salon)
"I" = (
/obj/machinery/atmospherics/pipe/smart/manifold4w/supply/hidden/layer4,
/obj/effect/turf_decal/tile/purple{
	dir = 1
	},
/obj/effect/turf_decal/tile/purple,
/turf/open/floor/iron,
/area/station/service/salon)
"J" = (
/obj/item/radio/intercom/directional/west,
/obj/structure/table/reinforced/rglass,
/obj/item/reagent_containers/spray/quantum_hair_dye{
	pixel_x = 6
	},
/obj/item/lipstick/random,
/turf/open/floor/iron,
/area/station/service/salon)
"K" = (
/obj/effect/turf_decal/tile/purple{
	dir = 1
	},
/obj/effect/turf_decal/tile/purple,
/turf/open/floor/iron,
/area/station/service/salon)
"O" = (
/obj/effect/turf_decal/trimline/neutral/filled/line{
	dir = 8
	},
/obj/machinery/atmospherics/components/unary/vent_scrubber/on/layer2{
	dir = 4
	},
/turf/open/floor/iron,
/area/station/hallway/primary/central)
"P" = (
/obj/structure/cable,
/obj/machinery/atmospherics/pipe/smart/manifold4w/supply/hidden/layer4,
/obj/machinery/atmospherics/pipe/smart/manifold4w/scrubbers/hidden/layer2,
/obj/structure/disposalpipe/segment{
	dir = 4
	},
/obj/effect/spawner/structure/window,
/obj/structure/curtain/cloth/fancy/mechanical{
	id = "barbershopcurtains"
	},
/turf/open/floor/plating,
/area/station/service/salon)
"S" = (
/turf/closed/wall,
/area/station/service/salon)
"T" = (
/obj/effect/turf_decal/tile/purple,
/obj/effect/turf_decal/tile/purple{
	dir = 1
	},
/turf/open/floor/iron,
/area/station/service/salon)
"V" = (
/obj/machinery/atmospherics/pipe/smart/manifold4w/supply/hidden/layer4,
/obj/machinery/atmospherics/pipe/smart/manifold4w/scrubbers/hidden/layer2,
/obj/effect/turf_decal/tile/purple,
/obj/effect/turf_decal/tile/purple{
	dir = 1
	},
/turf/open/floor/iron,
/area/station/service/salon)
"W" = (
/obj/structure/cable,
/obj/machinery/atmospherics/pipe/smart/manifold4w/supply/hidden/layer4,
/obj/machinery/atmospherics/pipe/smart/manifold4w/scrubbers/hidden/layer2,
/obj/structure/disposalpipe/segment{
	dir = 4
	},
/obj/effect/turf_decal/tile/purple,
/obj/effect/turf_decal/tile/purple{
	dir = 1
	},
/obj/machinery/button/curtain{
	id = "barbershopcurtains";
	pixel_x = 25;
	pixel_y = -24
	},
/obj/structure/chair{
	dir = 1
	},
/turf/open/floor/iron,
/area/station/service/salon)
"X" = (
/obj/machinery/firealarm/directional/north,
/obj/effect/turf_decal/tile/purple{
	dir = 1
	},
/obj/effect/turf_decal/tile/purple,
/obj/structure/bed/pod,
/obj/effect/landmark/start/hangover,
/turf/open/floor/iron,
/area/station/service/salon)
"Y" = (
/obj/effect/spawner/structure/window,
/obj/structure/curtain/cloth/fancy/mechanical{
	id = "barbershopcurtains"
	},
/turf/open/floor/plating,
/area/station/service/salon)
"Z" = (
/obj/machinery/atmospherics/components/unary/vent_pump/on/layer4,
/obj/effect/turf_decal/tile/purple{
	dir = 1
	},
/obj/effect/turf_decal/tile/purple,
/turf/open/floor/iron,
/area/station/service/salon)

(1,1,1) = {"
S
S
S
S
S
S
S
x
"}
(2,1,1) = {"
S
G
J
D
w
K
F
x
"}
(3,1,1) = {"
S
B
k
p
K
T
z
x
"}
(4,1,1) = {"
S
j
Z
I
H
y
f
x
"}
(5,1,1) = {"
S
u
K
v
T
i
c
x
"}
(6,1,1) = {"
S
X
q
d
T
V
h
x
"}
(7,1,1) = {"
S
A
r
s
K
T
W
x
"}
(8,1,1) = {"
S
S
S
S
Y
l
P
x
"}
(9,1,1) = {"
a
a
a
m
e
C
t
O
"}
