//MAP CONVERTED BY dmm2tgm.py THIS HEADER COMMENT PREVENTS RECONVERSION, DO NOT REMOVE
"Bj" = (
/obj/machinery/vending/barbervend,
/turf/template_noop,
/area/template_noop)
"Xf" = (
/obj/structure/closet/secure_closet/barber,
/turf/template_noop,
/area/template_noop)
"Xo" = (
/obj/structure/chair/plastic,
/obj/effect/landmark/start/barber,
/turf/template_noop,
/area/template_noop)

(1,1,1) = {"
Bj
"}
(2,1,1) = {"
Xo
"}
(3,1,1) = {"
Xf
"}
