//MAP CONVERTED BY dmm2tgm.py THIS HEADER COMMENT PREVENTS RECONVERSION, DO NOT REMOVE
"a" = (
/obj/structure/sign/poster/official/high_class_martini{
	pixel_x = -32
	},
/turf/open/floor/wood,
/area/ruin/powered/beach)

(1,1,1) = {"
a
"}
