//MAP CONVERTED BY dmm2tgm.py THIS HEADER COMMENT PREVENTS RECONVERSION, DO NOT REMOVE
"aa" = (
/turf/template_noop,
/area/template_noop)
"ac" = (
/turf/closed/wall/mineral/plastitanium/nodiagonal,
/area/shuttle/trader/engine)
"ae" = (
/turf/closed/wall/mineral/plastitanium,
/area/shuttle/trader/bridge)
"af" = (
/obj/structure/bed,
/obj/item/bedsheet/dorms,
/turf/open/floor/carpet,
/area/shuttle/trader/crew)
"ah" = (
/obj/effect/mapping_helpers/airlock/cyclelink_helper,
/obj/docking_port/mobile{
	callTime = 250;
	can_move_docking_ports = 1;
	dir = 2;
	dwidth = 11;
	height = 17;
	id = "tradership";
	launch_status = 0;
	movement_force = list("KNOCKDOWN" = 0, "THROW" = 0);
	name = "Trader Ship";
	port_direction = 8;
	preferred_direction = 4;
	width = 33
	},
/obj/machinery/door/airlock/external,
/obj/effect/turf_decal/stripes{
	dir = 1
	},
/turf/open/floor/plating,
/area/shuttle/trader/cargo)
"ak" = (
/obj/effect/turf_decal/trimline/brown/filled/line{
	dir = 9
	},
/obj/effect/turf_decal/trimline/yellow/line{
	dir = 9
	},
/obj/effect/turf_decal/trimline/blue/warning{
	dir = 9
	},
/turf/open/floor/iron/dark,
/area/shuttle/trader/bridge)
"am" = (
/obj/structure/table/wood,
/turf/open/floor/carpet,
/area/shuttle/trader/crew)
"ap" = (
/obj/effect/spawner/structure/window/plasma/reinforced/plastitanium,
/turf/open/floor/plating,
/area/shuttle/trader/bar)
"aq" = (
/obj/machinery/light{
	dir = 4
	},
/turf/open/floor/carpet,
/area/shuttle/trader/crew)
"ar" = (
/obj/machinery/deepfryer,
/obj/machinery/light{
	dir = 4
	},
/turf/open/floor/wood,
/area/shuttle/trader/bar)
"as" = (
/obj/structure/closet/secure_closet/freezer/fridge{
	req_access = null
	},
/obj/item/storage/box/ingredients/vegetarian,
/obj/item/storage/box/ingredients/italian,
/obj/item/storage/box/ingredients/fruity,
/obj/item/storage/box/ingredients/fiesta,
/obj/item/storage/box/ingredients/american,
/obj/item/reagent_containers/food/condiment/flour{
	list_reagents = list(/datum/reagent/consumable/flour = 600);
	name = "Premium All-Purpose Flour (16KG)";
	volume = 600
	},
/obj/item/reagent_containers/food/condiment/milk,
/obj/item/reagent_containers/food/condiment/enzyme{
	list_reagents = list(/datum/reagent/consumable/enzyme = 500);
	name = "universe-sized universal enyzyme";
	volume = 500
	},
/obj/item/reagent_containers/food/condiment/rice{
	list_reagents = list(/datum/reagent/consumable/rice = 150);
	name = "Basmati Rice Sack (4KG)";
	volume = 150
	},
/turf/open/floor/iron/freezer,
/area/shuttle/trader/bar)
"au" = (
/obj/structure/rack,
/obj/effect/spawner/lootdrop/maintenance/three,
/turf/open/floor/plating,
/area/shuttle/trader/bridge)
"aw" = (
/obj/effect/turf_decal/trimline/brown/filled/line{
	dir = 5
	},
/obj/effect/turf_decal/trimline/yellow/line{
	dir = 5
	},
/obj/effect/turf_decal/trimline/blue/warning{
	dir = 5
	},
/obj/structure/table,
/obj/machinery/light{
	dir = 1
	},
/obj/item/blackmarket_uplink,
/turf/open/floor/iron/dark,
/area/shuttle/trader/bridge)
"ax" = (
/obj/effect/turf_decal/stripes/line{
	dir = 8
	},
/turf/open/floor/engine/airless,
/area/shuttle/trader/engine)
"ay" = (
/turf/open/floor/engine/airless,
/area/shuttle/trader/engine)
"az" = (
/turf/open/floor/iron/freezer,
/area/shuttle/trader/bar)
"aB" = (
/obj/structure/chair/office{
	dir = 1
	},
/turf/open/floor/wood,
/area/shuttle/trader/crew)
"aC" = (
/turf/open/floor/carpet,
/area/shuttle/trader/crew)
"aE" = (
/obj/machinery/deepfryer,
/turf/open/floor/wood,
/area/shuttle/trader/bar)
"aF" = (
/obj/structure/closet/secure_closet/freezer/meat{
	req_access = list(401)
	},
/obj/item/food/meat/slab/monkey,
/obj/item/food/meat/slab/monkey,
/obj/item/food/meat/slab/monkey,
/obj/item/food/meat/slab/monkey,
/obj/item/food/meat/rawbacon,
/obj/item/food/meat/rawbacon,
/obj/item/food/meat/rawbacon,
/obj/item/food/meat/rawbacon,
/obj/item/food/meat/slab/chicken,
/obj/item/food/meat/slab/chicken,
/obj/item/food/meat/slab/chicken,
/obj/item/food/meat/slab/chicken,
/turf/open/floor/iron/freezer,
/area/shuttle/trader/bar)
"aG" = (
/obj/structure/closet/crate/freezer/tradership_cargo_freezer,
/turf/open/floor/iron/freezer,
/area/shuttle/trader/bar)
"aI" = (
/obj/effect/mapping_helpers/airlock/cyclelink_helper{
	dir = 1
	},
/obj/machinery/door/airlock/external,
/obj/effect/turf_decal/stripes,
/turf/open/floor/plating,
/area/shuttle/trader/cargo)
"aK" = (
/obj/effect/turf_decal/trimline/brown/filled/line{
	dir = 4
	},
/obj/effect/turf_decal/trimline/yellow/line{
	dir = 4
	},
/obj/effect/turf_decal/trimline/blue/warning{
	dir = 4
	},
/obj/structure/table,
/obj/structure/window/reinforced/spawner,
/obj/item/stack/package_wrap,
/obj/item/stack/package_wrap{
	pixel_x = -1;
	pixel_y = -1
	},
/obj/item/stack/wrapping_paper{
	pixel_x = 3;
	pixel_y = 4
	},
/turf/open/floor/iron/dark,
/area/shuttle/trader/bridge)
"aL" = (
/obj/structure/shuttle/engine/large{
	dir = 8
	},
/obj/effect/turf_decal/stripes/line{
	dir = 8
	},
/turf/open/floor/engine/airless,
/area/shuttle/trader/engine)
"aM" = (
/obj/machinery/light{
	dir = 4
	},
/turf/open/floor/iron/freezer,
/area/shuttle/trader/bar)
"aU" = (
/obj/structure/dresser,
/turf/open/floor/wood,
/area/shuttle/trader/crew)
"aV" = (
/obj/effect/turf_decal/tile/brown{
	dir = 4
	},
/obj/effect/turf_decal/tile/brown,
/obj/effect/turf_decal/tile/yellow,
/obj/structure/chair/sofa/bench/left{
	dir = 8
	},
/obj/effect/turf_decal/trimline/brown/filled/line{
	dir = 8
	},
/obj/effect/turf_decal/trimline/yellow/warning{
	dir = 8
	},
/turf/open/floor/iron,
/area/shuttle/trader/cargo)
"aW" = (
/obj/effect/turf_decal/tile/brown{
	dir = 4
	},
/obj/effect/turf_decal/tile/brown{
	dir = 8
	},
/obj/effect/turf_decal/tile/brown{
	dir = 1
	},
/obj/effect/turf_decal/tile/yellow{
	dir = 1
	},
/obj/structure/reagent_dispensers/water_cooler,
/obj/effect/turf_decal/trimline/brown/filled/corner,
/obj/effect/turf_decal/trimline/yellow/corner,
/obj/machinery/light{
	dir = 8
	},
/turf/open/floor/iron,
/area/shuttle/trader/cargo)
"aZ" = (
/obj/effect/turf_decal/tile/brown{
	dir = 4
	},
/obj/effect/turf_decal/tile/brown{
	dir = 1
	},
/obj/effect/turf_decal/tile/yellow{
	dir = 1
	},
/obj/effect/turf_decal/trimline/brown/filled/line,
/obj/effect/turf_decal/trimline/yellow/warning,
/turf/open/floor/iron,
/area/shuttle/trader/cargo)
"ba" = (
/obj/effect/turf_decal/tile/brown{
	dir = 4
	},
/obj/effect/turf_decal/tile/brown{
	dir = 1
	},
/obj/effect/turf_decal/tile/brown,
/obj/effect/turf_decal/tile/yellow,
/obj/effect/turf_decal/tile/yellow{
	dir = 1
	},
/obj/structure/chair/sofa/bench/right{
	dir = 8
	},
/obj/effect/turf_decal/trimline/brown/filled/corner{
	dir = 8
	},
/obj/effect/turf_decal/trimline/yellow/corner{
	dir = 8
	},
/obj/machinery/light{
	dir = 4
	},
/turf/open/floor/iron,
/area/shuttle/trader/cargo)
"bf" = (
/obj/structure/bed,
/obj/item/bedsheet/dorms,
/obj/machinery/light{
	dir = 1
	},
/turf/open/floor/wood,
/area/shuttle/trader/bridge)
"bg" = (
/turf/open/floor/wood,
/area/shuttle/trader/bridge)
"bh" = (
/obj/effect/turf_decal/stripes/line,
/obj/machinery/portable_atmospherics/canister/oxygen,
/obj/machinery/light{
	dir = 8
	},
/turf/open/floor/plating,
/area/shuttle/trader/engine)
"bn" = (
/obj/effect/turf_decal/stripes/line,
/obj/structure/tank_dispenser/oxygen,
/turf/open/floor/plating,
/area/shuttle/trader/engine)
"bo" = (
/obj/structure/table,
/obj/machinery/chem_dispenser/drinks/fullupgrade{
	dir = 8
	},
/turf/open/floor/wood,
/area/shuttle/trader/bar)
"bp" = (
/obj/structure/reagent_dispensers/cooking_oil,
/turf/open/floor/iron/freezer,
/area/shuttle/trader/bar)
"bq" = (
/obj/effect/turf_decal/tile/brown{
	dir = 8
	},
/obj/effect/turf_decal/tile/brown{
	dir = 1
	},
/obj/effect/turf_decal/tile/yellow{
	dir = 1
	},
/obj/effect/turf_decal/trimline/brown/filled/line{
	dir = 4
	},
/obj/effect/turf_decal/trimline/yellow/warning{
	dir = 4
	},
/turf/open/floor/iron,
/area/shuttle/trader/cargo)
"bx" = (
/obj/effect/spawner/structure/window/plasma/reinforced/plastitanium,
/obj/structure/curtain/cloth/fancy/mechanical{
	icon_state = "bounty-open";
	icon_type = "bounty";
	id = "FTUbridgedorm2"
	},
/turf/open/floor/plating,
/area/shuttle/trader/bridge)
"by" = (
/obj/effect/turf_decal/siding/wood,
/obj/machinery/door/airlock{
	name = "Quarters"
	},
/turf/open/floor/wood,
/area/shuttle/trader/crew)
"bA" = (
/obj/structure/table,
/obj/item/reagent_containers/food/condiment/saltshaker{
	pixel_x = -3;
	pixel_y = 9
	},
/obj/item/reagent_containers/food/condiment/peppermill{
	dir = 1;
	pixel_x = 3;
	pixel_y = 9
	},
/turf/open/floor/wood,
/area/shuttle/trader/bar)
"bB" = (
/obj/structure/closet/secure_closet/personal/cabinet,
/obj/machinery/button/curtain{
	id = "FTUbridgedorm2";
	pixel_x = 24
	},
/turf/open/floor/wood,
/area/shuttle/trader/bridge)
"bC" = (
/obj/machinery/door/airlock/freezer{
	req_access_txt = "402"
	},
/turf/open/floor/iron/freezer,
/area/shuttle/trader/bar)
"bD" = (
/turf/closed/wall/mineral/plastitanium/nodiagonal,
/area/shuttle/trader/bar)
"bE" = (
/turf/open/floor/glass/reinforced,
/area/shuttle/trader/cargo)
"bF" = (
/obj/effect/turf_decal/tile/brown{
	dir = 4
	},
/obj/effect/turf_decal/tile/brown,
/obj/effect/turf_decal/tile/yellow,
/obj/effect/turf_decal/trimline/brown/filled/line{
	dir = 8
	},
/obj/effect/turf_decal/trimline/yellow/warning{
	dir = 8
	},
/turf/open/floor/iron,
/area/shuttle/trader/cargo)
"bH" = (
/obj/effect/turf_decal/trimline/brown/filled/line{
	dir = 9
	},
/obj/effect/turf_decal/trimline/yellow/line{
	dir = 9
	},
/obj/machinery/light{
	dir = 1
	},
/turf/open/floor/iron/dark,
/area/shuttle/trader/crew)
"bI" = (
/obj/effect/turf_decal/trimline/brown/filled/line{
	dir = 5
	},
/obj/effect/turf_decal/trimline/yellow/line{
	dir = 5
	},
/turf/open/floor/iron/dark,
/area/shuttle/trader/crew)
"bL" = (
/obj/machinery/griddle,
/turf/open/floor/wood,
/area/shuttle/trader/bar)
"bM" = (
/obj/machinery/light{
	dir = 8
	},
/obj/effect/turf_decal/trimline/brown/filled/line{
	dir = 9
	},
/obj/effect/turf_decal/trimline/yellow/warning{
	dir = 9
	},
/obj/effect/turf_decal/trimline/yellow/line{
	dir = 9
	},
/turf/open/floor/iron/dark,
/area/shuttle/trader/engine)
"bN" = (
/obj/effect/turf_decal/tile/brown{
	dir = 8
	},
/obj/effect/turf_decal/tile/brown{
	dir = 1
	},
/obj/effect/turf_decal/tile/brown,
/obj/effect/turf_decal/tile/yellow,
/obj/effect/turf_decal/tile/yellow{
	dir = 1
	},
/obj/effect/turf_decal/trimline/brown/filled/corner{
	dir = 4
	},
/obj/effect/turf_decal/trimline/yellow/corner{
	dir = 4
	},
/obj/machinery/newscaster/directional/west,
/obj/machinery/light{
	dir = 8
	},
/turf/open/floor/iron,
/area/shuttle/trader/cargo)
"bQ" = (
/obj/effect/turf_decal/tile/brown{
	dir = 8
	},
/obj/effect/turf_decal/tile/brown,
/obj/effect/turf_decal/tile/yellow,
/obj/effect/turf_decal/trimline/brown/filled/line{
	dir = 1
	},
/obj/effect/turf_decal/trimline/yellow/warning{
	dir = 1
	},
/turf/open/floor/iron,
/area/shuttle/trader/cargo)
"bR" = (
/obj/effect/turf_decal/trimline/brown/filled/line{
	dir = 4
	},
/obj/effect/turf_decal/trimline/yellow/line{
	dir = 4
	},
/obj/effect/turf_decal/trimline/blue/warning{
	dir = 4
	},
/obj/machinery/light{
	dir = 4
	},
/turf/open/floor/iron/dark,
/area/shuttle/trader/bridge)
"bU" = (
/obj/structure/table,
/obj/machinery/microwave{
	pixel_x = -2;
	pixel_y = 8
	},
/turf/open/floor/wood,
/area/shuttle/trader/bar)
"bV" = (
/obj/structure/chair/sofa/corp/corner{
	dir = 1
	},
/turf/open/floor/wood,
/area/shuttle/trader/crew)
"bY" = (
/obj/machinery/light{
	dir = 4
	},
/turf/open/floor/wood,
/area/shuttle/trader/bar)
"bZ" = (
/obj/effect/turf_decal/trimline/brown/filled/line{
	dir = 5
	},
/obj/effect/turf_decal/trimline/yellow/warning{
	dir = 5
	},
/obj/effect/turf_decal/trimline/yellow/line{
	dir = 5
	},
/turf/open/floor/iron/dark,
/area/shuttle/trader/engine)
"ca" = (
/obj/machinery/door/airlock/mining{
	name = "Cargo Desk";
	req_access_txt = "401"
	},
/obj/effect/turf_decal/stripes{
	dir = 1
	},
/turf/open/floor/iron/dark,
/area/shuttle/trader/cargo)
"cb" = (
/turf/closed/wall/mineral/plastitanium,
/area/shuttle/trader/cargo)
"cd" = (
/obj/effect/spawner/structure/window/plasma/reinforced/plastitanium,
/turf/open/floor/plating,
/area/shuttle/trader/cargo)
"ch" = (
/obj/effect/turf_decal/trimline/brown/filled/line{
	dir = 4
	},
/obj/effect/turf_decal/trimline/yellow/warning{
	dir = 4
	},
/obj/effect/turf_decal/trimline/yellow/line{
	dir = 4
	},
/turf/open/floor/iron/dark,
/area/shuttle/trader/engine)
"ci" = (
/obj/machinery/door/airlock/engineering{
	name = "Engineering";
	req_access_txt = "402"
	},
/obj/effect/turf_decal/trimline/brown/filled/line{
	dir = 4
	},
/obj/effect/turf_decal/trimline/brown/filled/line{
	dir = 8
	},
/turf/open/floor/iron/dark,
/area/shuttle/trader/engine)
"cj" = (
/obj/effect/turf_decal/trimline/brown/filled/line{
	dir = 8
	},
/obj/effect/turf_decal/trimline/yellow/line{
	dir = 8
	},
/turf/open/floor/iron/dark,
/area/shuttle/trader/crew)
"ck" = (
/obj/effect/turf_decal/trimline/brown/filled/line{
	dir = 4
	},
/obj/effect/turf_decal/trimline/yellow/line{
	dir = 4
	},
/turf/open/floor/iron/dark,
/area/shuttle/trader/crew)
"cn" = (
/obj/machinery/chem_master/condimaster,
/turf/open/floor/wood,
/area/shuttle/trader/bar)
"cr" = (
/obj/structure/chair/office{
	dir = 1
	},
/turf/open/floor/iron/dark,
/area/shuttle/trader/cargo)
"cs" = (
/obj/structure/closet/crate/secure/tradership_cargo_valuable{
	used_preset = 3
	},
/obj/effect/turf_decal/stripes/line{
	dir = 8
	},
/obj/item/radio/intercom/directional/east,
/turf/open/floor/iron,
/area/shuttle/trader/cargo)
"cw" = (
/obj/effect/turf_decal/trimline/brown/filled/corner{
	dir = 4
	},
/obj/effect/turf_decal/trimline/yellow/corner{
	dir = 4
	},
/turf/open/floor/iron/dark,
/area/shuttle/trader/crew)
"cA" = (
/obj/machinery/firealarm/directional/south,
/obj/machinery/holopad,
/obj/machinery/light{
	dir = 8
	},
/turf/open/floor/iron/dark,
/area/shuttle/trader/cargo)
"cB" = (
/obj/effect/turf_decal/siding/wood{
	dir = 8
	},
/obj/structure/table/reinforced,
/turf/open/floor/wood,
/area/shuttle/trader/bridge)
"cD" = (
/obj/structure/closet/crate/secure/tradership_cargo_valuable{
	used_preset = 1
	},
/obj/effect/turf_decal/stripes/line{
	dir = 8
	},
/obj/machinery/light{
	dir = 4
	},
/turf/open/floor/iron,
/area/shuttle/trader/cargo)
"cH" = (
/obj/effect/turf_decal/trimline/brown/filled/line{
	dir = 10
	},
/obj/effect/turf_decal/trimline/yellow/line{
	dir = 10
	},
/obj/machinery/light,
/turf/open/floor/iron/dark,
/area/shuttle/trader/crew)
"cO" = (
/obj/machinery/door/airlock/mining{
	name = "Cargo Desk";
	req_access_txt = "401"
	},
/obj/effect/turf_decal/stripes/corner,
/obj/effect/turf_decal/stripes/corner{
	dir = 8
	},
/turf/open/floor/iron/dark,
/area/shuttle/trader/cargo)
"cR" = (
/obj/effect/turf_decal/trimline/brown/filled/line,
/obj/effect/turf_decal/trimline/yellow/line,
/turf/open/floor/iron/dark,
/area/shuttle/trader/crew)
"cS" = (
/obj/effect/turf_decal/trimline/brown/filled/corner{
	dir = 8
	},
/obj/effect/turf_decal/trimline/yellow/corner{
	dir = 8
	},
/turf/open/floor/iron/dark,
/area/shuttle/trader/crew)
"cT" = (
/obj/machinery/suit_storage_unit/standard_unit,
/obj/structure/window/reinforced/spawner/east,
/turf/open/floor/iron,
/area/shuttle/trader/cargo)
"cU" = (
/obj/machinery/suit_storage_unit/standard_unit,
/obj/machinery/light{
	dir = 4
	},
/turf/open/floor/iron,
/area/shuttle/trader/cargo)
"cW" = (
/obj/structure/closet/secure_closet/personal/cabinet,
/turf/open/floor/wood,
/area/shuttle/trader/bridge)
"cX" = (
/obj/structure/table,
/obj/machinery/chem_dispenser/drinks/beer/fullupgrade{
	dir = 8
	},
/turf/open/floor/wood,
/area/shuttle/trader/bar)
"cY" = (
/obj/machinery/grill,
/turf/open/floor/wood,
/area/shuttle/trader/bar)
"dd" = (
/obj/effect/turf_decal/siding/wood{
	dir = 1
	},
/turf/open/floor/wood,
/area/shuttle/trader/crew)
"de" = (
/obj/structure/kitchenspike,
/turf/open/floor/iron/freezer,
/area/shuttle/trader/bar)
"df" = (
/obj/effect/turf_decal/trimline/brown/filled/line{
	dir = 6
	},
/obj/effect/turf_decal/trimline/yellow/line{
	dir = 6
	},
/turf/open/floor/iron/dark,
/area/shuttle/trader/crew)
"di" = (
/obj/effect/turf_decal/stripes/corner{
	dir = 1
	},
/obj/effect/turf_decal/stripes/corner{
	dir = 4
	},
/turf/open/floor/iron/dark,
/area/shuttle/trader/cargo)
"dj" = (
/obj/effect/turf_decal/stripes/line{
	dir = 1
	},
/turf/open/floor/iron/dark,
/area/shuttle/trader/cargo)
"dk" = (
/obj/effect/turf_decal/stripes/corner{
	dir = 1
	},
/obj/machinery/door/airlock/command{
	name = "Bridge";
	req_access_txt = "403"
	},
/obj/effect/turf_decal/trimline/brown/filled/line{
	dir = 4
	},
/turf/open/floor/iron/dark,
/area/shuttle/trader/bridge)
"dn" = (
/obj/effect/turf_decal/siding/wood{
	dir = 8
	},
/obj/machinery/door/airlock/command{
	name = "Bridge Quarters";
	req_access_txt = "403"
	},
/turf/open/floor/wood,
/area/shuttle/trader/bridge)
"do" = (
/obj/effect/spawner/structure/window/plasma/reinforced/plastitanium,
/obj/structure/curtain/cloth/fancy/mechanical{
	icon_state = "bounty-open";
	icon_type = "bounty";
	id = "FTUbridgedorm1"
	},
/turf/open/floor/plating,
/area/shuttle/trader/bridge)
"dp" = (
/obj/machinery/processor,
/turf/open/floor/wood,
/area/shuttle/trader/bar)
"dt" = (
/turf/open/floor/wood,
/area/shuttle/trader/crew)
"dv" = (
/obj/structure/chair/sofa/corp/right{
	dir = 8
	},
/turf/open/floor/wood,
/area/shuttle/trader/crew)
"dx" = (
/obj/structure/tank_dispenser/oxygen,
/obj/effect/turf_decal/stripes/line{
	dir = 1
	},
/obj/machinery/light{
	dir = 8
	},
/turf/open/floor/iron,
/area/shuttle/trader/cargo)
"dy" = (
/obj/structure/window/reinforced/spawner/east,
/obj/structure/rack/shelf,
/obj/effect/turf_decal/stripes/line{
	dir = 1
	},
/turf/open/floor/iron,
/area/shuttle/trader/cargo)
"dz" = (
/turf/open/floor/iron/dark,
/area/shuttle/trader/cargo)
"dA" = (
/obj/structure/window/reinforced/spawner/west,
/obj/effect/turf_decal/stripes/line{
	dir = 1
	},
/obj/structure/closet/crate/secure/tradership_cargo_valuable{
	used_preset = 5
	},
/turf/open/floor/iron,
/area/shuttle/trader/cargo)
"dB" = (
/obj/structure/closet/crate/secure/tradership_cargo_valuable{
	used_preset = 2
	},
/obj/effect/turf_decal/stripes/line{
	dir = 1
	},
/turf/open/floor/iron,
/area/shuttle/trader/cargo)
"dE" = (
/obj/effect/turf_decal/trimline/brown/filled/line{
	dir = 4
	},
/obj/effect/turf_decal/trimline/yellow/line{
	dir = 4
	},
/obj/effect/turf_decal/trimline/blue/warning{
	dir = 4
	},
/turf/open/floor/iron/dark,
/area/shuttle/trader/bridge)
"dG" = (
/obj/structure/bed,
/obj/item/bedsheet/dorms,
/obj/machinery/button/curtain{
	id = "FTUbridgedorm1";
	pixel_x = 24
	},
/obj/machinery/light,
/turf/open/floor/wood,
/area/shuttle/trader/bridge)
"dH" = (
/obj/effect/turf_decal/tile/brown{
	dir = 4
	},
/obj/effect/turf_decal/tile/brown{
	dir = 8
	},
/obj/effect/turf_decal/tile/brown,
/obj/effect/turf_decal/tile/yellow,
/obj/item/kirbyplants/random,
/obj/effect/turf_decal/trimline/brown/filled/corner{
	dir = 1
	},
/obj/effect/turf_decal/trimline/yellow/corner{
	dir = 1
	},
/obj/machinery/light{
	dir = 4
	},
/turf/open/floor/iron,
/area/shuttle/trader/cargo)
"dJ" = (
/obj/structure/chair/office,
/turf/open/floor/wood,
/area/shuttle/trader/crew)
"dK" = (
/turf/open/floor/carpet/blue,
/area/shuttle/trader/crew)
"dM" = (
/obj/structure/closet/crate/secure/tradership_cargo_valuable{
	used_preset = 4
	},
/obj/effect/turf_decal/trimline/yellow/corner{
	dir = 4
	},
/turf/open/floor/iron,
/area/shuttle/trader/crew)
"dN" = (
/obj/structure/closet/crate/secure/tradership_cargo_very_valuable,
/obj/effect/turf_decal/trimline/yellow/corner{
	dir = 1
	},
/turf/open/floor/iron,
/area/shuttle/trader/crew)
"dP" = (
/obj/machinery/door/airlock/external{
	req_access_txt = "401"
	},
/obj/effect/mapping_helpers/airlock/cyclelink_helper,
/obj/effect/turf_decal/stripes{
	dir = 1
	},
/turf/open/floor/plating,
/area/shuttle/trader/cargo)
"dQ" = (
/turf/closed/wall/mineral/plastitanium/nodiagonal,
/area/shuttle/trader/cargo)
"dS" = (
/obj/effect/turf_decal/trimline/brown/filled/line{
	dir = 8
	},
/obj/effect/turf_decal/trimline/yellow/line{
	dir = 8
	},
/obj/effect/turf_decal/trimline/blue/warning{
	dir = 8
	},
/turf/open/floor/iron/dark,
/area/shuttle/trader/bridge)
"dT" = (
/obj/effect/turf_decal/trimline/brown/filled/line{
	dir = 4
	},
/obj/effect/turf_decal/trimline/yellow/line{
	dir = 4
	},
/obj/effect/turf_decal/trimline/blue/warning{
	dir = 4
	},
/obj/structure/table,
/obj/structure/window/reinforced/spawner/north,
/obj/structure/bedsheetbin,
/turf/open/floor/iron/dark,
/area/shuttle/trader/bridge)
"dW" = (
/obj/effect/spawner/structure/window/plasma/reinforced/plastitanium,
/turf/open/floor/plating,
/area/shuttle/trader/engine)
"dX" = (
/obj/structure/table/wood,
/turf/open/floor/wood,
/area/shuttle/trader/crew)
"ec" = (
/turf/open/floor/plating,
/area/shuttle/trader/cargo)
"ed" = (
/obj/structure/rack,
/obj/effect/spawner/lootdrop/maintenance,
/turf/open/floor/plating,
/area/shuttle/trader/bridge)
"ee" = (
/obj/machinery/door/airlock/maintenance_hatch{
	req_access_txt = "401"
	},
/obj/effect/turf_decal/stripes/line{
	dir = 4
	},
/turf/open/floor/plating,
/area/shuttle/trader/bridge)
"ef" = (
/obj/effect/turf_decal/trimline/brown/filled/line{
	dir = 6
	},
/obj/effect/turf_decal/trimline/yellow/line{
	dir = 6
	},
/obj/effect/turf_decal/trimline/blue/warning{
	dir = 6
	},
/obj/structure/table,
/obj/machinery/light,
/turf/open/floor/iron/dark,
/area/shuttle/trader/bridge)
"eh" = (
/obj/effect/turf_decal/trimline/brown/filled/line{
	dir = 8
	},
/obj/effect/turf_decal/trimline/yellow/warning{
	dir = 8
	},
/obj/effect/turf_decal/trimline/yellow/line{
	dir = 8
	},
/turf/open/floor/iron/dark,
/area/shuttle/trader/engine)
"ei" = (
/obj/machinery/door/firedoor,
/obj/structure/table/reinforced,
/obj/machinery/door/window{
	dir = 1
	},
/obj/machinery/door/window{
	req_access_txt = "401"
	},
/turf/open/floor/plating,
/area/shuttle/trader/cargo)
"ej" = (
/obj/machinery/door/airlock/external{
	req_access_txt = "401"
	},
/obj/effect/mapping_helpers/airlock/cyclelink_helper{
	dir = 1
	},
/obj/effect/turf_decal/stripes,
/turf/open/floor/plating,
/area/shuttle/trader/cargo)
"el" = (
/obj/structure/closet/secure_closet/personal/cabinet,
/turf/open/floor/wood,
/area/shuttle/trader/crew)
"em" = (
/obj/structure/chair/sofa/corp{
	dir = 1
	},
/turf/open/floor/wood,
/area/shuttle/trader/crew)
"gx" = (
/obj/machinery/light{
	dir = 8
	},
/obj/effect/turf_decal/trimline/brown/filled/line{
	dir = 10
	},
/obj/effect/turf_decal/trimline/yellow/warning{
	dir = 10
	},
/obj/effect/turf_decal/trimline/yellow/line{
	dir = 10
	},
/turf/open/floor/iron/dark,
/area/shuttle/trader/engine)
"ij" = (
/obj/effect/turf_decal/stripes/line{
	dir = 1
	},
/obj/effect/turf_decal/trimline/yellow/corner,
/turf/open/floor/iron,
/area/shuttle/trader/crew)
"ki" = (
/obj/effect/turf_decal/trimline/brown/filled/line,
/obj/effect/turf_decal/trimline/yellow/line,
/obj/machinery/light,
/turf/open/floor/iron/dark,
/area/shuttle/trader/crew)
"kO" = (
/obj/effect/turf_decal/trimline/brown/filled/line{
	dir = 1
	},
/obj/effect/turf_decal/trimline/yellow/line{
	dir = 1
	},
/turf/open/floor/iron/dark,
/area/shuttle/trader/crew)
"ld" = (
/obj/effect/turf_decal/stripes/line{
	dir = 1
	},
/obj/structure/table/reinforced,
/obj/item/storage/toolbox/electrical{
	pixel_y = 5
	},
/obj/item/storage/toolbox/mechanical{
	pixel_x = -2;
	pixel_y = -1
	},
/turf/open/floor/plating,
/area/shuttle/trader/engine)
"lH" = (
/obj/structure/bed,
/obj/item/bedsheet/dorms,
/turf/open/floor/carpet/blue,
/area/shuttle/trader/crew)
"mT" = (
/obj/structure/table/wood,
/turf/open/floor/carpet/blue,
/area/shuttle/trader/crew)
"nT" = (
/obj/effect/turf_decal/siding/wood,
/obj/structure/table/reinforced,
/turf/open/floor/wood,
/area/shuttle/trader/bar)
"qz" = (
/obj/machinery/computer/shuttle/trader{
	dir = 8
	},
/turf/open/floor/wood,
/area/shuttle/trader/bridge)
"qY" = (
/turf/closed/wall/mineral/plastitanium/nodiagonal,
/area/shuttle/trader/bridge)
"us" = (
/obj/machinery/suit_storage_unit/standard_unit,
/obj/structure/window/reinforced/spawner/west,
/turf/open/floor/iron,
/area/shuttle/trader/cargo)
"wM" = (
/turf/open/floor/iron/dark,
/area/shuttle/trader/crew)
"wY" = (
/obj/machinery/computer/camera_advanced/shuttle_docker/trader{
	dir = 8
	},
/turf/open/floor/wood,
/area/shuttle/trader/bridge)
"zJ" = (
/turf/closed/wall/mineral/plastitanium/nodiagonal,
/area/shuttle/trader/crew)
"As" = (
/obj/machinery/light{
	dir = 4
	},
/turf/open/floor/carpet/blue,
/area/shuttle/trader/crew)
"AX" = (
/obj/effect/turf_decal/siding/wood{
	dir = 8
	},
/obj/structure/table/reinforced,
/obj/item/storage/box/faction_access_cards{
	pixel_x = 4;
	pixel_y = 11
	},
/obj/item/encryptionkey/headset_faction{
	pixel_x = -5;
	pixel_y = 8
	},
/obj/item/encryptionkey/headset_faction{
	pixel_x = -3;
	pixel_y = 3
	},
/obj/item/encryptionkey/headset_faction{
	pixel_x = 7;
	pixel_y = 1
	},
/turf/open/floor/wood,
/area/shuttle/trader/bridge)
"DE" = (
/obj/structure/chair/comfy/shuttle{
	dir = 4;
	name = "captains chair"
	},
/obj/effect/turf_decal/siding/wood{
	dir = 8
	},
/turf/open/floor/wood,
/area/shuttle/trader/bridge)
"Fb" = (
/turf/open/floor/wood,
/area/shuttle/trader/bar)
"FW" = (
/obj/machinery/suit_storage_unit/standard_unit,
/turf/open/floor/iron,
/area/shuttle/trader/cargo)
"Gb" = (
/obj/effect/turf_decal/trimline/brown/filled/line{
	dir = 10
	},
/obj/effect/turf_decal/trimline/yellow/line{
	dir = 10
	},
/turf/open/floor/iron/dark,
/area/shuttle/trader/crew)
"Ls" = (
/obj/effect/turf_decal/stripes/line{
	dir = 1
	},
/obj/structure/closet/crate/tradership_cargo,
/obj/effect/turf_decal/trimline/yellow/corner{
	dir = 8
	},
/turf/open/floor/iron,
/area/shuttle/trader/crew)
"Lx" = (
/obj/effect/turf_decal/stripes/line{
	dir = 1
	},
/obj/structure/table/reinforced,
/obj/item/clothing/gloves/color/yellow,
/obj/item/multitool,
/turf/open/floor/plating,
/area/shuttle/trader/engine)
"LK" = (
/obj/effect/turf_decal/siding/wood,
/obj/structure/table/reinforced,
/obj/item/storage/box/drinkingglasses{
	pixel_x = -4;
	pixel_y = 11
	},
/obj/item/storage/box/condimentbottles{
	pixel_y = 8
	},
/obj/item/storage/box/beakers{
	pixel_x = 5;
	pixel_y = 3
	},
/obj/machinery/light{
	dir = 8
	},
/turf/open/floor/wood,
/area/shuttle/trader/bar)
"MM" = (
/obj/effect/turf_decal/stripes/corner{
	dir = 4
	},
/obj/machinery/door/airlock{
	name = "Crew Quarters"
	},
/obj/effect/turf_decal/trimline/brown/filled/line{
	dir = 8
	},
/turf/open/floor/iron/dark,
/area/shuttle/trader/cargo)
"QA" = (
/obj/structure/chair/sofa/corp/left{
	dir = 4
	},
/turf/open/floor/wood,
/area/shuttle/trader/crew)
"QH" = (
/obj/effect/turf_decal/trimline/brown/filled/line{
	dir = 6
	},
/obj/effect/turf_decal/trimline/yellow/warning{
	dir = 6
	},
/obj/effect/turf_decal/trimline/yellow/line{
	dir = 6
	},
/turf/open/floor/iron/dark,
/area/shuttle/trader/engine)
"QS" = (
/obj/effect/turf_decal/trimline/brown/filled/line{
	dir = 10
	},
/obj/effect/turf_decal/trimline/yellow/line{
	dir = 10
	},
/obj/effect/turf_decal/trimline/blue/warning{
	dir = 10
	},
/turf/open/floor/iron/dark,
/area/shuttle/trader/bridge)
"Rh" = (
/obj/effect/turf_decal/siding/wood{
	dir = 1
	},
/obj/machinery/door/airlock{
	name = "Quarters"
	},
/turf/open/floor/wood,
/area/shuttle/trader/crew)
"RH" = (
/obj/effect/turf_decal/siding/wood,
/obj/structure/table/reinforced,
/obj/item/storage/bag/tray,
/turf/open/floor/wood,
/area/shuttle/trader/bar)
"RO" = (
/obj/machinery/computer/crew{
	dir = 8
	},
/turf/open/floor/wood,
/area/shuttle/trader/bridge)
"UG" = (
/obj/effect/turf_decal/siding/wood,
/obj/machinery/door/window/southright{
	req_access_txt = "402"
	},
/turf/open/floor/wood,
/area/shuttle/trader/bar)
"UW" = (
/obj/structure/table/glass,
/turf/open/floor/wood,
/area/shuttle/trader/crew)
"Yi" = (
/obj/effect/turf_decal/stripes/line{
	dir = 8
	},
/obj/effect/turf_decal/stripes/line{
	dir = 4
	},
/turf/open/floor/iron/dark,
/area/shuttle/trader/cargo)
"ZF" = (
/obj/structure/chair/sofa/corp/corner{
	dir = 8
	},
/turf/open/floor/wood,
/area/shuttle/trader/crew)
"ZV" = (
/obj/effect/spawner/structure/window/plasma/reinforced/plastitanium,
/turf/open/floor/plating,
/area/shuttle/trader/bridge)

(1,1,1) = {"
aa
ac
ax
aL
ac
ac
ac
dW
dW
dW
ac
ac
ac
ax
aL
ac
aa
"}
(2,1,1) = {"
aa
ac
ay
ay
ac
bh
bM
eh
eh
eh
gx
Lx
ac
ay
ay
ac
aa
"}
(3,1,1) = {"
zJ
ac
ac
ac
ac
bn
bZ
ch
ch
ch
QH
ld
ac
ac
ac
ac
zJ
"}
(4,1,1) = {"
zJ
dX
dX
el
ac
ac
ac
ac
ci
ac
ac
ac
ac
el
dX
dX
zJ
"}
(5,1,1) = {"
zJ
dX
aB
dt
dt
zJ
bH
cj
cj
cj
cH
zJ
dt
dt
dJ
dX
zJ
"}
(6,1,1) = {"
zJ
am
aC
dt
dt
by
bI
ck
ck
cw
cR
Rh
dt
dt
dK
mT
zJ
"}
(7,1,1) = {"
zJ
af
aq
dt
aU
zJ
zJ
zJ
zJ
kO
cR
zJ
aU
dt
As
lH
zJ
"}
(8,1,1) = {"
zJ
zJ
zJ
zJ
zJ
zJ
cn
bU
bD
kO
cR
zJ
zJ
zJ
zJ
zJ
zJ
"}
(9,1,1) = {"
aa
ap
aE
Fb
Fb
Fb
Fb
Fb
LK
kO
cS
Gb
dd
QA
bV
zJ
aa
"}
(10,1,1) = {"
aa
ap
ar
Fb
bo
bA
cX
Fb
RH
kO
wM
cR
dd
UW
em
zJ
aa
"}
(11,1,1) = {"
aa
bD
bD
bD
bD
bD
bL
Fb
nT
kO
wM
cR
dd
dv
ZF
zJ
aa
"}
(12,1,1) = {"
aa
bD
as
az
de
bD
cY
Fb
nT
kO
wM
ki
zJ
zJ
zJ
zJ
aa
"}
(13,1,1) = {"
aa
bD
aF
az
az
bC
Fb
Fb
nT
kO
wM
cS
Gb
ij
dM
zJ
aa
"}
(14,1,1) = {"
aa
bD
aG
aM
bp
bD
dp
bY
UG
bI
ck
ck
df
Ls
dN
zJ
aa
"}
(15,1,1) = {"
aa
bD
bD
bD
bD
bD
bD
bD
bD
dQ
dQ
dQ
MM
dQ
dQ
zJ
aa
"}
(16,1,1) = {"
aa
aa
dQ
aW
bq
bq
bN
ca
dz
cA
dQ
FW
dj
dx
dQ
aa
aa
"}
(17,1,1) = {"
dQ
dQ
dQ
aZ
bE
bE
bQ
cb
dz
dz
dQ
cT
dj
dy
dQ
dQ
dQ
"}
(18,1,1) = {"
ah
ec
aI
aZ
bE
bE
bQ
cd
dz
dz
cO
Yi
di
dz
dP
ec
ej
"}
(19,1,1) = {"
dQ
dQ
dQ
aZ
bE
bE
bQ
ei
cr
dz
dQ
us
dj
dA
dQ
dQ
dQ
"}
(20,1,1) = {"
qY
au
dQ
ba
aV
bF
dH
cd
cs
cD
dQ
cU
dj
dB
dQ
ed
qY
"}
(21,1,1) = {"
qY
ee
dQ
dQ
dQ
dQ
dQ
dQ
dQ
dQ
dQ
qY
dk
qY
qY
ee
qY
"}
(22,1,1) = {"
qY
ak
dS
dS
dS
dS
dS
dS
dS
dS
dS
dS
dS
dS
dS
QS
qY
"}
(23,1,1) = {"
qY
aw
aK
dE
dE
dE
bR
dE
dE
dE
bR
dE
dE
dE
dT
ef
qY
"}
(24,1,1) = {"
ae
qY
qY
qY
dn
qY
qY
AX
DE
cB
qY
qY
dn
qY
qY
qY
ae
"}
(25,1,1) = {"
aa
ae
qY
bf
bg
bB
qY
wY
qz
RO
qY
cW
bg
dG
qY
ae
aa
"}
(26,1,1) = {"
aa
aa
ae
qY
bx
qY
qY
ZV
ZV
ZV
qY
qY
do
qY
ae
aa
aa
"}
