//MAP CONVERTED BY dmm2tgm.py THIS HEADER COMMENT PREVENTS RECONVERSION, DO NOT REMOVE
"ar" = (
/obj/structure/table/wood/poker,
/obj/item/storage/fancy/donut_box{
	pixel_y = 5
	},
/turf/open/floor/carpet,
/area/misc/hilbertshotel)
"aC" = (
/obj/structure/sign/painting/library,
/turf/closed/indestructible/steel,
/area/misc/hilbertshotel)
"aS" = (
/obj/structure/foamedmetal,
/turf/open/floor/iron/kitchen,
/area/misc/hilbertshotel)
"bw" = (
/obj/machinery/light_switch/directional/north,
/obj/effect/turf_decal/siding/wideplating_new/light{
	dir = 8
	},
/obj/structure/table/reinforced,
/obj/machinery/microwave{
	pixel_x = -2;
	pixel_y = 6
	},
/turf/open/floor/mineral/titanium/tiled/white,
/area/misc/hilbertshotel)
"bz" = (
/obj/effect/turf_decal/siding/wood/corner,
/obj/structure/table/wood,
/obj/item/pizzabox/margherita{
	pixel_y = 11
	},
/turf/open/floor/wood/parquet,
/area/misc/hilbertshotel)
"cy" = (
/obj/machinery/light_switch/directional/north{
	pixel_x = 18
	},
/obj/structure/showcase{
	name = "doorphone";
	icon = 'modular_skyrat/modules/aesthetics/intercom/icons/intercom.dmi';
	icon_state = "intercom";
	pixel_y = 24;
	density = 0
	},
/turf/open/floor/carpet/lone,
/area/misc/hilbertshotel)
"cz" = (
/obj/effect/turf_decal/siding/wood{
	dir = 4
	},
/turf/open/floor/wood/tile,
/area/misc/hilbertshotel)
"cD" = (
/obj/effect/turf_decal/siding/wood{
	dir = 1
	},
/obj/structure/sign/painting/large/library{
	dir = 1
	},
/turf/open/floor/wood/tile,
/area/misc/hilbertshotel)
"dw" = (
/obj/item/kitchen/spoon,
/obj/item/kitchen/spoon,
/obj/item/kitchen/spoon,
/obj/item/kitchen/spoon,
/obj/item/kitchen/fork,
/obj/item/kitchen/fork,
/obj/item/kitchen/fork,
/obj/item/kitchen/fork,
/obj/effect/spawner/random/food_or_drink/three_course_meal,
/obj/effect/spawner/random/food_or_drink/three_course_meal,
/obj/effect/spawner/random/food_or_drink/three_course_meal,
/obj/effect/spawner/random/food_or_drink/three_course_meal,
/obj/effect/spawner/random/food_or_drink/three_course_meal,
/obj/effect/spawner/random/food_or_drink/three_course_meal,
/obj/effect/spawner/random/food_or_drink/three_course_meal,
/obj/item/plate,
/obj/item/plate,
/obj/item/plate,
/obj/item/plate,
/obj/item/storage/cans/sixbeer,
/obj/item/reagent_containers/cup/glass/drinkingglass,
/obj/item/reagent_containers/cup/glass/drinkingglass,
/obj/item/reagent_containers/cup/glass/drinkingglass,
/obj/item/reagent_containers/cup/glass/drinkingglass,
/obj/item/storage/fancy/pickles_jar,
/obj/structure/closet/secure_closet/freezer/kitchen/mining{
	storage_capacity = 60
	},
/obj/effect/spawner/random/food_or_drink/donkpockets,
/turf/open/floor/iron/kitchen,
/area/misc/hilbertshotel)
"dS" = (
/obj/effect/turf_decal/siding/wood{
	dir = 8
	},
/obj/structure/aquarium/prefilled,
/turf/open/floor/wood/tile,
/area/misc/hilbertshotel)
"dT" = (
/obj/structure/chair/stool/bar/directional/west,
/turf/open/floor/wood/tile,
/area/misc/hilbertshotel)
"eO" = (
/obj/structure/bookcase/random,
/obj/effect/turf_decal/siding/wood{
	dir = 1
	},
/turf/open/floor/wood/parquet,
/area/misc/hilbertshotel)
"fa" = (
/obj/structure/railing{
	dir = 8
	},
/obj/structure/sign/poster/random/directional/north,
/obj/effect/spawner/liquids_spawner,
/turf/open/floor/iron/pool/cobble/corner{
	dir = 1
	},
/area/misc/hilbertshotel)
"fi" = (
/obj/structure/chair,
/obj/structure/extinguisher_cabinet/directional/north,
/turf/open/floor/iron/kitchen,
/area/misc/hilbertshotel)
"gQ" = (
/obj/structure/chair/sofa/corp/corner,
/obj/machinery/light/warm/directional/east,
/turf/open/floor/carpet,
/area/misc/hilbertshotel)
"ho" = (
/obj/effect/spawner/liquids_spawner,
/turf/open/floor/iron/pool/cobble/corner{
	dir = 4
	},
/area/misc/hilbertshotel)
"ik" = (
/obj/structure/closet/secure_closet/wall{
	pixel_y = -32
	},
/obj/effect/turf_decal/tile/neutral/diagonal_edge,
/obj/structure/sink/directional/east,
/obj/structure/mirror/directional/west,
/obj/effect/turf_decal/siding/white{
	dir = 4
	},
/turf/open/floor/iron/freezer,
/area/misc/hilbertshotel)
"iL" = (
/obj/effect/turf_decal/siding/wood,
/turf/open/floor/wood/tile,
/area/misc/hilbertshotel)
"jr" = (
/obj/machinery/light_switch/directional/south,
/turf/open/floor/carpet/donk,
/area/misc/hilbertshotel)
"jx" = (
/obj/structure/chair/office{
	dir = 4
	},
/obj/effect/turf_decal/siding/wood{
	dir = 10
	},
/turf/open/floor/wood/parquet,
/area/misc/hilbertshotel)
"jT" = (
/obj/item/kirbyplants/random,
/turf/open/floor/iron/kitchen,
/area/misc/hilbertshotel)
"kh" = (
/obj/structure/mirror/directional/north,
/obj/effect/turf_decal/siding/wood{
	dir = 1
	},
/turf/open/floor/wood/large,
/area/misc/hilbertshotel)
"kD" = (
/obj/effect/turf_decal/siding/wood/corner,
/turf/open/floor/wood/tile,
/area/misc/hilbertshotel)
"kS" = (
/obj/structure/table/wood/poker,
/obj/item/toy/cards/deck,
/turf/open/floor/carpet,
/area/misc/hilbertshotel)
"kW" = (
/obj/structure/flora/bush/grassy/style_random,
/obj/structure/flora/bush/flowers_br/style_3,
/obj/structure/window{
	dir = 8
	},
/turf/open/floor/grass,
/area/misc/hilbertshotel)
"lU" = (
/turf/open/floor/carpet/royalblue,
/area/misc/hilbertshotel)
"md" = (
/obj/structure/table/wood,
/obj/item/flashlight/lamp/green{
	pixel_x = 5;
	pixel_y = 14
	},
/obj/structure/sign/poster/random/directional/east,
/obj/effect/turf_decal/siding/wood{
	dir = 5
	},
/turf/open/floor/wood/parquet,
/area/misc/hilbertshotel)
"oZ" = (
/turf/closed/indestructible/steel,
/area/misc/hilbertshotel)
"pm" = (
/obj/structure/table/wood,
/obj/item/serviette_pack,
/obj/effect/turf_decal/siding/wood{
	dir = 9
	},
/turf/open/floor/wood/parquet,
/area/misc/hilbertshotel)
"pD" = (
/obj/machinery/light/warm/directional/north,
/turf/open/floor/carpet/royalblue,
/area/misc/hilbertshotel)
"st" = (
/obj/machinery/door/morgue,
/turf/open/floor/wood/parquet,
/area/misc/hilbertshotel)
"tZ" = (
/obj/structure/sink/kitchen/directional/west,
/turf/open/floor/iron/kitchen,
/area/misc/hilbertshotel)
"uX" = (
/obj/structure/chair/sofa/corp/left{
	dir = 8
	},
/turf/open/floor/carpet,
/area/misc/hilbertshotel)
"wb" = (
/obj/structure/closet/cabinet,
/obj/effect/turf_decal/siding/wood{
	dir = 10
	},
/turf/open/floor/wood/parquet,
/area/misc/hilbertshotel)
"wl" = (
/obj/structure/curtain/cloth,
/turf/open/floor/iron/kitchen,
/area/misc/hilbertshotel)
"wu" = (
/turf/open/floor/wood/tile,
/area/misc/hilbertshotel)
"wS" = (
/obj/structure/closet/cabinet,
/obj/machinery/light/dim/directional/north,
/obj/effect/turf_decal/siding/wood{
	dir = 1
	},
/turf/open/floor/wood/parquet,
/area/misc/hilbertshotel)
"xT" = (
/turf/closed/wall,
/area/misc/hilbertshotel)
"zA" = (
/obj/machinery/computer/security/telescreen/entertainment/directional/east,
/obj/effect/turf_decal/siding/wood{
	dir = 6
	},
/obj/machinery/jukebox{
	req_access = null
	},
/turf/open/floor/wood/parquet,
/area/misc/hilbertshotel)
"zY" = (
/obj/item/kirbyplants/random,
/obj/effect/turf_decal/siding/wood,
/turf/open/floor/wood/large,
/area/misc/hilbertshotel)
"Ae" = (
/obj/machinery/door/morgue,
/turf/open/floor/iron/freezer,
/area/misc/hilbertshotel)
"AE" = (
/obj/item/kirbyplants/random,
/obj/effect/turf_decal/siding/wood{
	dir = 9
	},
/turf/open/floor/wood/tile,
/area/misc/hilbertshotel)
"BR" = (
/obj/structure/chair/comfy/brown{
	dir = 4
	},
/turf/open/floor/carpet,
/area/misc/hilbertshotel)
"Dc" = (
/obj/item/kirbyplants/random,
/obj/structure/sign/poster/random/directional/north,
/turf/open/floor/iron/kitchen,
/area/misc/hilbertshotel)
"DR" = (
/obj/effect/turf_decal/siding/wood/corner{
	dir = 8
	},
/obj/effect/turf_decal/siding/wood/corner{
	dir = 1
	},
/turf/open/floor/wood/tile,
/area/misc/hilbertshotel)
"DX" = (
/obj/machinery/computer{
	dir = 8
	},
/turf/open/floor/carpet/donk,
/area/misc/hilbertshotel)
"Ea" = (
/obj/structure/chair/stool/bar/directional/north,
/turf/open/floor/wood/tile,
/area/misc/hilbertshotel)
"EX" = (
/obj/structure/table,
/obj/item/food/vendor_tray_meal/ramen,
/obj/machinery/computer/security/telescreen/entertainment/directional/west,
/turf/open/floor/iron/kitchen,
/area/misc/hilbertshotel)
"Fl" = (
/obj/structure/table,
/obj/effect/spawner/random/food_or_drink/three_course_meal,
/turf/open/floor/iron/kitchen,
/area/misc/hilbertshotel)
"FN" = (
/turf/open/space/bluespace,
/area/misc/hilbertshotel)
"Gv" = (
/obj/structure/chair/sofa/corp/right,
/obj/structure/sign/poster/random/directional/north,
/turf/open/floor/carpet,
/area/misc/hilbertshotel)
"HO" = (
/obj/structure/railing/corner{
	dir = 1
	},
/obj/effect/spawner/liquids_spawner,
/obj/machinery/light/dim/directional/south,
/turf/open/floor/iron/pool/cobble/corner{
	dir = 8
	},
/area/misc/hilbertshotel)
"Ib" = (
/obj/item/toy/plush/skyrat/breakdancing_bird,
/turf/open/floor/carpet,
/area/misc/hilbertshotel)
"Ix" = (
/obj/structure/bed/double,
/obj/item/bedsheet/random/double,
/obj/effect/turf_decal/siding/wood{
	dir = 4
	},
/turf/open/floor/wood/parquet,
/area/misc/hilbertshotel)
"Je" = (
/obj/structure/dresser,
/obj/machinery/computer/security/telescreen/entertainment/directional/north,
/obj/effect/turf_decal/siding/wood{
	dir = 1
	},
/turf/open/floor/wood/parquet,
/area/misc/hilbertshotel)
"JW" = (
/obj/item/kirbyplants/random,
/obj/effect/turf_decal/siding/wood/corner,
/obj/effect/turf_decal/siding/wood{
	dir = 10
	},
/turf/open/floor/wood/tile,
/area/misc/hilbertshotel)
"LC" = (
/obj/effect/turf_decal/siding/wood{
	dir = 1
	},
/obj/structure/closet/mini_fridge{
	density = 0;
	pixel_y = 8
	},
/obj/item/storage/cans/sixbeer,
/turf/open/floor/wood/tile,
/area/misc/hilbertshotel)
"Mj" = (
/turf/open/floor/carpet/donk,
/area/misc/hilbertshotel)
"Mk" = (
/obj/machinery/light_switch/directional/north,
/obj/structure/curtain,
/obj/machinery/shower/directional/east{
	pixel_x = -10
	},
/obj/item/soap/deluxe,
/turf/open/floor/iron/freezer,
/area/misc/hilbertshotel)
"Mp" = (
/obj/structure/bed/dogbed,
/obj/effect/turf_decal/siding/wood{
	dir = 6
	},
/turf/open/floor/wood/parquet,
/area/misc/hilbertshotel)
"MO" = (
/obj/structure/chair{
	dir = 8
	},
/turf/open/floor/iron/kitchen,
/area/misc/hilbertshotel)
"Oh" = (
/obj/structure/sign/poster/random/directional/south,
/obj/machinery/vending/wallmed/directional/west,
/obj/structure/table,
/obj/structure/bedsheetbin,
/turf/open/floor/iron/freezer,
/area/misc/hilbertshotel)
"Py" = (
/obj/structure/table/reinforced,
/obj/machinery/light/cold/directional/east,
/obj/effect/turf_decal/siding/wideplating_new/light{
	dir = 10
	},
/obj/item/kitchen/rollingpin{
	pixel_x = -3
	},
/obj/item/knife/kitchen,
/turf/open/floor/mineral/titanium/tiled/white,
/area/misc/hilbertshotel)
"PK" = (
/obj/structure/sign/poster/random/directional/south,
/turf/open/floor/iron/kitchen,
/area/misc/hilbertshotel)
"QJ" = (
/obj/structure/table/wood/poker,
/obj/structure/noticeboard{
	dir = 4;
	pixel_x = -64;
	pixel_y = -32
	},
/turf/open/floor/carpet,
/area/misc/hilbertshotel)
"Rr" = (
/obj/structure/chair{
	dir = 1
	},
/turf/open/floor/iron/kitchen,
/area/misc/hilbertshotel)
"RF" = (
/obj/effect/spawner/liquids_spawner,
/turf/open/floor/iron/pool/cobble/corner,
/area/misc/hilbertshotel)
"RM" = (
/obj/structure/flora/bush/large/style_random,
/obj/structure/flora/bush/lavendergrass/style_random,
/obj/structure/window{
	dir = 8
	},
/obj/structure/window{
	dir = 1
	},
/turf/open/floor/grass,
/area/misc/hilbertshotel)
"RP" = (
/turf/open/floor/carpet,
/area/misc/hilbertshotel)
"SS" = (
/turf/closed/indestructible/hoteldoor{
	icon_state = "door_closed";
	icon = 'icons/obj/doors/puzzledoor/default.dmi'
	},
/area/misc/hilbertshotel)
"SV" = (
/obj/structure/chair{
	dir = 1
	},
/obj/machinery/light/cold/directional/west,
/turf/open/floor/iron/kitchen,
/area/misc/hilbertshotel)
"Tj" = (
/obj/machinery/light/warm/directional/west,
/obj/effect/turf_decal/siding/wood{
	dir = 8
	},
/turf/open/floor/wood/tile,
/area/misc/hilbertshotel)
"Tu" = (
/obj/structure/toilet{
	dir = 8
	},
/obj/machinery/light/small/directional/east,
/turf/open/floor/iron/freezer,
/area/misc/hilbertshotel)
"Ul" = (
/obj/structure/curtain,
/turf/open/floor/iron/freezer,
/area/misc/hilbertshotel)
"UQ" = (
/obj/structure/chair/stool/bar/directional/south,
/obj/structure/sign/poster/random/directional/north,
/obj/effect/turf_decal/siding/wood{
	dir = 1
	},
/turf/open/floor/wood/tile,
/area/misc/hilbertshotel)
"UU" = (
/obj/effect/turf_decal/siding/wood{
	dir = 8
	},
/obj/structure/decorative/shelf,
/obj/machinery/light_switch/directional/west,
/turf/open/floor/wood/tile,
/area/misc/hilbertshotel)
"Wh" = (
/turf/open/floor/iron/freezer,
/area/misc/hilbertshotel)
"Wt" = (
/obj/structure/closet/secure_closet/wall{
	pixel_y = 32
	},
/obj/effect/turf_decal/tile/neutral/diagonal_edge,
/obj/effect/turf_decal/siding/white{
	dir = 4
	},
/turf/open/floor/iron/freezer,
/area/misc/hilbertshotel)
"WI" = (
/turf/open/floor/iron/kitchen,
/area/misc/hilbertshotel)
"WN" = (
/obj/structure/sign/painting/library,
/turf/closed/wall,
/area/misc/hilbertshotel)
"WX" = (
/obj/effect/turf_decal/siding/wood{
	dir = 8
	},
/turf/open/floor/wood/parquet,
/area/misc/hilbertshotel)
"YW" = (
/obj/effect/turf_decal/siding/wood{
	dir = 4
	},
/obj/effect/turf_decal/siding/wood/corner{
	dir = 8
	},
/turf/open/floor/wood/tile,
/area/misc/hilbertshotel)
"Zq" = (
/obj/effect/turf_decal/siding/wideplating_new/light{
	dir = 9
	},
/obj/structure/closet/crate/bin,
/turf/open/floor/mineral/titanium/tiled/white,
/area/misc/hilbertshotel)

(1,1,1) = {"
FN
FN
FN
FN
FN
FN
FN
FN
FN
FN
FN
FN
FN
FN
FN
"}
(2,1,1) = {"
FN
oZ
oZ
aC
oZ
oZ
SS
oZ
oZ
oZ
oZ
oZ
oZ
oZ
FN
"}
(3,1,1) = {"
FN
oZ
pm
WX
jx
xT
cy
wb
xT
Dc
EX
SV
jT
oZ
FN
"}
(4,1,1) = {"
FN
oZ
eO
Mj
DX
xT
kh
zY
xT
fi
Fl
Rr
PK
oZ
FN
"}
(5,1,1) = {"
FN
oZ
wS
Mj
Mj
st
lU
lU
wl
WI
MO
WI
WI
oZ
FN
"}
(6,1,1) = {"
FN
oZ
Je
Mj
jr
xT
pD
lU
wl
WI
WI
WI
dw
oZ
FN
"}
(7,1,1) = {"
FN
oZ
md
Ix
Mp
xT
lU
lU
xT
bw
Py
tZ
Zq
oZ
FN
"}
(8,1,1) = {"
FN
oZ
xT
xT
xT
xT
st
xT
xT
xT
xT
xT
xT
oZ
FN
"}
(9,1,1) = {"
FN
oZ
AE
ar
BR
Tj
DR
UU
dS
JW
xT
Mk
Oh
oZ
FN
"}
(10,1,1) = {"
FN
oZ
UQ
QJ
kS
Ea
kD
cz
cz
YW
Ae
Wh
Tu
oZ
FN
"}
(11,1,1) = {"
FN
oZ
cD
dT
dT
wu
iL
xT
xT
xT
xT
Ul
xT
oZ
FN
"}
(12,1,1) = {"
FN
oZ
LC
wu
wu
RP
RP
WN
aS
aS
xT
Wt
ik
oZ
FN
"}
(13,1,1) = {"
FN
oZ
Gv
RP
bz
Ib
RP
xT
aS
aS
xT
fa
HO
oZ
FN
"}
(14,1,1) = {"
FN
oZ
gQ
uX
zA
RM
kW
xT
aS
aS
xT
RF
ho
oZ
FN
"}
(15,1,1) = {"
FN
oZ
oZ
aC
oZ
oZ
oZ
oZ
oZ
oZ
oZ
oZ
oZ
oZ
FN
"}
(16,1,1) = {"
FN
FN
FN
FN
FN
FN
FN
FN
FN
FN
FN
FN
FN
FN
FN
"}
