//MAP CONVERTED BY dmm2tgm.py THIS HEADER COMMENT PREVENTS RECONVERSION, DO NOT REMOVE
"ar" = (
/obj/structure/table/wood/poker,
/obj/item/storage/fancy/donut_box{
	pixel_y = 5
	},
/obj/effect/turf_decal/siding/wood{
	dir = 8
	},
/turf/open/floor/carpet,
/area/misc/hilbertshotel)
"aC" = (
/obj/structure/sign/painting/library,
/turf/closed/indestructible/steel,
/area/misc/hilbertshotel)
"aS" = (
/obj/structure/closet/secure_closet/wall{
	pixel_y = 32
	},
/obj/effect/turf_decal/tile/neutral/diagonal_centre,
/turf/open/floor/iron/freezer,
/area/misc/hilbertshotel)
"bw" = (
/obj/machinery/light_switch/directional/north,
/obj/effect/turf_decal/siding/wideplating_new/light{
	dir = 8
	},
/obj/structure/table/reinforced,
/obj/machinery/microwave{
	pixel_x = -2;
	pixel_y = 6
	},
/turf/open/floor/mineral/titanium/tiled/white,
/area/misc/hilbertshotel)
"bz" = (
/obj/structure/aquarium/prefilled,
/obj/effect/turf_decal/siding/wood/corner,
/turf/open/floor/wood/parquet,
/area/misc/hilbertshotel)
"cy" = (
/obj/machinery/light_switch/directional/north{
	pixel_x = 18
	},
/obj/structure/showcase{
	name = "doorphone";
	icon = 'modular_skyrat/modules/aesthetics/intercom/icons/intercom.dmi';
	icon_state = "intercom";
	pixel_y = 24;
	density = 0
	},
/obj/effect/turf_decal/siding/wood{
	dir = 1
	},
/obj/effect/turf_decal/siding/wood/corner{
	dir = 8
	},
/turf/open/floor/carpet/lone,
/area/misc/hilbertshotel)
"cz" = (
/obj/effect/turf_decal/siding/wood{
	dir = 4
	},
/turf/open/floor/wood/tile,
/area/misc/hilbertshotel)
"cD" = (
/obj/structure/sign/painting/large/library{
	pixel_y = 32
	},
/obj/effect/turf_decal/siding/wood{
	dir = 1
	},
/turf/open/floor/wood/tile,
/area/misc/hilbertshotel)
"dw" = (
/obj/item/kitchen/spoon,
/obj/item/kitchen/spoon,
/obj/item/kitchen/spoon,
/obj/item/kitchen/spoon,
/obj/item/kitchen/fork,
/obj/item/kitchen/fork,
/obj/item/kitchen/fork,
/obj/item/kitchen/fork,
/obj/effect/spawner/random/food_or_drink/three_course_meal,
/obj/effect/spawner/random/food_or_drink/three_course_meal,
/obj/effect/spawner/random/food_or_drink/three_course_meal,
/obj/effect/spawner/random/food_or_drink/three_course_meal,
/obj/effect/spawner/random/food_or_drink/three_course_meal,
/obj/effect/spawner/random/food_or_drink/three_course_meal,
/obj/effect/spawner/random/food_or_drink/three_course_meal,
/obj/item/plate,
/obj/item/plate,
/obj/item/plate,
/obj/item/plate,
/obj/item/storage/cans/sixbeer,
/obj/item/reagent_containers/cup/glass/drinkingglass,
/obj/item/reagent_containers/cup/glass/drinkingglass,
/obj/item/reagent_containers/cup/glass/drinkingglass,
/obj/item/reagent_containers/cup/glass/drinkingglass,
/obj/item/storage/fancy/pickles_jar,
/obj/structure/closet/secure_closet/freezer/kitchen/mining{
	storage_capacity = 60
	},
/obj/effect/spawner/random/food_or_drink/donkpockets,
/turf/open/floor/iron/kitchen,
/area/misc/hilbertshotel)
"dS" = (
/obj/effect/turf_decal/siding/wood{
	dir = 8
	},
/obj/structure/table/wood,
/turf/open/floor/wood/tile,
/area/misc/hilbertshotel)
"dT" = (
/obj/structure/chair/stool/bar/directional/west,
/turf/open/floor/wood/tile,
/area/misc/hilbertshotel)
"eO" = (
/obj/structure/bookcase/random,
/obj/effect/turf_decal/siding/wood{
	dir = 1
	},
/turf/open/floor/wood/parquet,
/area/misc/hilbertshotel)
"fa" = (
/obj/effect/spawner/liquids_spawner,
/obj/structure/railing{
	dir = 1
	},
/turf/open/floor/plating/cobblestone/sparse,
/area/misc/hilbertshotel)
"fi" = (
/obj/structure/chair,
/obj/structure/extinguisher_cabinet/directional/north,
/turf/open/floor/iron/kitchen,
/area/misc/hilbertshotel)
"gg" = (
/obj/effect/turf_decal/tile/neutral/diagonal_edge,
/obj/structure/chair/plastic{
	dir = 8
	},
/obj/structure/sign/poster/random/directional/east,
/turf/open/floor/iron/freezer,
/area/misc/hilbertshotel)
"gQ" = (
/obj/structure/chair/sofa/corp/corner,
/obj/machinery/light/warm/directional/east,
/obj/effect/turf_decal/siding/wood{
	dir = 5
	},
/turf/open/floor/carpet,
/area/misc/hilbertshotel)
"ho" = (
/obj/structure/window{
	dir = 1
	},
/obj/structure/flora/rock,
/obj/effect/spawner/liquids_spawner,
/turf/open/floor/plating/cobblestone/sparse,
/area/misc/hilbertshotel)
"ik" = (
/obj/structure/window{
	dir = 1
	},
/obj/structure/flora/ocean/coral,
/obj/structure/flora/ocean/longseaweed,
/obj/effect/spawner/liquids_spawner,
/turf/open/floor/plating/cobblestone/sparse,
/area/misc/hilbertshotel)
"iC" = (
/obj/effect/turf_decal/tile/neutral/diagonal_edge,
/obj/structure/closet/secure_closet/wall{
	pixel_y = 32
	},
/turf/open/floor/iron/freezer,
/area/misc/hilbertshotel)
"iL" = (
/obj/effect/turf_decal/siding/wood,
/obj/structure/sign/painting/library{
	pixel_y = -32
	},
/turf/open/floor/wood/tile,
/area/misc/hilbertshotel)
"jr" = (
/obj/machinery/light_switch/directional/south,
/obj/effect/turf_decal/siding/wood,
/turf/open/floor/carpet/donk,
/area/misc/hilbertshotel)
"jx" = (
/obj/structure/chair/office{
	dir = 4
	},
/obj/effect/turf_decal/siding/wood{
	dir = 10
	},
/turf/open/floor/wood/parquet,
/area/misc/hilbertshotel)
"jT" = (
/obj/item/kirbyplants/random,
/turf/open/floor/iron/kitchen,
/area/misc/hilbertshotel)
"kh" = (
/obj/structure/mirror/directional/north,
/obj/effect/turf_decal/siding/wood{
	dir = 1
	},
/turf/open/floor/wood/large,
/area/misc/hilbertshotel)
"kD" = (
/obj/effect/turf_decal/siding/wood/corner,
/turf/open/floor/wood/tile,
/area/misc/hilbertshotel)
"kS" = (
/obj/structure/table/wood/poker,
/obj/item/toy/cards/deck,
/turf/open/floor/carpet,
/area/misc/hilbertshotel)
"kW" = (
/obj/effect/turf_decal/siding/wood,
/obj/structure/flora/bush/grassy/style_random,
/obj/structure/flora/bush/flowers_br/style_3,
/obj/structure/window{
	dir = 8
	},
/obj/structure/window,
/turf/open/floor/grass,
/area/misc/hilbertshotel)
"lU" = (
/obj/effect/turf_decal/siding/wood{
	dir = 6
	},
/turf/open/floor/carpet/royalblue,
/area/misc/hilbertshotel)
"md" = (
/obj/structure/table/wood,
/obj/item/flashlight/lamp/green{
	pixel_x = 5;
	pixel_y = 14
	},
/obj/structure/sign/poster/random/directional/east,
/obj/effect/turf_decal/siding/wood{
	dir = 5
	},
/turf/open/floor/wood/parquet,
/area/misc/hilbertshotel)
"mz" = (
/obj/effect/turf_decal/siding/wood,
/turf/open/floor/carpet,
/area/misc/hilbertshotel)
"oZ" = (
/turf/closed/indestructible/steel,
/area/misc/hilbertshotel)
"pm" = (
/obj/structure/table/wood,
/obj/item/serviette_pack,
/obj/effect/turf_decal/siding/wood{
	dir = 9
	},
/turf/open/floor/wood/parquet,
/area/misc/hilbertshotel)
"pD" = (
/obj/machinery/light/warm/directional/north,
/obj/effect/turf_decal/siding/wood{
	dir = 1
	},
/turf/open/floor/carpet/royalblue,
/area/misc/hilbertshotel)
"rs" = (
/obj/effect/turf_decal/siding/wood/corner,
/obj/effect/turf_decal/siding/wood/corner{
	dir = 4
	},
/turf/open/floor/wood/tile,
/area/misc/hilbertshotel)
"st" = (
/obj/machinery/door/morgue,
/turf/open/floor/wood/parquet,
/area/misc/hilbertshotel)
"tZ" = (
/obj/structure/sink/kitchen/directional/west,
/turf/open/floor/iron/kitchen,
/area/misc/hilbertshotel)
"uX" = (
/obj/structure/chair/sofa/corp/left{
	dir = 8
	},
/obj/effect/turf_decal/siding/wood{
	dir = 4
	},
/turf/open/floor/carpet,
/area/misc/hilbertshotel)
"va" = (
/obj/effect/turf_decal/siding/wood{
	dir = 6
	},
/turf/open/floor/carpet,
/area/misc/hilbertshotel)
"wb" = (
/obj/structure/closet/cabinet,
/obj/effect/turf_decal/siding/wood{
	dir = 10
	},
/turf/open/floor/wood/parquet,
/area/misc/hilbertshotel)
"wg" = (
/obj/effect/turf_decal/siding/wood/corner{
	dir = 8
	},
/obj/effect/turf_decal/siding/wood/corner,
/turf/open/floor/carpet/donk,
/area/misc/hilbertshotel)
"wl" = (
/obj/structure/curtain/cloth,
/turf/open/floor/iron/kitchen,
/area/misc/hilbertshotel)
"wu" = (
/turf/open/floor/wood/tile,
/area/misc/hilbertshotel)
"wS" = (
/obj/structure/closet/cabinet,
/obj/machinery/light/dim/directional/north,
/obj/effect/turf_decal/siding/wood{
	dir = 1
	},
/turf/open/floor/wood/parquet,
/area/misc/hilbertshotel)
"zA" = (
/obj/machinery/computer/security/telescreen/entertainment/directional/east,
/obj/structure/table/glass,
/obj/item/pizzabox/margherita{
	pixel_y = 11
	},
/obj/effect/turf_decal/siding/wood{
	dir = 6
	},
/turf/open/floor/wood/parquet,
/area/misc/hilbertshotel)
"zY" = (
/obj/item/kirbyplants/random,
/obj/effect/turf_decal/siding/wood,
/turf/open/floor/wood/large,
/area/misc/hilbertshotel)
"Ae" = (
/obj/machinery/door/morgue,
/turf/open/floor/iron/freezer,
/area/misc/hilbertshotel)
"AE" = (
/obj/item/kirbyplants/random,
/obj/effect/turf_decal/siding/wood{
	dir = 9
	},
/turf/open/floor/wood/tile,
/area/misc/hilbertshotel)
"BR" = (
/obj/structure/chair/comfy/brown{
	dir = 4
	},
/obj/effect/turf_decal/siding/wood{
	dir = 8
	},
/turf/open/floor/carpet,
/area/misc/hilbertshotel)
"Dc" = (
/obj/item/kirbyplants/random,
/obj/structure/sign/poster/random/directional/north,
/turf/open/floor/iron/kitchen,
/area/misc/hilbertshotel)
"DR" = (
/obj/effect/turf_decal/siding/wood/corner{
	dir = 8
	},
/obj/effect/turf_decal/siding/wood/corner{
	dir = 1
	},
/turf/open/floor/wood/tile,
/area/misc/hilbertshotel)
"DX" = (
/obj/machinery/computer{
	dir = 8
	},
/obj/effect/turf_decal/siding/wood,
/turf/open/floor/carpet/donk,
/area/misc/hilbertshotel)
"Ea" = (
/obj/structure/chair/stool/bar/directional/north,
/turf/open/floor/wood/tile,
/area/misc/hilbertshotel)
"EX" = (
/obj/structure/table,
/obj/item/food/vendor_tray_meal/ramen,
/obj/machinery/computer/security/telescreen/entertainment/directional/west,
/turf/open/floor/iron/kitchen,
/area/misc/hilbertshotel)
"Fl" = (
/obj/structure/table,
/obj/effect/spawner/random/food_or_drink/three_course_meal,
/turf/open/floor/iron/kitchen,
/area/misc/hilbertshotel)
"FN" = (
/turf/open/space/bluespace,
/area/misc/hilbertshotel)
"Gv" = (
/obj/structure/chair/sofa/corp/right,
/obj/structure/sign/poster/random/directional/north,
/obj/effect/turf_decal/siding/wood{
	dir = 1
	},
/turf/open/floor/carpet,
/area/misc/hilbertshotel)
"HO" = (
/obj/structure/window{
	dir = 1
	},
/obj/structure/flora/ocean/seaweed,
/obj/effect/spawner/liquids_spawner,
/turf/open/floor/plating/cobblestone/sparse,
/area/misc/hilbertshotel)
"Ib" = (
/obj/effect/turf_decal/siding/wood{
	dir = 4
	},
/obj/item/toy/plush/skyrat/breakdancing_bird,
/turf/open/floor/carpet,
/area/misc/hilbertshotel)
"Ix" = (
/obj/structure/bed/double,
/obj/item/bedsheet/random/double,
/obj/effect/turf_decal/siding/wood{
	dir = 4
	},
/turf/open/floor/wood/parquet,
/area/misc/hilbertshotel)
"IW" = (
/obj/structure/sink/directional/west,
/obj/structure/mirror/directional/east,
/turf/open/floor/iron/freezer,
/area/misc/hilbertshotel)
"Je" = (
/obj/structure/dresser,
/obj/machinery/computer/security/telescreen/entertainment/directional/north,
/obj/effect/turf_decal/siding/wood{
	dir = 1
	},
/turf/open/floor/wood/parquet,
/area/misc/hilbertshotel)
"JW" = (
/obj/item/kirbyplants/random,
/obj/effect/turf_decal/siding/wood/corner,
/obj/effect/turf_decal/siding/wood{
	dir = 10
	},
/turf/open/floor/wood/tile,
/area/misc/hilbertshotel)
"KN" = (
/obj/effect/turf_decal/tile/neutral/diagonal_centre,
/obj/structure/closet/secure_closet/wall{
	pixel_x = -28
	},
/turf/open/floor/iron/freezer,
/area/misc/hilbertshotel)
"LC" = (
/obj/structure/closet/mini_fridge{
	density = 0;
	pixel_y = 8
	},
/obj/item/storage/cans/sixbeer,
/obj/effect/turf_decal/siding/wood{
	dir = 1
	},
/turf/open/floor/wood/tile,
/area/misc/hilbertshotel)
"LJ" = (
/obj/effect/spawner/liquids_spawner,
/obj/structure/railing/corner{
	dir = 4
	},
/obj/structure/railing/corner{
	dir = 1
	},
/turf/open/floor/plating/cobblestone/sparse,
/area/misc/hilbertshotel)
"Mj" = (
/turf/open/floor/carpet/donk,
/area/misc/hilbertshotel)
"Mk" = (
/obj/machinery/light_switch/directional/north,
/obj/structure/curtain,
/obj/machinery/shower/directional/east{
	pixel_x = -10
	},
/obj/item/soap/deluxe,
/turf/open/floor/iron/freezer,
/area/misc/hilbertshotel)
"Mp" = (
/obj/structure/bed/dogbed,
/obj/effect/turf_decal/siding/wood{
	dir = 6
	},
/turf/open/floor/wood/parquet,
/area/misc/hilbertshotel)
"MO" = (
/obj/structure/chair{
	dir = 8
	},
/turf/open/floor/iron/kitchen,
/area/misc/hilbertshotel)
"Oh" = (
/obj/structure/sign/poster/random/directional/south,
/obj/machinery/vending/wallmed/directional/west,
/obj/structure/table,
/obj/structure/bedsheetbin,
/turf/open/floor/iron/freezer,
/area/misc/hilbertshotel)
"Py" = (
/obj/structure/table/reinforced,
/obj/machinery/light/cold/directional/east,
/obj/effect/turf_decal/siding/wideplating_new/light{
	dir = 10
	},
/obj/item/kitchen/rollingpin{
	pixel_x = -3
	},
/obj/item/knife/kitchen,
/turf/open/floor/mineral/titanium/tiled/white,
/area/misc/hilbertshotel)
"PK" = (
/obj/structure/sign/poster/random/directional/south,
/turf/open/floor/iron/kitchen,
/area/misc/hilbertshotel)
"QJ" = (
/obj/structure/table/wood/poker,
/obj/structure/noticeboard{
	dir = 4;
	pixel_x = -64;
	pixel_y = -32
	},
/turf/open/floor/carpet,
/area/misc/hilbertshotel)
"Rr" = (
/obj/structure/chair{
	dir = 1
	},
/turf/open/floor/iron/kitchen,
/area/misc/hilbertshotel)
"RB" = (
/obj/effect/turf_decal/siding/wood{
	dir = 1
	},
/obj/effect/turf_decal/siding/wood/corner,
/turf/open/floor/carpet/royalblue,
/area/misc/hilbertshotel)
"RF" = (
/obj/effect/spawner/liquids_spawner,
/turf/open/floor/plating/cobblestone/sparse,
/area/misc/hilbertshotel)
"RM" = (
/obj/structure/flora/bush/large/style_random,
/obj/structure/flora/bush/lavendergrass/style_random,
/obj/structure/window{
	dir = 8
	},
/obj/structure/window{
	dir = 1
	},
/turf/open/floor/grass,
/area/misc/hilbertshotel)
"RP" = (
/turf/open/floor/carpet,
/area/misc/hilbertshotel)
"SS" = (
/turf/closed/indestructible/hoteldoor{
	icon_state = "door_closed";
	icon = 'icons/obj/doors/puzzledoor/default.dmi'
	},
/area/misc/hilbertshotel)
"SV" = (
/obj/structure/chair{
	dir = 1
	},
/obj/machinery/light/cold/directional/west,
/turf/open/floor/iron/kitchen,
/area/misc/hilbertshotel)
"Tj" = (
/obj/machinery/light/warm/directional/west,
/obj/effect/turf_decal/siding/wood{
	dir = 8
	},
/turf/open/floor/wood/tile,
/area/misc/hilbertshotel)
"Tu" = (
/obj/structure/toilet{
	dir = 8
	},
/obj/machinery/light/small/directional/east,
/turf/open/floor/iron/freezer,
/area/misc/hilbertshotel)
"TJ" = (
/obj/machinery/shower/directional/west{
	pixel_x = 10
	},
/obj/structure/curtain,
/turf/open/floor/iron/freezer,
/area/misc/hilbertshotel)
"Ul" = (
/obj/structure/railing{
	dir = 1
	},
/obj/effect/spawner/liquids_spawner,
/obj/machinery/light/dim/directional/east,
/turf/open/floor/plating/cobblestone/sparse,
/area/misc/hilbertshotel)
"UQ" = (
/obj/structure/chair/stool/bar/directional/south,
/obj/structure/sign/poster/random/directional/north,
/obj/effect/turf_decal/siding/wood{
	dir = 1
	},
/turf/open/floor/wood/tile,
/area/misc/hilbertshotel)
"UU" = (
/obj/effect/turf_decal/siding/wood{
	dir = 8
	},
/obj/structure/decorative/shelf,
/obj/machinery/light_switch/directional/west,
/turf/open/floor/wood/tile,
/area/misc/hilbertshotel)
"Vi" = (
/obj/effect/turf_decal/siding/wood/corner,
/turf/open/floor/carpet/royalblue,
/area/misc/hilbertshotel)
"Wh" = (
/turf/open/floor/iron/freezer,
/area/misc/hilbertshotel)
"Wt" = (
/obj/effect/turf_decal/siding/wood/corner{
	dir = 8
	},
/turf/open/floor/carpet/royalblue,
/area/misc/hilbertshotel)
"WI" = (
/turf/open/floor/iron/kitchen,
/area/misc/hilbertshotel)
"WN" = (
/obj/effect/turf_decal/siding/wood/corner{
	dir = 4
	},
/obj/effect/turf_decal/siding/wood/corner{
	dir = 1
	},
/turf/open/floor/carpet/royalblue,
/area/misc/hilbertshotel)
"WX" = (
/obj/effect/turf_decal/siding/wood{
	dir = 8
	},
/turf/open/floor/wood/parquet,
/area/misc/hilbertshotel)
"YW" = (
/obj/effect/turf_decal/siding/wood{
	dir = 4
	},
/obj/effect/turf_decal/siding/wood/corner{
	dir = 8
	},
/turf/open/floor/wood/tile,
/area/misc/hilbertshotel)
"Zq" = (
/obj/effect/turf_decal/siding/wideplating_new/light{
	dir = 9
	},
/obj/structure/closet/crate/bin,
/turf/open/floor/mineral/titanium/tiled/white,
/area/misc/hilbertshotel)

(1,1,1) = {"
FN
FN
FN
FN
FN
FN
FN
FN
FN
FN
FN
FN
FN
FN
FN
"}
(2,1,1) = {"
FN
oZ
oZ
aC
oZ
oZ
SS
oZ
oZ
oZ
oZ
oZ
oZ
oZ
FN
"}
(3,1,1) = {"
FN
oZ
pm
WX
jx
oZ
cy
wb
oZ
Dc
EX
SV
jT
oZ
FN
"}
(4,1,1) = {"
FN
oZ
eO
Mj
DX
oZ
kh
zY
oZ
fi
Fl
Rr
PK
oZ
FN
"}
(5,1,1) = {"
FN
oZ
wS
Mj
wg
st
WN
Wt
wl
WI
MO
WI
WI
oZ
FN
"}
(6,1,1) = {"
FN
oZ
Je
Mj
jr
oZ
pD
Vi
wl
WI
WI
WI
dw
oZ
FN
"}
(7,1,1) = {"
FN
oZ
md
Ix
Mp
oZ
RB
lU
oZ
bw
Py
tZ
Zq
oZ
FN
"}
(8,1,1) = {"
FN
oZ
oZ
oZ
oZ
oZ
st
oZ
oZ
oZ
oZ
oZ
oZ
oZ
FN
"}
(9,1,1) = {"
FN
oZ
AE
ar
BR
Tj
DR
UU
dS
JW
oZ
Mk
Oh
oZ
FN
"}
(10,1,1) = {"
FN
oZ
UQ
QJ
kS
Ea
kD
cz
rs
YW
Ae
IW
Tu
oZ
FN
"}
(11,1,1) = {"
FN
oZ
cD
dT
dT
wu
iL
oZ
Ae
oZ
oZ
oZ
oZ
oZ
FN
"}
(12,1,1) = {"
FN
oZ
LC
wu
wu
RP
mz
oZ
iC
KN
fa
RF
ik
oZ
FN
"}
(13,1,1) = {"
FN
oZ
Gv
RP
bz
Ib
va
oZ
aS
Wh
LJ
RF
HO
oZ
FN
"}
(14,1,1) = {"
FN
oZ
gQ
uX
zA
RM
kW
oZ
TJ
gg
Ul
RF
ho
oZ
FN
"}
(15,1,1) = {"
FN
oZ
oZ
aC
oZ
oZ
oZ
oZ
oZ
oZ
oZ
oZ
oZ
oZ
FN
"}
(16,1,1) = {"
FN
FN
FN
FN
FN
FN
FN
FN
FN
FN
FN
FN
FN
FN
FN
"}
