//MAP CONVERTED BY dmm2tgm.py THIS HEADER COMMENT PREVENTS RECONVERSION, DO NOT REMOVE
"a" = (
/turf/open/floor/engine,
/area/station/security/spacepod_hangar)
"b" = (
/obj/effect/turf_decal/bot,
/obj/effect/decal/cleanable/dirt,
/obj/machinery/suit_storage_unit/security,
/obj/effect/turf_decal/tile/neutral/half/contrasted{
	dir = 1
	},
/turf/open/floor/iron/dark,
/area/station/ai_monitored/security/armory)
"c" = (
/turf/closed/wall/r_wall,
/area/station/security/spacepod_hangar)
"f" = (
/obj/machinery/door/airlock/security/glass{
	name = "Spacepod Hangar"
	},
/obj/effect/mapping_helpers/airlock/access/any/security/spacepod_pilot,
/obj/structure/cable,
/obj/machinery/atmospherics/pipe/smart/manifold4w/scrubbers/hidden/layer2,
/turf/open/floor/iron,
/area/station/security/spacepod_hangar)
"g" = (
/obj/effect/landmark/start/spacepod_pilot,
/turf/open/floor/iron,
/area/station/security/spacepod_hangar)
"h" = (
/obj/item/storage/box/teargas{
	pixel_x = 3;
	pixel_y = 3
	},
/obj/item/storage/box/handcuffs,
/obj/item/storage/box/flashbangs{
	pixel_x = -3;
	pixel_y = -3
	},
/obj/structure/table,
/obj/structure/extinguisher_cabinet/directional/east,
/obj/effect/turf_decal/tile/neutral{
	dir = 1
	},
/turf/open/floor/iron/dark,
/area/station/ai_monitored/security/armory)
"i" = (
/turf/closed/wall,
/area/station/security/spacepod_hangar)
"j" = (
/obj/effect/turf_decal/stripes/line,
/obj/effect/turf_decal/tile/neutral/half/contrasted{
	dir = 1
	},
/turf/open/floor/iron/showroomfloor,
/area/station/ai_monitored/security/armory)
"k" = (
/obj/effect/spawner/structure/window/reinforced,
/obj/machinery/atmospherics/pipe/smart/manifold4w/supply/hidden/layer4,
/turf/open/floor/plating,
/area/station/security/spacepod_hangar)
"l" = (
/obj/structure/cable,
/obj/structure/closet/secure_closet{
	name = "contraband locker";
	req_access = list("armory")
	},
/obj/effect/spawner/random/contraband/armory,
/obj/effect/spawner/random/maintenance/three,
/obj/machinery/power/apc/auto_name/directional/south,
/obj/effect/turf_decal/tile/neutral/half/contrasted{
	dir = 1
	},
/turf/open/floor/iron/dark,
/area/station/ai_monitored/security/armory)
"m" = (
/obj/structure/closet/secure_closet/security/sec,
/obj/item/clothing/ears/earmuffs,
/obj/item/clothing/glasses/sunglasses/big,
/obj/item/clothing/head/spacepod_pilot,
/obj/item/clothing/under/rank/spacepod_pilot,
/obj/structure/cable,
/obj/machinery/power/apc/auto_name/directional/north,
/turf/open/floor/iron,
/area/station/security/spacepod_hangar)
"n" = (
/obj/structure/cable,
/obj/machinery/atmospherics/components/unary/vent_pump/on/layer4{
	dir = 4
	},
/turf/open/floor/iron,
/area/station/security/spacepod_hangar)
"o" = (
/turf/closed/wall/rust,
/area/station/security/spacepod_hangar)
"p" = (
/obj/effect/turf_decal/stripes/line{
	dir = 8
	},
/obj/machinery/suit_storage_unit/security,
/obj/structure/railing{
	dir = 8
	},
/turf/open/floor/iron,
/area/station/security/spacepod_hangar)
"q" = (
/obj/machinery/atmospherics/pipe/smart/manifold4w/supply/hidden/layer4,
/obj/machinery/atmospherics/pipe/smart/manifold4w/scrubbers/hidden/layer2,
/turf/open/floor/iron,
/area/station/security/spacepod_hangar)
"s" = (
/obj/structure/sign/warning/docking,
/turf/closed/wall,
/area/station/security/processing)
"t" = (
/obj/structure/table,
/obj/machinery/recharger,
/obj/effect/decal/cleanable/dirt,
/obj/effect/turf_decal/stripes/corner{
	dir = 1
	},
/obj/effect/turf_decal/tile/neutral/half/contrasted{
	dir = 1
	},
/turf/open/floor/iron/dark,
/area/station/security/lockers)
"u" = (
/obj/item/storage/box/chemimp{
	pixel_x = 6;
	pixel_y = 6
	},
/obj/item/storage/box/trackimp{
	pixel_x = -6;
	pixel_y = 6
	},
/obj/structure/table,
/obj/machinery/light/directional/south,
/obj/structure/reagent_dispensers/wall/peppertank/directional/south,
/obj/item/storage/box/firingpins,
/obj/item/storage/box/firingpins,
/obj/item/storage/lockbox/loyalty,
/obj/effect/turf_decal/tile/neutral/half/contrasted{
	dir = 1
	},
/turf/open/floor/iron/dark,
/area/station/ai_monitored/security/armory)
"v" = (
/obj/spacepod/prebuilt/sec/roundstart,
/turf/open/floor/engine,
/area/station/security/spacepod_hangar)
"x" = (
/obj/structure/table,
/obj/item/storage/toolbox/mechanical,
/obj/item/weldingtool/largetank,
/obj/machinery/light/directional/south,
/turf/open/floor/iron,
/area/station/security/spacepod_hangar)
"y" = (
/obj/machinery/gulag_teleporter,
/obj/effect/turf_decal/box,
/obj/effect/turf_decal/stripes/corner,
/obj/machinery/atmospherics/pipe/smart/manifold4w/supply/hidden/layer4,
/turf/open/floor/iron/dark,
/area/station/security/processing)
"z" = (
/turf/closed/wall/r_wall,
/area/station/ai_monitored/security/armory)
"C" = (
/obj/structure/fans/tiny/forcefield,
/obj/machinery/door/poddoor/multi_tile/three_tile_hor,
/turf/open/floor/plating,
/area/station/security/spacepod_hangar)
"D" = (
/obj/structure/fans/tiny/forcefield,
/turf/open/floor/plating,
/area/station/security/spacepod_hangar)
"E" = (
/obj/structure/table,
/obj/item/spacepod_equipment/weaponry/disabler,
/obj/item/spacepod_equipment/thruster,
/obj/item/spacepod_equipment/lights/security,
/obj/effect/turf_decal/stripes/line{
	dir = 8
	},
/obj/structure/railing{
	dir = 8
	},
/turf/open/floor/iron,
/area/station/security/spacepod_hangar)
"G" = (
/obj/machinery/vending/security,
/obj/effect/turf_decal/bot,
/obj/structure/cable,
/obj/effect/turf_decal/tile/neutral/half/contrasted{
	dir = 1
	},
/turf/open/floor/iron/dark,
/area/station/security/lockers)
"H" = (
/obj/effect/turf_decal/stripes/line{
	dir = 6
	},
/obj/structure/cable,
/obj/effect/turf_decal/tile/neutral{
	dir = 1
	},
/turf/open/floor/iron/showroomfloor,
/area/station/ai_monitored/security/armory)
"I" = (
/obj/machinery/light/directional/west,
/turf/open/floor/engine,
/area/station/security/spacepod_hangar)
"J" = (
/turf/open/space/basic,
/area/space)
"K" = (
/obj/machinery/atmospherics/components/unary/vent_scrubber/on/layer2{
	dir = 1
	},
/obj/machinery/light/directional/east,
/turf/open/floor/iron,
/area/station/security/spacepod_hangar)
"L" = (
/turf/closed/wall/r_wall,
/area/station/security/processing)
"M" = (
/obj/structure/rack,
/obj/item/gun/energy/ionrifle{
	pixel_y = 4
	},
/obj/item/gun/energy/temperature/security,
/obj/effect/turf_decal/bot,
/obj/item/clothing/suit/hooded/ablative,
/obj/machinery/light_switch/directional/east,
/obj/effect/turf_decal/tile/neutral/half/contrasted{
	dir = 1
	},
/turf/open/floor/iron/dark,
/area/station/ai_monitored/security/armory)
"N" = (
/obj/effect/spawner/structure/window/reinforced,
/obj/structure/cable,
/turf/open/floor/plating,
/area/station/security/spacepod_hangar)
"O" = (
/obj/effect/turf_decal/stripes/line{
	dir = 10
	},
/obj/machinery/atmospherics/components/unary/vent_scrubber/on/layer2{
	dir = 1
	},
/obj/effect/turf_decal/tile/neutral{
	dir = 4
	},
/turf/open/floor/iron/showroomfloor,
/area/station/ai_monitored/security/armory)
"P" = (
/obj/effect/turf_decal/bot,
/obj/effect/decal/cleanable/dirt,
/obj/item/radio/intercom/directional/south,
/obj/machinery/suit_storage_unit/security,
/obj/effect/turf_decal/tile/neutral/half/contrasted{
	dir = 1
	},
/turf/open/floor/iron/dark,
/area/station/ai_monitored/security/armory)
"Q" = (
/obj/effect/turf_decal/stripes/line{
	dir = 8
	},
/turf/open/floor/iron,
/area/station/security/spacepod_hangar)
"R" = (
/turf/open/floor/iron,
/area/station/security/spacepod_hangar)
"S" = (
/obj/structure/table,
/turf/open/floor/iron,
/area/station/security/spacepod_hangar)
"T" = (
/obj/structure/lattice/catwalk,
/obj/structure/marker_beacon/burgundy{
	name = "landing marker"
	},
/turf/open/space/basic,
/area/space/nearstation)
"U" = (
/turf/closed/wall/r_wall/rust,
/area/station/ai_monitored/security/armory)
"V" = (
/obj/effect/spawner/structure/window/reinforced,
/turf/open/floor/plating,
/area/station/security/processing)
"W" = (
/turf/closed/wall/r_wall,
/area/station/security/lockers)
"X" = (
/obj/machinery/airalarm/directional/west,
/obj/machinery/light/directional/west,
/obj/effect/turf_decal/bot,
/obj/machinery/computer/prisoner/gulag_teleporter_computer{
	dir = 4
	},
/turf/open/floor/iron/dark,
/area/station/security/processing)
"Y" = (
/obj/structure/cable,
/obj/machinery/atmospherics/pipe/smart/manifold4w/scrubbers/hidden/layer2,
/turf/open/floor/iron/showroomfloor,
/area/station/security/lockers)
"Z" = (
/obj/structure/table,
/obj/machinery/recharger,
/obj/structure/sign/warning/electric_shock/directional/south,
/obj/effect/turf_decal/siding/red/corner{
	dir = 4
	},
/obj/machinery/power/apc/auto_name/directional/east,
/obj/structure/cable,
/obj/effect/turf_decal/tile/neutral/half/contrasted{
	dir = 1
	},
/turf/open/floor/iron/dark,
/area/station/security/lockers)

(1,1,1) = {"
O
u
U
c
c
c
c
c
"}
(2,1,1) = {"
j
b
z
a
a
I
a
C
"}
(3,1,1) = {"
j
P
z
a
v
a
a
D
"}
(4,1,1) = {"
H
l
U
a
a
a
a
D
"}
(5,1,1) = {"
M
h
z
p
Q
Q
E
c
"}
(6,1,1) = {"
z
z
z
m
g
R
x
c
"}
(7,1,1) = {"
t
G
N
n
R
R
S
c
"}
(8,1,1) = {"
Y
Y
f
q
K
c
c
c
"}
(9,1,1) = {"
Z
W
i
k
o
c
T
J
"}
(10,1,1) = {"
L
L
X
y
V
V
s
J
"}
