//MAP CONVERTED BY dmm2tgm.py THIS HEADER COMMENT PREVENTS RECONVERSION, DO NOT REMOVE
"a" = (
/turf/open/floor/plating/airless,
/area/station/hallway/secondary/entry)
"b" = (
/obj/effect/landmark/start/hangover,
/obj/effect/turf_decal/tile/neutral/half/contrasted{
	dir = 1
	},
/turf/open/floor/iron,
/area/station/hallway/secondary/entry)
"e" = (
/obj/structure/table,
/obj/item/paper_bin{
	pixel_x = -4;
	pixel_y = 4
	},
/obj/item/pen,
/obj/effect/turf_decal/loading_area{
	dir = 1
	},
/obj/effect/turf_decal/tile/neutral/half/contrasted{
	dir = 1
	},
/turf/open/floor/iron/dark,
/area/station/hallway/secondary/entry)
"f" = (
/turf/closed/wall/rust,
/area/station/hallway/secondary/entry)
"g" = (
/obj/machinery/door/airlock/external{
	name = "Arrival Shuttle Airlock";
	space_dir = 2
	},
/obj/effect/mapping_helpers/airlock/cyclelink_helper_multi{
	cycle_id = "arrival-airlock-east"
	},
/turf/open/floor/iron/dark,
/area/station/hallway/secondary/entry)
"h" = (
/obj/effect/turf_decal/tile/blue{
	dir = 8
	},
/obj/machinery/atmospherics/components/unary/vent_scrubber/on/layer2{
	dir = 1
	},
/obj/effect/turf_decal/box,
/turf/open/floor/iron,
/area/station/hallway/secondary/entry)
"i" = (
/obj/effect/turf_decal/stripes/line,
/obj/effect/decal/cleanable/dirt,
/obj/structure/flora/grass/jungle/a/style_random,
/turf/open/misc/asteroid/airless,
/area/station/hallway/secondary/entry)
"j" = (
/obj/effect/turf_decal/stripes/line,
/obj/machinery/light/small/directional/west,
/obj/machinery/status_display/shuttle/directional/west{
	shuttle_id = "arrivals_shuttle"
	},
/turf/open/floor/iron,
/area/station/hallway/secondary/entry)
"k" = (
/obj/effect/spawner/structure/window/reinforced,
/obj/structure/sign/warning/vacuum/external,
/turf/open/floor/plating,
/area/station/hallway/secondary/entry)
"n" = (
/obj/effect/turf_decal/delivery,
/obj/machinery/vending/clothing,
/obj/effect/turf_decal/tile/neutral{
	dir = 4
	},
/turf/open/floor/iron/dark,
/area/station/hallway/secondary/entry)
"o" = (
/turf/open/floor/iron,
/area/station/hallway/secondary/entry)
"p" = (
/obj/effect/turf_decal/tile/red,
/obj/effect/turf_decal/stripes/corner,
/obj/item/radio/intercom/directional/east,
/obj/effect/turf_decal/tile/blue{
	dir = 4
	},
/turf/open/floor/iron,
/area/station/hallway/secondary/entry)
"q" = (
/turf/closed/wall,
/area/station/hallway/secondary/entry)
"r" = (
/obj/effect/turf_decal/tile/blue{
	dir = 8
	},
/obj/effect/turf_decal/tile/red,
/obj/effect/turf_decal/tile/red{
	dir = 1
	},
/obj/effect/turf_decal/stripes/line,
/obj/effect/turf_decal/stripes/corner{
	dir = 1
	},
/obj/effect/decal/cleanable/dirt,
/obj/machinery/bluespace_vendor/directional/west,
/turf/open/floor/iron,
/area/station/hallway/secondary/entry)
"s" = (
/obj/effect/turf_decal/stripes/line,
/obj/structure/flora/bush/pale/style_random,
/obj/effect/decal/cleanable/dirt,
/turf/open/misc/asteroid/airless,
/area/station/hallway/secondary/entry)
"t" = (
/obj/effect/turf_decal/stripes/line,
/obj/machinery/light/small/directional/east,
/obj/machinery/status_display/shuttle/directional/east{
	shuttle_id = "arrivals_shuttle"
	},
/turf/open/floor/iron,
/area/station/hallway/secondary/entry)
"v" = (
/obj/effect/turf_decal/stripes/line,
/obj/structure/flora/grass/jungle/a/style_random,
/obj/effect/decal/cleanable/dirt,
/turf/open/misc/asteroid/airless,
/area/station/hallway/secondary/entry)
"x" = (
/obj/effect/turf_decal/bot,
/obj/structure/closet/emcloset,
/obj/effect/turf_decal/tile/neutral{
	dir = 4
	},
/obj/effect/turf_decal/tile/neutral{
	dir = 1
	},
/obj/machinery/light/small/directional/south,
/obj/structure/sign/poster/contraband/random/directional/south,
/turf/open/floor/iron/dark,
/area/station/hallway/secondary/entry)
"y" = (
/obj/effect/turf_decal/stripes/line{
	dir = 4
	},
/obj/effect/turf_decal/tile/neutral{
	dir = 1
	},
/turf/open/floor/iron/dark,
/area/station/hallway/secondary/entry)
"z" = (
/obj/effect/turf_decal/bot,
/obj/machinery/computer/shuttle/arrivals/recall{
	dir = 1
	},
/obj/effect/turf_decal/tile/neutral/half/contrasted{
	dir = 1
	},
/turf/open/floor/iron/dark,
/area/station/hallway/secondary/entry)
"A" = (
/obj/effect/turf_decal/tile/blue{
	dir = 8
	},
/obj/effect/turf_decal/tile/red,
/obj/effect/turf_decal/stripes/corner{
	dir = 8
	},
/turf/open/floor/iron,
/area/station/hallway/secondary/entry)
"D" = (
/obj/effect/turf_decal/stripes/line,
/turf/open/misc/asteroid/airless,
/area/station/hallway/secondary/entry)
"E" = (
/obj/machinery/door/airlock/external{
	name = "Arrival Shuttle Airlock"
	},
/obj/effect/mapping_helpers/airlock/cyclelink_helper,
/turf/open/floor/iron/dark,
/area/station/hallway/secondary/entry)
"F" = (
/obj/effect/spawner/structure/window/reinforced,
/turf/open/floor/plating,
/area/station/hallway/secondary/entry)
"G" = (
/obj/machinery/door/airlock/external{
	name = "Arrival Shuttle Airlock";
	space_dir = 2
	},
/obj/effect/mapping_helpers/airlock/cyclelink_helper{
	dir = 1
	},
/turf/open/floor/iron/dark,
/area/station/hallway/secondary/entry)
"I" = (
/obj/structure/sign/warning/docking,
/turf/closed/wall,
/area/station/hallway/secondary/entry)
"J" = (
/obj/effect/turf_decal/tile/neutral/half/contrasted{
	dir = 1
	},
/turf/open/floor/iron,
/area/station/hallway/secondary/entry)
"K" = (
/obj/effect/turf_decal/stripes/line,
/obj/structure/flora/bush/lavendergrass/style_random,
/obj/structure/flora/bush/ferny/style_random,
/turf/open/misc/asteroid/airless,
/area/station/hallway/secondary/entry)
"M" = (
/turf/closed/mineral/random/labormineral,
/area/station/hallway/secondary/entry)
"O" = (
/obj/docking_port/stationary{
	dir = 4;
	dwidth = 1;
	height = 13;
	shuttle_id = "arrivals_stationary";
	name = "arrivals";
	width = 5
	},
/turf/open/floor/plating/airless,
/area/station/hallway/secondary/entry)
"P" = (
/obj/effect/turf_decal/box/corners{
	dir = 8
	},
/turf/open/floor/plating/airless,
/area/station/hallway/secondary/entry)
"S" = (
/obj/effect/turf_decal/stripes/line,
/obj/structure/flora/grass/jungle/b/style_random,
/obj/effect/decal/cleanable/dirt,
/turf/open/misc/asteroid/airless,
/area/station/hallway/secondary/entry)
"T" = (
/obj/structure/sign/warning/secure_area{
	name = "EMERGENCY STORAGE"
	},
/turf/closed/wall,
/area/station/hallway/secondary/entry)
"U" = (
/obj/effect/turf_decal/stripes/line,
/obj/effect/decal/cleanable/dirt,
/obj/structure/flora/grass/jungle/b/style_random,
/turf/open/misc/asteroid/airless,
/area/station/hallway/secondary/entry)
"V" = (
/obj/effect/turf_decal/bot,
/obj/effect/spawner/random/vending/colavend,
/obj/effect/turf_decal/tile/neutral/half/contrasted{
	dir = 1
	},
/turf/open/floor/iron/dark,
/area/station/hallway/secondary/entry)
"W" = (
/obj/machinery/door/airlock/external{
	name = "Arrival Shuttle Airlock"
	},
/obj/effect/landmark/navigate_destination,
/obj/effect/mapping_helpers/airlock/cyclelink_helper_multi{
	cycle_id = "arrival-airlock-east"
	},
/turf/open/floor/plating,
/area/station/hallway/secondary/entry)
"X" = (
/obj/effect/turf_decal/bot,
/obj/effect/turf_decal/tile/neutral{
	dir = 4
	},
/obj/effect/turf_decal/tile/neutral{
	dir = 1
	},
/obj/structure/closet/firecloset,
/turf/open/floor/iron/dark,
/area/station/hallway/secondary/entry)
"Y" = (
/obj/effect/landmark/start/assistant,
/obj/effect/turf_decal/tile/neutral/half/contrasted{
	dir = 1
	},
/turf/open/floor/iron,
/area/station/hallway/secondary/entry)

(1,1,1) = {"
x
f
M
S
a
a
a
a
"}
(2,1,1) = {"
X
q
M
v
a
O
a
a
"}
(3,1,1) = {"
T
f
q
I
a
a
a
a
"}
(4,1,1) = {"
r
E
j
G
a
a
a
a
"}
(5,1,1) = {"
A
F
F
F
a
a
a
a
"}
(6,1,1) = {"
h
n
F
s
a
a
a
a
"}
(7,1,1) = {"
Y
V
k
v
a
a
a
a
"}
(8,1,1) = {"
J
z
F
D
a
a
a
a
"}
(9,1,1) = {"
b
e
F
U
a
a
a
a
"}
(10,1,1) = {"
p
y
F
K
a
a
a
a
"}
(11,1,1) = {"
f
W
F
F
a
a
a
a
"}
(12,1,1) = {"
q
o
t
g
a
a
a
a
"}
(13,1,1) = {"
f
q
f
I
a
a
a
a
"}
(14,1,1) = {"
f
M
M
i
P
a
a
a
"}
