//MAP CONVERTED BY dmm2tgm.py THIS HEADER COMMENT PREVENTS RECONVERSION, DO NOT REMOVE
"e" = (
/obj/effect/turf_decal/tile/neutral,
/obj/effect/turf_decal/tile/neutral{
	dir = 8
	},
/obj/effect/turf_decal/tile/neutral{
	dir = 1
	},
/obj/effect/turf_decal/bot,
/obj/structure/window/reinforced/spawner/directional/south,
/obj/structure/window/reinforced/spawner/directional/east,
/obj/effect/decal/cleanable/dirt,
/obj/structure/closet/secure_closet/armory_kiboko,
/turf/open/floor/iron/showroomfloor,
/area/station/ai_monitored/security/armory)
"q" = (
/obj/effect/turf_decal/tile/neutral,
/obj/effect/turf_decal/tile/neutral{
	dir = 4
	},
/obj/effect/turf_decal/tile/neutral{
	dir = 1
	},
/obj/effect/turf_decal/bot,
/obj/structure/window/reinforced/spawner/directional/north,
/obj/structure/window/reinforced/spawner/directional/west,
/obj/structure/rack/gunrack,
/obj/effect/spawner/armory_spawn/microfusion,
/turf/open/floor/iron/showroomfloor,
/area/station/ai_monitored/security/armory)
"u" = (
/obj/effect/turf_decal/tile/neutral,
/obj/effect/turf_decal/tile/neutral{
	dir = 8
	},
/obj/effect/turf_decal/bot,
/obj/structure/rack,
/obj/item/clothing/head/helmet/sec{
	pixel_x = -3;
	pixel_y = 3
	},
/obj/item/clothing/head/helmet/sec,
/obj/item/clothing/head/helmet/sec{
	pixel_x = 3;
	pixel_y = -3
	},
/obj/item/clothing/suit/armor/vest/alt/sec{
	pixel_x = -3;
	pixel_y = 3
	},
/obj/item/clothing/suit/armor/vest/alt/sec,
/obj/item/clothing/suit/armor/vest/alt/sec{
	pixel_x = 3;
	pixel_y = -3
	},
/turf/open/floor/iron/dark,
/area/station/ai_monitored/security/armory)
"w" = (
/obj/effect/turf_decal/tile/neutral{
	dir = 8
	},
/obj/effect/turf_decal/tile/neutral{
	dir = 4
	},
/obj/effect/turf_decal/tile/neutral{
	dir = 1
	},
/obj/effect/turf_decal/bot,
/obj/structure/window/reinforced/spawner/directional/north,
/obj/structure/window/reinforced/spawner/directional/east,
/obj/structure/rack/gunrack,
/obj/effect/spawner/armory_spawn/smg,
/turf/open/floor/iron/showroomfloor,
/area/station/ai_monitored/security/armory)
"G" = (
/obj/effect/turf_decal/tile/neutral,
/obj/effect/turf_decal/tile/neutral{
	dir = 8
	},
/obj/effect/turf_decal/tile/neutral{
	dir = 4
	},
/obj/effect/turf_decal/bot,
/obj/structure/window/reinforced/spawner/directional/south,
/obj/structure/window/reinforced/spawner/directional/west,
/obj/structure/rack/gunrack,
/obj/effect/spawner/armory_spawn/shotguns,
/turf/open/floor/iron/showroomfloor,
/area/station/ai_monitored/security/armory)
"N" = (
/obj/item/clothing/mask/gas/sechailer{
	pixel_x = -3;
	pixel_y = 3
	},
/obj/item/clothing/mask/gas/sechailer,
/obj/item/clothing/mask/gas/sechailer{
	pixel_x = 3;
	pixel_y = -3
	},
/obj/item/flashlight/seclite,
/obj/item/flashlight/seclite,
/obj/item/flashlight/seclite,
/obj/effect/turf_decal/tile/neutral,
/obj/effect/decal/cleanable/cobweb,
/obj/machinery/airalarm/directional/west,
/obj/structure/table,
/obj/item/storage/barricade{
	pixel_y = -5
	},
/obj/item/storage/barricade,
/obj/item/storage/barricade{
	pixel_y = 5
	},
/turf/open/floor/iron/dark,
/area/station/ai_monitored/security/armory)
"S" = (
/turf/template_noop,
/area/template_noop)

(1,1,1) = {"
N
S
S
S
"}
(2,1,1) = {"
u
S
S
S
"}
(3,1,1) = {"
S
S
w
e
"}
(4,1,1) = {"
S
S
q
G
"}
