//MAP CONVERTED BY dmm2tgm.py THIS HEADER COMMENT PREVENTS RECONVERSION, DO NOT REMOVE
"a" = (
/turf/template_noop,
/area/template_noop)
"d" = (
/obj/machinery/button/delam_scram,
/turf/closed/wall/r_wall,
/area/station/engineering/supermatter/room)
"g" = (
/obj/effect/turf_decal/stripes/red/box,
/obj/structure/cable,
/turf/open/floor/engine,
/area/station/engineering/supermatter/room)
"R" = (
/obj/effect/turf_decal/stripes/red/box,
/obj/machinery/atmospherics/components/unary/vent_pump/on/layer4{
	dir = 1
	},
/turf/open/floor/engine,
/area/station/engineering/supermatter/room)
"X" = (
/obj/structure/sign/delam_procedure/directional/south,
/turf/template_noop,
/area/template_noop)
"Y" = (
/obj/machinery/atmospherics/components/unary/delam_scram/directional/north{
	pixel_y = 12
	},
/turf/template_noop,
/area/template_noop)

(1,1,1) = {"
a
a
a
a
a
a
a
Y
"}
(2,1,1) = {"
R
d
g
X
a
a
a
a
"}
