//MAP CONVERTED BY dmm2tgm.py THIS HEADER COMMENT PREVENTS RECONVERSION, DO NOT REMOVE
"a" = (
/turf/closed/wall,
/area/station/common/cryopods)
"c" = (
/obj/structure/table,
/obj/item/clipboard,
/obj/item/screwdriver{
	pixel_y = 16
	},
/turf/open/floor/iron/dark,
/area/station/maintenance/port/greater)
"d" = (
/obj/effect/turf_decal/bot,
/obj/structure/frame/computer{
	anchored = 1;
	dir = 1
	},
/obj/structure/cable,
/turf/open/floor/iron/dark,
/area/station/maintenance/port/greater)
"e" = (
/obj/effect/spawner/structure/window/reinforced,
/obj/machinery/door/poddoor/shutters/preopen{
	id = "greylair";
	name = "Lair Privacy Shutter"
	},
/obj/machinery/atmospherics/pipe/smart/manifold4w/scrubbers/hidden/layer2,
/obj/structure/cable,
/turf/open/floor/plating,
/area/station/maintenance/port/greater)
"g" = (
/turf/open/floor/iron,
/area/station/common/cryopods)
"j" = (
/obj/machinery/computer/cryopod/directional/east,
/obj/machinery/atmospherics/pipe/smart/manifold4w/supply/hidden/layer4,
/turf/open/floor/iron,
/area/station/common/cryopods)
"l" = (
/obj/effect/spawner/structure/window/reinforced,
/turf/open/floor/plating,
/area/station/common/cryopods)
"o" = (
/obj/machinery/power/apc/auto_name/directional/west,
/obj/structure/cable,
/turf/open/floor/iron,
/area/station/common/cryopods)
"r" = (
/obj/effect/spawner/structure/window/reinforced,
/obj/machinery/door/poddoor/shutters/preopen{
	id = "greylair";
	name = "Lair Privacy Shutter"
	},
/obj/structure/cable,
/turf/open/floor/plating,
/area/station/maintenance/port/greater)
"u" = (
/obj/effect/turf_decal/bot,
/obj/structure/frame/computer{
	anchored = 1;
	dir = 1
	},
/obj/machinery/atmospherics/pipe/smart/manifold4w/supply/hidden/layer4,
/turf/open/floor/iron/dark,
/area/station/maintenance/port/greater)
"x" = (
/obj/machinery/cryopod,
/obj/effect/turf_decal/siding/white,
/obj/machinery/airalarm/directional/east,
/turf/open/floor/iron/dark,
/area/station/common/cryopods)
"z" = (
/obj/machinery/door/airlock/public/glass{
	name = "Cryopods"
	},
/obj/effect/landmark/navigate_destination,
/turf/open/floor/iron,
/area/station/common/cryopods)
"A" = (
/obj/machinery/cryopod,
/obj/effect/turf_decal/siding/white,
/obj/machinery/atmospherics/pipe/smart/manifold4w/supply/hidden/layer4,
/turf/open/floor/iron/dark,
/area/station/common/cryopods)
"D" = (
/obj/machinery/atmospherics/pipe/smart/manifold4w/supply/hidden/layer4,
/turf/open/floor/iron,
/area/station/common/cryopods)
"J" = (
/obj/effect/turf_decal/siding/white{
	dir = 1
	},
/obj/machinery/atmospherics/components/unary/vent_pump/on/layer4{
	dir = 1
	},
/obj/machinery/camera/directional/east,
/obj/machinery/time_clock/directional/east,
/obj/item/kirbyplants/random,
/turf/open/floor/iron/dark,
/area/station/common/cryopods)
"O" = (
/obj/machinery/cryopod,
/obj/effect/turf_decal/siding/white,
/obj/machinery/atmospherics/pipe/smart/manifold4w/scrubbers/hidden/layer2,
/turf/open/floor/iron/dark,
/area/station/common/cryopods)
"Q" = (
/obj/structure/table,
/obj/item/storage/briefcase/secure,
/obj/item/taperecorder,
/obj/structure/sign/warning/electric_shock/directional/south,
/turf/open/floor/iron/dark,
/area/station/maintenance/port/greater)
"R" = (
/obj/effect/spawner/structure/window/reinforced,
/obj/machinery/door/poddoor/shutters/preopen{
	id = "greylair";
	name = "Lair Privacy Shutter"
	},
/obj/machinery/atmospherics/pipe/smart/manifold4w/supply/hidden/layer4,
/obj/structure/cable,
/turf/open/floor/plating,
/area/station/maintenance/port/greater)
"S" = (
/obj/machinery/cryopod{
	dir = 1
	},
/obj/effect/turf_decal/siding/white{
	dir = 9
	},
/turf/open/floor/iron/dark,
/area/station/common/cryopods)
"U" = (
/turf/closed/wall,
/area/station/maintenance/port/greater)
"V" = (
/obj/structure/sign/poster/timeclock_psa/directional/west,
/turf/open/floor/iron,
/area/station/common/cryopods)
"W" = (
/obj/machinery/cryopod,
/obj/effect/turf_decal/siding/white,
/obj/structure/cable,
/obj/machinery/atmospherics/components/unary/vent_scrubber/on/layer2{
	dir = 4
	},
/obj/machinery/light/directional/west,
/turf/open/floor/iron/dark,
/area/station/common/cryopods)
"X" = (
/obj/effect/turf_decal/bot,
/obj/structure/frame/computer{
	anchored = 1;
	dir = 1
	},
/obj/machinery/atmospherics/pipe/smart/manifold4w/scrubbers/hidden/layer2,
/turf/open/floor/iron/dark,
/area/station/maintenance/port/greater)

(1,1,1) = {"
Q
a
a
a
a
a
"}
(2,1,1) = {"
d
r
W
o
V
l
"}
(3,1,1) = {"
X
e
O
g
g
z
"}
(4,1,1) = {"
u
R
A
D
S
l
"}
(5,1,1) = {"
c
r
x
j
J
l
"}
(6,1,1) = {"
U
a
a
a
a
a
"}
