//MAP CONVERTED BY dmm2tgm.py THIS HEADER COMMENT PREVENTS RECONVERSION, DO NOT REMOVE
"ab" = (
/obj/effect/spawner/structure/window/reinforced,
/turf/open/floor/plating,
/area/ruin/unpowered/colony/atmos)
"cl" = (
/turf/open/floor/iron,
/area/ruin/unpowered/colony/mess_hall)
"dv" = (
/obj/effect/spawner/structure/window/reinforced/plasma,
/turf/open/floor/plating,
/area/ruin/unpowered/colony/external_airlock)
"dJ" = (
/obj/effect/spawner/structure/window/reinforced/plasma,
/turf/open/floor/plating,
/area/ruin/unpowered/colony/operating_theatre)
"dX" = (
/turf/open/floor/iron,
/area/ruin/unpowered/colony/secure_storage)
"eo" = (
/obj/effect/spawner/structure/window/reinforced/plasma,
/turf/open/floor/plating,
/area/ruin/unpowered/colony/medbay)
"gb" = (
/turf/closed/wall,
/area/ruin/unpowered/colony/bathroom)
"gX" = (
/obj/effect/spawner/structure/window/reinforced/plasma,
/turf/open/floor/plating,
/area/shuttle/crow)
"ho" = (
/obj/structure/grille,
/turf/template_noop,
/area/template_noop)
"hE" = (
/obj/effect/spawner/structure/window/reinforced/plasma,
/turf/open/floor/plating,
/area/ruin/unpowered/colony/security)
"iw" = (
/turf/open/floor/iron,
/area/ruin/unpowered/colony/operating_theatre)
"ix" = (
/turf/closed/wall/r_wall,
/area/ruin/unpowered/colony/external_airlock)
"iR" = (
/obj/effect/spawner/structure/window/reinforced,
/turf/open/floor/plating,
/area/ruin/unpowered/colony/medbay)
"jd" = (
/turf/closed/wall/r_wall,
/area/ruin/unpowered/colony/mess_hall)
"kv" = (
/turf/closed/wall/r_wall,
/area/ruin/unpowered/colony/medbay)
"kH" = (
/obj/effect/spawner/structure/window/reinforced/plasma,
/turf/open/floor/plating,
/area/ruin/unpowered/colony/ops)
"md" = (
/obj/structure/railing{
	dir = 8
	},
/turf/open/floor/planetary/concrete,
/area/ruin/unpowered/colony/outdoors/cargo_bay)
"mo" = (
/turf/open/floor/engine/n2,
/area/ruin/unpowered/colony/atmos)
"ne" = (
/obj/structure/railing{
	dir = 8
	},
/turf/open/floor/planetary/concrete,
/area/template_noop)
"oD" = (
/obj/structure/railing,
/turf/open/floor/planetary/concrete,
/area/ruin/unpowered/colony/outdoors/cargo_bay)
"oJ" = (
/turf/open/floor/iron,
/area/ruin/unpowered/colony/security)
"qw" = (
/turf/closed/wall/r_wall,
/area/ruin/unpowered/colony/secure_storage)
"rN" = (
/turf/closed/wall,
/area/ruin/unpowered/colony/medbay)
"uw" = (
/turf/open/floor/iron,
/area/ruin/unpowered/colony/medbay)
"uF" = (
/turf/closed/wall,
/area/ruin/unpowered/colony/armory)
"vP" = (
/turf/open/floor/iron,
/area/ruin/unpowered/colony/engineering)
"ws" = (
/obj/effect/spawner/structure/window/reinforced,
/turf/open/floor/plating,
/area/ruin/unpowered/colony/engineering)
"wE" = (
/turf/open/floor/engine/o2,
/area/ruin/unpowered/colony/atmos)
"wM" = (
/obj/effect/spawner/structure/window/reinforced,
/turf/open/floor/plating,
/area/ruin/unpowered/colony/hallways)
"xk" = (
/turf/closed/wall,
/area/ruin/unpowered/colony/dorms)
"xG" = (
/turf/open/floor/iron,
/area/ruin/unpowered/colony/armory)
"yC" = (
/turf/closed/wall,
/area/ruin/unpowered/colony/mess_hall)
"yG" = (
/turf/open/floor/iron,
/area/ruin/unpowered/colony/dorms)
"yZ" = (
/turf/closed/wall,
/area/ruin/unpowered/colony/security)
"zc" = (
/turf/closed/wall/r_wall,
/area/ruin/unpowered/colony/dorms)
"zp" = (
/turf/closed/wall,
/area/ruin/unpowered/colony/hallways)
"zW" = (
/obj/effect/spawner/structure/window/reinforced,
/turf/open/floor/plating,
/area/ruin/unpowered/colony/security)
"AA" = (
/turf/open/floor/engine/airless,
/area/ruin/unpowered/colony/atmos)
"BT" = (
/turf/open/floor/planetary/concrete,
/area/template_noop)
"BY" = (
/turf/open/floor/iron,
/area/ruin/unpowered/colony/ops)
"Do" = (
/obj/effect/spawner/structure/window/reinforced,
/turf/open/floor/plating,
/area/ruin/unpowered/colony/mess_hall)
"Dx" = (
/obj/effect/spawner/structure/window/reinforced/plasma,
/turf/open/floor/plating,
/area/ruin/unpowered/colony/hallways)
"Eb" = (
/turf/closed/wall,
/area/ruin/unpowered/colony/engineering)
"Ej" = (
/turf/open/floor/iron,
/area/shuttle/crow)
"Er" = (
/turf/open/floor/iron,
/area/ruin/unpowered/colony/hallways)
"EP" = (
/turf/closed/wall/r_wall,
/area/ruin/unpowered/colony/armory)
"EY" = (
/turf/open/floor/iron,
/area/ruin/unpowered/colony/bathroom)
"Fc" = (
/obj/effect/spawner/structure/window/reinforced/plasma,
/turf/open/floor/plating,
/area/ruin/unpowered/colony/atmos)
"Ff" = (
/turf/open/floor/iron,
/area/ruin/unpowered/colony/atmos)
"FF" = (
/turf/closed/wall/r_wall,
/area/ruin/unpowered/colony/hallways)
"FK" = (
/turf/closed/wall/r_wall,
/area/ruin/unpowered/colony/ops)
"It" = (
/obj/effect/spawner/structure/window/reinforced/plasma,
/turf/open/floor/plating,
/area/ruin/unpowered/colony/mess_hall)
"Jg" = (
/turf/open/floor/iron,
/area/ruin/unpowered/colony/external_airlock)
"Jv" = (
/turf/template_noop,
/area/template_noop)
"JF" = (
/turf/closed/wall/r_wall,
/area/ruin/unpowered/colony/operating_theatre)
"Ly" = (
/turf/closed/wall,
/area/ruin/unpowered/colony/atmos)
"LD" = (
/turf/closed/wall/r_wall,
/area/ruin/unpowered/colony/atmos)
"Nm" = (
/obj/structure/grille,
/turf/open/floor/planetary/concrete,
/area/ruin/unpowered/colony/outdoors/cargo_bay)
"NA" = (
/turf/closed/wall/r_wall,
/area/template_noop)
"OQ" = (
/obj/structure/railing{
	dir = 1
	},
/turf/open/floor/planetary/concrete,
/area/template_noop)
"Pi" = (
/obj/effect/spawner/structure/window/reinforced/plasma,
/turf/open/floor/plating,
/area/ruin/unpowered/colony/engineering)
"PB" = (
/turf/closed/wall,
/area/ruin/unpowered/colony/ops)
"Qv" = (
/obj/structure/grille,
/turf/open/floor/planetary/concrete,
/area/template_noop)
"RS" = (
/turf/closed/wall,
/area/ruin/unpowered/colony/operating_theatre)
"SJ" = (
/turf/open/floor/planetary/concrete,
/area/ruin/unpowered/colony/outdoors/cargo_bay)
"Tt" = (
/turf/open/floor/planetary/concrete,
/area/ruin/unpowered/colony/ops)
"Tv" = (
/turf/open/floor/plating,
/area/ruin/unpowered/colony/external_airlock)
"VL" = (
/turf/closed/wall/r_wall,
/area/ruin/unpowered/colony/security)
"Wg" = (
/obj/structure/railing{
	dir = 4
	},
/turf/open/floor/planetary/concrete,
/area/ruin/unpowered/colony/outdoors/cargo_bay)
"Yx" = (
/obj/machinery/power/tracker,
/turf/open/floor/planetary/concrete,
/area/template_noop)
"YZ" = (
/turf/closed/wall/r_wall,
/area/ruin/unpowered/colony/engineering)
"Zf" = (
/obj/machinery/power/solar,
/turf/open/floor/planetary/concrete,
/area/template_noop)

(1,1,1) = {"
Jv
Jv
Jv
Jv
Jv
Jv
Jv
Jv
Jv
Jv
Jv
Jv
Jv
Jv
LD
Fc
Fc
Fc
gX
LD
ne
EP
EP
EP
EP
EP
EP
EP
EP
EP
EP
ne
ne
ne
ne
ne
NA
NA
Jv
"}
(2,1,1) = {"
Jv
Jv
Jv
Jv
Jv
Jv
Jv
Jv
Jv
LD
LD
LD
LD
LD
LD
Ff
Ff
Ff
Ff
LD
Fc
EP
xG
xG
xG
xG
xG
uF
xG
xG
VL
VL
hE
hE
hE
VL
VL
VL
Jv
"}
(3,1,1) = {"
Jv
Jv
Jv
Jv
Jv
Jv
Jv
Jv
Jv
LD
mo
mo
Fc
Ff
Ff
Ff
Ff
Ff
Ff
Ff
Ff
EP
xG
xG
xG
xG
xG
xG
xG
xG
VL
oJ
oJ
oJ
oJ
oJ
oJ
VL
Jv
"}
(4,1,1) = {"
Jv
Qv
Qv
Qv
Qv
Qv
Qv
Qv
Qv
LD
mo
mo
Fc
Ff
Ff
Ff
Ff
Ff
Ff
Ff
Ff
EP
EP
xG
EP
EP
EP
EP
EP
EP
VL
oJ
oJ
oJ
oJ
oJ
oJ
VL
Jv
"}
(5,1,1) = {"
Jv
Qv
BT
Zf
Zf
Yx
Zf
Zf
BT
LD
mo
mo
Fc
Ff
Ff
Ff
Ff
Ff
Ff
Ff
Ff
yZ
oJ
oJ
oJ
oJ
oJ
oJ
oJ
oJ
oJ
oJ
oJ
oJ
oJ
oJ
oJ
VL
Jv
"}
(6,1,1) = {"
Jv
Qv
BT
BT
BT
BT
BT
BT
BT
LD
LD
LD
LD
Ff
Ff
Ff
Ff
Ff
Ff
Ff
Ff
yZ
oJ
oJ
oJ
oJ
oJ
oJ
oJ
oJ
oJ
oJ
oJ
oJ
oJ
oJ
oJ
VL
Jv
"}
(7,1,1) = {"
Jv
Qv
BT
Zf
Zf
Zf
Zf
Zf
BT
LD
wE
wE
Fc
Ff
Ff
Ff
Ff
Ff
Ff
Ff
Ff
yZ
yZ
oJ
yZ
yZ
yZ
yZ
yZ
VL
VL
hE
hE
hE
hE
hE
VL
VL
Jv
"}
(8,1,1) = {"
Jv
Qv
BT
BT
BT
BT
BT
BT
BT
LD
wE
wE
Fc
Ff
Ff
Ff
Ff
Ff
Ff
Ff
Ff
yZ
oJ
oJ
oJ
yZ
Er
Er
Er
FF
FF
SJ
SJ
SJ
SJ
SJ
VL
VL
Jv
"}
(9,1,1) = {"
Jv
Qv
BT
Zf
Zf
Zf
Zf
Zf
BT
LD
LD
LD
LD
Ff
Ff
Ff
Ff
Ff
Ff
Ff
Ff
yZ
oJ
oJ
oJ
yZ
Er
Er
Er
FF
SJ
SJ
SJ
SJ
SJ
SJ
oD
Nm
BT
"}
(10,1,1) = {"
Jv
Qv
BT
BT
BT
BT
BT
BT
BT
LD
AA
AA
Fc
Ff
Ff
Ff
Ej
Ff
Ff
Ff
Ff
yZ
oJ
oJ
oJ
yZ
Er
Er
Er
FF
SJ
SJ
SJ
SJ
SJ
SJ
oD
Nm
BT
"}
(11,1,1) = {"
Jv
Qv
BT
Zf
Zf
Zf
Zf
Zf
BT
LD
AA
AA
Fc
Ff
Ff
Ff
Ff
Ff
Ff
Ff
Ff
yZ
oJ
oJ
oJ
yZ
zp
Er
zp
FF
SJ
SJ
SJ
SJ
SJ
SJ
oD
Nm
BT
"}
(12,1,1) = {"
Jv
Qv
BT
BT
BT
BT
BT
BT
BT
LD
LD
LD
LD
Ff
Ff
Ff
Ff
Ff
Ff
Ff
Ff
yZ
oJ
oJ
oJ
oJ
Er
Er
Er
FF
SJ
SJ
SJ
SJ
SJ
SJ
oD
Nm
BT
"}
(13,1,1) = {"
Jv
Qv
BT
Zf
Zf
Zf
Zf
BT
BT
OQ
BT
BT
Fc
Ff
Ff
Ff
Ff
Ff
Ff
Ff
Ff
yZ
oJ
oJ
oJ
yZ
Er
Er
Er
FF
SJ
SJ
SJ
SJ
SJ
SJ
SJ
md
BT
"}
(14,1,1) = {"
Jv
Qv
BT
BT
BT
BT
BT
BT
YZ
YZ
YZ
YZ
YZ
Eb
Eb
Eb
Eb
Eb
Ff
ab
Ly
yZ
oJ
oJ
oJ
yZ
Er
Er
Er
FF
SJ
SJ
SJ
SJ
SJ
SJ
SJ
SJ
BT
"}
(15,1,1) = {"
Jv
Qv
BT
Zf
Zf
Zf
Zf
BT
YZ
vP
vP
vP
vP
vP
vP
vP
vP
Eb
Er
Er
Er
yZ
zW
yZ
zW
yZ
Er
Er
Er
FF
SJ
SJ
SJ
SJ
SJ
SJ
SJ
Wg
BT
"}
(16,1,1) = {"
Jv
Qv
BT
BT
BT
BT
BT
BT
Pi
vP
vP
vP
vP
vP
vP
vP
vP
Eb
Er
Er
Er
Er
Er
Er
Er
Er
Er
Er
Er
Dx
SJ
SJ
SJ
SJ
SJ
SJ
oD
Nm
BT
"}
(17,1,1) = {"
Jv
Qv
BT
Zf
Zf
Zf
Zf
BT
Pi
vP
vP
vP
vP
vP
vP
vP
vP
vP
Er
Er
Er
Er
Er
Er
Er
Er
Er
Er
Er
Dx
SJ
SJ
SJ
SJ
SJ
SJ
oD
Nm
BT
"}
(18,1,1) = {"
Jv
Qv
BT
BT
BT
BT
BT
BT
Pi
vP
vP
vP
vP
vP
vP
vP
vP
ws
Er
Er
Er
gb
gb
gb
EY
gb
gb
Er
Er
FF
Dx
FF
FF
SJ
SJ
SJ
oD
Nm
BT
"}
(19,1,1) = {"
Jv
Qv
BT
Zf
Zf
Zf
Zf
BT
YZ
vP
vP
vP
vP
vP
vP
vP
vP
ws
Er
Er
Er
gb
EY
EY
EY
EY
gb
Er
Er
FF
Er
Er
Dx
SJ
SJ
SJ
oD
Nm
BT
"}
(20,1,1) = {"
Jv
BT
BT
BT
BT
BT
BT
BT
zc
xk
xk
xk
xk
xk
xk
xk
xk
xk
xk
Er
Er
gb
gb
gb
EY
EY
gb
Er
Er
Er
Er
Er
FF
ix
Tv
ix
ix
ix
BT
"}
(21,1,1) = {"
Jv
kH
kH
FK
FK
FK
FF
FF
zc
yG
yG
yG
xk
yG
xk
yG
yG
yG
xk
Er
Er
gb
EY
EY
EY
EY
gb
Er
Er
FF
Er
Er
Dx
Tv
Tv
Tv
dv
BT
BT
"}
(22,1,1) = {"
kH
kH
BY
FK
BY
PB
Er
Er
xk
xk
yG
xk
xk
yG
xk
xk
yG
xk
xk
Er
Er
gb
gb
gb
EY
EY
gb
Er
Er
FF
FF
FF
FF
Tv
Tv
Tv
ix
BT
BT
"}
(23,1,1) = {"
kH
BY
BY
BY
BY
PB
Er
Er
xk
yG
yG
yG
yG
yG
yG
yG
yG
yG
xk
Er
Er
gb
EY
EY
EY
EY
gb
Er
Er
FF
Er
Er
Dx
Tv
Tv
Tv
dv
BT
BT
"}
(24,1,1) = {"
kH
BY
BY
PB
PB
PB
Er
Er
xk
xk
yG
xk
xk
yG
xk
xk
yG
xk
xk
Er
Er
gb
gb
gb
EY
gb
gb
Er
Er
Er
Er
Er
FF
ix
Tv
dv
ix
ix
BT
"}
(25,1,1) = {"
kH
BY
BY
BY
BY
PB
zp
Er
xk
yG
yG
yG
xk
yG
xk
yG
yG
yG
xk
Er
Er
Er
Er
Er
Er
Er
Er
Er
Er
FF
Er
Er
Dx
Jg
Jg
Jg
Jg
ix
BT
"}
(26,1,1) = {"
kH
BY
BY
BY
BY
PB
Er
Er
xk
xk
xk
xk
xk
yG
xk
xk
xk
xk
xk
Er
Er
Er
Er
Er
Er
Er
Er
Er
Er
FF
Er
Er
FF
Jg
Jg
Jg
Jg
ix
BT
"}
(27,1,1) = {"
kH
BY
BY
BY
BY
BY
Er
Er
Er
Er
Er
Er
Er
Er
Er
Er
Er
Er
Er
Er
Er
Er
Er
Er
Er
Er
Er
Er
Er
Er
Er
Er
Er
Jg
Jg
Jg
Jg
ix
BT
"}
(28,1,1) = {"
kH
BY
BY
BY
BY
PB
Er
Er
Er
Er
Er
Er
Er
Er
Er
Er
Er
Er
Er
Er
Er
Er
Er
Er
Er
Er
Er
Er
Er
Er
Er
Er
Er
Jg
Jg
Jg
Jg
ix
BT
"}
(29,1,1) = {"
PB
PB
BY
BY
FK
FK
FF
Dx
kv
iR
uw
iR
rN
Do
Do
Do
cl
yC
yC
yC
yC
wM
Er
wM
wM
zp
wM
Er
wM
zp
zp
zp
FF
ix
ix
ix
ix
ix
BT
"}
(30,1,1) = {"
Jv
PB
BY
BY
FK
Tt
BT
BT
kv
uw
uw
uw
rN
cl
cl
cl
cl
yC
cl
cl
yC
Er
Er
Er
Er
zp
Er
Er
Er
Er
Er
Er
Er
Er
Er
Er
FF
BT
BT
"}
(31,1,1) = {"
qw
qw
qw
dX
qw
qw
NA
BT
eo
uw
uw
uw
rN
cl
cl
cl
cl
yC
cl
cl
yC
Er
Er
Er
Er
zp
Er
Er
Er
Er
Er
Er
Er
Er
Er
Er
FF
BT
Jv
"}
(32,1,1) = {"
qw
dX
dX
dX
dX
qw
BT
BT
eo
uw
uw
uw
rN
cl
cl
cl
cl
yC
cl
cl
yC
Er
Er
Er
Er
zp
Er
Er
Er
Er
Er
Er
Er
Er
Er
Er
Dx
BT
ho
"}
(33,1,1) = {"
qw
dX
dX
dX
dX
qw
BT
BT
kv
uw
uw
uw
rN
cl
cl
cl
cl
yC
cl
yC
yC
Er
Er
Er
Er
zp
Er
Er
Er
Er
Er
Er
Er
Er
Er
Er
Dx
BT
ho
"}
(34,1,1) = {"
qw
dX
dX
dX
dX
qw
BT
BT
JF
RS
iw
RS
RS
cl
cl
cl
cl
cl
cl
cl
yC
Er
Er
Er
Er
zp
Er
Er
Er
Er
Er
Er
Er
Er
Er
Er
FF
BT
ho
"}
(35,1,1) = {"
qw
qw
qw
qw
qw
qw
BT
BT
JF
iw
iw
iw
RS
cl
cl
cl
cl
cl
cl
cl
jd
FF
Dx
Dx
FF
FF
Er
Er
Er
Er
Er
Er
Er
Er
Er
Er
FF
BT
ho
"}
(36,1,1) = {"
Jv
Jv
Jv
Jv
Jv
ho
BT
BT
dJ
iw
iw
iw
RS
cl
cl
cl
cl
cl
cl
cl
jd
BT
BT
BT
BT
FF
FF
Er
Er
Er
Er
Er
Er
Er
Er
Er
FF
BT
ho
"}
(37,1,1) = {"
Jv
Jv
Jv
Jv
Jv
ho
BT
BT
JF
iw
iw
JF
JF
jd
It
It
It
jd
It
jd
jd
BT
Jv
Jv
BT
BT
FF
Dx
Dx
Dx
FF
FF
Dx
Dx
Dx
FF
FF
BT
ho
"}
(38,1,1) = {"
Jv
Jv
Jv
Jv
Jv
ho
BT
BT
JF
JF
JF
JF
BT
BT
BT
BT
BT
BT
BT
BT
BT
BT
Jv
Jv
Jv
BT
BT
BT
BT
BT
BT
BT
BT
BT
BT
BT
BT
BT
ho
"}
(39,1,1) = {"
Jv
Jv
Jv
Jv
Jv
ho
BT
BT
BT
BT
BT
BT
BT
Jv
Jv
Jv
Jv
Jv
Jv
Jv
Jv
Jv
Jv
Jv
Jv
Jv
Jv
Jv
Jv
Jv
Jv
Jv
Jv
Jv
Jv
Jv
Jv
Jv
ho
"}
(40,1,1) = {"
Jv
Jv
Jv
Jv
Jv
ho
ho
ho
ho
ho
ho
ho
ho
ho
ho
ho
ho
ho
ho
ho
ho
ho
ho
ho
ho
ho
ho
ho
ho
ho
ho
ho
ho
ho
ho
ho
ho
ho
ho
"}
