//MAP CONVERTED BY dmm2tgm.py THIS HEADER COMMENT PREVENTS RECONVERSION, DO NOT REMOVE
"aS" = (
/obj/structure/rack,
/obj/effect/spawner/lootdrop/maintenance,
/obj/effect/spawner/lootdrop/scanner,
/obj/effect/spawner/lootdrop/scanner,
/obj/effect/spawner/lootdrop/scanner,
/obj/effect/decal/cleanable/dirt,
/turf/open/floor/iron/white,
/area/ruin/unpowered)
"bm" = (
/obj/effect/spawner/clear,
/obj/effect/spawner/lootdrop/maintenance,
/turf/template_noop,
/area/template_noop)
"ce" = (
/obj/item/raw_anomaly_core/random,
/obj/effect/decal/cleanable/dirt,
/obj/effect/decal/cleanable/blood/old,
/turf/open/floor/engine,
/area/ruin/unpowered)
"ct" = (
/obj/structure/extinguisher_cabinet/directional/west,
/obj/effect/decal/cleanable/blood/old,
/obj/effect/decal/cleanable/dirt,
/obj/item/reagent_containers/glass/bucket,
/obj/effect/decal/cleanable/vomit/old,
/obj/structure/cable,
/turf/open/floor/carpet,
/area/ruin/unpowered)
"db" = (
/obj/effect/decal/cleanable/dirt,
/turf/open/floor/iron/white,
/area/ruin/unpowered)
"dn" = (
/obj/effect/spawner/lootdrop/maintenance,
/obj/effect/decal/cleanable/dirt,
/obj/machinery/light/directional/north,
/turf/open/floor/carpet,
/area/ruin/unpowered)
"fJ" = (
/turf/open/floor/plating,
/area/ruin/unpowered)
"fR" = (
/obj/effect/decal/cleanable/cobweb,
/obj/effect/decal/cleanable/dirt,
/turf/open/floor/engine,
/area/ruin/unpowered)
"gL" = (
/obj/effect/spawner/clear,
/obj/structure/closet/crate,
/obj/effect/spawner/lootdrop/donkpockets,
/turf/template_noop,
/area/template_noop)
"hQ" = (
/obj/structure/bed,
/obj/item/bedsheet/dorms,
/obj/effect/decal/cleanable/dirt,
/turf/open/floor/carpet,
/area/ruin/unpowered)
"ik" = (
/obj/effect/decal/cleanable/dirt,
/obj/structure/sign/warning/securearea{
	pixel_y = 32
	},
/turf/open/floor/iron/white,
/area/ruin/unpowered)
"iz" = (
/obj/structure/railing,
/obj/effect/decal/cleanable/dirt,
/obj/structure/cable,
/obj/machinery/power/port_gen/pacman,
/turf/open/floor/iron/white,
/area/ruin/unpowered)
"lv" = (
/obj/effect/decal/cleanable/dirt,
/mob/living/simple_animal/hostile/netherworld,
/turf/open/floor/engine,
/area/ruin/unpowered)
"oa" = (
/turf/closed/wall/concrete,
/area/ruin/unpowered)
"oN" = (
/obj/effect/decal/cleanable/blood/old,
/obj/effect/decal/cleanable/dirt,
/turf/open/floor/iron/white,
/area/ruin/unpowered)
"qo" = (
/obj/structure/table,
/obj/item/paper,
/obj/effect/spawner/lootdrop/contraband,
/obj/effect/decal/cleanable/dirt,
/turf/open/floor/iron/white,
/area/ruin/unpowered)
"rm" = (
/obj/structure/chair/office,
/obj/effect/decal/cleanable/dirt,
/obj/machinery/light/directional/east,
/turf/open/floor/iron/white,
/area/ruin/unpowered)
"tA" = (
/mob/living/simple_animal/hostile/asteroid/basilisk,
/obj/effect/decal/cleanable/greenglow/ecto,
/obj/effect/decal/cleanable/dirt,
/turf/open/floor/engine,
/area/ruin/unpowered)
"uy" = (
/obj/effect/decal/cleanable/dirt,
/turf/open/floor/plating,
/area/ruin/unpowered)
"wu" = (
/turf/template_noop,
/area/template_noop)
"BR" = (
/obj/effect/decal/cleanable/dirt,
/turf/open/floor/engine,
/area/ruin/unpowered)
"Cm" = (
/obj/effect/decal/cleanable/dirt,
/obj/machinery/light/directional/west,
/turf/open/floor/iron/white,
/area/ruin/unpowered)
"Cp" = (
/mob/living/simple_animal/hostile/netherworld,
/obj/effect/decal/cleanable/greenglow/ecto,
/obj/effect/decal/cleanable/dirt,
/turf/open/floor/engine,
/area/ruin/unpowered)
"CA" = (
/obj/effect/spawner/lootdrop/maintenance,
/obj/effect/decal/cleanable/dirt,
/turf/open/floor/carpet,
/area/ruin/unpowered)
"CY" = (
/obj/machinery/door/airlock,
/obj/effect/decal/cleanable/dirt,
/turf/open/floor/iron/white,
/area/ruin/unpowered)
"CZ" = (
/obj/effect/spawner/lootdrop/maintenance,
/obj/effect/decal/cleanable/dirt,
/obj/structure/cable,
/turf/open/floor/carpet,
/area/ruin/unpowered)
"DH" = (
/obj/effect/decal/cleanable/greenglow/ecto,
/obj/effect/decal/cleanable/dirt,
/turf/open/floor/iron/white,
/area/ruin/unpowered)
"DP" = (
/obj/effect/decal/cleanable/dirt,
/obj/structure/closet/emcloset,
/turf/open/floor/iron/white,
/area/ruin/unpowered)
"Er" = (
/obj/effect/spawner/clear,
/obj/machinery/power/floodlight,
/turf/template_noop,
/area/template_noop)
"EP" = (
/obj/structure/closet/crate/trashcart,
/obj/effect/spawner/clear,
/turf/template_noop,
/area/template_noop)
"Fj" = (
/obj/effect/spawner/lootdrop/away_loot,
/obj/effect/decal/cleanable/dirt,
/turf/open/floor/engine,
/area/ruin/unpowered)
"Gs" = (
/obj/effect/decal/cleanable/greenglow/ecto,
/obj/effect/decal/cleanable/dirt,
/turf/open/floor/carpet,
/area/ruin/unpowered)
"Hh" = (
/obj/effect/decal/cleanable/cobweb/cobweb2,
/obj/effect/decal/cleanable/dirt,
/obj/structure/bed,
/turf/open/floor/engine,
/area/ruin/unpowered)
"Km" = (
/mob/living/simple_animal/hostile/netherworld,
/obj/effect/decal/cleanable/dirt,
/turf/open/floor/engine,
/area/ruin/unpowered)
"Kr" = (
/obj/machinery/door/airlock/external,
/turf/open/floor/plating,
/area/ruin/unpowered)
"Kt" = (
/obj/effect/spawner/lootdrop/maintenance,
/turf/template_noop,
/area/template_noop)
"La" = (
/obj/structure/bed,
/obj/item/bedsheet/dorms,
/obj/effect/decal/cleanable/dirt,
/obj/machinery/power/apc/auto_name/east{
	start_charge = 0
	},
/obj/structure/cable,
/turf/open/floor/carpet,
/area/ruin/unpowered)
"Mq" = (
/obj/effect/spawner/lootdrop/maintenance,
/obj/structure/chair/office,
/obj/effect/decal/cleanable/dirt,
/obj/structure/cable,
/turf/open/floor/carpet,
/area/ruin/unpowered)
"Ni" = (
/obj/effect/spawner/clear,
/obj/structure/closet/crate,
/obj/effect/spawner/lootdrop/away_loot,
/obj/item/stack/sheet/mineral/plasma/five,
/obj/item/stack/sheet/mineral/plasma/five,
/turf/template_noop,
/area/template_noop)
"Ns" = (
/obj/structure/window/reinforced/fulltile,
/turf/open/floor/plating,
/area/ruin/unpowered)
"Pm" = (
/obj/structure/table/wood,
/obj/item/paper,
/obj/effect/decal/cleanable/dirt,
/turf/open/floor/carpet,
/area/ruin/unpowered)
"Pq" = (
/obj/structure/table,
/obj/item/clothing/mask/gas,
/obj/effect/spawner/lootdrop/contraband,
/obj/effect/decal/cleanable/dirt,
/turf/open/floor/iron/white,
/area/ruin/unpowered)
"Pu" = (
/obj/effect/decal/cleanable/dirt,
/obj/effect/mob_spawn/human/corpse/assistant,
/turf/open/floor/iron/white,
/area/ruin/unpowered)
"PC" = (
/obj/effect/spawner/clear,
/turf/template_noop,
/area/template_noop)
"Re" = (
/turf/closed/wall/r_wall,
/area/ruin/unpowered)
"RC" = (
/obj/effect/decal/cleanable/blood/old,
/obj/effect/decal/cleanable/dirt,
/obj/structure/cable,
/turf/open/floor/carpet,
/area/ruin/unpowered)
"SE" = (
/obj/structure/table/wood,
/obj/machinery/microwave,
/obj/effect/decal/cleanable/dirt,
/turf/open/floor/carpet,
/area/ruin/unpowered)
"TV" = (
/obj/effect/decal/cleanable/dirt,
/obj/effect/decal/cleanable/blood/old,
/turf/open/floor/engine,
/area/ruin/unpowered)
"Ux" = (
/obj/item/restraints/legcuffs/beartrap,
/turf/open/floor/plating,
/area/ruin/unpowered)
"Uz" = (
/obj/structure/bookcase/manuals/research_and_development,
/obj/effect/decal/cleanable/dirt,
/turf/open/floor/carpet,
/area/ruin/unpowered)
"VW" = (
/obj/effect/spawner/lootdrop/powercell,
/obj/item/storage/toolbox/emergency,
/obj/structure/rack,
/obj/effect/decal/cleanable/dirt,
/turf/open/floor/carpet,
/area/ruin/unpowered)
"Xd" = (
/obj/item/restraints/legcuffs/beartrap,
/obj/machinery/door/airlock/vault{
	locked = 1
	},
/obj/effect/decal/cleanable/dirt,
/turf/open/floor/engine,
/area/ruin/unpowered)
"Zo" = (
/obj/effect/decal/cleanable/cobweb/cobweb2,
/obj/structure/table/wood,
/obj/item/flashlight/lamp/green,
/obj/effect/decal/cleanable/dirt,
/turf/open/floor/carpet,
/area/ruin/unpowered)
"ZB" = (
/obj/machinery/door/airlock/vault{
	locked = 1
	},
/obj/effect/decal/cleanable/dirt,
/turf/open/floor/engine,
/area/ruin/unpowered)

(1,1,1) = {"
wu
wu
wu
wu
wu
wu
Kt
wu
wu
wu
PC
wu
wu
"}
(2,1,1) = {"
wu
Re
Re
Re
Re
oa
oa
oa
oa
oa
Kr
oa
wu
"}
(3,1,1) = {"
wu
Re
fR
Km
Xd
Cm
DP
aS
oa
Ux
fJ
oa
wu
"}
(4,1,1) = {"
Kt
Re
Fj
Cp
Ns
oN
DH
db
Kr
uy
Ux
oa
wu
"}
(5,1,1) = {"
wu
Re
Re
Re
Re
ik
Pu
oa
oa
oa
oa
oa
wu
"}
(6,1,1) = {"
wu
Re
ce
lv
ZB
DH
db
oa
iz
ct
SE
oa
wu
"}
(7,1,1) = {"
wu
Re
Hh
TV
Ns
db
db
oa
Uz
Mq
Pm
Ns
wu
"}
(8,1,1) = {"
wu
Re
Re
Re
Re
db
oN
CY
Gs
CZ
VW
Ns
wu
"}
(9,1,1) = {"
wu
Re
Fj
tA
ZB
db
Pq
oa
dn
RC
CA
Ns
wu
"}
(10,1,1) = {"
wu
Re
BR
Fj
Ns
rm
qo
oa
Zo
La
hQ
oa
wu
"}
(11,1,1) = {"
wu
Re
Re
Re
Re
oa
oa
oa
oa
oa
oa
oa
wu
"}
(12,1,1) = {"
wu
Re
PC
PC
Re
Er
Er
oa
gL
Ni
EP
oa
Kt
"}
(13,1,1) = {"
wu
PC
PC
PC
PC
PC
PC
PC
PC
bm
bm
bm
wu
"}
