//MAP CONVERTED BY dmm2tgm.py THIS HEADER COMMENT PREVENTS RECONVERSION, DO NOT REMOVE
"aG" = (
/obj/structure/table/wood,
/obj/effect/decal/cleanable/dirt,
/obj/item/paper,
/obj/item/pen/fountain,
/turf/open/floor/carpet,
/area/ruin/unpowered)
"aP" = (
/turf/template_noop,
/area/template_noop)
"bc" = (
/obj/machinery/power/mining_drill,
/obj/effect/ore_node_spawner/generous,
/turf/open/floor/planetary/rock,
/area/template_noop)
"cG" = (
/obj/effect/decal/cleanable/dirt,
/obj/structure/cable,
/obj/machinery/power/terminal,
/obj/machinery/light/small/directional/east,
/turf/open/floor/plating,
/area/ruin/unpowered)
"gr" = (
/obj/machinery/door/airlock/mining,
/turf/open/floor/plating,
/area/ruin/unpowered)
"hA" = (
/obj/item/storage/toolbox/mechanical,
/obj/effect/decal/cleanable/dirt,
/turf/open/floor/plating,
/area/ruin/unpowered)
"in" = (
/obj/structure/closet/crate,
/obj/effect/turf_decal/bot,
/obj/effect/spawner/lootdrop/maintenance/five,
/obj/effect/decal/cleanable/dirt,
/obj/machinery/button/door/directional/north{
	id = "mining_facil_north";
	name = "Mining Shutters"
	},
/turf/open/floor/iron,
/area/ruin/unpowered)
"lM" = (
/obj/structure/fence/corner{
	dir = 10
	},
/obj/effect/spawner/clear,
/turf/template_noop,
/area/template_noop)
"lO" = (
/obj/machinery/conveyor{
	id = "mining_facil"
	},
/turf/open/floor/plating,
/area/ruin/unpowered)
"mf" = (
/obj/structure/fence{
	dir = 8
	},
/obj/effect/spawner/clear,
/turf/template_noop,
/area/template_noop)
"mo" = (
/obj/structure/ore_box,
/obj/effect/turf_decal/bot,
/obj/effect/decal/cleanable/dirt,
/obj/machinery/light/warm/directional/east,
/turf/open/floor/iron,
/area/ruin/unpowered)
"nh" = (
/obj/effect/decal/cleanable/dirt,
/obj/machinery/light/warm/directional/west,
/turf/open/floor/iron,
/area/ruin/unpowered)
"nr" = (
/obj/effect/spawner/lootdrop/maintenance,
/obj/effect/decal/cleanable/dirt,
/obj/structure/rack,
/obj/item/stack/sheet/mineral/plasma/five,
/obj/effect/decal/cleanable/cobweb,
/turf/open/floor/plating,
/area/ruin/unpowered)
"nH" = (
/obj/structure/plasticflaps,
/obj/machinery/conveyor{
	id = "mining_facil"
	},
/turf/open/floor/plating,
/area/ruin/unpowered)
"nJ" = (
/turf/open/floor/carpet,
/area/ruin/unpowered)
"pC" = (
/obj/structure/chair/office,
/turf/open/floor/carpet,
/area/ruin/unpowered)
"qr" = (
/obj/effect/decal/cleanable/dirt,
/obj/item/stack/sheet/mineral/plasma/five,
/turf/open/floor/plating,
/area/ruin/unpowered)
"rC" = (
/obj/structure/grille/broken,
/obj/effect/spawner/clear,
/turf/template_noop,
/area/template_noop)
"rF" = (
/turf/open/floor/iron,
/area/ruin/unpowered)
"uH" = (
/obj/effect/spawner/clear,
/turf/template_noop,
/area/template_noop)
"wa" = (
/obj/effect/decal/cleanable/dirt,
/obj/machinery/door/airlock/mining,
/turf/open/floor/iron,
/area/ruin/unpowered)
"xi" = (
/obj/structure/fence/cut/large{
	dir = 8
	},
/obj/effect/spawner/clear,
/turf/template_noop,
/area/template_noop)
"xM" = (
/obj/machinery/conveyor{
	id = "mining_facil"
	},
/obj/machinery/light/warm/directional/west,
/turf/open/floor/plating,
/area/ruin/unpowered)
"zb" = (
/obj/effect/decal/cleanable/dirt,
/obj/effect/spawner/lootdrop/away_loot,
/obj/item/clothing/under/suit/beige,
/obj/item/clothing/shoes/laceup,
/obj/item/megaphone,
/obj/structure/closet,
/turf/open/floor/carpet,
/area/ruin/unpowered)
"zX" = (
/obj/effect/spawner/clear,
/obj/effect/spawner/clear,
/turf/template_noop,
/area/template_noop)
"Ae" = (
/obj/effect/decal/cleanable/dirt,
/obj/structure/cable,
/obj/machinery/power/smes,
/turf/open/floor/plating,
/area/ruin/unpowered)
"Av" = (
/obj/structure/fence,
/obj/effect/spawner/clear,
/turf/template_noop,
/area/template_noop)
"Cr" = (
/obj/structure/fence/corner{
	dir = 8
	},
/obj/effect/spawner/clear,
/turf/template_noop,
/area/template_noop)
"Cy" = (
/obj/structure/closet/crate,
/obj/effect/turf_decal/bot,
/obj/effect/spawner/lootdrop/away_loot,
/obj/effect/decal/cleanable/dirt,
/turf/open/floor/iron,
/area/ruin/unpowered)
"Dr" = (
/obj/machinery/door/poddoor/shutters{
	id = "mining_facil_south"
	},
/turf/open/floor/iron,
/area/ruin/unpowered)
"DA" = (
/obj/effect/decal/cleanable/dirt,
/obj/machinery/power/port_gen/pacman,
/obj/structure/cable,
/turf/open/floor/plating,
/area/ruin/unpowered)
"DN" = (
/turf/closed/wall,
/area/ruin/unpowered)
"Es" = (
/obj/structure/cable,
/turf/open/floor/planetary/rock,
/area/template_noop)
"Ey" = (
/obj/structure/filingcabinet,
/turf/open/floor/carpet,
/area/ruin/unpowered)
"FW" = (
/obj/effect/decal/cleanable/dirt,
/obj/machinery/power/apc/auto_name/south,
/obj/structure/cable,
/obj/item/stack/sheet/mineral/plasma/five,
/turf/open/floor/plating,
/area/ruin/unpowered)
"Gx" = (
/obj/effect/decal/cleanable/dirt,
/turf/open/floor/carpet,
/area/ruin/unpowered)
"He" = (
/obj/structure/closet,
/obj/effect/spawner/lootdrop/clothes,
/obj/effect/spawner/lootdrop/shoes,
/obj/effect/spawner/lootdrop/gloves,
/obj/effect/spawner/lootdrop/headgear,
/obj/effect/decal/cleanable/dirt,
/obj/machinery/light/warm/directional/north,
/turf/open/floor/iron,
/area/ruin/unpowered)
"Hk" = (
/obj/structure/fence/corner,
/obj/effect/spawner/clear,
/turf/template_noop,
/area/template_noop)
"HP" = (
/obj/structure/cable,
/obj/effect/decal/cleanable/dirt,
/turf/open/floor/plating,
/area/ruin/unpowered)
"Jn" = (
/obj/structure/cable,
/obj/effect/spawner/structure/window/reinforced,
/turf/open/floor/plating,
/area/ruin/unpowered)
"Jx" = (
/obj/machinery/mining_brace,
/obj/structure/cable,
/turf/open/floor/planetary/rock,
/area/template_noop)
"KM" = (
/obj/effect/spawner/lootdrop/maintenance,
/obj/effect/decal/cleanable/dirt,
/turf/open/floor/iron,
/area/ruin/unpowered)
"Lf" = (
/obj/structure/closet/crate,
/obj/effect/turf_decal/bot,
/obj/effect/spawner/lootdrop/maintenance,
/obj/effect/decal/cleanable/dirt,
/turf/open/floor/iron,
/area/ruin/unpowered)
"LE" = (
/obj/effect/decal/cleanable/dirt,
/obj/machinery/light/warm/directional/north,
/turf/open/floor/carpet,
/area/ruin/unpowered)
"LJ" = (
/obj/structure/ore_box,
/turf/open/floor/planetary/rock,
/area/template_noop)
"Md" = (
/obj/item/kirbyplants/random,
/obj/effect/decal/cleanable/dirt,
/obj/effect/decal/cleanable/cobweb/cobweb2,
/turf/open/floor/carpet,
/area/ruin/unpowered)
"Mp" = (
/obj/effect/spawner/clear,
/obj/structure/cable,
/turf/template_noop,
/area/template_noop)
"MU" = (
/obj/effect/turf_decal/loading_area,
/obj/effect/decal/cleanable/dirt,
/obj/effect/decal/cleanable/cobweb,
/turf/open/floor/iron,
/area/ruin/unpowered)
"Nf" = (
/obj/machinery/door/poddoor/shutters{
	id = "mining_facil_north"
	},
/turf/open/floor/iron,
/area/ruin/unpowered)
"OG" = (
/turf/open/floor/planetary/rock,
/area/template_noop)
"PE" = (
/obj/item/stack/cable_coil,
/turf/open/floor/planetary/rock,
/area/template_noop)
"PG" = (
/obj/machinery/conveyor_switch/oneway{
	id = "mining_facil"
	},
/obj/effect/turf_decal/box,
/turf/open/floor/iron,
/area/ruin/unpowered)
"Qd" = (
/obj/effect/spawner/structure/window/reinforced,
/obj/machinery/door/poddoor/shutters/preopen{
	id = "mining_facil_privacy"
	},
/turf/open/floor/plating,
/area/ruin/unpowered)
"Re" = (
/obj/structure/closet,
/obj/effect/spawner/lootdrop/clothes,
/obj/effect/spawner/lootdrop/shoes,
/obj/effect/spawner/lootdrop/gloves,
/obj/effect/spawner/lootdrop/headgear,
/obj/effect/decal/cleanable/dirt,
/obj/effect/decal/cleanable/cobweb/cobweb2,
/turf/open/floor/iron,
/area/ruin/unpowered)
"RQ" = (
/obj/effect/decal/cleanable/dirt,
/obj/machinery/button/door/directional/south{
	id = "mining_facil_south";
	name = "Cargo Bay Shutters"
	},
/turf/open/floor/iron,
/area/ruin/unpowered)
"RZ" = (
/obj/structure/closet/crate,
/obj/effect/turf_decal/bot,
/obj/effect/spawner/lootdrop/maintenance,
/obj/effect/decal/cleanable/dirt,
/obj/machinery/light/warm/directional/east,
/turf/open/floor/iron,
/area/ruin/unpowered)
"Tw" = (
/obj/structure/closet,
/obj/effect/spawner/lootdrop/clothes,
/obj/effect/spawner/lootdrop/shoes,
/obj/effect/spawner/lootdrop/gloves,
/obj/effect/spawner/lootdrop/headgear,
/obj/effect/decal/cleanable/dirt,
/turf/open/floor/iron,
/area/ruin/unpowered)
"TF" = (
/obj/effect/spawner/lootdrop/maintenance,
/obj/effect/decal/cleanable/dirt,
/obj/structure/cable,
/turf/open/floor/plating,
/area/ruin/unpowered)
"UD" = (
/obj/structure/ore_box,
/obj/effect/turf_decal/bot,
/obj/effect/decal/cleanable/dirt,
/turf/open/floor/iron,
/area/ruin/unpowered)
"WO" = (
/obj/effect/spawner/lootdrop/maintenance,
/turf/open/floor/iron,
/area/ruin/unpowered)
"Yl" = (
/obj/effect/spawner/structure/window/reinforced,
/turf/open/floor/plating,
/area/ruin/unpowered)
"Zn" = (
/obj/effect/decal/cleanable/dirt,
/turf/open/floor/iron,
/area/ruin/unpowered)
"Zw" = (
/obj/machinery/mining_brace,
/turf/open/floor/planetary/rock,
/area/template_noop)
"ZJ" = (
/obj/structure/table/wood,
/obj/item/paper_bin,
/obj/machinery/button/door/directional/south{
	id = "mining_facil_privacy";
	name = "Privacy Shutters"
	},
/turf/open/floor/carpet,
/area/ruin/unpowered)

(1,1,1) = {"
Cr
Av
Av
Av
Av
Av
Av
Av
Av
Av
lM
aP
aP
aP
aP
aP
aP
aP
aP
aP
aP
aP
aP
uH
aP
"}
(2,1,1) = {"
mf
aP
aP
aP
aP
OG
aP
aP
aP
aP
mf
aP
aP
aP
aP
aP
aP
aP
aP
aP
aP
uH
uH
uH
uH
"}
(3,1,1) = {"
mf
aP
aP
aP
aP
OG
OG
uH
uH
DN
DN
DN
DN
DN
Yl
Yl
Yl
Yl
DN
DN
DN
DN
uH
uH
uH
"}
(4,1,1) = {"
mf
aP
aP
aP
uH
OG
Zw
uH
uH
xM
nH
lO
xM
lO
lO
nH
MU
KM
nh
Zn
Zn
Dr
uH
zX
aP
"}
(5,1,1) = {"
mf
aP
aP
aP
OG
OG
OG
OG
uH
uH
DN
Yl
Yl
Yl
Yl
Yl
PG
Zn
Zn
rF
rF
Dr
uH
uH
uH
"}
(6,1,1) = {"
xi
aP
aP
aP
OG
bc
OG
OG
OG
OG
Nf
rF
rF
rF
Zn
Zn
Zn
rF
rF
Zn
rF
Dr
uH
uH
aP
"}
(7,1,1) = {"
mf
aP
aP
OG
OG
OG
OG
OG
OG
uH
Nf
rF
KM
Zn
rF
rF
Zn
rF
Zn
Zn
WO
Dr
uH
uH
aP
"}
(8,1,1) = {"
mf
OG
OG
OG
OG
Es
OG
PE
uH
uH
DN
in
Cy
Zn
mo
UD
Zn
Zn
Lf
RZ
RQ
DN
uH
uH
uH
"}
(9,1,1) = {"
mf
aP
aP
uH
OG
Jx
OG
LJ
uH
uH
DN
DN
DN
wa
DN
Qd
wa
Qd
DN
DN
wa
DN
uH
uH
aP
"}
(10,1,1) = {"
rC
aP
OG
uH
OG
Es
OG
uH
OG
uH
DN
nr
hA
FW
DN
zb
nJ
ZJ
DN
Tw
Zn
DN
uH
uH
aP
"}
(11,1,1) = {"
uH
aP
aP
OG
uH
Es
Es
Mp
Mp
Mp
Jn
HP
qr
TF
DN
LE
pC
aG
DN
He
rF
gr
uH
uH
aP
"}
(12,1,1) = {"
rC
aP
aP
aP
aP
aP
aP
uH
OG
uH
DN
DA
cG
Ae
DN
Md
Gx
Ey
DN
Re
Zn
DN
uH
uH
uH
"}
(13,1,1) = {"
Hk
Av
Av
Av
Av
Av
Av
Av
Av
Av
DN
DN
DN
DN
DN
DN
Qd
DN
DN
Yl
DN
DN
aP
uH
aP
"}
