//MAP CONVERTED BY dmm2tgm.py THIS HEADER COMMENT PREVENTS RECONVERSION, DO NOT REMOVE
"a" = (
/turf/closed/wall/mineral/plastitanium,
/area/ruin/unpowered)
"b" = (
/obj/effect/decal/cleanable/blood/old,
/obj/machinery/light/small/directional/west,
/turf/open/floor/pod/dark,
/area/ruin/unpowered)
"c" = (
/obj/effect/turf_decal/stripes/line{
	dir = 6
	},
/obj/effect/decal/cleanable/dirt,
/turf/open/floor/plating,
/area/ruin/unpowered)
"d" = (
/obj/structure/window/reinforced/plasma/plastitanium,
/obj/structure/shuttle/engine/heater{
	dir = 1
	},
/turf/open/floor/plating,
/area/ruin/unpowered)
"e" = (
/obj/effect/spawner/random/away_loot,
/obj/effect/decal/cleanable/dirt,
/obj/effect/decal/cleanable/blood/old,
/turf/open/floor/iron/white,
/area/ruin/unpowered)
"f" = (
/obj/machinery/atmospherics/components/unary/vent_scrubber/on/layer2{
	dir = 1
	},
/obj/effect/decal/cleanable/dirt,
/turf/open/floor/pod/dark,
/area/ruin/unpowered)
"g" = (
/obj/structure/grille,
/obj/item/shard,
/turf/open/floor/plating,
/area/ruin/unpowered)
"h" = (
/obj/structure/window/reinforced/spawner/west,
/obj/structure/table/optable,
/turf/open/floor/iron/white,
/area/ruin/unpowered)
"i" = (
/obj/machinery/door/airlock/external,
/turf/open/floor/plating,
/area/ruin/unpowered)
"j" = (
/obj/machinery/atmospherics/pipe/smart/manifold4w/scrubbers/hidden,
/obj/effect/decal/cleanable/dirt,
/turf/open/floor/pod/dark,
/area/ruin/unpowered)
"k" = (
/obj/structure/cable,
/obj/effect/decal/cleanable/dirt,
/obj/effect/decal/cleanable/blood/old,
/turf/open/floor/pod/dark,
/area/ruin/unpowered)
"l" = (
/obj/machinery/atmospherics/components/unary/vent_pump/on{
	dir = 4
	},
/turf/open/floor/pod/dark,
/area/ruin/unpowered)
"m" = (
/obj/effect/turf_decal/stripes/line,
/obj/effect/spawner/random/medical/medicine,
/obj/effect/decal/cleanable/dirt,
/turf/open/floor/iron/white,
/area/ruin/unpowered)
"n" = (
/obj/effect/spawner/random/tech_supply,
/obj/effect/decal/cleanable/dirt,
/turf/open/floor/pod/dark,
/area/ruin/unpowered)
"o" = (
/turf/open/floor/pod/dark,
/area/ruin/unpowered)
"p" = (
/obj/structure/window/reinforced/spawner/north,
/obj/effect/spawner/random/tech_supply,
/obj/effect/decal/cleanable/dirt,
/turf/open/floor/pod/dark,
/area/ruin/unpowered)
"q" = (
/obj/structure/window/reinforced/spawner/west,
/obj/structure/chair/comfy/shuttle{
	dir = 4
	},
/obj/effect/decal/cleanable/dirt,
/turf/open/floor/pod/dark,
/area/ruin/unpowered)
"r" = (
/obj/effect/decal/cleanable/dirt,
/turf/open/floor/pod/dark,
/area/ruin/unpowered)
"s" = (
/obj/machinery/stasis,
/obj/effect/decal/cleanable/dirt,
/obj/machinery/light/small/directional/east,
/turf/open/floor/iron/white,
/area/ruin/unpowered)
"t" = (
/obj/structure/window/reinforced/spawner/north,
/obj/structure/window/reinforced/spawner/west,
/obj/effect/turf_decal/stripes/line{
	dir = 1
	},
/obj/structure/table,
/obj/item/storage/backpack/duffelbag/med/surgery,
/obj/effect/spawner/random/medical/medkit,
/turf/open/floor/iron/white,
/area/ruin/unpowered)
"u" = (
/obj/effect/decal/cleanable/dirt,
/obj/machinery/light/small/directional/east,
/turf/open/floor/pod/dark,
/area/ruin/unpowered)
"v" = (
/obj/effect/turf_decal/stripes/line{
	dir = 9
	},
/obj/effect/decal/cleanable/dirt,
/obj/machinery/light/small/directional/west,
/turf/open/floor/plating,
/area/ruin/unpowered)
"x" = (
/obj/structure/window/reinforced/spawner/east,
/obj/structure/chair/comfy/shuttle{
	dir = 8
	},
/turf/open/floor/pod/dark,
/area/ruin/unpowered)
"y" = (
/obj/structure/cable,
/obj/effect/decal/cleanable/dirt,
/turf/open/floor/pod/dark,
/area/ruin/unpowered)
"z" = (
/obj/effect/turf_decal/stripes/line,
/obj/effect/spawner/random/medical/equipment,
/obj/effect/decal/cleanable/dirt,
/turf/open/floor/iron/white,
/area/ruin/unpowered)
"B" = (
/obj/structure/window/reinforced/spawner/west,
/obj/effect/turf_decal/stripes/line,
/obj/machinery/computer/operating{
	dir = 4
	},
/turf/open/floor/iron/white,
/area/ruin/unpowered)
"C" = (
/obj/machinery/atmospherics/components/unary/portables_connector/visible{
	dir = 8
	},
/obj/machinery/portable_atmospherics/canister,
/obj/effect/turf_decal/box,
/obj/effect/decal/cleanable/dirt,
/obj/machinery/light/small/directional/north,
/turf/open/floor/plating,
/area/ruin/unpowered)
"D" = (
/obj/machinery/atmospherics/pipe/smart/manifold4w/supply/hidden,
/obj/effect/decal/cleanable/dirt,
/turf/open/floor/pod/dark,
/area/ruin/unpowered)
"E" = (
/obj/effect/turf_decal/stripes/line{
	dir = 4
	},
/obj/machinery/power/terminal{
	dir = 1
	},
/obj/structure/cable,
/obj/structure/closet/crate,
/obj/item/tank/internals/oxygen,
/turf/open/floor/plating,
/area/ruin/unpowered)
"G" = (
/obj/structure/window/reinforced/spawner/north,
/obj/effect/turf_decal/stripes/line{
	dir = 1
	},
/obj/effect/spawner/random/ballistic_weapon,
/obj/structure/table,
/obj/effect/decal/cleanable/dirt,
/turf/open/floor/iron/white,
/area/ruin/unpowered)
"H" = (
/obj/effect/turf_decal/stripes/line{
	dir = 4
	},
/obj/machinery/power/port_gen/pacman,
/obj/structure/cable,
/turf/open/floor/plating,
/area/ruin/unpowered)
"I" = (
/obj/effect/turf_decal/stripes/line{
	dir = 10
	},
/obj/effect/decal/cleanable/dirt,
/obj/effect/spawner/random/modsuit,
/turf/open/floor/plating,
/area/ruin/unpowered)
"J" = (
/obj/effect/decal/cleanable/dirt,
/obj/effect/mob_spawn/corpse/human/commander,
/turf/open/floor/pod/dark,
/area/ruin/unpowered)
"K" = (
/obj/effect/turf_decal/stripes/line{
	dir = 1
	},
/obj/effect/spawner/random/medical/medicine,
/obj/effect/decal/cleanable/dirt,
/turf/open/floor/iron/white,
/area/ruin/unpowered)
"N" = (
/obj/structure/window/reinforced/plasma/plastitanium,
/turf/open/floor/plating,
/area/ruin/unpowered)
"O" = (
/obj/effect/mob_spawn/corpse/human/assistant,
/obj/effect/decal/cleanable/dirt,
/turf/open/floor/pod/dark,
/area/ruin/unpowered)
"P" = (
/obj/machinery/atmospherics/components/unary/portables_connector/visible{
	dir = 4
	},
/obj/machinery/portable_atmospherics/canister/air,
/obj/effect/turf_decal/box,
/obj/effect/decal/cleanable/dirt,
/turf/open/floor/plating,
/area/ruin/unpowered)
"Q" = (
/obj/effect/spawner/random/away_loot,
/obj/effect/decal/cleanable/dirt,
/turf/open/floor/pod/dark,
/area/ruin/unpowered)
"R" = (
/obj/effect/turf_decal/stripes/line{
	dir = 5
	},
/obj/machinery/power/smes,
/obj/structure/cable,
/obj/machinery/light/small/directional/west,
/turf/open/floor/plating,
/area/ruin/unpowered)
"S" = (
/obj/item/stack/cable_coil,
/obj/effect/decal/cleanable/dirt,
/turf/open/floor/pod/dark,
/area/ruin/unpowered)
"T" = (
/obj/structure/shuttle/engine/propulsion/burst{
	dir = 1
	},
/turf/closed/wall/mineral/plastitanium,
/area/ruin/unpowered)
"U" = (
/obj/structure/window/reinforced/spawner/north,
/obj/effect/spawner/random/tech_supply/five,
/obj/structure/table,
/obj/item/pickaxe/drill,
/obj/effect/decal/cleanable/dirt,
/turf/open/floor/pod/dark,
/area/ruin/unpowered)
"W" = (
/obj/effect/mob_spawn/corpse/human/cargo_tech,
/obj/effect/decal/cleanable/dirt,
/obj/effect/decal/cleanable/blood/old,
/turf/open/floor/pod/dark,
/area/ruin/unpowered)
"Y" = (
/obj/effect/turf_decal/stripes/line{
	dir = 5
	},
/obj/effect/decal/cleanable/dirt,
/turf/open/floor/plating,
/area/ruin/unpowered)
"Z" = (
/obj/item/circuitboard/computer/apc_control,
/obj/effect/decal/cleanable/dirt,
/turf/open/floor/pod/dark,
/area/ruin/unpowered)

(1,1,1) = {"
a
a
a
a
N
N
a
a
a
a
"}
(2,1,1) = {"
T
d
r
b
n
r
N
v
I
a
"}
(3,1,1) = {"
a
a
n
Q
O
r
i
Y
c
i
"}
(4,1,1) = {"
a
P
o
l
Z
y
a
a
a
a
"}
(5,1,1) = {"
N
D
D
D
r
k
R
E
H
N
"}
(6,1,1) = {"
N
j
j
j
f
r
n
J
n
N
"}
(7,1,1) = {"
a
C
x
x
U
S
t
h
B
a
"}
(8,1,1) = {"
a
a
q
q
p
W
K
e
m
a
"}
(9,1,1) = {"
T
d
r
u
r
r
G
s
z
a
"}
(10,1,1) = {"
a
a
a
a
N
g
a
a
a
a
"}
