//MAP CONVERTED BY dmm2tgm.py THIS HEADER COMMENT PREVENTS RECONVERSION, DO NOT REMOVE
"aK" = (
/obj/machinery/door/airlock/external,
/obj/effect/mapping_helpers/airlock/cyclelink_helper{
	dir = 1
	},
/turf/open/floor/plating,
/area/ruin/space/has_grav/gasthelizard)
"bo" = (
/obj/structure/window/reinforced{
	dir = 4
	},
/obj/machinery/atmospherics/components/unary/outlet_injector,
/obj/effect/turf_decal/stripes/line{
	dir = 4
	},
/turf/open/floor/plasteel/airless/dark,
/area/ruin/space/has_grav/gasthelizard)
"cy" = (
/obj/machinery/portable_atmospherics/scrubber,
/obj/effect/turf_decal/bot,
/turf/open/floor/plasteel,
/area/ruin/space/has_grav/gasthelizard)
"dl" = (
/obj/structure/table/reinforced,
/obj/item/reagent_containers/syringe,
/obj/item/reagent_containers/dropper,
/obj/item/reagent_containers/glass/bottle/mutagen,
/obj/item/reagent_containers/glass/bottle/mutagen,
/obj/item/razor,
/turf/open/floor/plasteel/airless/dark,
/area/ruin/space/has_grav/gasthelizard)
"gD" = (
/obj/structure/window/reinforced{
	dir = 8
	},
/obj/machinery/light{
	dir = 1
	},
/obj/structure/bed,
/obj/effect/turf_decal/stripes/line{
	dir = 8
	},
/obj/effect/decal/cleanable/blood/tracks{
	dir = 8
	},
/obj/item/paper/crumpled,
/turf/open/floor/plasteel/airless/dark,
/area/ruin/space/has_grav/gasthelizard)
"gS" = (
/obj/machinery/atmospherics/pipe/simple/general/visible{
	dir = 9
	},
/obj/machinery/light{
	dir = 4
	},
/turf/open/floor/plasteel,
/area/ruin/space/has_grav/gasthelizard)
"iS" = (
/obj/effect/turf_decal/stripes/line{
	dir = 8
	},
/turf/open/floor/plasteel/airless/dark,
/area/ruin/space/has_grav/gasthelizard)
"kN" = (
/obj/machinery/atmospherics/pipe/manifold/general/visible{
	dir = 1
	},
/obj/machinery/power/apc{
	dir = 1;
	name = "Worn-out APC";
	pixel_x = 1;
	pixel_y = 23
	},
/obj/machinery/light{
	dir = 1
	},
/obj/structure/cable,
/turf/open/floor/plasteel,
/area/ruin/space/has_grav/gasthelizard)
"lb" = (
/obj/item/reagent_containers/glass/bottle/morphine{
	pixel_x = -4;
	pixel_y = 1
	},
/obj/item/reagent_containers/glass/bottle/chloralhydrate,
/obj/item/reagent_containers/glass/bottle/toxin{
	pixel_x = 6;
	pixel_y = 8
	},
/obj/item/reagent_containers/glass/bottle/morphine{
	pixel_x = 5;
	pixel_y = 1
	},
/obj/item/reagent_containers/glass/bottle/facid{
	name = "fluorosulfuric acid bottle";
	pixel_x = -3;
	pixel_y = 6
	},
/obj/structure/table/reinforced,
/turf/open/floor/plasteel/airless/dark,
/area/ruin/space/has_grav/gasthelizard)
"nw" = (
/turf/template_noop,
/area/template_noop)
"oM" = (
/obj/structure/table,
/obj/item/paper_bin,
/turf/open/floor/plasteel,
/area/ruin/space/has_grav/gasthelizard)
"oZ" = (
/obj/structure/window/reinforced{
	dir = 4
	},
/obj/effect/turf_decal/stripes/line{
	dir = 4
	},
/obj/effect/decal/cleanable/blood/tracks{
	dir = 5
	},
/turf/open/floor/plasteel/airless/dark,
/area/ruin/space/has_grav/gasthelizard)
"pM" = (
/obj/machinery/atmospherics/pipe/manifold/general/visible{
	dir = 4
	},
/turf/open/floor/plasteel,
/area/ruin/space/has_grav/gasthelizard)
"pW" = (
/obj/structure/table/reinforced,
/obj/item/surgicaldrill,
/obj/item/hemostat,
/obj/item/scalpel,
/obj/item/surgical_drapes,
/obj/item/retractor,
/obj/item/cautery,
/obj/item/circular_saw,
/obj/machinery/light,
/turf/open/floor/plasteel/airless/dark,
/area/ruin/space/has_grav/gasthelizard)
"qZ" = (
/obj/structure/kitchenspike,
/turf/open/floor/plasteel/airless/dark,
/area/ruin/space/has_grav/gasthelizard)
"rG" = (
/obj/structure/window/reinforced{
	dir = 8
	},
/obj/effect/turf_decal/stripes/line{
	dir = 8
	},
/turf/open/floor/plasteel/airless/dark,
/area/ruin/space/has_grav/gasthelizard)
"sh" = (
/obj/structure/lattice,
/turf/template_noop,
/area/template_noop)
"sA" = (
/obj/machinery/atmospherics/pipe/simple/general/visible{
	dir = 9
	},
/turf/open/floor/plasteel,
/area/ruin/space/has_grav/gasthelizard)
"vk" = (
/obj/structure/chair/office,
/turf/open/floor/plasteel,
/area/ruin/space/has_grav/gasthelizard)
"vn" = (
/obj/structure/closet/crate/freezer,
/obj/item/stack/sheet/animalhide/lizard,
/obj/item/food/meat/slab/human/mutant/lizard,
/obj/item/food/meat/slab/human/mutant/lizard,
/obj/item/food/meat/slab/human/mutant/lizard,
/obj/item/food/meat/slab/human/mutant/lizard,
/obj/item/food/meat/slab/human/mutant/lizard,
/obj/item/food/meat/slab/human/mutant/lizard,
/turf/open/floor/plasteel/airless/dark,
/area/ruin/space/has_grav/gasthelizard)
"wy" = (
/turf/open/floor/plating,
/area/ruin/space/has_grav/gasthelizard)
"wR" = (
/obj/machinery/atmospherics/components/unary/portables_connector/visible{
	dir = 4
	},
/obj/machinery/portable_atmospherics/canister/nitrous_oxide,
/turf/open/floor/plasteel,
/area/ruin/space/has_grav/gasthelizard)
"xg" = (
/obj/structure/window/reinforced{
	dir = 8
	},
/obj/machinery/light{
	dir = 1
	},
/obj/structure/bed,
/obj/effect/decal/remains/human,
/obj/effect/turf_decal/stripes/line{
	dir = 8
	},
/turf/open/floor/plasteel/airless/dark,
/area/ruin/space/has_grav/gasthelizard)
"xj" = (
/obj/machinery/atmospherics/pipe/manifold/general/visible,
/turf/open/floor/plasteel,
/area/ruin/space/has_grav/gasthelizard)
"xQ" = (
/turf/open/floor/plasteel,
/area/ruin/space/has_grav/gasthelizard)
"zN" = (
/obj/machinery/portable_atmospherics/pump,
/obj/effect/turf_decal/bot,
/turf/open/floor/plasteel,
/area/ruin/space/has_grav/gasthelizard)
"Ce" = (
/turf/open/floor/plasteel/airless/dark,
/area/ruin/space/has_grav/gasthelizard)
"CR" = (
/obj/structure/table/reinforced,
/obj/item/kitchen/knife/butcher,
/obj/item/restraints/handcuffs,
/obj/item/reagent_containers/spray/pepper,
/turf/open/floor/plasteel/airless/dark,
/area/ruin/space/has_grav/gasthelizard)
"Dj" = (
/obj/machinery/atmospherics/components/unary/portables_connector/visible{
	dir = 4
	},
/obj/machinery/portable_atmospherics/canister/carbon_dioxide,
/turf/open/floor/plasteel,
/area/ruin/space/has_grav/gasthelizard)
"Dk" = (
/obj/machinery/light,
/turf/open/floor/plasteel,
/area/ruin/space/has_grav/gasthelizard)
"DP" = (
/obj/structure/rack,
/obj/item/storage/toolbox/drone,
/obj/item/melee/baton/cattleprod,
/turf/open/floor/plasteel,
/area/ruin/space/has_grav/gasthelizard)
"Eh" = (
/obj/machinery/gibber,
/turf/open/floor/plasteel/airless/dark,
/area/ruin/space/has_grav/gasthelizard)
"EI" = (
/obj/structure/window/reinforced{
	dir = 4
	},
/obj/effect/turf_decal/stripes/line{
	dir = 4
	},
/turf/open/floor/plasteel/airless/dark,
/area/ruin/space/has_grav/gasthelizard)
"Fx" = (
/obj/structure/closet/crate/freezer,
/obj/item/food/meat/slab/human/mutant/lizard,
/obj/item/food/meat/slab/human/mutant/lizard,
/obj/item/food/meat/slab/human/mutant/lizard,
/obj/item/food/meat/slab/human/mutant/lizard,
/obj/item/food/meat/slab/human/mutant/lizard,
/obj/machinery/light{
	dir = 1
	},
/obj/item/food/meat/slab/human/mutant/lizard,
/obj/item/food/meat/slab/human/mutant/lizard,
/turf/open/floor/plasteel/airless/dark,
/area/ruin/space/has_grav/gasthelizard)
"Gg" = (
/obj/structure/table,
/obj/item/pen/red,
/turf/open/floor/plasteel,
/area/ruin/space/has_grav/gasthelizard)
"Ha" = (
/obj/machinery/atmospherics/components/unary/outlet_injector,
/obj/effect/turf_decal/stripes/line{
	dir = 4
	},
/turf/open/floor/plasteel/airless/dark,
/area/ruin/space/has_grav/gasthelizard)
"Ht" = (
/obj/structure/table/optable,
/obj/effect/decal/cleanable/blood/old,
/turf/open/floor/plasteel/airless/dark,
/area/ruin/space/has_grav/gasthelizard)
"HJ" = (
/obj/machinery/light{
	dir = 1
	},
/obj/structure/bed,
/obj/effect/decal/remains/human,
/obj/effect/turf_decal/stripes/line{
	dir = 8
	},
/obj/effect/decal/cleanable/blood,
/turf/open/floor/plasteel/airless/dark,
/area/ruin/space/has_grav/gasthelizard)
"Il" = (
/obj/structure/window/reinforced{
	dir = 4
	},
/obj/machinery/light,
/obj/structure/table,
/obj/item/gps/spaceruin,
/turf/open/floor/plasteel,
/area/ruin/space/has_grav/gasthelizard)
"IE" = (
/obj/machinery/atmospherics/pipe/simple/general/visible{
	dir = 4
	},
/turf/open/floor/plasteel,
/area/ruin/space/has_grav/gasthelizard)
"JR" = (
/obj/structure/closet/crate/freezer,
/obj/item/food/meat/slab/human/mutant/lizard,
/obj/item/food/meat/slab/human/mutant/lizard,
/obj/item/food/meat/slab/human/mutant/lizard,
/obj/item/food/meat/slab/human/mutant/lizard,
/obj/item/clothing/under/rank/prisoner,
/obj/item/food/meat/slab/human/mutant/lizard,
/obj/item/food/meat/slab/human/mutant/lizard,
/obj/item/food/meat/slab/human/mutant/lizard,
/turf/open/floor/plasteel/airless/dark,
/area/ruin/space/has_grav/gasthelizard)
"NL" = (
/obj/structure/window/reinforced{
	dir = 1;
	layer = 2.9
	},
/obj/effect/turf_decal/tile/blue{
	dir = 1
	},
/obj/effect/turf_decal/tile/blue{
	dir = 4
	},
/turf/open/floor/plasteel,
/area/ruin/space/has_grav/gasthelizard)
"PN" = (
/obj/structure/window/reinforced{
	dir = 8
	},
/obj/machinery/light{
	dir = 1
	},
/obj/structure/bed,
/obj/effect/decal/remains/human,
/obj/effect/turf_decal/stripes/line{
	dir = 8
	},
/obj/item/toy/plush/lizardplushie,
/turf/open/floor/plasteel/airless/dark,
/area/ruin/space/has_grav/gasthelizard)
"Qf" = (
/obj/machinery/door/airlock/security,
/turf/open/floor/plasteel/airless/dark,
/area/ruin/space/has_grav/gasthelizard)
"Qh" = (
/obj/machinery/door/window/brigdoor/northleft,
/obj/machinery/atmospherics/components/binary/pump{
	dir = 1
	},
/obj/effect/turf_decal/tile/blue{
	dir = 1
	},
/obj/effect/turf_decal/tile/blue{
	dir = 4
	},
/turf/open/floor/plasteel,
/area/ruin/space/has_grav/gasthelizard)
"Ra" = (
/obj/structure/table,
/obj/item/storage/box/prisoner,
/turf/open/floor/plasteel,
/area/ruin/space/has_grav/gasthelizard)
"Rk" = (
/obj/machinery/atmospherics/components/unary/portables_connector/visible{
	dir = 4
	},
/obj/machinery/portable_atmospherics/canister/toxins,
/turf/open/floor/plasteel,
/area/ruin/space/has_grav/gasthelizard)
"RL" = (
/obj/effect/turf_decal/stripes/line{
	dir = 4
	},
/turf/open/floor/plasteel/airless/dark,
/area/ruin/space/has_grav/gasthelizard)
"RW" = (
/obj/structure/table/reinforced,
/obj/item/clothing/suit/straight_jacket,
/obj/item/reagent_containers/syringe/lethal,
/obj/item/reagent_containers/syringe/lethal/choral,
/turf/open/floor/plasteel/airless/dark,
/area/ruin/space/has_grav/gasthelizard)
"Se" = (
/obj/structure/window/reinforced{
	dir = 4
	},
/obj/machinery/atmospherics/components/unary/outlet_injector,
/obj/effect/turf_decal/stripes/line{
	dir = 4
	},
/obj/effect/decal/cleanable/blood/tracks{
	dir = 1
	},
/turf/open/floor/plasteel/airless/dark,
/area/ruin/space/has_grav/gasthelizard)
"Ts" = (
/obj/structure/closet/emcloset,
/turf/open/floor/plasteel,
/area/ruin/space/has_grav/gasthelizard)
"UN" = (
/obj/machinery/door/airlock/external,
/obj/effect/mapping_helpers/airlock/cyclelink_helper,
/turf/open/floor/plating,
/area/ruin/space/has_grav/gasthelizard)
"Xz" = (
/turf/closed/wall,
/area/ruin/space/has_grav/gasthelizard)
"ZZ" = (
/obj/machinery/suit_storage_unit/standard_unit,
/turf/open/floor/plasteel,
/area/ruin/space/has_grav/gasthelizard)

(1,1,1) = {"
nw
nw
nw
nw
nw
nw
nw
nw
sh
nw
nw
nw
nw
nw
"}
(2,1,1) = {"
nw
nw
nw
sh
sh
sh
sh
nw
sh
sh
sh
nw
nw
nw
"}
(3,1,1) = {"
nw
nw
nw
sh
sh
Xz
Xz
Xz
Xz
Xz
Xz
Xz
sh
nw
"}
(4,1,1) = {"
nw
sh
sh
sh
sh
Xz
wR
Dj
Rk
DP
ZZ
Xz
sh
sh
"}
(5,1,1) = {"
sh
nw
Xz
Xz
Xz
Xz
kN
pM
sA
xQ
Dk
Xz
Xz
Xz
"}
(6,1,1) = {"
nw
sh
Xz
HJ
iS
NL
IE
xQ
xQ
xQ
xQ
UN
wy
aK
"}
(7,1,1) = {"
sh
sh
Xz
EI
bo
Qh
xj
xQ
xQ
xQ
Ts
Xz
Xz
Xz
"}
(8,1,1) = {"
nw
sh
Xz
PN
rG
NL
IE
xQ
xQ
Gg
Xz
Xz
sh
sh
"}
(9,1,1) = {"
sh
sh
Xz
EI
bo
Qh
xj
xQ
vk
oM
Xz
sh
sh
nw
"}
(10,1,1) = {"
nw
nw
Xz
gD
rG
NL
IE
xQ
xQ
Ra
Xz
sh
nw
nw
"}
(11,1,1) = {"
sh
sh
Xz
oZ
Se
Qh
xj
xQ
xQ
Il
Xz
sh
nw
nw
"}
(12,1,1) = {"
sh
nw
Xz
xg
rG
NL
IE
xQ
xQ
cy
Xz
sh
nw
nw
"}
(13,1,1) = {"
nw
sh
Xz
RL
Ha
Qh
gS
xQ
xQ
zN
Xz
sh
nw
nw
"}
(14,1,1) = {"
nw
sh
Xz
Xz
Xz
Xz
Xz
Xz
Qf
Xz
Xz
sh
nw
nw
"}
(15,1,1) = {"
nw
sh
sh
Xz
vn
Ce
qZ
Eh
Ce
pW
Xz
nw
nw
nw
"}
(16,1,1) = {"
nw
sh
sh
Xz
Fx
Ce
Ce
Ce
Ce
Ht
Xz
nw
nw
nw
"}
(17,1,1) = {"
nw
nw
sh
Xz
JR
Ce
CR
RW
lb
dl
Xz
sh
sh
nw
"}
(18,1,1) = {"
nw
nw
sh
Xz
Xz
Xz
Xz
Xz
Xz
Xz
Xz
sh
nw
nw
"}
(19,1,1) = {"
nw
nw
nw
nw
sh
sh
nw
nw
sh
sh
sh
nw
nw
nw
"}
