//MAP CONVERTED BY dmm2tgm.py THIS HEADER COMMENT PREVENTS RECONVERSION, DO NOT REMOVE
"a" = (
/obj/structure/fans/tiny/invisible,
/turf/open/indestructible/reebe_void,
/area/ruin/powered/reebe/space)
"b" = (
/obj/structure/fluff/clockwork/clockgolem_remains,
/turf/open/floor/bronze/flat,
/area/ruin/powered/reebe)
"c" = (
/obj/structure/girder/bronze,
/turf/open/floor/bronze/flat,
/area/ruin/powered/reebe)
"d" = (
/obj/effect/decal/cleanable/blood/gibs/limb,
/turf/open/floor/bronze/flat,
/area/ruin/powered/reebe)
"e" = (
/turf/open/floor/bronze,
/area/ruin/powered/reebe)
"f" = (
/obj/effect/spawner/structure/window/bronze,
/turf/open/floor/bronze,
/area/ruin/powered/reebe)
"g" = (
/obj/effect/mob_spawn/corpse/human/blood_cultist,
/obj/structure/fluff/clockwork/alloy_shards/large{
	pixel_x = 16;
	pixel_y = -8
	},
/turf/open/floor/bronze,
/area/ruin/powered/reebe)
"h" = (
/obj/effect/decal/cleanable/blood,
/obj/item/clockwork/weapon/brass_battlehammer,
/turf/open/floor/bronze/filled,
/area/ruin/powered/reebe)
"j" = (
/obj/effect/mob_spawn/corpse/human/clock_cultist,
/turf/open/floor/bronze/filled,
/area/ruin/powered/reebe)
"k" = (
/obj/effect/decal/cleanable/blood/drip{
	pixel_x = 10;
	pixel_y = 4
	},
/obj/effect/decal/cleanable/blood/drip{
	pixel_x = 8;
	pixel_y = 11
	},
/obj/effect/decal/cleanable/blood/drip,
/turf/open/floor/bronze,
/area/ruin/powered/reebe)
"l" = (
/obj/effect/portal/permanent/one_way/reebe/leaving,
/turf/open/floor/bronze/filled,
/area/ruin/powered/reebe)
"m" = (
/obj/effect/mob_spawn/corpse/human/blood_cultist,
/obj/effect/decal/cleanable/blood,
/turf/open/floor/bronze/flat,
/area/ruin/powered/reebe)
"n" = (
/obj/effect/mob_spawn/corpse/human/blood_cultist,
/turf/open/floor/bronze/flat,
/area/ruin/powered/reebe)
"o" = (
/obj/effect/decal/cleanable/blood/gibs/core,
/turf/open/floor/bronze/flat,
/area/ruin/powered/reebe)
"p" = (
/turf/open/floor/bronze/flat,
/area/ruin/powered/reebe)
"q" = (
/obj/effect/landmark/portal_exit{
	id = "reebe_entry"
	},
/turf/open/floor/bronze/filled,
/area/ruin/powered/reebe)
"r" = (
/obj/structure/fluff/clockwork/alloy_shards/medium{
	pixel_x = 6;
	pixel_y = 7
	},
/turf/open/floor/bronze,
/area/ruin/powered/reebe)
"s" = (
/obj/effect/landmark/portal_exit{
	id = "reebe_entry"
	},
/turf/open/floor/bronze,
/area/ruin/powered/reebe)
"t" = (
/obj/effect/mob_spawn/corpse/human/blood_cultist,
/turf/open/floor/bronze/filled,
/area/ruin/powered/reebe)
"u" = (
/obj/effect/decal/cleanable/blood/footprints{
	dir = 4
	},
/turf/open/floor/bronze/flat,
/area/ruin/powered/reebe)
"v" = (
/turf/open/indestructible/reebe_void/spawning/lattices,
/area/ruin/powered/reebe/space)
"w" = (
/obj/structure/deployable_barricade/wooden,
/turf/open/floor/bronze/flat,
/area/ruin/powered/reebe)
"x" = (
/obj/item/stack/sheet/mineral/wood,
/turf/open/floor/bronze/flat,
/area/ruin/powered/reebe)
"y" = (
/obj/effect/mob_spawn/corpse/human/clock_cultist,
/obj/effect/decal/cleanable/blood,
/turf/open/floor/bronze/filled,
/area/ruin/powered/reebe)
"z" = (
/obj/effect/decal/cleanable/blood,
/turf/open/floor/bronze/flat,
/area/ruin/powered/reebe)
"A" = (
/turf/open/floor/bronze/filled,
/area/ruin/powered/reebe)
"B" = (
/obj/effect/decal/cleanable/blood/tracks,
/turf/open/floor/bronze/flat,
/area/ruin/powered/reebe)
"C" = (
/obj/structure/fluff/clockwork/blind_eye,
/turf/open/floor/bronze,
/area/ruin/powered/reebe)
"D" = (
/turf/open/indestructible/reebe_void,
/area/ruin/powered/reebe/space)
"E" = (
/obj/structure/table/reinforced{
	color = "#BC8D1E"
	},
/turf/open/floor/bronze/filled,
/area/ruin/powered/reebe)
"F" = (
/obj/effect/mob_spawn/corpse/human/clock_cultist,
/turf/open/floor/bronze,
/area/ruin/powered/reebe)
"G" = (
/obj/effect/decal/cleanable/blood/gibs/body,
/obj/item/clothing/suit/clockwork/cloak,
/turf/open/floor/bronze,
/area/ruin/powered/reebe)
"H" = (
/obj/effect/decal/cleanable/blood/gibs,
/turf/open/floor/bronze/flat,
/area/ruin/powered/reebe)
"J" = (
/obj/structure/deployable_barricade/wooden,
/turf/open/floor/bronze/filled,
/area/ruin/powered/reebe)
"K" = (
/obj/effect/decal/cleanable/blood/tracks,
/turf/open/floor/bronze/filled,
/area/ruin/powered/reebe)
"L" = (
/obj/item/paper/crumpled/bloody/reebe2,
/turf/open/floor/bronze,
/area/ruin/powered/reebe)
"M" = (
/obj/item/melee/cultblade/dagger{
	pixel_x = 9;
	pixel_y = 1
	},
/obj/effect/decal/cleanable/blood/splatter,
/turf/open/floor/bronze/filled,
/area/ruin/powered/reebe)
"P" = (
/obj/item/paper/crumpled/ruins/reebe1,
/turf/open/floor/bronze/flat,
/area/ruin/powered/reebe)
"Q" = (
/obj/effect/decal/cleanable/blood/splatter,
/turf/open/floor/bronze/flat,
/area/ruin/powered/reebe)
"R" = (
/turf/closed/wall/mineral/bronze,
/area/ruin/powered/reebe)
"S" = (
/obj/item/stack/sheet/mineral/wood,
/turf/open/floor/bronze/filled,
/area/ruin/powered/reebe)
"T" = (
/obj/structure/fluff/clockwork/alloy_shards/small{
	pixel_x = -4;
	pixel_y = -6
	},
/turf/open/floor/bronze/flat,
/area/ruin/powered/reebe)
"U" = (
/obj/effect/mob_spawn/corpse/human/blood_cultist,
/obj/effect/decal/cleanable/blood/tracks,
/turf/open/floor/bronze,
/area/ruin/powered/reebe)
"V" = (
/obj/effect/decal/cleanable/blood,
/turf/open/floor/bronze/filled,
/area/ruin/powered/reebe)
"W" = (
/obj/structure/fans/tiny/invisible,
/obj/structure/fans/tiny/invisible,
/turf/open/indestructible/reebe_void,
/area/ruin/powered/reebe/space)
"X" = (
/obj/effect/mob_spawn/corpse/human/blood_cultist,
/turf/open/floor/bronze,
/area/ruin/powered/reebe)
"Y" = (
/obj/structure/fluff/clockwork/alloy_shards/medium_gearbit{
	pixel_x = -5;
	pixel_y = 7
	},
/turf/open/floor/bronze/flat,
/area/ruin/powered/reebe)
"Z" = (
/obj/effect/spawner/structure/window/bronze,
/obj/effect/decal/cleanable/blood/splatter/over_window,
/turf/open/floor/bronze,
/area/ruin/powered/reebe)

(1,1,1) = {"
a
a
a
a
a
a
a
a
a
a
a
a
a
a
a
a
a
a
a
a
a
a
a
a
a
a
a
a
a
a
a
a
a
a
a
a
a
a
a
a
a
a
a
a
a
a
a
a
a
a
"}
(2,1,1) = {"
a
D
D
D
D
D
D
D
D
D
D
D
D
D
D
D
D
D
D
D
D
D
D
D
D
D
D
D
D
D
D
D
D
D
D
D
D
D
D
D
D
D
D
D
D
D
D
D
D
a
"}
(3,1,1) = {"
a
D
D
D
D
D
D
D
D
D
D
D
D
D
D
D
D
D
D
D
D
D
D
D
D
D
D
D
D
D
D
D
D
D
D
D
D
D
D
D
D
D
D
D
D
D
D
D
D
a
"}
(4,1,1) = {"
a
D
D
D
D
D
D
D
D
D
D
D
D
D
D
D
D
D
D
D
D
D
D
D
D
D
D
D
D
D
D
D
D
D
D
D
D
D
D
D
D
D
D
D
D
D
D
D
D
a
"}
(5,1,1) = {"
a
D
D
D
D
D
D
D
D
D
D
D
D
D
D
D
D
D
D
D
D
D
D
D
D
D
D
D
D
D
D
D
D
D
D
D
D
D
D
D
D
D
D
D
D
D
D
D
D
a
"}
(6,1,1) = {"
a
D
D
D
D
D
D
D
D
D
D
D
D
D
D
D
D
D
D
D
D
D
D
D
D
D
D
D
D
D
D
D
D
D
D
D
D
D
D
D
D
D
D
D
D
D
D
D
D
a
"}
(7,1,1) = {"
a
D
D
D
D
D
D
D
D
D
D
D
D
D
D
D
D
D
D
D
D
D
D
D
D
D
D
D
D
D
D
D
D
D
D
D
D
D
D
D
D
D
D
D
D
D
D
D
D
a
"}
(8,1,1) = {"
a
D
D
D
D
D
D
D
D
D
D
D
D
D
D
D
D
D
D
D
D
D
D
D
D
D
D
D
D
D
D
D
D
D
D
D
D
D
D
D
D
D
D
D
D
D
D
D
D
a
"}
(9,1,1) = {"
a
D
D
D
D
D
D
D
D
D
D
D
D
D
D
D
D
D
D
D
D
v
v
v
v
v
v
v
D
D
D
D
D
D
D
D
D
D
D
D
D
D
D
D
D
D
D
D
D
a
"}
(10,1,1) = {"
a
D
D
D
D
D
D
D
D
D
D
D
D
D
D
D
D
D
D
v
v
v
R
R
R
R
R
v
v
v
D
D
D
D
D
D
D
D
D
D
D
D
D
D
D
D
D
D
D
a
"}
(11,1,1) = {"
a
D
D
D
D
D
D
D
D
D
D
D
D
D
D
D
v
v
v
v
v
v
R
e
A
e
R
v
v
v
v
v
v
D
D
D
D
D
D
D
D
D
D
D
D
D
D
D
D
a
"}
(12,1,1) = {"
a
D
D
D
D
D
D
D
D
D
D
D
D
D
v
v
v
v
v
v
v
R
R
A
e
A
R
R
v
v
v
v
v
v
v
D
D
D
D
D
D
D
D
D
D
D
D
D
D
a
"}
(13,1,1) = {"
a
D
D
D
D
D
D
D
D
D
D
D
D
v
v
v
v
v
f
f
f
R
E
p
p
p
E
R
f
f
f
v
v
v
v
v
D
D
D
D
D
D
D
D
D
D
D
D
D
a
"}
(14,1,1) = {"
a
D
D
D
D
D
D
D
D
D
D
D
v
v
v
v
f
f
f
G
V
R
e
p
A
p
e
R
A
e
f
f
f
v
v
v
v
D
D
D
D
D
D
D
D
D
D
D
D
a
"}
(15,1,1) = {"
a
D
D
D
D
D
D
D
D
D
D
v
v
v
v
f
f
e
h
d
H
p
p
p
p
p
p
p
p
p
A
e
f
f
v
v
v
v
D
D
D
D
D
D
D
D
D
D
D
a
"}
(16,1,1) = {"
a
D
D
D
D
D
D
D
D
D
v
v
v
v
f
f
A
o
p
p
e
R
E
e
p
e
E
R
e
p
p
p
A
f
f
v
v
v
D
D
D
D
D
D
D
D
D
D
D
a
"}
(17,1,1) = {"
a
D
D
D
D
D
D
D
D
D
v
v
v
f
f
A
p
p
e
e
f
R
R
e
p
e
R
R
f
e
e
p
p
A
f
f
v
v
v
D
D
D
D
D
D
D
D
D
D
a
"}
(18,1,1) = {"
a
D
D
D
D
D
D
D
D
D
v
v
v
f
e
p
p
e
f
f
f
v
f
A
p
A
f
v
f
f
f
e
p
p
e
f
v
v
v
D
D
D
D
D
D
D
D
D
D
a
"}
(19,1,1) = {"
a
D
D
D
D
D
D
D
D
D
v
v
f
f
A
p
e
f
f
v
v
v
f
A
p
A
f
v
v
v
f
f
e
p
A
f
f
v
v
D
D
D
D
D
D
D
D
D
D
a
"}
(20,1,1) = {"
a
D
D
D
D
D
D
D
D
v
v
v
f
e
p
p
e
f
v
v
v
v
f
A
p
A
f
v
v
v
v
f
e
p
p
e
f
v
v
v
D
D
D
D
D
D
D
D
D
a
"}
(21,1,1) = {"
a
D
D
D
D
D
D
D
D
v
v
v
f
A
p
e
f
f
v
v
v
v
R
e
p
e
R
v
v
v
v
f
f
e
p
A
f
v
v
v
D
D
D
D
D
D
D
D
D
a
"}
(22,1,1) = {"
a
D
D
D
D
D
D
D
v
v
v
R
R
R
p
R
R
v
v
v
v
R
R
f
e
f
R
R
v
v
v
v
R
R
p
R
R
R
v
v
v
D
D
D
D
D
D
D
D
a
"}
(23,1,1) = {"
a
D
D
D
D
D
D
D
v
R
R
R
S
F
p
E
R
f
f
f
R
R
c
A
A
A
c
R
R
f
f
f
R
E
p
e
E
R
R
R
v
D
D
D
D
D
D
D
D
a
"}
(24,1,1) = {"
a
D
D
D
D
D
D
D
v
R
e
A
x
p
p
g
r
A
A
A
e
f
A
p
e
p
A
f
e
A
A
A
e
e
m
p
p
A
s
R
v
D
D
D
D
D
D
D
D
a
"}
(25,1,1) = {"
a
D
D
D
D
D
D
D
v
R
l
L
w
A
p
T
Y
p
p
p
p
e
A
e
A
e
A
e
b
p
n
p
p
p
z
A
p
e
q
R
v
D
D
D
D
D
D
D
D
a
"}
(26,1,1) = {"
a
D
D
D
D
D
D
D
v
R
k
y
x
p
p
e
U
K
V
A
e
f
A
p
e
p
A
f
F
A
A
A
e
e
u
P
p
A
s
R
v
D
D
D
D
D
D
D
D
a
"}
(27,1,1) = {"
a
D
D
D
D
D
D
D
v
R
R
R
J
C
p
E
R
f
f
f
R
R
c
A
A
A
c
R
R
f
f
f
R
E
u
e
E
R
R
R
v
D
D
D
D
D
D
D
D
a
"}
(28,1,1) = {"
a
D
D
D
D
D
D
D
v
v
v
R
R
R
p
R
R
v
v
v
v
R
R
f
e
f
R
R
v
v
v
v
R
R
u
R
R
R
v
v
v
D
D
D
D
D
D
D
D
a
"}
(29,1,1) = {"
a
D
D
D
D
D
D
D
D
v
v
v
f
A
p
e
f
f
v
v
v
v
R
e
p
e
R
v
v
v
v
f
f
X
B
A
f
v
v
v
D
D
D
D
D
D
D
D
D
a
"}
(30,1,1) = {"
a
D
D
D
D
D
D
D
D
v
v
v
f
e
p
p
e
f
v
v
v
v
f
A
p
A
f
v
v
v
v
f
e
p
p
e
f
v
v
v
D
D
D
D
D
D
D
D
D
a
"}
(31,1,1) = {"
a
D
D
D
D
D
D
D
D
D
v
v
f
f
A
p
e
f
f
v
v
v
f
M
p
A
f
v
v
v
f
f
e
p
A
f
f
v
v
D
D
D
D
D
D
D
D
D
D
a
"}
(32,1,1) = {"
a
D
D
D
D
D
D
D
D
D
v
v
v
f
e
p
p
e
f
f
f
v
f
j
Q
A
f
v
f
f
f
e
p
p
e
f
v
v
v
D
D
D
D
D
D
D
D
D
D
a
"}
(33,1,1) = {"
a
D
D
D
D
D
D
D
D
D
v
v
v
f
Z
t
p
p
e
e
f
R
R
e
p
e
R
R
f
e
e
p
p
A
f
f
v
v
v
D
D
D
D
D
D
D
D
D
D
a
"}
(34,1,1) = {"
a
D
D
D
D
D
D
D
D
D
D
v
v
v
f
Z
A
p
p
p
e
R
E
e
p
e
E
R
e
p
p
p
A
f
f
v
v
v
D
D
D
D
D
D
D
D
D
D
D
a
"}
(35,1,1) = {"
a
D
D
D
D
D
D
D
D
D
D
v
v
v
v
f
f
e
A
p
p
p
p
p
p
p
p
p
p
p
A
e
f
f
v
v
v
v
D
D
D
D
D
D
D
D
D
D
D
a
"}
(36,1,1) = {"
a
D
D
D
D
D
D
D
D
D
D
D
v
v
v
v
f
f
f
e
A
R
e
p
A
p
e
R
A
e
f
f
f
v
v
v
v
D
D
D
D
D
D
D
D
D
D
D
D
a
"}
(37,1,1) = {"
a
D
D
D
D
D
D
D
D
D
D
D
D
v
v
v
v
v
f
f
f
R
E
p
p
p
E
R
f
f
f
v
v
v
v
v
D
D
D
D
D
D
D
D
D
D
D
D
D
a
"}
(38,1,1) = {"
a
D
D
D
D
D
D
D
D
D
D
D
D
D
v
v
v
v
v
v
v
R
R
A
e
A
R
R
v
v
v
v
v
v
v
D
D
D
D
D
D
D
D
D
D
D
D
D
D
a
"}
(39,1,1) = {"
a
D
D
D
D
D
D
D
D
D
D
D
D
D
D
D
v
v
v
v
v
v
R
e
A
e
R
v
v
v
v
v
v
D
D
D
D
D
D
D
D
D
D
D
D
D
D
D
D
a
"}
(40,1,1) = {"
a
D
D
D
D
D
D
D
D
D
D
D
D
D
D
D
D
D
D
v
v
v
R
R
R
R
R
v
v
v
D
D
D
D
D
D
D
D
D
D
D
D
D
D
D
D
D
D
D
a
"}
(41,1,1) = {"
a
D
D
D
D
D
D
D
D
D
D
D
D
D
D
D
D
D
D
D
D
v
v
v
v
v
v
v
D
D
D
D
D
D
D
D
D
D
D
D
D
D
D
D
D
D
D
D
D
a
"}
(42,1,1) = {"
a
D
D
D
D
D
D
D
D
D
D
D
D
D
D
D
D
D
D
D
D
D
D
D
D
D
D
D
D
D
D
D
D
D
D
D
D
D
D
D
D
D
D
D
D
D
D
D
D
a
"}
(43,1,1) = {"
a
D
D
D
D
D
D
D
D
D
D
D
D
D
D
D
D
D
D
D
D
D
D
D
D
D
D
D
D
D
D
D
D
D
D
D
D
D
D
D
D
D
D
D
D
D
D
D
D
a
"}
(44,1,1) = {"
a
D
D
D
D
D
D
D
D
D
D
D
D
D
D
D
D
D
D
D
D
D
D
D
D
D
D
D
D
D
D
D
D
D
D
D
D
D
D
D
D
D
D
D
D
D
D
D
D
a
"}
(45,1,1) = {"
a
D
D
D
D
D
D
D
D
D
D
D
D
D
D
D
D
D
D
D
D
D
D
D
D
D
D
D
D
D
D
D
D
D
D
D
D
D
D
D
D
D
D
D
D
D
D
D
D
a
"}
(46,1,1) = {"
a
D
D
D
D
D
D
D
D
D
D
D
D
D
D
D
D
D
D
D
D
D
D
D
D
D
D
D
D
D
D
D
D
D
D
D
D
D
D
D
D
D
D
D
D
D
D
D
D
a
"}
(47,1,1) = {"
a
D
D
D
D
D
D
D
D
D
D
D
D
D
D
D
D
D
D
D
D
D
D
D
D
D
D
D
D
D
D
D
D
D
D
D
D
D
D
D
D
D
D
D
D
D
D
D
D
a
"}
(48,1,1) = {"
a
D
D
D
D
D
D
D
D
D
D
D
D
D
D
D
D
D
D
D
D
D
D
D
D
D
D
D
D
D
D
D
D
D
D
D
D
D
D
D
D
D
D
D
D
D
D
D
D
a
"}
(49,1,1) = {"
a
D
D
D
D
D
D
D
D
D
D
D
D
D
D
D
D
D
D
D
D
D
D
D
D
D
D
D
D
D
D
D
D
D
D
D
D
D
D
D
D
D
D
D
D
D
D
D
D
a
"}
(50,1,1) = {"
a
a
a
a
a
a
a
a
a
a
a
a
a
a
a
a
a
a
a
a
a
a
a
a
a
a
a
a
a
a
a
a
a
a
a
a
a
a
a
a
a
a
a
a
a
a
a
a
a
W
"}
