//MAP CONVERTED BY dmm2tgm.py THIS HEADER COMMENT PREVENTS RECONVERSION, DO NOT REMOVE
"aj" = (
/obj/structure/table/bronze,
/turf/open/floor/bronze/filled,
/area/ruin/powered/reebe)
"ak" = (
/obj/effect/decal/cleanable/blood,
/obj/item/clockwork/weapon/brass_battlehammer,
/turf/open/floor/bronze/filled,
/area/ruin/powered/reebe)
"aW" = (
/obj/effect/landmark/portal_exit{
	id = "reebe_entry"
	},
/turf/open/floor/bronze,
/area/ruin/powered/reebe)
"cg" = (
/obj/item/paper/crumpled/bloody/reebe2,
/turf/open/floor/bronze,
/area/ruin/powered/reebe)
"en" = (
/obj/structure/deployable_barricade/wooden,
/turf/open/floor/bronze/flat,
/area/ruin/powered/reebe)
"et" = (
/obj/effect/mob_spawn/corpse/human/blood_cultist,
/turf/open/floor/bronze/filled,
/area/ruin/powered/reebe)
"eC" = (
/obj/structure/table/bronze,
/obj/item/clothing/gloves/clockwork{
	pixel_y = -5
	},
/obj/item/clothing/head/helmet/clockwork{
	pixel_x = 7;
	pixel_y = 8
	},
/obj/item/clothing/shoes/clockwork{
	pixel_x = -8;
	pixel_y = 7
	},
/turf/open/floor/bronze/filled,
/area/ruin/powered/reebe)
"fX" = (
/obj/effect/landmark/portal_exit{
	id = "reebe_entry"
	},
/turf/open/floor/bronze/filled,
/area/ruin/powered/reebe)
"gl" = (
/obj/effect/decal/cleanable/blood/drip{
	pixel_x = 10;
	pixel_y = 4
	},
/obj/effect/decal/cleanable/blood/drip{
	pixel_x = 8;
	pixel_y = 11
	},
/obj/effect/decal/cleanable/blood/drip,
/turf/open/floor/bronze,
/area/ruin/powered/reebe)
"hB" = (
/obj/effect/spawner/structure/window/bronze,
/obj/structure/fluff/clockwork/blind_eye,
/turf/open/floor/bronze,
/area/ruin/powered/reebe)
"hU" = (
/obj/structure/fluff/clockwork/alloy_shards,
/turf/open/floor/bronze/flat,
/area/ruin/powered/reebe)
"iJ" = (
/turf/open/floor/bronze,
/area/ruin/powered/reebe)
"kg" = (
/obj/effect/mob_spawn/corpse/human/clock_cultist,
/obj/effect/decal/cleanable/blood,
/turf/open/floor/bronze/filled,
/area/ruin/powered/reebe)
"kq" = (
/obj/effect/decal/cleanable/blood/tracks,
/turf/open/floor/bronze/flat,
/area/ruin/powered/reebe)
"kZ" = (
/obj/effect/decal/cleanable/blood/tracks,
/turf/open/floor/bronze/filled,
/area/ruin/powered/reebe)
"lj" = (
/obj/effect/decal/cleanable/blood/splatter,
/turf/open/floor/bronze/flat,
/area/ruin/powered/reebe)
"lC" = (
/obj/effect/decal/cleanable/blood/gibs,
/turf/open/floor/bronze/flat,
/area/ruin/powered/reebe)
"lQ" = (
/obj/item/ectoplasm{
	pixel_y = -3
	},
/obj/item/stack/sheet/runed_metal{
	pixel_x = 12
	},
/turf/open/floor/bronze/filled,
/area/ruin/powered/reebe)
"mj" = (
/obj/structure/destructible/clockwork/gear_base/powered/prosperity_prism,
/turf/open/floor/bronze/flat,
/area/ruin/powered/reebe)
"mx" = (
/obj/effect/rune/convert,
/turf/open/floor/bronze/flat,
/area/ruin/powered/reebe)
"mA" = (
/obj/item/melee/cultblade/dagger{
	pixel_x = 9;
	pixel_y = 1
	},
/obj/effect/decal/cleanable/blood/splatter,
/turf/open/floor/bronze/filled,
/area/ruin/powered/reebe)
"mL" = (
/turf/open/indestructible/reebe_void,
/area/ruin/powered/reebe/space)
"oh" = (
/obj/effect/mob_spawn/corpse/human/clock_cultist,
/turf/open/floor/bronze,
/area/ruin/powered/reebe)
"ok" = (
/obj/structure/fans/tiny/invisible,
/turf/open/indestructible/reebe_void,
/area/ruin/powered/reebe/space)
"oo" = (
/obj/structure/fans/tiny/invisible,
/obj/structure/fans/tiny/invisible,
/turf/open/indestructible/reebe_void,
/area/ruin/powered/reebe/space)
"oH" = (
/obj/item/paper/crumpled/ruins/reebe1,
/turf/open/floor/bronze/flat,
/area/ruin/powered/reebe)
"pl" = (
/obj/effect/decal/cleanable/blood/footprints{
	dir = 4
	},
/turf/open/floor/bronze/flat,
/area/ruin/powered/reebe)
"pM" = (
/obj/effect/landmark/late_cog_portals,
/turf/open/floor/bronze/flat,
/area/ruin/powered/reebe)
"qI" = (
/obj/effect/decal/cleanable/blood/gibs/core,
/turf/open/floor/bronze/flat,
/area/ruin/powered/reebe)
"qS" = (
/turf/closed/wall/mineral/bronze,
/area/ruin/powered/reebe)
"rw" = (
/obj/effect/mob_spawn/corpse/human/blood_cultist,
/obj/effect/decal/cleanable/blood/tracks,
/obj/effect/rune/raise_dead,
/turf/open/floor/bronze,
/area/ruin/powered/reebe)
"rR" = (
/obj/effect/rune/blood_boil,
/turf/open/floor/bronze/flat,
/area/ruin/powered/reebe)
"tr" = (
/obj/structure/table/bronze,
/obj/item/clothing/suit/clockwork/speed{
	pixel_x = -5;
	pixel_y = -1
	},
/obj/item/clothing/suit/clockwork{
	pixel_x = 4
	},
/turf/open/floor/bronze/filled,
/area/ruin/powered/reebe)
"tH" = (
/obj/effect/decal/cleanable/blood,
/obj/effect/landmark/late_cog_portals,
/turf/open/floor/bronze/flat,
/area/ruin/powered/reebe)
"ve" = (
/obj/effect/spawner/structure/window/bronze,
/turf/open/floor/bronze,
/area/ruin/powered/reebe)
"vA" = (
/obj/structure/table/bronze,
/obj/item/gun/ballistic/rifle/lionhunter/clockwork,
/obj/item/ammo_box/a762/lionhunter/clock{
	pixel_x = 12;
	pixel_y = 9
	},
/obj/item/ammo_box/a762/lionhunter/clock{
	pixel_x = -12;
	pixel_y = 9
	},
/obj/item/ammo_box/a762/lionhunter/clock{
	pixel_y = 9
	},
/turf/open/floor/bronze/flat,
/area/ruin/powered/reebe)
"vV" = (
/obj/effect/rune/teleport{
	cultist_name = "Reebe"
	},
/turf/open/floor/bronze/flat,
/area/ruin/powered/reebe)
"wu" = (
/obj/structure/fluff/clockwork/alloy_shards/small{
	pixel_x = -4;
	pixel_y = -6
	},
/turf/open/floor/bronze/flat,
/area/ruin/powered/reebe)
"wS" = (
/obj/structure/fluff/clockwork/alloy_shards/medium_gearbit{
	pixel_x = -5;
	pixel_y = 7
	},
/turf/open/floor/bronze/flat,
/area/ruin/powered/reebe)
"wW" = (
/obj/structure/deployable_barricade/wooden,
/turf/open/floor/bronze/filled,
/area/ruin/powered/reebe)
"xd" = (
/turf/open/floor/bronze/flat,
/area/ruin/powered/reebe)
"xm" = (
/obj/effect/decal/cleanable/dirt,
/obj/structure/destructible/clockwork/gear_base/powered/interdiction_lens,
/turf/open/floor/bronze/filled,
/area/ruin/powered/reebe)
"yd" = (
/obj/effect/decal/cleanable/blood,
/turf/open/floor/bronze/filled,
/area/ruin/powered/reebe)
"yL" = (
/obj/effect/decal/cleanable/dirt,
/turf/open/floor/bronze,
/area/ruin/powered/reebe)
"AF" = (
/obj/structure/table/bronze,
/obj/item/storage/belt/utility/clock{
	pixel_y = -8
	},
/obj/item/storage/belt/utility/clock{
	pixel_y = 3
	},
/obj/structure/fluff/clockwork/blind_eye,
/turf/open/floor/bronze/filled,
/area/ruin/powered/reebe)
"Bm" = (
/obj/effect/decal/cleanable/dirt,
/turf/open/floor/bronze/filled,
/area/ruin/powered/reebe)
"BT" = (
/obj/structure/fluff/clockwork/alloy_shards/medium{
	pixel_x = 6;
	pixel_y = 7
	},
/turf/open/floor/bronze,
/area/ruin/powered/reebe)
"Cj" = (
/obj/structure/door_assembly/door_assembly_bronze/clock,
/turf/open/floor/bronze/flat,
/area/ruin/powered/reebe)
"FD" = (
/obj/effect/portal/permanent/one_way/reebe/leaving,
/turf/open/floor/bronze/filled,
/area/ruin/powered/reebe)
"FM" = (
/obj/effect/decal/cleanable/dirt,
/turf/open/floor/bronze/flat,
/area/ruin/powered/reebe)
"Go" = (
/obj/structure/table/bronze,
/turf/open/floor/bronze,
/area/ruin/powered/reebe)
"HU" = (
/obj/effect/decal/cleanable/blood/footprints{
	dir = 4
	},
/turf/open/floor/bronze/filled,
/area/ruin/powered/reebe)
"Iw" = (
/obj/effect/spawner/structure/window/bronze,
/obj/effect/decal/cleanable/blood/splatter/over_window,
/turf/open/floor/bronze,
/area/ruin/powered/reebe)
"JD" = (
/obj/effect/decal/cleanable/blood/gibs/limb,
/obj/effect/decal/cleanable/dirt,
/turf/open/floor/bronze/flat,
/area/ruin/powered/reebe)
"JM" = (
/obj/structure/bed{
	dir = 1
	},
/obj/item/bedsheet/orange{
	dir = 1
	},
/turf/open/floor/bronze,
/area/ruin/powered/reebe)
"KE" = (
/obj/effect/mob_spawn/corpse/human/blood_cultist,
/obj/effect/decal/cleanable/blood,
/turf/open/floor/bronze/flat,
/area/ruin/powered/reebe)
"Mu" = (
/obj/item/stack/sheet/mineral/wood,
/turf/open/floor/bronze/flat,
/area/ruin/powered/reebe)
"My" = (
/obj/effect/decal/cleanable/blood/gibs/body,
/obj/item/clothing/suit/clockwork/cloak,
/turf/open/floor/bronze,
/area/ruin/powered/reebe)
"MF" = (
/obj/structure/fluff/clockwork/blind_eye,
/turf/open/floor/bronze,
/area/ruin/powered/reebe)
"Nh" = (
/obj/item/ectoplasm,
/turf/open/indestructible/reebe_void,
/area/ruin/powered/reebe/space)
"Nw" = (
/obj/structure/door_assembly/door_assembly_bronze/clock,
/turf/open/floor/bronze,
/area/ruin/powered/reebe)
"Os" = (
/obj/item/stack/sheet/mineral/wood,
/turf/open/floor/bronze/filled,
/area/ruin/powered/reebe)
"Pd" = (
/obj/structure/table/bronze,
/obj/item/clothing/glasses/clockwork/wraith_spectacles{
	pixel_x = 9;
	pixel_y = 11
	},
/obj/item/clothing/glasses/clockwork/wraith_spectacles{
	pixel_x = -6;
	pixel_y = 11
	},
/obj/item/restraints/handcuffs/clockwork{
	pixel_y = -3
	},
/turf/open/floor/bronze/flat,
/area/ruin/powered/reebe)
"Pi" = (
/turf/open/floor/bronze/filled,
/area/ruin/powered/reebe)
"Pn" = (
/obj/effect/mob_spawn/corpse/human/clock_cultist,
/turf/open/floor/bronze/filled,
/area/ruin/powered/reebe)
"Pv" = (
/obj/machinery/door/airlock/bronze,
/turf/open/floor/bronze,
/area/ruin/powered/reebe)
"PD" = (
/obj/structure/destructible/clockwork/gear_base/powered/tinkerers_cache,
/turf/open/floor/bronze/flat,
/area/ruin/powered/reebe)
"PZ" = (
/obj/structure/destructible/clockwork/gear_base/technologists_lectern,
/turf/open/floor/bronze/flat,
/area/ruin/powered/reebe)
"QR" = (
/obj/machinery/door/airlock/bronze,
/turf/open/floor/bronze/flat,
/area/ruin/powered/reebe)
"QX" = (
/turf/open/indestructible/reebe_void/spawning/lattices,
/area/ruin/powered/reebe/space)
"Sy" = (
/obj/effect/mob_spawn/corpse/human/blood_cultist,
/obj/effect/rune/empower,
/turf/open/floor/bronze/flat,
/area/ruin/powered/reebe)
"To" = (
/obj/effect/decal/cleanable/blood/footprints{
	dir = 4
	},
/obj/effect/decal/cleanable/blood,
/turf/open/floor/bronze/flat,
/area/ruin/powered/reebe)
"TG" = (
/obj/structure/table/bronze,
/obj/item/clockwork/clockwork_slab{
	pixel_x = -4
	},
/obj/item/clockwork/clockwork_slab{
	pixel_x = 5
	},
/turf/open/floor/bronze/filled,
/area/ruin/powered/reebe)
"TR" = (
/obj/effect/mob_spawn/corpse/human/blood_cultist,
/turf/open/floor/bronze,
/area/ruin/powered/reebe)
"Uj" = (
/obj/structure/bed{
	dir = 1
	},
/obj/item/bedsheet/orange{
	dir = 1
	},
/obj/effect/mob_spawn/corpse/human/clock_cultist,
/obj/effect/decal/cleanable/blood/splatter,
/turf/open/floor/bronze,
/area/ruin/powered/reebe)
"UF" = (
/obj/effect/decal/cleanable/dirt,
/obj/structure/table/bronze,
/obj/item/stack/sheet/bronze/thirty{
	pixel_y = 10;
	pixel_x = 10
	},
/obj/item/stack/sheet/bronze/thirty{
	pixel_y = 5;
	pixel_x = 5
	},
/obj/item/stack/sheet/bronze/thirty,
/obj/item/clockwork/replica_fabricator{
	pixel_x = -10;
	pixel_y = 10
	},
/turf/open/floor/bronze,
/area/ruin/powered/reebe)
"UI" = (
/obj/structure/table/bronze,
/obj/item/clockwork/weapon/brass_spear{
	pixel_x = -6;
	pixel_y = 5
	},
/obj/item/clockwork/weapon/brass_spear{
	pixel_x = 6;
	pixel_y = -4
	},
/obj/item/clockwork/weapon/brass_spear,
/turf/open/floor/bronze/filled,
/area/ruin/powered/reebe)
"UJ" = (
/obj/item/ectoplasm,
/turf/open/floor/bronze/flat,
/area/ruin/powered/reebe)
"Vv" = (
/obj/structure/fluff/clockwork/clockgolem_remains,
/turf/open/floor/bronze/flat,
/area/ruin/powered/reebe)
"XZ" = (
/obj/effect/mob_spawn/corpse/human/blood_cultist,
/obj/structure/fluff/clockwork/alloy_shards/large{
	pixel_x = 16;
	pixel_y = -8
	},
/turf/open/floor/bronze,
/area/ruin/powered/reebe)
"Yc" = (
/obj/structure/fluff/clockwork/blind_eye,
/turf/open/floor/bronze/flat,
/area/ruin/powered/reebe)
"Ym" = (
/obj/effect/decal/cleanable/blood/splatter/over_window,
/turf/closed/wall/mineral/bronze,
/area/ruin/powered/reebe)

(1,1,1) = {"
ok
ok
ok
ok
ok
ok
ok
ok
ok
ok
ok
ok
ok
ok
ok
ok
ok
ok
ok
ok
ok
ok
ok
ok
ok
ok
ok
ok
ok
ok
ok
ok
ok
ok
ok
ok
ok
ok
ok
ok
ok
ok
ok
ok
ok
ok
ok
ok
ok
ok
"}
(2,1,1) = {"
ok
mL
mL
mL
mL
mL
mL
mL
mL
mL
mL
mL
mL
mL
mL
mL
mL
mL
mL
mL
mL
mL
mL
mL
mL
mL
mL
mL
mL
mL
mL
mL
mL
mL
mL
mL
mL
mL
mL
mL
mL
mL
mL
mL
mL
mL
mL
mL
mL
ok
"}
(3,1,1) = {"
ok
mL
mL
mL
mL
mL
mL
mL
mL
mL
mL
mL
mL
mL
mL
mL
mL
mL
mL
mL
mL
mL
mL
mL
mL
mL
mL
mL
mL
mL
mL
mL
mL
mL
mL
mL
mL
mL
mL
mL
mL
mL
mL
mL
mL
mL
mL
mL
mL
ok
"}
(4,1,1) = {"
ok
mL
mL
mL
mL
mL
mL
mL
mL
mL
mL
mL
mL
mL
mL
mL
mL
mL
mL
mL
mL
mL
mL
mL
mL
mL
mL
mL
mL
mL
mL
mL
mL
mL
mL
mL
mL
mL
mL
mL
mL
mL
mL
mL
mL
mL
mL
mL
mL
ok
"}
(5,1,1) = {"
ok
mL
mL
mL
mL
mL
mL
mL
mL
mL
mL
mL
mL
mL
mL
mL
mL
mL
mL
mL
mL
mL
mL
mL
mL
mL
mL
mL
mL
mL
mL
mL
mL
mL
mL
mL
mL
mL
mL
mL
mL
mL
mL
mL
mL
mL
mL
mL
mL
ok
"}
(6,1,1) = {"
ok
mL
mL
mL
mL
mL
mL
mL
mL
mL
mL
mL
mL
mL
mL
mL
mL
mL
mL
mL
mL
mL
mL
mL
mL
mL
mL
mL
mL
mL
mL
mL
mL
mL
mL
mL
mL
mL
mL
mL
mL
mL
mL
mL
mL
mL
mL
mL
mL
ok
"}
(7,1,1) = {"
ok
mL
mL
mL
mL
mL
mL
mL
mL
mL
mL
mL
mL
mL
mL
mL
mL
mL
mL
mL
mL
mL
mL
mL
mL
mL
mL
mL
mL
mL
mL
mL
mL
mL
mL
mL
mL
mL
mL
mL
mL
mL
mL
mL
mL
mL
mL
mL
mL
ok
"}
(8,1,1) = {"
ok
mL
mL
mL
mL
mL
mL
mL
mL
mL
mL
mL
mL
mL
mL
mL
mL
mL
mL
mL
mL
mL
mL
mL
mL
mL
mL
mL
mL
mL
mL
mL
mL
mL
mL
mL
mL
mL
mL
mL
mL
mL
mL
mL
mL
mL
mL
mL
mL
ok
"}
(9,1,1) = {"
ok
mL
mL
mL
mL
mL
mL
mL
mL
mL
mL
mL
mL
mL
mL
mL
mL
mL
mL
mL
mL
QX
QX
QX
QX
QX
QX
QX
mL
mL
mL
mL
mL
mL
mL
mL
mL
mL
mL
mL
mL
mL
mL
mL
mL
mL
mL
mL
mL
ok
"}
(10,1,1) = {"
ok
mL
mL
mL
mL
mL
mL
mL
mL
mL
mL
mL
mL
mL
mL
mL
mL
mL
mL
QX
QX
QX
qS
qS
qS
qS
qS
QX
QX
QX
mL
mL
mL
mL
mL
mL
mL
mL
mL
mL
mL
mL
mL
mL
mL
mL
mL
mL
mL
ok
"}
(11,1,1) = {"
ok
mL
mL
mL
mL
mL
mL
mL
mL
mL
mL
mL
mL
mL
mL
mL
QX
QX
QX
QX
QX
QX
qS
Uj
Pi
JM
qS
QX
QX
QX
QX
QX
QX
mL
mL
mL
mL
mL
mL
mL
mL
mL
mL
mL
mL
mL
mL
mL
mL
ok
"}
(12,1,1) = {"
ok
mL
mL
mL
mL
mL
mL
mL
mL
mL
mL
mL
mL
mL
QX
QX
QX
QX
QX
QX
QX
qS
qS
HU
iJ
Pi
qS
qS
QX
QX
QX
QX
QX
QX
QX
mL
mL
mL
mL
mL
mL
mL
mL
mL
mL
mL
mL
mL
mL
ok
"}
(13,1,1) = {"
ok
mL
mL
mL
mL
mL
mL
mL
mL
mL
mL
mL
mL
QX
QX
QX
QX
QX
ve
ve
hB
qS
aj
To
xd
xd
aj
qS
ve
ve
ve
QX
QX
QX
QX
QX
mL
mL
mL
mL
mL
mL
mL
mL
mL
mL
mL
mL
mL
ok
"}
(14,1,1) = {"
ok
mL
mL
mL
mL
mL
mL
mL
mL
mL
mL
mL
QX
QX
QX
QX
ve
ve
ve
My
yd
qS
Nw
xd
Pi
xd
yL
qS
Pi
iJ
ve
ve
ve
QX
QX
QX
QX
mL
mL
mL
mL
mL
mL
mL
mL
mL
mL
mL
mL
ok
"}
(15,1,1) = {"
ok
mL
mL
mL
mL
mL
mL
mL
mL
mL
mL
QX
QX
QX
QX
ve
ve
iJ
ak
JD
lC
xd
xd
xd
xd
xd
xd
xd
xd
xd
Bm
iJ
ve
ve
QX
QX
QX
QX
mL
mL
mL
mL
mL
mL
mL
mL
mL
mL
mL
ok
"}
(16,1,1) = {"
ok
mL
mL
mL
mL
mL
mL
mL
mL
mL
QX
QX
QX
QX
ve
ve
Pi
qI
xd
xd
iJ
qS
aj
iJ
Yc
iJ
aj
qS
iJ
xd
pM
UJ
Pi
ve
ve
QX
QX
QX
mL
mL
mL
mL
mL
mL
mL
mL
mL
mL
mL
ok
"}
(17,1,1) = {"
ok
mL
mL
mL
mL
mL
mL
mL
mL
mL
QX
QX
QX
ve
ve
Pi
xd
xd
iJ
iJ
ve
qS
qS
iJ
xd
iJ
qS
qS
ve
iJ
iJ
xd
xd
Pi
ve
ve
QX
QX
QX
mL
mL
mL
mL
mL
mL
mL
mL
mL
mL
ok
"}
(18,1,1) = {"
ok
mL
mL
mL
mL
mL
mL
mL
mL
mL
QX
QX
QX
ve
iJ
xd
xd
iJ
ve
ve
ve
QX
ve
Pi
rR
Pi
ve
QX
ve
ve
ve
iJ
xd
xd
iJ
ve
QX
QX
QX
mL
mL
mL
mL
mL
mL
mL
mL
mL
mL
ok
"}
(19,1,1) = {"
ok
mL
mL
mL
mL
mL
mL
mL
mL
mL
QX
QX
ve
ve
Pi
xd
iJ
ve
ve
QX
QX
QX
ve
Pi
xd
Bm
ve
QX
QX
QX
ve
ve
yL
xd
Pi
ve
ve
QX
QX
mL
mL
mL
mL
mL
mL
mL
mL
mL
mL
ok
"}
(20,1,1) = {"
ok
mL
mL
mL
mL
mL
mL
mL
mL
QX
QX
QX
ve
yL
Cj
xd
iJ
ve
QX
QX
QX
QX
ve
Pi
xd
Pi
ve
QX
QX
QX
QX
ve
iJ
xd
pM
iJ
ve
QX
QX
QX
mL
mL
mL
mL
mL
mL
mL
mL
mL
ok
"}
(21,1,1) = {"
ok
mL
mL
mL
mL
mL
mL
mL
mL
QX
QX
QX
ve
Pi
UJ
iJ
ve
ve
QX
QX
QX
QX
qS
iJ
xd
iJ
qS
QX
QX
QX
QX
ve
ve
iJ
xd
Pi
ve
QX
QX
QX
mL
mL
mL
mL
mL
mL
mL
mL
mL
ok
"}
(22,1,1) = {"
ok
mL
mL
mL
mL
mL
mL
mL
QX
QX
QX
qS
qS
qS
xd
qS
qS
QX
QX
QX
QX
qS
qS
qS
Pv
qS
qS
qS
QX
QX
QX
QX
qS
qS
xd
qS
qS
qS
QX
QX
QX
mL
mL
mL
mL
mL
mL
mL
mL
ok
"}
(23,1,1) = {"
ok
mL
mL
mL
mL
mL
mL
mL
QX
qS
qS
qS
Os
oh
xd
aj
qS
ve
ve
ve
qS
qS
PD
Bm
Pi
Pi
PZ
qS
qS
ve
ve
ve
qS
aj
xd
Nw
aj
qS
qS
qS
QX
mL
mL
mL
mL
mL
mL
mL
mL
ok
"}
(24,1,1) = {"
ok
mL
mL
mL
mL
mL
mL
mL
QX
qS
yL
Bm
Mu
xd
xd
XZ
BT
Bm
Pi
Pi
iJ
qS
Pi
hU
iJ
xd
Pi
qS
iJ
Pi
Pi
Bm
iJ
iJ
KE
FM
xd
Pi
aW
qS
QX
mL
mL
mL
mL
mL
mL
mL
mL
ok
"}
(25,1,1) = {"
ok
mL
mL
mL
mL
mL
mL
mL
QX
qS
FD
cg
en
Pi
xd
wu
wS
xd
xd
xd
xd
Pv
Pi
iJ
xm
iJ
Pi
Pv
Vv
xd
Sy
xd
xd
mx
tH
Pi
xd
iJ
fX
qS
QX
mL
mL
mL
mL
mL
mL
mL
mL
ok
"}
(26,1,1) = {"
ok
mL
mL
mL
mL
mL
mL
mL
QX
qS
gl
kg
Mu
xd
xd
iJ
rw
kZ
yd
Pi
iJ
qS
Pi
xd
iJ
hU
Pi
Ym
oh
Pi
Pi
Pi
iJ
iJ
pl
oH
FM
Pi
aW
qS
QX
mL
mL
mL
mL
mL
mL
mL
mL
ok
"}
(27,1,1) = {"
ok
mL
mL
mL
mL
mL
mL
mL
QX
qS
qS
qS
wW
MF
xd
aj
qS
ve
ve
ve
qS
qS
mj
Pi
Pi
Pi
PD
qS
qS
ve
ve
ve
qS
aj
pl
iJ
aj
qS
qS
qS
QX
mL
mL
mL
mL
mL
mL
mL
mL
ok
"}
(28,1,1) = {"
ok
mL
mL
mL
mL
mL
mL
mL
QX
QX
QX
qS
qS
qS
xd
qS
qS
QX
QX
QX
QX
qS
qS
qS
Pv
qS
qS
qS
QX
QX
QX
QX
qS
qS
pl
qS
qS
qS
QX
QX
QX
mL
mL
mL
mL
mL
mL
mL
mL
ok
"}
(29,1,1) = {"
ok
mL
mL
mL
mL
mL
mL
mL
mL
QX
QX
QX
ve
lQ
xd
iJ
ve
ve
QX
QX
QX
QX
qS
yL
xd
iJ
qS
QX
QX
QX
QX
ve
ve
TR
kq
Pi
ve
QX
QX
QX
mL
mL
mL
mL
mL
mL
mL
mL
mL
ok
"}
(30,1,1) = {"
ok
mL
mL
mL
mL
mL
mL
mL
mL
QX
QX
QX
ve
iJ
vV
FM
iJ
ve
QX
QX
QX
QX
ve
Pi
xd
Pi
ve
QX
QX
QX
QX
ve
iJ
xd
pM
yL
ve
QX
QX
QX
mL
mL
mL
mL
mL
mL
mL
mL
mL
ok
"}
(31,1,1) = {"
ok
mL
mL
mL
mL
mL
mL
mL
mL
mL
QX
QX
ve
ve
Pi
xd
iJ
ve
ve
QX
QX
QX
ve
mA
xd
Pi
ve
QX
QX
QX
ve
ve
iJ
xd
Pi
ve
ve
QX
QX
mL
mL
mL
mL
mL
mL
mL
mL
mL
mL
ok
"}
(32,1,1) = {"
ok
mL
mL
mL
mL
mL
mL
mL
mL
mL
QX
QX
QX
ve
iJ
xd
xd
yL
ve
ve
ve
QX
ve
Pn
lj
Pi
ve
QX
ve
ve
ve
yL
xd
xd
iJ
ve
QX
QX
QX
mL
mL
mL
mL
mL
mL
mL
mL
mL
mL
ok
"}
(33,1,1) = {"
ok
mL
mL
mL
mL
mL
mL
mL
mL
mL
QX
QX
QX
ve
Iw
et
xd
xd
iJ
iJ
ve
qS
qS
iJ
xd
iJ
qS
qS
ve
iJ
iJ
xd
xd
Pi
ve
ve
QX
QX
QX
mL
mL
mL
mL
mL
mL
mL
mL
mL
mL
ok
"}
(34,1,1) = {"
ok
mL
mL
mL
mL
mL
mL
mL
mL
mL
mL
QX
QX
QX
ve
Iw
Pi
xd
xd
xd
iJ
qS
AF
iJ
xd
iJ
UI
qS
iJ
xd
pM
xd
Pi
ve
ve
QX
QX
QX
mL
mL
mL
mL
mL
mL
mL
mL
mL
mL
mL
ok
"}
(35,1,1) = {"
ok
mL
mL
mL
mL
mL
mL
mL
mL
mL
mL
QX
QX
QX
QX
ve
ve
iJ
Pi
FM
xd
QR
xd
xd
Pd
xd
xd
QR
xd
xd
Pi
iJ
ve
ve
QX
QX
QX
QX
mL
mL
mL
mL
mL
mL
mL
mL
mL
mL
mL
ok
"}
(36,1,1) = {"
ok
mL
mL
mL
mL
mL
mL
mL
mL
mL
mL
mL
QX
QX
QX
QX
ve
ve
ve
iJ
Pi
qS
iJ
xd
tr
FM
iJ
qS
Bm
iJ
ve
ve
ve
QX
QX
QX
QX
mL
mL
mL
mL
mL
mL
mL
mL
mL
mL
mL
mL
ok
"}
(37,1,1) = {"
ok
mL
mL
mL
mL
mL
mL
mL
mL
mL
mL
mL
mL
QX
QX
QX
QX
QX
ve
ve
ve
qS
TG
xd
vA
xd
eC
qS
ve
ve
ve
QX
QX
QX
QX
QX
mL
mL
mL
mL
mL
mL
mL
mL
mL
mL
mL
mL
mL
ok
"}
(38,1,1) = {"
ok
mL
mL
mL
mL
mL
mL
mL
mL
mL
mL
mL
mL
mL
QX
QX
QX
QX
QX
QX
QX
qS
qS
Pi
iJ
Pi
qS
qS
QX
QX
QX
QX
QX
QX
QX
mL
mL
mL
mL
mL
mL
mL
mL
mL
mL
mL
mL
mL
mL
ok
"}
(39,1,1) = {"
ok
mL
mL
mL
mL
mL
mL
mL
mL
mL
mL
mL
mL
mL
mL
mL
QX
QX
QX
QX
QX
QX
qS
UF
Pi
Go
qS
QX
QX
QX
QX
QX
QX
mL
mL
mL
mL
mL
mL
mL
mL
mL
mL
mL
mL
mL
mL
mL
mL
ok
"}
(40,1,1) = {"
ok
mL
mL
mL
mL
mL
mL
mL
mL
mL
mL
mL
mL
mL
mL
mL
mL
mL
mL
QX
QX
QX
qS
qS
qS
qS
qS
QX
QX
QX
mL
mL
mL
mL
mL
mL
mL
mL
mL
mL
mL
mL
mL
mL
mL
mL
mL
mL
mL
ok
"}
(41,1,1) = {"
ok
mL
mL
mL
mL
mL
mL
mL
mL
mL
mL
mL
mL
mL
mL
mL
mL
mL
mL
mL
mL
QX
QX
QX
QX
QX
QX
QX
mL
mL
mL
mL
mL
mL
mL
mL
mL
mL
mL
mL
mL
mL
mL
mL
mL
mL
mL
mL
mL
ok
"}
(42,1,1) = {"
ok
mL
mL
mL
mL
mL
mL
mL
mL
mL
mL
mL
mL
mL
mL
mL
mL
mL
mL
mL
mL
mL
mL
mL
mL
mL
mL
mL
mL
mL
mL
mL
mL
mL
mL
mL
mL
mL
mL
mL
mL
mL
mL
mL
mL
mL
mL
mL
mL
ok
"}
(43,1,1) = {"
ok
mL
mL
mL
mL
mL
mL
mL
mL
mL
mL
mL
mL
mL
mL
mL
mL
mL
mL
mL
mL
mL
mL
mL
mL
mL
mL
mL
mL
mL
mL
mL
mL
mL
mL
mL
mL
mL
mL
mL
mL
mL
mL
mL
mL
mL
mL
mL
mL
ok
"}
(44,1,1) = {"
ok
mL
mL
mL
mL
mL
mL
mL
mL
mL
mL
mL
mL
mL
mL
mL
mL
mL
mL
mL
mL
mL
mL
mL
mL
mL
mL
mL
mL
mL
mL
mL
mL
mL
mL
mL
mL
mL
mL
mL
mL
mL
mL
mL
mL
mL
mL
mL
mL
ok
"}
(45,1,1) = {"
ok
mL
mL
mL
mL
mL
mL
mL
mL
mL
mL
mL
mL
mL
mL
mL
mL
mL
mL
mL
mL
mL
mL
mL
mL
mL
mL
mL
mL
mL
mL
mL
mL
mL
mL
mL
mL
mL
mL
mL
mL
mL
mL
mL
mL
mL
mL
mL
mL
ok
"}
(46,1,1) = {"
ok
mL
mL
mL
mL
mL
mL
mL
mL
mL
mL
mL
mL
mL
mL
mL
mL
mL
mL
mL
mL
mL
mL
mL
mL
mL
mL
mL
mL
mL
mL
mL
mL
mL
mL
mL
mL
mL
mL
mL
mL
mL
mL
mL
mL
mL
mL
mL
mL
ok
"}
(47,1,1) = {"
ok
mL
mL
mL
mL
mL
mL
mL
mL
mL
mL
mL
mL
mL
mL
mL
mL
mL
mL
mL
mL
mL
mL
mL
mL
mL
mL
mL
mL
mL
mL
mL
mL
mL
mL
mL
mL
mL
mL
mL
mL
mL
mL
mL
mL
mL
mL
mL
mL
ok
"}
(48,1,1) = {"
ok
mL
mL
mL
mL
mL
mL
mL
mL
mL
mL
mL
mL
Nh
mL
mL
mL
mL
mL
mL
mL
mL
mL
mL
mL
mL
mL
mL
mL
mL
mL
mL
mL
mL
mL
mL
mL
mL
mL
mL
mL
mL
mL
mL
mL
mL
mL
mL
mL
ok
"}
(49,1,1) = {"
ok
mL
mL
mL
mL
mL
mL
mL
mL
mL
mL
mL
mL
mL
mL
mL
mL
mL
mL
mL
mL
mL
mL
mL
mL
mL
mL
mL
mL
mL
mL
mL
mL
mL
mL
mL
mL
mL
mL
mL
mL
mL
mL
mL
mL
mL
mL
mL
mL
ok
"}
(50,1,1) = {"
ok
ok
ok
ok
ok
ok
ok
ok
ok
ok
ok
ok
ok
ok
ok
ok
ok
ok
ok
ok
ok
ok
ok
ok
ok
ok
ok
ok
ok
ok
ok
ok
ok
ok
ok
ok
ok
ok
ok
ok
ok
ok
ok
ok
ok
ok
ok
ok
ok
oo
"}
