//MAP CONVERTED BY dmm2tgm.py THIS HEADER COMMENT PREVENTS RECONVERSION, DO NOT REMOVE
"a" = (
/obj/effect/baseturf_helper/virtual_domain,
/turf/closed/wall/mineral/plastitanium/nodiagonal,
/area/space)

(1,1,1) = {"
a
"}
