//MAP CONVERTED BY dmm2tgm.py THIS HEADER COMMENT PREVENTS RECONVERSION, DO NOT REMOVE
"a" = (
/obj/effect/landmark/bitrunning/cache_goal_turf,
/obj/effect/turf_decal/loading_area,
/turf/open/floor/bitrunning_transport,
/area/virtual_domain/safehouse)
"d" = (
/obj/effect/turf_decal/tile/neutral/fourcorners,
/obj/effect/turf_decal/stripes/line{
	dir = 6
	},
/turf/open/floor/iron,
/area/virtual_domain/safehouse)
"e" = (
/turf/closed/wall/mineral/plastitanium/nodiagonal,
/area/virtual_domain/safehouse)
"f" = (
/obj/effect/turf_decal/stripes/line{
	dir = 1
	},
/turf/open/floor/iron,
/area/virtual_domain/safehouse)
"g" = (
/obj/machinery/power/shuttle_engine/huge,
/turf/open/misc/dirt,
/area/virtual_domain)
"i" = (
/obj/effect/turf_decal/stripes/line{
	dir = 8
	},
/obj/effect/turf_decal/stripes/line{
	dir = 4
	},
/obj/structure/closet/crate/secure/weapon,
/obj/item/storage/belt/military/army,
/obj/item/ammo_box/magazine/m16,
/obj/item/ammo_box/magazine/m16,
/obj/item/storage/pouch/medical/firstaid/stabilizer,
/obj/item/storage/pouch/ammo,
/turf/open/floor/iron,
/area/virtual_domain/safehouse)
"k" = (
/obj/machinery/power/shuttle_engine/heater,
/turf/closed/wall/mineral/plastitanium/nodiagonal,
/area/virtual_domain/safehouse)
"l" = (
/turf/open/misc/dirt,
/area/virtual_domain)
"q" = (
/obj/effect/turf_decal/stripes/end,
/obj/effect/decal/cleanable/dirt,
/obj/structure/closet/crate/secure/weapon,
/obj/item/storage/belt/military/army,
/obj/item/ammo_box/magazine/m16,
/obj/item/ammo_box/magazine/m16,
/obj/item/storage/pouch/medical/firstaid/stabilizer,
/obj/item/storage/pouch/ammo,
/turf/open/floor/iron,
/area/virtual_domain/safehouse)
"r" = (
/obj/effect/turf_decal/tile/neutral/fourcorners,
/turf/open/floor/iron,
/area/virtual_domain/safehouse)
"t" = (
/obj/effect/spawner/structure/window/reinforced/plasma/plastitanium,
/turf/open/floor/plating,
/area/virtual_domain/safehouse)
"u" = (
/obj/effect/turf_decal/tile/neutral/fourcorners,
/obj/effect/turf_decal/stripes/line,
/obj/effect/decal/cleanable/blood/old,
/obj/effect/decal/cleanable/dirt,
/turf/open/floor/iron,
/area/virtual_domain/safehouse)
"x" = (
/obj/effect/turf_decal/tile/neutral/half/contrasted,
/obj/effect/turf_decal/stripes/line{
	dir = 1
	},
/obj/machinery/light/small/red/directional/north,
/obj/effect/decal/cleanable/dirt,
/turf/open/floor/iron,
/area/virtual_domain/safehouse)
"y" = (
/obj/effect/turf_decal/stripes/line{
	dir = 1
	},
/obj/machinery/door/airlock/hatch,
/obj/effect/turf_decal/stripes/line,
/obj/effect/turf_decal/sand/volcanic,
/turf/open/floor/iron/white,
/area/virtual_domain/safehouse)
"A" = (
/obj/machinery/power/shuttle_engine/propulsion,
/turf/open/misc/dirt,
/area/virtual_domain)
"E" = (
/obj/effect/turf_decal/stripes/line{
	dir = 10
	},
/obj/effect/decal/cleanable/generic,
/obj/effect/landmark/bitrunning/hololadder_spawn,
/turf/open/floor/iron,
/area/virtual_domain/safehouse)
"G" = (
/obj/effect/turf_decal/tile/neutral{
	dir = 4
	},
/obj/effect/turf_decal/stripes/line{
	dir = 6
	},
/obj/machinery/light/small/directional/south,
/obj/effect/decal/cleanable/dirt,
/obj/effect/landmark/bitrunning/hololadder_spawn,
/turf/open/floor/iron,
/area/virtual_domain/safehouse)
"H" = (
/obj/effect/turf_decal/tile/neutral/fourcorners,
/obj/effect/turf_decal/stripes/line,
/turf/open/floor/iron,
/area/virtual_domain/safehouse)
"I" = (
/obj/effect/turf_decal/tile/neutral/fourcorners,
/obj/effect/turf_decal/stripes/line{
	dir = 4
	},
/obj/structure/chair/comfy/shuttle{
	dir = 1
	},
/obj/machinery/light/small/red/directional/east,
/turf/open/floor/iron,
/area/virtual_domain/safehouse)
"L" = (
/obj/effect/turf_decal/stripes/end{
	dir = 1
	},
/obj/effect/turf_decal/sand/volcanic,
/obj/structure/closet/crate/secure/weapon,
/obj/item/storage/belt/military/army,
/obj/item/ammo_box/magazine/m16,
/obj/item/ammo_box/magazine/m16,
/obj/item/storage/pouch/medical/firstaid/loaded,
/obj/item/storage/pouch/medical/loaded,
/turf/open/floor/iron,
/area/virtual_domain/safehouse)
"M" = (
/obj/effect/turf_decal/tile/neutral,
/obj/effect/turf_decal/stripes/line{
	dir = 5
	},
/obj/effect/decal/cleanable/dirt,
/obj/machinery/computer{
	dir = 2;
	name = "vehicle console";
	icon_screen = "shuttle";
	desc = "An armored vehicle control computer. Doesn't work anymore... who would've thought."
	},
/turf/open/floor/iron,
/area/virtual_domain/safehouse)
"P" = (
/obj/effect/turf_decal/tile/neutral/fourcorners,
/obj/effect/decal/cleanable/dirt,
/turf/open/floor/iron,
/area/virtual_domain/safehouse)
"T" = (
/obj/effect/turf_decal/tile/neutral/half/contrasted{
	dir = 1
	},
/obj/effect/turf_decal/stripes/line,
/obj/effect/landmark/bitrunning/hololadder_spawn,
/turf/open/floor/iron,
/area/virtual_domain/safehouse)
"W" = (
/obj/effect/decal/cleanable/dirt,
/obj/effect/landmark/bitrunning/cache_goal_turf,
/obj/effect/turf_decal/loading_area,
/obj/machinery/light/small/directional/south,
/turf/open/floor/bitrunning_transport,
/area/virtual_domain/safehouse)
"X" = (
/obj/effect/turf_decal/tile/neutral/half/contrasted,
/obj/effect/turf_decal/stripes/line{
	dir = 1
	},
/obj/effect/decal/cleanable/dirt/dust,
/obj/structure/table/reinforced,
/obj/item/storage/toolbox/emergency,
/turf/open/floor/iron,
/area/virtual_domain/safehouse)

(1,1,1) = {"
e
e
e
e
e
e
e
l
l
l
"}
(2,1,1) = {"
e
L
i
q
a
k
A
l
l
l
"}
(3,1,1) = {"
e
x
r
u
W
k
l
l
g
l
"}
(4,1,1) = {"
y
f
r
H
E
k
l
l
l
l
"}
(5,1,1) = {"
t
X
P
H
T
k
l
l
l
l
"}
(6,1,1) = {"
t
M
I
d
G
k
A
l
l
l
"}
(7,1,1) = {"
e
e
e
e
e
e
e
l
l
l
"}
