//MAP CONVERTED BY dmm2tgm.py THIS HEADER COMMENT PREVENTS RECONVERSION, DO NOT REMOVE
"a" = (
/turf/closed/wall,
/area/station/commons/fitness/recreation)
"b" = (
/obj/machinery/cryopod,
/obj/effect/turf_decal/siding/white,
/obj/machinery/power/apc/auto_name/directional/east,
/obj/structure/cable,
/turf/open/floor/iron/dark,
/area/station/common/cryopods)
"d" = (
/obj/machinery/cryopod,
/obj/effect/turf_decal/siding/white,
/turf/open/floor/iron/dark,
/area/station/common/cryopods)
"e" = (
/obj/machinery/cryopod{
	dir = 1
	},
/obj/effect/turf_decal/siding/white{
	dir = 1
	},
/obj/machinery/airalarm/directional/east,
/obj/machinery/atmospherics/components/unary/vent_pump/on/layer4{
	dir = 1
	},
/obj/machinery/camera/directional/east,
/turf/open/floor/iron/dark,
/area/station/common/cryopods)
"h" = (
/obj/machinery/cryopod,
/obj/effect/turf_decal/siding/white,
/obj/machinery/atmospherics/components/unary/vent_scrubber/on/layer2,
/turf/open/floor/iron/dark,
/area/station/common/cryopods)
"p" = (
/obj/effect/landmark/start/hangover,
/obj/structure/cable,
/obj/machinery/atmospherics/pipe/smart/manifold4w/supply/hidden/layer4,
/obj/machinery/atmospherics/pipe/smart/manifold4w/scrubbers/hidden/layer2,
/turf/open/floor/iron/white,
/area/station/common/cryopods)
"q" = (
/obj/structure/sign/warning/no_smoking/circle/directional/south,
/obj/machinery/camera/directional/south,
/obj/machinery/disposal/bin,
/obj/effect/turf_decal/box,
/obj/structure/disposalpipe/trunk{
	dir = 8
	},
/turf/open/floor/iron/white/side{
	dir = 4
	},
/area/station/commons/fitness/recreation)
"t" = (
/obj/machinery/computer/cryopod{
	dir = 8;
	pixel_x = 32
	},
/obj/structure/cable,
/obj/machinery/atmospherics/pipe/smart/manifold4w/supply/hidden/layer4,
/obj/machinery/light/directional/east,
/turf/open/floor/iron/white,
/area/station/common/cryopods)
"x" = (
/obj/machinery/cryopod{
	dir = 1
	},
/obj/effect/turf_decal/siding/white{
	dir = 1
	},
/turf/open/floor/iron/dark,
/area/station/common/cryopods)
"C" = (
/obj/effect/spawner/structure/window/reinforced,
/turf/open/floor/plating,
/area/station/common/cryopods)
"G" = (
/obj/effect/landmark/start/hangover,
/obj/structure/cable,
/obj/machinery/atmospherics/pipe/smart/manifold4w/supply/hidden/layer4,
/obj/machinery/atmospherics/pipe/smart/manifold4w/scrubbers/hidden/layer2,
/turf/open/floor/iron/white/side{
	dir = 4
	},
/area/station/commons/fitness/recreation)
"J" = (
/obj/structure/cable,
/obj/machinery/atmospherics/pipe/smart/manifold4w/supply/hidden/layer4,
/turf/open/floor/iron/white,
/area/station/common/cryopods)
"L" = (
/obj/machinery/light/directional/east,
/turf/open/floor/iron,
/area/station/commons/fitness/recreation)
"N" = (
/turf/closed/wall,
/area/station/common/cryopods)
"Q" = (
/obj/structure/cable,
/obj/machinery/atmospherics/pipe/smart/manifold4w/supply/hidden/layer4,
/obj/machinery/atmospherics/pipe/smart/manifold4w/scrubbers/hidden/layer2,
/obj/machinery/door/airlock/public/glass{
	name = "Cryopods"
	},
/turf/open/floor/iron/white,
/area/station/common/cryopods)
"X" = (
/turf/open/floor/iron/white/side{
	dir = 4
	},
/area/station/commons/fitness/recreation)

(1,1,1) = {"
L
X
G
q
a
"}
(2,1,1) = {"
N
C
Q
C
N
"}
(3,1,1) = {"
C
h
p
x
C
"}
(4,1,1) = {"
C
d
J
x
C
"}
(5,1,1) = {"
C
b
t
e
C
"}
(6,1,1) = {"
N
N
N
N
N
"}
