//MAP CONVERTED BY dmm2tgm.py THIS HEADER COMMENT PREVENTS RECONVERSION, DO NOT REMOVE
"a" = (
/turf/closed/wall/r_wall,
/area/station/ai_monitored/security/armory)
"c" = (
/obj/structure/cable,
/obj/effect/turf_decal/stripes/line{
	dir = 4
	},
/turf/open/floor/iron/dark,
/area/station/ai_monitored/security/armory)
"e" = (
/obj/effect/turf_decal/tile/red,
/obj/effect/turf_decal/tile/red{
	dir = 8
	},
/mob/living/simple_animal/bot/secbot/beepsky/armsky,
/turf/open/floor/iron/dark,
/area/station/ai_monitored/security/armory)
"f" = (
/obj/machinery/camera/directional/south{
	c_tag = "Armory - Interior"
	},
/obj/structure/table/reinforced,
/obj/item/gun/energy/e_gun/dragnet,
/obj/item/gun/energy/e_gun/dragnet,
/obj/structure/cable,
/obj/effect/turf_decal/stripes/line{
	dir = 4
	},
/obj/machinery/power/apc/auto_name/directional/south,
/obj/item/melee/hammer,
/obj/item/melee/hammer,
/obj/item/melee/hammer,
/obj/item/storage/box/firingpins,
/obj/item/storage/box/firingpins,
/turf/open/floor/iron/dark,
/area/station/ai_monitored/security/armory)
"g" = (
/obj/structure/cable,
/obj/machinery/atmospherics/pipe/smart/manifold4w/supply/hidden/layer4{
	dir = 4
	},
/obj/machinery/atmospherics/pipe/smart/manifold4w/scrubbers/hidden/layer2{
	dir = 8
	},
/turf/open/floor/iron/dark,
/area/station/ai_monitored/security/armory)
"h" = (
/obj/structure/chair/office,
/obj/effect/turf_decal/tile/red{
	dir = 8
	},
/turf/open/floor/iron/dark,
/area/station/ai_monitored/security/armory)
"j" = (
/obj/effect/turf_decal/bot,
/obj/structure/closet/secure_closet/smartgun,
/obj/machinery/atmospherics/pipe/smart/manifold4w/scrubbers/hidden/layer2{
	dir = 8
	},
/turf/open/floor/iron/dark,
/area/station/ai_monitored/security/armory)
"k" = (
/obj/effect/landmark/event_spawn,
/obj/structure/cable,
/obj/machinery/atmospherics/components/unary/vent_pump/on/layer4{
	dir = 8
	},
/obj/machinery/atmospherics/pipe/smart/manifold4w/scrubbers/hidden/layer2{
	dir = 9
	},
/turf/open/floor/iron/dark,
/area/station/ai_monitored/security/armory)
"l" = (
/obj/effect/turf_decal/bot,
/obj/machinery/atmospherics/pipe/smart/manifold4w/scrubbers/hidden/layer2{
	dir = 8
	},
/obj/structure/rack/gunrack,
/obj/effect/spawner/armory_spawn/shotguns,
/turf/open/floor/iron/dark,
/area/station/ai_monitored/security/armory)
"m" = (
/obj/structure/table/reinforced,
/obj/effect/turf_decal/tile/neutral/fourcorners,
/obj/item/storage/barricade{
	pixel_y = -5
	},
/obj/item/storage/barricade,
/obj/item/storage/barricade{
	pixel_y = 5
	},
/turf/open/floor/iron/dark,
/area/station/ai_monitored/security/armory)
"n" = (
/obj/machinery/light/directional/east,
/obj/effect/turf_decal/tile/neutral/fourcorners,
/obj/machinery/dish_drive/bullet{
	succrange = 6
	},
/turf/open/floor/iron/dark,
/area/station/ai_monitored/security/armory)
"o" = (
/obj/effect/turf_decal/stripes/line{
	dir = 1
	},
/obj/machinery/atmospherics/components/unary/vent_scrubber/on/layer2,
/turf/open/floor/iron/dark,
/area/station/ai_monitored/security/armory)
"p" = (
/obj/machinery/flasher/portable,
/obj/effect/turf_decal/tile/neutral/fourcorners,
/turf/open/floor/iron/dark,
/area/station/ai_monitored/security/armory)
"t" = (
/obj/effect/turf_decal/stripes/corner{
	dir = 1
	},
/turf/open/floor/iron/dark,
/area/station/ai_monitored/security/armory)
"u" = (
/obj/effect/turf_decal/stripes/line{
	dir = 9
	},
/turf/open/floor/iron/dark,
/area/station/ai_monitored/security/armory)
"v" = (
/obj/effect/turf_decal/stripes/line{
	dir = 1
	},
/turf/open/floor/iron/dark,
/area/station/ai_monitored/security/armory)
"w" = (
/obj/machinery/door/poddoor{
	id = "armouryaccess";
	name = "Armoury Access"
	},
/obj/effect/turf_decal/stripes/line,
/obj/effect/turf_decal/stripes/line{
	dir = 1
	},
/turf/open/floor/iron,
/area/station/ai_monitored/security/armory)
"x" = (
/obj/effect/spawner/structure/window/reinforced,
/turf/open/floor/plating,
/area/station/ai_monitored/security/armory)
"y" = (
/obj/effect/turf_decal/tile/neutral/fourcorners,
/obj/machinery/firealarm/directional/west,
/obj/machinery/flasher/portable,
/turf/open/floor/iron/dark,
/area/station/ai_monitored/security/armory)
"A" = (
/obj/effect/turf_decal/stripes/line{
	dir = 5
	},
/turf/open/floor/iron/dark,
/area/station/ai_monitored/security/armory)
"B" = (
/obj/structure/reagent_dispensers/wall/peppertank/directional/east,
/obj/structure/table/reinforced,
/obj/item/clothing/mask/gas/sechailer{
	pixel_x = -3;
	pixel_y = 3
	},
/obj/item/clothing/mask/gas/sechailer,
/obj/item/clothing/mask/gas/sechailer{
	pixel_x = 3;
	pixel_y = -3
	},
/obj/item/flashlight/seclite,
/obj/item/flashlight/seclite,
/obj/item/flashlight/seclite,
/obj/effect/turf_decal/tile/neutral/fourcorners,
/turf/open/floor/iron/dark,
/area/station/ai_monitored/security/armory)
"C" = (
/obj/structure/table/reinforced,
/obj/machinery/recharger,
/obj/effect/turf_decal/stripes/line{
	dir = 5
	},
/obj/machinery/button/door/directional/south{
	id = "armouryaccess";
	name = "Armoury Access";
	req_access = list("armory")
	},
/obj/item/key/security,
/turf/open/floor/iron/dark,
/area/station/ai_monitored/security/armory)
"D" = (
/obj/item/storage/box/teargas{
	pixel_x = 3;
	pixel_y = 3
	},
/obj/item/storage/box/handcuffs,
/obj/item/storage/box/flashbangs{
	pixel_x = -3;
	pixel_y = -3
	},
/obj/structure/table/reinforced,
/obj/effect/turf_decal/tile/neutral/fourcorners,
/obj/item/gun/grenadelauncher,
/turf/open/floor/iron/dark,
/area/station/ai_monitored/security/armory)
"F" = (
/obj/structure/rack,
/obj/item/gun/energy/ionrifle,
/obj/item/clothing/suit/hooded/ablative,
/obj/item/gun/energy/temperature/security,
/obj/effect/turf_decal/tile/neutral/fourcorners,
/turf/open/floor/iron/dark,
/area/station/ai_monitored/security/armory)
"G" = (
/obj/structure/rack,
/obj/item/clothing/suit/armor/bulletproof{
	pixel_x = -3;
	pixel_y = 3
	},
/obj/item/clothing/suit/armor/bulletproof,
/obj/item/clothing/suit/armor/bulletproof{
	pixel_x = 3;
	pixel_y = -3
	},
/obj/item/clothing/head/helmet/alt{
	layer = 3.00001;
	pixel_x = -3;
	pixel_y = 3
	},
/obj/item/clothing/head/helmet/alt{
	layer = 3.00001
	},
/obj/item/clothing/head/helmet/alt{
	layer = 3.00001;
	pixel_x = 3;
	pixel_y = -3
	},
/obj/item/storage/secure/safe/directional/east,
/obj/effect/turf_decal/tile/neutral/fourcorners,
/turf/open/floor/iron/dark,
/area/station/ai_monitored/security/armory)
"I" = (
/obj/structure/closet/secure_closet/contraband/armory,
/obj/machinery/light/directional/east,
/obj/effect/turf_decal/tile/neutral/fourcorners,
/obj/effect/spawner/random/maintenance/three,
/obj/effect/spawner/random/contraband/armory,
/turf/open/floor/iron/dark,
/area/station/ai_monitored/security/armory)
"J" = (
/obj/effect/turf_decal/tile/neutral/fourcorners,
/obj/structure/closet/ammunitionlocker/useful,
/obj/item/storage/box/lethalshot,
/obj/item/storage/box/lethalshot,
/obj/item/storage/box/lethalshot,
/obj/item/storage/box/lethalshot,
/turf/open/floor/iron/dark,
/area/station/ai_monitored/security/armory)
"K" = (
/obj/item/grenade/barrier{
	pixel_x = -3;
	pixel_y = 1
	},
/obj/item/grenade/barrier,
/obj/item/grenade/barrier{
	pixel_x = 3;
	pixel_y = -1
	},
/obj/item/grenade/barrier{
	pixel_x = 6;
	pixel_y = -2
	},
/obj/structure/table/reinforced,
/obj/effect/turf_decal/tile/neutral/fourcorners,
/obj/item/radio/intercom/directional/north,
/turf/open/floor/iron/dark,
/area/station/ai_monitored/security/armory)
"L" = (
/obj/effect/turf_decal/bot,
/obj/machinery/atmospherics/pipe/smart/manifold4w/scrubbers/hidden/layer2{
	dir = 8
	},
/obj/structure/rack/gunrack,
/obj/effect/spawner/armory_spawn/microfusion,
/turf/open/floor/iron/dark,
/area/station/ai_monitored/security/armory)
"M" = (
/obj/effect/turf_decal/stripes/line{
	dir = 4
	},
/turf/open/floor/iron/dark,
/area/station/ai_monitored/security/armory)
"N" = (
/obj/machinery/door/firedoor,
/obj/machinery/door/airlock/security{
	name = "Armoury"
	},
/obj/structure/cable,
/obj/effect/turf_decal/stripes/line{
	dir = 8
	},
/obj/effect/turf_decal/stripes/line{
	dir = 4
	},
/obj/machinery/atmospherics/pipe/smart/manifold4w/supply/hidden/layer4,
/obj/machinery/atmospherics/pipe/smart/manifold4w/scrubbers/hidden/layer2,
/obj/effect/mapping_helpers/airlock/access/all/security/armory,
/turf/open/floor/iron,
/area/station/ai_monitored/security/armory)
"O" = (
/obj/item/storage/box/chemimp{
	pixel_x = 6
	},
/obj/item/storage/box/trackimp{
	pixel_x = -3
	},
/obj/item/storage/lockbox/loyalty,
/obj/structure/table/reinforced,
/obj/effect/turf_decal/tile/neutral/fourcorners,
/obj/machinery/airalarm/directional/north,
/turf/open/floor/iron/dark,
/area/station/ai_monitored/security/armory)
"P" = (
/obj/structure/rack,
/obj/item/clothing/suit/armor/riot{
	pixel_x = -3;
	pixel_y = 3
	},
/obj/item/clothing/suit/armor/riot,
/obj/item/clothing/suit/armor/riot{
	pixel_x = 3;
	pixel_y = -3
	},
/obj/item/clothing/head/helmet/riot{
	pixel_x = -3;
	pixel_y = 3
	},
/obj/item/clothing/head/helmet/riot,
/obj/item/clothing/head/helmet/riot{
	pixel_x = 3;
	pixel_y = -3
	},
/obj/item/shield/riot{
	pixel_x = -3;
	pixel_y = 3
	},
/obj/item/shield/riot,
/obj/item/shield/riot{
	pixel_x = 3;
	pixel_y = -3
	},
/obj/structure/sign/nanotrasen{
	pixel_x = 32
	},
/obj/effect/turf_decal/tile/neutral/fourcorners,
/turf/open/floor/iron/dark,
/area/station/ai_monitored/security/armory)
"Q" = (
/obj/structure/table/reinforced,
/obj/machinery/door/firedoor,
/obj/machinery/door/window/brigdoor/right/directional/north{
	name = "Armoury Desk";
	req_access = list("armory")
	},
/obj/item/folder/red,
/obj/item/pen,
/obj/machinery/door/window/right/directional/south{
	name = "Armoury Desk"
	},
/obj/effect/turf_decal/delivery,
/turf/open/floor/iron,
/area/station/ai_monitored/security/armory)
"S" = (
/obj/effect/turf_decal/stripes/line{
	dir = 8
	},
/turf/open/floor/iron/dark,
/area/station/ai_monitored/security/armory)
"V" = (
/obj/machinery/door/firedoor,
/obj/machinery/door/airlock/security{
	name = "Armoury"
	},
/obj/effect/turf_decal/stripes/line{
	dir = 8
	},
/obj/effect/turf_decal/stripes/line{
	dir = 4
	},
/obj/effect/mapping_helpers/airlock/access/all/security/armory,
/turf/open/floor/iron,
/area/station/ai_monitored/security/armory)
"W" = (
/obj/structure/rack,
/obj/effect/turf_decal/tile/neutral/fourcorners,
/obj/item/clothing/head/helmet/sec{
	pixel_x = -3;
	pixel_y = 3
	},
/obj/item/clothing/head/helmet/sec,
/obj/item/clothing/head/helmet/sec{
	pixel_x = 3;
	pixel_y = -3
	},
/obj/item/clothing/suit/armor/vest/security{
	pixel_x = 3;
	pixel_y = -3
	},
/obj/item/clothing/suit/armor/vest/security,
/obj/item/clothing/suit/armor/vest/security{
	pixel_x = -3;
	pixel_y = 3
	},
/turf/open/floor/iron/dark,
/area/station/ai_monitored/security/armory)
"X" = (
/obj/effect/turf_decal/bot,
/obj/machinery/atmospherics/pipe/smart/manifold4w/scrubbers/hidden/layer2{
	dir = 8
	},
/obj/structure/rack/gunrack,
/obj/effect/spawner/armory_spawn/cmg,
/turf/open/floor/iron/dark,
/area/station/ai_monitored/security/armory)
"Y" = (
/obj/effect/spawner/structure/window/reinforced,
/obj/structure/cable,
/turf/open/floor/plating,
/area/station/ai_monitored/security/armory)

(1,1,1) = {"
a
a
Y
Y
a
Y
V
N
x
a
"}
(2,1,1) = {"
a
p
p
p
y
J
v
g
C
a
"}
(3,1,1) = {"
a
K
u
S
S
S
t
g
e
w
"}
(4,1,1) = {"
a
O
o
X
L
j
l
k
h
Q
"}
(5,1,1) = {"
a
m
A
M
M
M
M
c
f
a
"}
(6,1,1) = {"
a
D
I
W
G
P
F
n
B
a
"}
(7,1,1) = {"
a
a
a
a
a
a
a
a
a
a
"}
