//MAP CONVERTED BY dmm2tgm.py THIS HEADER COMMENT PREVENTS RECONVERSION, DO NOT REMOVE
"a" = (
/turf/template_noop,
/area/template_noop)
"i" = (
/obj/effect/turf_decal/stripes/red/box,
/turf/template_noop,
/area/template_noop)
"j" = (
/obj/structure/sign/delam_procedure,
/turf/template_noop,
/area/template_noop)
"l" = (
/obj/machinery/button/delam_scram,
/turf/closed/wall/r_wall,
/area/station/engineering/supermatter/room)
"t" = (
/obj/machinery/atmospherics/components/unary/delam_scram{
	dir = 4
	},
/turf/template_noop,
/area/template_noop)
"M" = (
/obj/structure/cable,
/obj/machinery/atmospherics/pipe/smart/manifold4w/cyan/visible,
/obj/machinery/meter,
/turf/open/floor/iron,
/area/station/engineering/supermatter/room)

(1,1,1) = {"
t
a
a
a
a
a
a
"}
(2,1,1) = {"
a
a
a
a
a
a
a
"}
(3,1,1) = {"
a
a
a
a
a
a
a
"}
(4,1,1) = {"
a
a
a
a
a
a
a
"}
(5,1,1) = {"
a
a
a
a
M
j
a
"}
(6,1,1) = {"
a
a
a
a
i
l
i
"}
(7,1,1) = {"
a
a
a
a
a
a
a
"}
