//MAP CONVERTED BY dmm2tgm.py THIS HEADER COMMENT PREVENTS RECONVERSION, DO NOT REMOVE
"bZ" = (
/obj/structure/table/glass,
/obj/item/razor{
	pixel_x = -6
	},
/obj/item/reagent_containers/spray/barbers_aid{
	pixel_x = 6
	},
/obj/machinery/light/directional/south,
/obj/item/radio/intercom/directional/south,
/turf/open/floor/iron/edge,
/area/station/service/barber)
"eI" = (
/obj/structure/table/glass,
/obj/structure/mirror/directional/south,
/obj/item/hairbrush/comb{
	pixel_y = 10
	},
/obj/item/reagent_containers/dropper,
/turf/open/floor/iron/edge,
/area/station/service/barber)
"fE" = (
/obj/machinery/firealarm/directional/south,
/obj/effect/turf_decal/tile/neutral{
	dir = 8
	},
/turf/open/floor/iron,
/area/station/hallway/primary/port)
"gH" = (
/obj/machinery/atmospherics/pipe/smart/manifold4w/supply/hidden/layer4,
/obj/machinery/atmospherics/pipe/smart/manifold4w/scrubbers/hidden/layer2,
/turf/open/floor/iron/dark/smooth_edge{
	dir = 4
	},
/area/station/service/barber)
"hb" = (
/turf/closed/wall/r_wall,
/area/station/science/robotics/mechbay)
"iK" = (
/obj/structure/table/glass,
/turf/open/floor/iron/dark/textured_corner{
	dir = 4
	},
/area/station/service/barber)
"kI" = (
/obj/machinery/camera/directional/south{
	c_tag = "Barber Shop"
	},
/obj/machinery/door/window/left/directional/west{
	name = "Massage Parlor"
	},
/obj/machinery/atmospherics/pipe/smart/manifold4w/supply/hidden/layer4,
/obj/machinery/atmospherics/pipe/smart/manifold4w/scrubbers/hidden/layer2,
/turf/open/floor/iron/edge{
	dir = 8
	},
/area/station/service/barber)
"ld" = (
/obj/machinery/computer/mechpad,
/obj/effect/turf_decal/bot,
/obj/structure/sign/poster/official/build{
	pixel_y = 32
	},
/turf/open/floor/iron,
/area/station/science/robotics/mechbay)
"lM" = (
/obj/machinery/button/curtain{
	id = "barbershopcurtains";
	pixel_y = -24;
	pixel_x = -6
	},
/obj/machinery/vending/barbervend,
/turf/open/floor/iron/edge{
	dir = 4
	},
/area/station/service/barber)
"mD" = (
/obj/machinery/dryer{
	pixel_y = 24
	},
/obj/machinery/atmospherics/pipe/smart/manifold4w/supply/hidden/layer4,
/turf/open/floor/iron/dark,
/area/station/service/barber)
"pe" = (
/turf/closed/wall,
/area/station/service/barber)
"px" = (
/obj/machinery/mechpad,
/obj/effect/turf_decal/bot,
/obj/structure/sign/warning/secure_area/directional/north,
/turf/open/floor/iron,
/area/station/science/robotics/mechbay)
"pW" = (
/obj/structure/closet/secure_closet/barber,
/obj/machinery/firealarm/directional/north,
/turf/open/floor/iron/edge{
	dir = 4
	},
/area/station/service/barber)
"sq" = (
/obj/structure/chair/stool/bar/directional/south,
/obj/effect/landmark/start/barber,
/obj/machinery/light/directional/west,
/turf/open/floor/iron/dark/smooth_edge{
	dir = 8
	},
/area/station/service/barber)
"tp" = (
/obj/machinery/atmospherics/components/unary/vent_scrubber/on/layer2{
	dir = 4
	},
/turf/open/floor/iron/edge{
	dir = 1
	},
/area/station/service/barber)
"xL" = (
/obj/effect/spawner/structure/window,
/obj/structure/curtain/cloth/fancy/mechanical{
	id = "barbershopcurtains"
	},
/turf/open/floor/plating,
/area/station/service/barber)
"yk" = (
/turf/closed/wall,
/area/station/maintenance/port)
"yr" = (
/obj/structure/window/spawner/west,
/obj/item/kirbyplants/random,
/turf/open/floor/iron/edge{
	dir = 8
	},
/area/station/service/barber)
"zY" = (
/obj/machinery/door/firedoor,
/obj/machinery/door/airlock/public/glass{
	name = "Port Primary Hallway"
	},
/obj/effect/turf_decal/stripes/line{
	dir = 8
	},
/obj/effect/turf_decal/stripes/line{
	dir = 4
	},
/turf/open/floor/iron,
/area/station/hallway/primary/port)
"Eg" = (
/obj/machinery/airalarm/directional/north,
/obj/machinery/atmospherics/components/unary/vent_pump/on/layer4{
	dir = 4
	},
/turf/open/floor/iron/dark,
/area/station/service/barber)
"EC" = (
/obj/structure/cable,
/obj/machinery/atmospherics/pipe/smart/manifold4w/scrubbers/hidden/layer2,
/obj/machinery/atmospherics/pipe/smart/manifold4w/supply/hidden/layer4,
/turf/open/floor/iron/edge{
	dir = 1
	},
/area/station/service/barber)
"Gw" = (
/obj/effect/turf_decal/tile/neutral{
	dir = 8
	},
/obj/structure/cable,
/obj/machinery/atmospherics/pipe/smart/manifold4w/scrubbers/hidden/layer2,
/obj/machinery/atmospherics/pipe/smart/manifold4w/supply/hidden/layer4,
/turf/open/floor/iron,
/area/station/hallway/primary/port)
"Ik" = (
/obj/structure/bed/pod{
	dir = 1
	},
/obj/effect/landmark/start/hangover,
/obj/item/radio/intercom/directional/west,
/turf/open/floor/iron/dark/smooth_edge{
	dir = 8
	},
/area/station/service/barber)
"In" = (
/obj/machinery/light_switch/directional/north,
/obj/effect/landmark/start/barber,
/turf/open/floor/iron/edge{
	dir = 1
	},
/area/station/service/barber)
"JJ" = (
/obj/effect/turf_decal/tile/purple/fourcorners,
/obj/structure/sign/nanotrasen{
	pixel_x = -32
	},
/obj/machinery/disposal/bin,
/obj/structure/disposalpipe/trunk{
	dir = 4
	},
/obj/effect/turf_decal/bot,
/obj/effect/turf_decal/stripes/line{
	dir = 8
	},
/turf/open/floor/iron,
/area/station/hallway/primary/central/fore)
"Kc" = (
/obj/structure/chair/comfy/barber_chair,
/obj/machinery/atmospherics/components/unary/vent_pump/on/layer4{
	dir = 8
	},
/obj/effect/landmark/start/hangover,
/turf/open/floor/iron,
/area/station/service/barber)
"KI" = (
/obj/structure/chair/comfy/barber_chair,
/obj/machinery/atmospherics/pipe/smart/manifold4w/supply/hidden/layer4,
/obj/machinery/atmospherics/pipe/smart/manifold4w/scrubbers/hidden/layer2,
/obj/effect/landmark/start/hangover,
/obj/structure/cable,
/turf/open/floor/iron,
/area/station/service/barber)
"LB" = (
/obj/machinery/atmospherics/pipe/smart/manifold4w/supply/hidden/layer4,
/obj/effect/landmark/start/barber,
/obj/structure/cable,
/obj/machinery/holopad,
/turf/open/floor/iron,
/area/station/service/barber)
"Mt" = (
/obj/machinery/atmospherics/pipe/smart/manifold4w/supply/hidden/layer4,
/turf/open/floor/iron/dark,
/area/station/service/barber)
"Pp" = (
/turf/closed/wall/r_wall,
/area/station/maintenance/port)
"QA" = (
/obj/machinery/newscaster/directional/south,
/turf/open/floor/iron/dark,
/area/station/service/barber)
"Tl" = (
/obj/effect/turf_decal/tile/neutral{
	dir = 8
	},
/turf/open/floor/iron,
/area/station/hallway/primary/port)
"Tn" = (
/obj/effect/turf_decal/tile/neutral{
	dir = 8
	},
/obj/machinery/airalarm/directional/south,
/turf/open/floor/iron,
/area/station/hallway/primary/port)
"Ts" = (
/obj/structure/table/glass,
/obj/structure/mirror/directional/south,
/turf/open/floor/iron/edge,
/area/station/service/barber)
"Un" = (
/obj/effect/turf_decal/tile/neutral{
	dir = 8
	},
/obj/machinery/light/directional/south,
/turf/open/floor/iron,
/area/station/hallway/primary/port)
"Vn" = (
/obj/structure/mirror/directional/north,
/obj/structure/sink/directional/south,
/obj/machinery/atmospherics/components/unary/vent_scrubber/on/layer2,
/turf/open/floor/iron/dark/smooth_edge{
	dir = 4
	},
/area/station/service/barber)
"VF" = (
/obj/structure/cable,
/obj/machinery/atmospherics/pipe/smart/manifold4w/scrubbers/hidden/layer2,
/obj/machinery/door/firedoor,
/obj/machinery/atmospherics/pipe/smart/manifold4w/supply/hidden/layer4,
/obj/machinery/door/airlock/glass{
	name = "Barber Shop"
	},
/turf/open/floor/iron,
/area/station/service/barber)
"Wm" = (
/obj/effect/turf_decal/bot,
/obj/structure/reagent_dispensers/fueltank,
/obj/effect/decal/cleanable/dirt,
/turf/open/floor/iron,
/area/station/science/robotics/mechbay)
"Yc" = (
/turf/closed/wall/r_wall,
/area/station/service/barber)
"Zf" = (
/obj/machinery/atmospherics/pipe/smart/manifold4w/scrubbers/hidden/layer2,
/obj/effect/landmark/start/barber,
/turf/open/floor/iron/edge{
	dir = 1
	},
/area/station/service/barber)
"ZO" = (
/obj/machinery/power/apc/auto_name/directional/south,
/obj/machinery/atmospherics/pipe/smart/manifold4w/supply/hidden/layer4,
/obj/machinery/atmospherics/pipe/smart/manifold4w/scrubbers/hidden/layer2,
/obj/structure/cable,
/turf/open/floor/iron,
/area/station/service/barber)

(1,1,1) = {"
Tn
yk
yk
yk
yk
Pp
"}
(2,1,1) = {"
Un
pe
sq
Ik
iK
hb
"}
(3,1,1) = {"
Tl
pe
Eg
QA
Yc
hb
"}
(4,1,1) = {"
Tl
pe
mD
Mt
hb
Wm
"}
(5,1,1) = {"
Tl
pe
Vn
gH
hb
px
"}
(6,1,1) = {"
Tl
xL
yr
kI
hb
ld
"}
(7,1,1) = {"
Tl
xL
tp
ZO
hb
hb
"}
(8,1,1) = {"
Tl
xL
Zf
KI
Ts
hb
"}
(9,1,1) = {"
Gw
VF
EC
LB
bZ
hb
"}
(10,1,1) = {"
Un
pe
In
Kc
eI
hb
"}
(11,1,1) = {"
fE
pe
pW
lM
pe
hb
"}
(12,1,1) = {"
zY
pe
xL
xL
pe
JJ
"}
