//MAP CONVERTED BY dmm2tgm.py THIS HEADER COMMENT PREVENTS RECONVERSION, DO NOT REMOVE
"j" = (
/obj/effect/turf_decal/bot,
/obj/effect/turf_decal/tile/neutral/fourcorners,
/obj/structure/window/reinforced/spawner/directional/east{
	pixel_x = 3
	},
/obj/structure/rack/gunrack,
/obj/effect/spawner/armory_spawn/shotguns,
/turf/open/floor/iron/dark,
/area/station/ai_monitored/security/armory)
"k" = (
/obj/item/storage/secure/safe/directional/east,
/obj/effect/turf_decal/tile/neutral/fourcorners,
/obj/machinery/dish_drive/bullet,
/turf/open/floor/iron/dark,
/area/station/ai_monitored/security/armory)
"l" = (
/obj/effect/turf_decal/bot,
/obj/structure/window/reinforced/spawner/directional/east{
	pixel_x = 3
	},
/obj/effect/turf_decal/tile/neutral/fourcorners,
/obj/structure/window/reinforced/spawner,
/obj/structure/rack/gunrack,
/obj/effect/spawner/armory_spawn/microfusion,
/turf/open/floor/iron/dark,
/area/station/ai_monitored/security/armory)
"E" = (
/obj/structure/rack,
/obj/structure/window/reinforced/spawner/directional/north,
/obj/effect/turf_decal/tile/neutral/fourcorners,
/obj/effect/turf_decal/bot,
/obj/item/clothing/suit/armor/vest/alt/sec{
	pixel_x = 3;
	pixel_y = -3
	},
/obj/item/clothing/suit/armor/vest/alt/sec,
/obj/item/clothing/suit/armor/vest/alt/sec{
	pixel_x = -3;
	pixel_y = 3
	},
/obj/item/clothing/head/helmet/sec{
	pixel_x = 3;
	pixel_y = -3
	},
/obj/item/clothing/head/helmet/sec,
/obj/item/clothing/head/helmet/sec{
	pixel_x = -3;
	pixel_y = 3
	},
/turf/open/floor/iron/dark,
/area/station/ai_monitored/security/armory)
"L" = (
/obj/effect/turf_decal/bot,
/obj/effect/turf_decal/tile/neutral/fourcorners,
/obj/structure/window/reinforced/spawner/directional/east{
	pixel_x = 3
	},
/obj/structure/rack/gunrack,
/obj/effect/spawner/armory_spawn/cmg,
/turf/open/floor/iron/dark,
/area/station/ai_monitored/security/armory)
"M" = (
/obj/structure/rack,
/obj/item/gun/energy/ionrifle,
/obj/item/clothing/suit/hooded/ablative,
/obj/item/gun/energy/temperature/security,
/obj/structure/window/reinforced/spawner,
/obj/effect/turf_decal/tile/neutral/fourcorners,
/obj/effect/turf_decal/bot,
/turf/open/floor/iron/dark,
/area/station/ai_monitored/security/armory)
"O" = (
/obj/structure/table/reinforced,
/obj/effect/turf_decal/tile/neutral/fourcorners,
/obj/machinery/airalarm/directional/north,
/obj/item/storage/barricade{
	pixel_y = 10
	},
/obj/item/storage/barricade{
	pixel_y = 5
	},
/obj/item/storage/barricade,
/turf/open/floor/iron/dark,
/area/station/ai_monitored/security/armory)
"R" = (
/obj/structure/rack,
/obj/item/clothing/suit/armor/riot{
	pixel_x = -3;
	pixel_y = 3
	},
/obj/item/clothing/suit/armor/riot,
/obj/item/clothing/suit/armor/riot{
	pixel_x = 3;
	pixel_y = -3
	},
/obj/item/clothing/head/helmet/toggleable/riot{
	pixel_x = -3;
	pixel_y = 3
	},
/obj/item/clothing/head/helmet/toggleable/riot,
/obj/item/clothing/head/helmet/toggleable/riot{
	pixel_x = 3;
	pixel_y = -3
	},
/obj/item/shield/riot{
	pixel_x = -3;
	pixel_y = 3
	},
/obj/item/shield/riot,
/obj/item/shield/riot{
	pixel_x = 3;
	pixel_y = -3
	},
/obj/effect/turf_decal/tile/neutral/fourcorners,
/obj/effect/turf_decal/bot,
/turf/open/floor/iron/dark,
/area/station/ai_monitored/security/armory)
"U" = (
/obj/structure/rack,
/obj/item/clothing/suit/armor/bulletproof{
	pixel_x = -3;
	pixel_y = 3
	},
/obj/item/clothing/suit/armor/bulletproof,
/obj/item/clothing/suit/armor/bulletproof{
	pixel_x = 3;
	pixel_y = -3
	},
/obj/item/clothing/head/helmet/alt{
	layer = 3.00001;
	pixel_x = -3;
	pixel_y = 3
	},
/obj/item/clothing/head/helmet/alt{
	layer = 3.00001
	},
/obj/item/clothing/head/helmet/alt{
	layer = 3.00001;
	pixel_x = 3;
	pixel_y = -3
	},
/obj/effect/turf_decal/tile/neutral/fourcorners,
/obj/effect/turf_decal/bot,
/turf/open/floor/iron/dark,
/area/station/ai_monitored/security/armory)
"X" = (
/obj/effect/turf_decal/bot,
/obj/effect/turf_decal/tile/neutral/fourcorners,
/obj/structure/window/reinforced/spawner/directional/east{
	pixel_x = 3
	},
/obj/structure/window/reinforced/spawner/directional/north,
/obj/structure/closet/secure_closet/smartgun,
/turf/open/floor/iron/dark,
/area/station/ai_monitored/security/armory)
"Y" = (
/turf/template_noop,
/area/template_noop)

(1,1,1) = {"
O
Y
X
L
j
l
"}
(2,1,1) = {"
Y
Y
E
U
R
M
"}
(3,1,1) = {"
Y
Y
Y
Y
Y
Y
"}
(4,1,1) = {"
Y
Y
Y
k
Y
Y
"}
