//MAP CONVERTED BY dmm2tgm.py THIS HEADER COMMENT PREVENTS RECONVERSION, DO NOT REMOVE
"a" = (
/turf/closed/wall/r_wall,
/area/station/ai_monitored/security/armory)
"b" = (
/obj/item/storage/secure/safe/directional/east,
/obj/effect/turf_decal/tile/neutral/fourcorners,
/obj/machinery/dish_drive/bullet{
	succrange = 6
	},
/turf/open/floor/iron/dark,
/area/station/ai_monitored/security/armory)
"c" = (
/obj/structure/cable,
/obj/effect/turf_decal/stripes/line{
	dir = 1
	},
/turf/open/floor/iron/dark,
/area/station/ai_monitored/security/armory)
"d" = (
/obj/structure/sign/warning/directional/west,
/obj/structure/lattice,
/turf/open/space/basic,
/area/space/nearstation)
"e" = (
/obj/machinery/atmospherics/pipe/smart/manifold4w/scrubbers/hidden/layer2,
/obj/effect/turf_decal/stripes/corner{
	dir = 1
	},
/obj/effect/turf_decal/stripes/line{
	dir = 4
	},
/turf/open/floor/iron/dark,
/area/station/ai_monitored/security/armory)
"f" = (
/obj/machinery/camera/directional/south{
	c_tag = "Armory - Interior"
	},
/obj/effect/turf_decal/trimline/dark_red/filled/line,
/obj/structure/chair/office,
/turf/open/floor/iron/dark,
/area/station/ai_monitored/security/armory)
"g" = (
/obj/structure/cable,
/obj/machinery/atmospherics/pipe/smart/manifold4w/supply/hidden/layer4,
/obj/machinery/atmospherics/pipe/smart/manifold4w/scrubbers/hidden/layer2,
/mob/living/simple_animal/bot/secbot/beepsky/armsky,
/obj/effect/turf_decal/stripes/corner{
	dir = 4
	},
/turf/open/floor/iron/dark,
/area/station/ai_monitored/security/armory)
"h" = (
/obj/effect/turf_decal/trimline/dark_red/filled/warning,
/turf/open/floor/iron/dark,
/area/station/ai_monitored/security/armory)
"i" = (
/obj/effect/turf_decal/tile/neutral/fourcorners,
/obj/vehicle/ridden/secway,
/obj/structure/reagent_dispensers/wall/peppertank/directional/east,
/obj/item/key/security,
/turf/open/floor/iron/dark,
/area/station/ai_monitored/security/armory)
"j" = (
/obj/effect/turf_decal/bot,
/obj/effect/turf_decal/tile/neutral/fourcorners,
/obj/structure/window/reinforced/spawner/east{
	pixel_x = 3
	},
/obj/structure/rack/gunrack,
/obj/effect/spawner/armory_spawn/shotguns,
/turf/open/floor/iron/dark,
/area/station/ai_monitored/security/armory)
"k" = (
/obj/effect/landmark/event_spawn,
/obj/structure/cable,
/obj/machinery/atmospherics/components/unary/vent_pump/on/layer4{
	dir = 8
	},
/obj/effect/turf_decal/stripes/line{
	dir = 1
	},
/turf/open/floor/iron/dark/smooth_large,
/area/station/ai_monitored/security/armory)
"l" = (
/obj/effect/turf_decal/bot,
/obj/structure/window/reinforced/spawner/east{
	pixel_x = 3
	},
/obj/effect/turf_decal/tile/neutral/fourcorners,
/obj/structure/window/reinforced/spawner,
/obj/structure/rack/gunrack,
/obj/effect/spawner/armory_spawn/microfusion,
/turf/open/floor/iron/dark,
/area/station/ai_monitored/security/armory)
"m" = (
/obj/structure/table/reinforced,
/obj/effect/turf_decal/tile/neutral/fourcorners,
/obj/machinery/newscaster/directional/north,
/obj/item/clothing/mask/gas/sechailer,
/obj/item/clothing/mask/gas/sechailer{
	pixel_y = -2
	},
/obj/item/clothing/mask/gas/sechailer{
	pixel_y = 3
	},
/obj/item/flashlight/seclite{
	pixel_y = -1
	},
/obj/item/flashlight/seclite{
	pixel_y = -3;
	pixel_x = 2
	},
/obj/item/flashlight/seclite{
	pixel_y = -5;
	pixel_x = 4
	},
/turf/open/floor/iron/dark,
/area/station/ai_monitored/security/armory)
"n" = (
/obj/effect/turf_decal/stripes/line{
	dir = 4
	},
/obj/structure/cable,
/obj/effect/turf_decal/stripes/corner{
	dir = 1
	},
/turf/open/floor/iron/dark,
/area/station/ai_monitored/security/armory)
"o" = (
/obj/effect/turf_decal/stripes/line{
	dir = 1
	},
/obj/machinery/atmospherics/pipe/smart/manifold4w/scrubbers/hidden/layer2,
/obj/effect/turf_decal/stripes/line,
/turf/open/floor/iron/dark,
/area/station/ai_monitored/security/armory)
"p" = (
/obj/machinery/flasher/portable,
/obj/effect/turf_decal/tile/neutral/fourcorners,
/obj/effect/turf_decal/bot,
/turf/open/floor/iron/dark,
/area/station/ai_monitored/security/armory)
"q" = (
/obj/structure/lattice,
/obj/structure/sign/warning/directional/west,
/turf/open/space,
/area/space/nearstation)
"t" = (
/obj/machinery/atmospherics/pipe/smart/manifold4w/scrubbers/hidden/layer2,
/obj/effect/turf_decal/stripes/line{
	dir = 4
	},
/turf/open/floor/iron/dark,
/area/station/ai_monitored/security/armory)
"u" = (
/obj/effect/turf_decal/stripes/line{
	dir = 9
	},
/obj/machinery/atmospherics/pipe/smart/manifold4w/scrubbers/hidden/layer2,
/obj/effect/turf_decal/stripes/corner,
/turf/open/floor/iron/dark,
/area/station/ai_monitored/security/armory)
"v" = (
/obj/effect/turf_decal/trimline/dark_red/filled/warning{
	dir = 8
	},
/turf/open/floor/iron/dark,
/area/station/ai_monitored/security/armory)
"w" = (
/obj/machinery/door/poddoor{
	id = "armouryaccess";
	name = "Armoury Access"
	},
/obj/effect/turf_decal/stripes/line,
/obj/effect/turf_decal/stripes/line{
	dir = 1
	},
/turf/open/floor/iron,
/area/station/ai_monitored/security/armory)
"x" = (
/obj/effect/turf_decal/tile/neutral/fourcorners,
/obj/structure/table/reinforced,
/obj/machinery/recharger,
/turf/open/floor/iron/dark,
/area/station/ai_monitored/security/armory)
"y" = (
/obj/effect/turf_decal/tile/neutral/fourcorners,
/obj/machinery/flasher/portable,
/obj/effect/turf_decal/bot,
/obj/machinery/light/directional/west,
/turf/open/floor/iron/dark,
/area/station/ai_monitored/security/armory)
"z" = (
/obj/structure/cable,
/obj/machinery/atmospherics/pipe/smart/manifold4w/supply/hidden/layer4,
/obj/machinery/atmospherics/pipe/smart/manifold4w/scrubbers/hidden/layer2,
/obj/effect/turf_decal/trimline/dark_red/filled/warning{
	dir = 8
	},
/turf/open/floor/iron/dark,
/area/station/ai_monitored/security/armory)
"A" = (
/obj/machinery/atmospherics/components/unary/vent_scrubber/on/layer2{
	dir = 8
	},
/obj/effect/turf_decal/stripes/line{
	dir = 1
	},
/obj/effect/turf_decal/stripes/line,
/turf/open/floor/iron/dark/smooth_large,
/area/station/ai_monitored/security/armory)
"B" = (
/obj/machinery/power/apc/auto_name/directional/south,
/obj/structure/cable,
/obj/effect/turf_decal/trimline/dark_red/filled/line,
/obj/effect/turf_decal/stripes/line{
	dir = 4
	},
/obj/machinery/status_display/ai/directional/east,
/turf/open/floor/iron/dark,
/area/station/ai_monitored/security/armory)
"C" = (
/obj/machinery/button/door/directional/south{
	id = "armouryaccess";
	name = "Armoury Access";
	req_access = list("armory")
	},
/obj/effect/turf_decal/trimline/dark_red/filled/line{
	dir = 10
	},
/turf/open/floor/iron/dark,
/area/station/ai_monitored/security/armory)
"D" = (
/obj/item/storage/box/teargas{
	pixel_x = 3;
	pixel_y = 3
	},
/obj/item/storage/box/handcuffs,
/obj/item/storage/box/flashbangs{
	pixel_x = -3;
	pixel_y = -3
	},
/obj/structure/table/reinforced,
/obj/effect/turf_decal/tile/neutral/fourcorners,
/obj/machinery/status_display/ai/directional/east,
/obj/machinery/firealarm/directional/north,
/turf/open/floor/iron/dark,
/area/station/ai_monitored/security/armory)
"E" = (
/obj/structure/rack,
/obj/structure/window/reinforced/spawner/north,
/obj/effect/turf_decal/tile/neutral/fourcorners,
/obj/effect/turf_decal/bot,
/obj/item/clothing/suit/armor/vest/security{
	pixel_x = 3;
	pixel_y = -3
	},
/obj/item/clothing/suit/armor/vest/security,
/obj/item/clothing/suit/armor/vest/security{
	pixel_x = -3;
	pixel_y = 3
	},
/obj/item/clothing/head/helmet/sec{
	pixel_x = 3;
	pixel_y = -3
	},
/obj/item/clothing/head/helmet/sec,
/obj/item/clothing/head/helmet/sec{
	pixel_x = -3;
	pixel_y = 3
	},
/turf/open/floor/iron/dark,
/area/station/ai_monitored/security/armory)
"F" = (
/obj/structure/sign/nanotrasen{
	pixel_x = 32
	},
/obj/effect/turf_decal/tile/neutral/fourcorners,
/obj/structure/closet/secure_closet/armory2,
/obj/effect/turf_decal/bot,
/obj/item/storage/box/lethalshot,
/obj/item/storage/box/lethalshot,
/obj/item/storage/box/lethalshot,
/turf/open/floor/iron/dark,
/area/station/ai_monitored/security/armory)
"G" = (
/obj/structure/table/reinforced,
/obj/machinery/door/firedoor,
/obj/machinery/door/window/brigdoor/right/directional/north{
	name = "Armoury Desk";
	req_access = list("armory")
	},
/obj/machinery/door/window/right/directional/south{
	name = "Armoury Desk";
	req_access = list("security")
	},
/obj/item/restraints/handcuffs,
/obj/item/assembly/flash/handheld,
/turf/open/floor/iron/dark,
/area/station/ai_monitored/security/armory)
"I" = (
/obj/effect/turf_decal/stripes/line{
	dir = 5
	},
/obj/effect/turf_decal/stripes/corner{
	dir = 8
	},
/turf/open/floor/iron/dark,
/area/station/ai_monitored/security/armory)
"J" = (
/obj/effect/turf_decal/trimline/dark_red/filled/line{
	dir = 8
	},
/obj/effect/turf_decal/stripes/line{
	dir = 1
	},
/turf/open/floor/iron/dark,
/area/station/ai_monitored/security/armory)
"K" = (
/obj/item/grenade/barrier{
	pixel_x = -3;
	pixel_y = 8
	},
/obj/item/grenade/barrier{
	pixel_y = 7
	},
/obj/item/grenade/barrier{
	pixel_x = 3;
	pixel_y = 6
	},
/obj/item/grenade/barrier{
	pixel_x = 6;
	pixel_y = 5
	},
/obj/structure/table/reinforced,
/obj/effect/turf_decal/tile/neutral/fourcorners,
/obj/item/radio/intercom/directional/north,
/turf/open/floor/iron/dark,
/area/station/ai_monitored/security/armory)
"L" = (
/obj/effect/turf_decal/bot,
/obj/effect/turf_decal/tile/neutral/fourcorners,
/obj/structure/window/reinforced/spawner/east{
	pixel_x = 3
	},
/obj/structure/rack/gunrack,
/obj/effect/spawner/armory_spawn/cmg,
/turf/open/floor/iron/dark,
/area/station/ai_monitored/security/armory)
"M" = (
/obj/structure/rack,
/obj/item/gun/energy/ionrifle,
/obj/item/clothing/suit/hooded/ablative,
/obj/item/gun/energy/temperature/security,
/obj/structure/window/reinforced/spawner,
/obj/effect/turf_decal/tile/neutral/fourcorners,
/obj/effect/turf_decal/bot,
/turf/open/floor/iron/dark,
/area/station/ai_monitored/security/armory)
"N" = (
/obj/machinery/door/firedoor,
/obj/machinery/door/airlock/security{
	name = "Armoury"
	},
/obj/structure/cable,
/obj/machinery/atmospherics/pipe/smart/manifold4w/supply/hidden/layer4,
/obj/machinery/atmospherics/pipe/smart/manifold4w/scrubbers/hidden/layer2,
/obj/effect/mapping_helpers/airlock/access/all/security/armory,
/obj/effect/landmark/navigate_destination,
/obj/effect/turf_decal/tile/neutral/fourcorners,
/obj/effect/turf_decal/stripes/line{
	dir = 8
	},
/obj/effect/turf_decal/stripes/line{
	dir = 4
	},
/turf/open/floor/iron/dark,
/area/station/ai_monitored/security/armory)
"O" = (
/obj/structure/table/reinforced,
/obj/effect/turf_decal/tile/neutral/fourcorners,
/obj/machinery/airalarm/directional/north,
/obj/item/storage/barricade{
	pixel_y = 10
	},
/obj/item/storage/barricade{
	pixel_y = 5
	},
/obj/item/storage/barricade,
/turf/open/floor/iron/dark,
/area/station/ai_monitored/security/armory)
"P" = (
/obj/structure/closet/secure_closet/contraband/armory,
/obj/machinery/light/directional/east,
/obj/effect/turf_decal/tile/neutral/fourcorners,
/obj/effect/turf_decal/bot,
/obj/effect/spawner/random/maintenance/three,
/obj/effect/spawner/random/contraband/armory,
/turf/open/floor/iron/dark,
/area/station/ai_monitored/security/armory)
"Q" = (
/obj/structure/sign/nanotrasen{
	pixel_x = 32
	},
/obj/effect/turf_decal/tile/neutral/fourcorners,
/obj/structure/table/reinforced,
/obj/item/storage/box/firingpins{
	pixel_y = 5
	},
/turf/open/floor/iron/dark,
/area/station/ai_monitored/security/armory)
"R" = (
/obj/structure/rack,
/obj/item/clothing/suit/armor/riot{
	pixel_x = -3;
	pixel_y = 3
	},
/obj/item/clothing/suit/armor/riot,
/obj/item/clothing/suit/armor/riot{
	pixel_x = 3;
	pixel_y = -3
	},
/obj/item/clothing/head/helmet/riot{
	pixel_x = -3;
	pixel_y = 3
	},
/obj/item/clothing/head/helmet/riot,
/obj/item/clothing/head/helmet/riot{
	pixel_x = 3;
	pixel_y = -3
	},
/obj/item/shield/riot{
	pixel_x = -3;
	pixel_y = 3
	},
/obj/item/shield/riot,
/obj/item/shield/riot{
	pixel_x = 3;
	pixel_y = -3
	},
/obj/effect/turf_decal/tile/neutral/fourcorners,
/obj/effect/turf_decal/bot,
/turf/open/floor/iron/dark,
/area/station/ai_monitored/security/armory)
"S" = (
/obj/effect/turf_decal/stripes/line{
	dir = 8
	},
/obj/machinery/atmospherics/pipe/smart/manifold4w/scrubbers/hidden/layer2,
/obj/effect/turf_decal/stripes/line{
	dir = 4
	},
/turf/open/floor/iron/dark,
/area/station/ai_monitored/security/armory)
"U" = (
/obj/structure/rack,
/obj/item/clothing/suit/armor/bulletproof{
	pixel_x = -3;
	pixel_y = 3
	},
/obj/item/clothing/suit/armor/bulletproof,
/obj/item/clothing/suit/armor/bulletproof{
	pixel_x = 3;
	pixel_y = -3
	},
/obj/item/clothing/head/helmet/alt{
	layer = 3.00001;
	pixel_x = -3;
	pixel_y = 3
	},
/obj/item/clothing/head/helmet/alt{
	layer = 3.00001
	},
/obj/item/clothing/head/helmet/alt{
	layer = 3.00001;
	pixel_x = 3;
	pixel_y = -3
	},
/obj/effect/turf_decal/tile/neutral/fourcorners,
/obj/effect/turf_decal/bot,
/turf/open/floor/iron/dark,
/area/station/ai_monitored/security/armory)
"V" = (
/obj/machinery/door/firedoor,
/obj/machinery/door/airlock/security{
	name = "Armoury"
	},
/obj/effect/mapping_helpers/airlock/access/all/security/armory,
/obj/structure/cable,
/obj/effect/turf_decal/tile/neutral/fourcorners,
/obj/effect/turf_decal/stripes/line{
	dir = 8
	},
/obj/effect/turf_decal/stripes/line{
	dir = 4
	},
/turf/open/floor/iron/dark,
/area/station/ai_monitored/security/armory)
"W" = (
/obj/effect/turf_decal/stripes/line{
	dir = 4
	},
/obj/effect/turf_decal/stripes/line{
	dir = 8
	},
/turf/open/floor/iron/dark,
/area/station/ai_monitored/security/armory)
"X" = (
/obj/effect/turf_decal/bot,
/obj/effect/turf_decal/tile/neutral/fourcorners,
/obj/structure/window/reinforced/spawner/east{
	pixel_x = 3
	},
/obj/structure/window/reinforced/spawner/north,
/obj/structure/closet/secure_closet/smartgun,
/turf/open/floor/iron/dark,
/area/station/ai_monitored/security/armory)
"Y" = (
/obj/effect/spawner/structure/window/reinforced,
/obj/structure/cable,
/turf/open/floor/plating,
/area/station/ai_monitored/security/armory)
"Z" = (
/obj/machinery/light/directional/east,
/obj/effect/turf_decal/tile/neutral/fourcorners,
/obj/structure/table/reinforced,
/obj/item/storage/box/chemimp{
	pixel_x = 4;
	pixel_y = 10
	},
/obj/item/storage/box/trackimp{
	pixel_y = 6
	},
/obj/item/storage/lockbox/loyalty,
/turf/open/floor/iron/dark,
/area/station/ai_monitored/security/armory)

(1,1,1) = {"
a
a
Y
Y
a
Y
V
N
Y
a
"}
(2,1,1) = {"
a
x
p
p
y
J
v
z
C
a
"}
(3,1,1) = {"
a
K
u
S
S
e
t
g
h
w
"}
(4,1,1) = {"
a
O
o
X
L
j
l
k
h
w
"}
(5,1,1) = {"
a
m
A
E
U
R
M
c
f
G
"}
(6,1,1) = {"
a
D
I
W
W
W
W
n
B
a
"}
(7,1,1) = {"
a
a
P
F
b
i
Q
Z
a
a
"}
(8,1,1) = {"
q
a
a
a
a
a
a
a
a
d
"}
