//MAP CONVERTED BY dmm2tgm.py THIS HEADER COMMENT PREVENTS RECONVERSION, DO NOT REMOVE
"bg" = (
/obj/machinery/atmospherics/pipe/smart/manifold4w/scrubbers/hidden/layer2,
/obj/machinery/atmospherics/components/unary/vent_pump/on/layer4{
	dir = 8
	},
/obj/effect/decal/cleanable/dirt,
/obj/effect/decal/cleanable/dirt,
/turf/open/floor/iron/large,
/area/station/service/tv_studio)
"br" = (
/obj/machinery/airalarm/directional/west,
/turf/open/floor/iron/large,
/area/station/service/tv_studio)
"co" = (
/turf/open/floor/wood,
/area/station/service/tv_studio)
"cy" = (
/obj/machinery/atmospherics/pipe/smart/manifold4w/supply/hidden/layer4,
/obj/machinery/atmospherics/pipe/smart/manifold4w/scrubbers/hidden/layer2,
/obj/effect/decal/cleanable/dirt,
/turf/open/floor/iron/large,
/area/station/service/tv_studio)
"df" = (
/obj/machinery/atmospherics/pipe/smart/manifold4w/scrubbers/hidden/layer2,
/obj/machinery/atmospherics/pipe/smart/manifold4w/supply/hidden/layer4,
/obj/structure/cable,
/obj/effect/turf_decal/siding/wood{
	dir = 4
	},
/turf/open/floor/wood,
/area/station/service/tv_studio)
"eF" = (
/obj/effect/spawner/structure/window/reinforced,
/obj/machinery/door/poddoor/shutters/preopen{
	name = "Record Shutters";
	id = "Record Shutters"
	},
/turf/open/floor/plating,
/area/station/service/tv_studio)
"fO" = (
/obj/machinery/atmospherics/components/unary/vent_scrubber/on/layer2{
	dir = 1
	},
/obj/machinery/light/directional/south,
/obj/effect/decal/cleanable/dirt,
/obj/machinery/newscaster/directional/south,
/turf/open/floor/iron/large,
/area/station/service/tv_studio)
"fY" = (
/obj/machinery/atmospherics/components/unary/vent_scrubber/on/layer2{
	dir = 8
	},
/turf/open/floor/iron/large,
/area/station/service/tv_studio)
"gm" = (
/obj/machinery/atmospherics/pipe/smart/manifold4w/supply/hidden/layer4,
/obj/machinery/atmospherics/pipe/smart/manifold4w/scrubbers/hidden/layer2,
/obj/machinery/airalarm/directional/north,
/obj/effect/decal/cleanable/dirt,
/turf/open/floor/iron/large,
/area/station/service/tv_studio)
"hc" = (
/obj/machinery/atmospherics/components/unary/vent_pump/on/layer4{
	dir = 4
	},
/obj/structure/extinguisher_cabinet/directional/north,
/obj/effect/turf_decal/siding/wood{
	dir = 1
	},
/obj/effect/decal/cleanable/dirt,
/turf/open/floor/wood,
/area/station/service/tv_studio)
"hn" = (
/obj/machinery/atmospherics/pipe/smart/manifold4w/scrubbers/hidden/layer2,
/obj/machinery/atmospherics/pipe/smart/manifold4w/supply/hidden/layer4,
/obj/structure/cable,
/obj/machinery/firealarm/directional/east,
/obj/effect/turf_decal/siding/wood{
	dir = 6
	},
/turf/open/floor/wood,
/area/station/service/tv_studio)
"hx" = (
/obj/machinery/atmospherics/pipe/smart/manifold4w/scrubbers/hidden/layer2,
/turf/open/floor/iron/large,
/area/station/service/tv_studio)
"hR" = (
/obj/machinery/vending/autodrobe,
/obj/machinery/atmospherics/components/unary/vent_scrubber/on/layer2{
	dir = 1
	},
/obj/effect/decal/cleanable/dirt,
/turf/open/floor/iron/large,
/area/station/service/tv_studio)
"iv" = (
/obj/effect/spawner/structure/window/reinforced,
/obj/machinery/door/poddoor/shutters/preopen{
	name = "TV Show Shutters";
	id = "TV Show Shutters"
	},
/turf/open/floor/plating,
/area/station/service/tv_studio)
"iB" = (
/obj/structure/chair/sofa/corp/left,
/obj/effect/turf_decal/siding/wood{
	dir = 1
	},
/turf/open/floor/wood,
/area/station/service/tv_studio)
"iV" = (
/obj/structure/table/glass,
/obj/item/radio{
	frequency = 1455;
	name = "Operator radio"
	},
/turf/open/floor/iron/large,
/area/station/service/tv_studio)
"kk" = (
/obj/structure/chair/sofa/corp,
/obj/effect/turf_decal/siding/wood{
	dir = 1
	},
/obj/effect/decal/cleanable/dirt,
/turf/open/floor/wood,
/area/station/service/tv_studio)
"kM" = (
/obj/machinery/navbeacon{
	codes_txt = "patrol;next_patrol=arrivals2";
	location = "arrivals1"
	},
/obj/effect/decal/cleanable/dirt,
/turf/open/floor/wood,
/area/station/service/tv_studio)
"kW" = (
/obj/structure/table/glass,
/obj/item/folder,
/turf/open/floor/iron/large,
/area/station/service/tv_studio)
"mr" = (
/obj/machinery/atmospherics/pipe/smart/manifold4w/scrubbers/hidden/layer2,
/obj/machinery/atmospherics/pipe/smart/manifold4w/supply/hidden/layer4,
/obj/structure/cable,
/obj/machinery/airalarm/directional/east,
/obj/effect/turf_decal/siding/wood{
	dir = 4
	},
/obj/machinery/light/directional/east,
/turf/open/floor/wood,
/area/station/service/tv_studio)
"nG" = (
/obj/structure/chair/office{
	dir = 4
	},
/obj/machinery/atmospherics/pipe/smart/manifold4w/scrubbers/hidden/layer2,
/obj/effect/decal/cleanable/dirt,
/turf/open/floor/iron/large,
/area/station/service/tv_studio)
"pe" = (
/obj/structure/chair/sofa/corp/right{
	dir = 4
	},
/obj/effect/turf_decal/siding/wood{
	dir = 8
	},
/obj/effect/decal/cleanable/dirt,
/turf/open/floor/wood,
/area/station/service/tv_studio)
"qg" = (
/obj/structure/table/glass,
/obj/item/toy/plush/beeplushie,
/turf/open/floor/wood,
/area/station/service/tv_studio)
"qq" = (
/obj/effect/decal/cleanable/dirt,
/turf/open/floor/iron/large,
/area/station/service/tv_studio)
"rg" = (
/obj/effect/turf_decal/siding/wood{
	dir = 10
	},
/obj/machinery/light/directional/south,
/turf/open/floor/wood,
/area/station/service/tv_studio)
"rV" = (
/obj/machinery/light/directional/south,
/obj/effect/decal/cleanable/dirt,
/turf/open/floor/iron/large,
/area/station/service/tv_studio)
"sb" = (
/obj/machinery/atmospherics/components/unary/vent_scrubber/on/layer2{
	dir = 4
	},
/obj/effect/turf_decal/siding/wood,
/turf/open/floor/wood,
/area/station/service/tv_studio)
"uM" = (
/obj/structure/table,
/obj/machinery/button/door{
	name = "Record Shutters";
	id = "Record Shutters";
	pixel_x = 6
	},
/obj/machinery/button/door{
	pixel_x = -6;
	id = "TV Show Shutters";
	name = "TV Show Shutters"
	},
/turf/open/floor/iron/large,
/area/station/service/tv_studio)
"uY" = (
/obj/structure/chair/sofa/corp/corner{
	dir = 4
	},
/obj/effect/turf_decal/siding/wood{
	dir = 9
	},
/obj/machinery/light/directional/north,
/turf/open/floor/wood,
/area/station/service/tv_studio)
"vh" = (
/obj/machinery/door/airlock{
	name = "TV Show Room"
	},
/obj/effect/mapping_helpers/airlock/access/all/service/library,
/obj/machinery/atmospherics/pipe/smart/manifold4w/supply/hidden/layer4,
/obj/machinery/atmospherics/pipe/smart/manifold4w/scrubbers/hidden/layer2,
/obj/machinery/door/firedoor,
/turf/open/floor/iron/large,
/area/station/service/tv_studio)
"vJ" = (
/obj/machinery/light/directional/south,
/turf/open/floor/iron/large,
/area/station/service/tv_studio)
"vO" = (
/obj/machinery/door/poddoor/shutters/preopen{
	name = "TV Show Shutters";
	id = "TV Show Shutters";
	dir = 4
	},
/obj/effect/spawner/structure/window/reinforced,
/turf/open/floor/plating,
/area/station/service/tv_studio)
"yd" = (
/obj/effect/spawner/structure/window/reinforced,
/turf/open/floor/plating,
/area/station/service/tv_studio)
"yY" = (
/obj/structure/table/glass,
/obj/item/modular_computer/laptop,
/obj/effect/decal/cleanable/dirt,
/turf/open/floor/iron/large,
/area/station/service/tv_studio)
"Cg" = (
/obj/machinery/firealarm/directional/west,
/obj/machinery/light/directional/south,
/turf/open/floor/iron/large,
/area/station/service/tv_studio)
"Du" = (
/obj/structure/table,
/obj/machinery/computer/security/telescreen{
	dir = 8;
	name = "TV Record Screen";
	network = list("tv","thunder")
	},
/turf/open/floor/iron/large,
/area/station/service/tv_studio)
"DO" = (
/obj/structure/table/glass,
/obj/effect/decal/cleanable/dirt,
/turf/open/floor/wood,
/area/station/service/tv_studio)
"Fa" = (
/obj/effect/turf_decal/siding/wood,
/obj/effect/decal/cleanable/dirt,
/turf/open/floor/wood,
/area/station/service/tv_studio)
"GG" = (
/obj/structure/table/wood,
/obj/item/radio/intercom/tv,
/obj/effect/turf_decal/siding/wood{
	dir = 8
	},
/turf/open/floor/wood,
/area/station/service/tv_studio)
"GL" = (
/obj/structure/statue/sandstone/venus{
	dir = 1;
	name = "Honor"
	},
/obj/machinery/light/directional/north,
/turf/open/floor/iron/large,
/area/station/service/tv_studio)
"Hf" = (
/obj/structure/chair/office,
/turf/open/floor/wood,
/area/station/service/tv_studio)
"Hn" = (
/obj/structure/chair/office{
	dir = 1
	},
/obj/effect/turf_decal/siding/wood,
/turf/open/floor/wood,
/area/station/service/tv_studio)
"HJ" = (
/obj/structure/table,
/obj/item/radio{
	frequency = 1455;
	name = "Operator radio"
	},
/obj/machinery/firealarm/directional/north,
/turf/open/floor/iron/large,
/area/station/service/tv_studio)
"Im" = (
/obj/machinery/vending/clothing,
/obj/machinery/atmospherics/components/unary/vent_pump/on/layer4{
	dir = 1
	},
/turf/open/floor/iron/large,
/area/station/service/tv_studio)
"Kc" = (
/obj/machinery/atmospherics/pipe/smart/manifold4w/scrubbers/hidden/layer2,
/obj/machinery/atmospherics/components/unary/vent_pump/on/layer4{
	dir = 8
	},
/turf/open/floor/iron/large,
/area/station/service/tv_studio)
"KV" = (
/obj/structure/table/wood,
/obj/item/radio/intercom/tv,
/turf/open/floor/wood,
/area/station/service/tv_studio)
"Ld" = (
/turf/closed/wall,
/area/station/service/tv_studio)
"Mp" = (
/obj/structure/chair/comfy/lime,
/obj/effect/decal/cleanable/dirt,
/turf/open/floor/iron/large,
/area/station/service/tv_studio)
"MO" = (
/obj/effect/turf_decal/siding/wood{
	dir = 8
	},
/turf/open/floor/wood,
/area/station/service/tv_studio)
"Nv" = (
/obj/structure/table,
/obj/item/tv_radio{
	pixel_y = 19
	},
/obj/item/tv_radio{
	pixel_y = 13
	},
/obj/item/tv_radio{
	pixel_y = 4
	},
/turf/open/floor/iron/large,
/area/station/service/tv_studio)
"Nx" = (
/obj/structure/table,
/obj/item/circuitboard/computer/wooden_tv,
/obj/item/circuitboard/computer/wooden_tv,
/obj/item/circuitboard/computer/wooden_tv,
/turf/open/floor/iron/large,
/area/station/service/tv_studio)
"Om" = (
/obj/structure/statue/sandstone/venus{
	name = "Justice"
	},
/obj/machinery/light/directional/north,
/obj/effect/decal/cleanable/dirt,
/turf/open/floor/iron/large,
/area/station/service/tv_studio)
"OA" = (
/obj/effect/spawner/structure/window/reinforced,
/obj/machinery/door/poddoor/shutters/preopen{
	name = "TV Show Shutters";
	id = "TV Show Shutters";
	dir = 4
	},
/turf/open/floor/plating,
/area/station/service/tv_studio)
"Qx" = (
/obj/machinery/atmospherics/pipe/smart/manifold4w/supply/hidden/layer4,
/obj/machinery/atmospherics/pipe/smart/manifold4w/scrubbers/hidden/layer2,
/obj/machinery/firealarm/directional/north,
/turf/open/floor/iron/large,
/area/station/service/tv_studio)
"Rj" = (
/obj/machinery/atmospherics/pipe/smart/manifold4w/scrubbers/hidden/layer2,
/obj/machinery/atmospherics/pipe/smart/manifold4w/supply/hidden/layer4,
/obj/structure/cable,
/obj/machinery/door/airlock{
	name = "TV and Radio Studio"
	},
/obj/effect/mapping_helpers/airlock/access/all/service/library,
/obj/machinery/door/firedoor,
/turf/open/floor/wood,
/area/station/service/tv_studio)
"Sm" = (
/obj/machinery/atmospherics/pipe/smart/manifold4w/scrubbers/hidden/layer2,
/obj/machinery/atmospherics/pipe/smart/manifold4w/supply/hidden/layer4,
/obj/structure/cable,
/obj/machinery/power/apc/auto_name/directional/east,
/obj/effect/turf_decal/siding/wood{
	dir = 4
	},
/turf/open/floor/wood,
/area/station/service/tv_studio)
"Su" = (
/turf/open/floor/iron/large,
/area/station/service/tv_studio)
"Tw" = (
/obj/machinery/door/airlock{
	name = "Record Room"
	},
/obj/effect/mapping_helpers/airlock/access/all/service/library,
/obj/machinery/atmospherics/pipe/smart/manifold4w/scrubbers/hidden/layer2,
/obj/machinery/atmospherics/pipe/smart/manifold4w/supply/hidden/layer4,
/obj/machinery/door/firedoor,
/turf/open/floor/iron/large,
/area/station/service/tv_studio)
"TF" = (
/obj/structure/table/wood,
/obj/item/radio/intercom/tv,
/obj/effect/decal/cleanable/dirt,
/turf/open/floor/wood,
/area/station/service/tv_studio)
"Vs" = (
/obj/machinery/atmospherics/pipe/smart/manifold4w/scrubbers/hidden/layer2,
/obj/machinery/atmospherics/pipe/smart/manifold4w/supply/hidden/layer4,
/obj/structure/cable,
/obj/effect/turf_decal/siding/wood{
	dir = 5
	},
/turf/open/floor/wood,
/area/station/service/tv_studio)
"Xl" = (
/obj/machinery/camera/tv_camera,
/turf/open/floor/iron/large,
/area/station/service/tv_studio)
"YE" = (
/obj/structure/table,
/obj/item/device/pocket_tvcamera,
/obj/item/device/pocket_tvcamera,
/obj/item/device/pocket_tvcamera,
/obj/machinery/airalarm/directional/north,
/obj/effect/decal/cleanable/dirt,
/turf/open/floor/iron/large,
/area/station/service/tv_studio)

(1,1,1) = {"
Ld
uY
pe
MO
MO
GG
rg
Ld
"}
(2,1,1) = {"
yd
kk
qg
co
Hf
TF
Hn
yd
"}
(3,1,1) = {"
yd
iB
DO
co
co
KV
Fa
yd
"}
(4,1,1) = {"
Ld
hc
co
co
kM
co
sb
Ld
"}
(5,1,1) = {"
Rj
Vs
df
mr
Sm
df
hn
Rj
"}
(6,1,1) = {"
Ld
Ld
Tw
Ld
Ld
vh
Ld
Ld
"}
(7,1,1) = {"
Ld
YE
Kc
Nx
Ld
gm
Im
Ld
"}
(8,1,1) = {"
Ld
Nv
nG
fO
Ld
cy
vJ
Ld
"}
(9,1,1) = {"
Ld
HJ
Du
uM
Ld
Qx
hR
Ld
"}
(10,1,1) = {"
Ld
eF
eF
eF
Ld
vh
Ld
Ld
"}
(11,1,1) = {"
Ld
Om
Su
Su
br
cy
Cg
Ld
"}
(12,1,1) = {"
iv
Su
Su
yY
Su
bg
Su
iv
"}
(13,1,1) = {"
iv
Su
Mp
kW
Su
hx
Xl
iv
"}
(14,1,1) = {"
iv
qq
Su
iV
Su
fY
qq
iv
"}
(15,1,1) = {"
Ld
GL
Su
qq
Su
qq
rV
Ld
"}
(16,1,1) = {"
Ld
OA
OA
OA
OA
OA
vO
Ld
"}
