//MAP CONVERTED BY dmm2tgm.py THIS HEADER COMMENT PREVENTS RECONVERSION, DO NOT REMOVE
"a" = (
/turf/closed/wall,
/area/station/commons/fitness/recreation)
"b" = (
/obj/machinery/cryopod,
/obj/effect/turf_decal/siding/white,
/obj/machinery/power/apc/auto_name/directional/east,
/obj/structure/cable,
/turf/open/floor/iron/dark,
/area/station/common/cryopods)
"c" = (
/obj/structure/table,
/obj/effect/turf_decal/trimline/neutral/filled/corner{
	dir = 1
	},
/obj/item/storage/medkit/regular,
/turf/open/floor/iron,
/area/station/commons/fitness/recreation)
"d" = (
/obj/machinery/cryopod,
/obj/effect/turf_decal/siding/white,
/turf/open/floor/iron/dark,
/area/station/common/cryopods)
"e" = (
/obj/machinery/cryopod{
	dir = 1
	},
/obj/effect/turf_decal/siding/white{
	dir = 1
	},
/obj/machinery/airalarm/directional/east,
/obj/machinery/atmospherics/components/unary/vent_pump/on/layer4{
	dir = 1
	},
/obj/machinery/camera/directional/east,
/turf/open/floor/iron/dark,
/area/station/common/cryopods)
"g" = (
/obj/machinery/holopad,
/obj/effect/turf_decal/bot,
/turf/open/floor/iron/large,
/area/station/commons/fitness/recreation)
"h" = (
/obj/machinery/cryopod,
/obj/effect/turf_decal/siding/white,
/obj/machinery/atmospherics/components/unary/vent_scrubber/on/layer2,
/turf/open/floor/iron/dark,
/area/station/common/cryopods)
"i" = (
/obj/machinery/atmospherics/pipe/smart/manifold4w/scrubbers/hidden/layer2,
/obj/machinery/atmospherics/pipe/smart/manifold4w/supply/hidden/layer4,
/obj/structure/cable,
/turf/open/floor/iron/white/side{
	dir = 4
	},
/area/station/commons/fitness/recreation)
"k" = (
/obj/structure/disposalpipe/segment{
	dir = 4
	},
/obj/effect/turf_decal/tile/neutral/half/contrasted,
/obj/structure/tank_holder/extinguisher,
/turf/open/floor/iron,
/area/station/commons/fitness/recreation)
"l" = (
/obj/effect/turf_decal/trimline/neutral/filled/line{
	dir = 9
	},
/turf/open/floor/iron,
/area/station/commons/fitness/recreation)
"m" = (
/obj/effect/turf_decal/trimline/neutral/filled/line{
	dir = 5
	},
/turf/open/floor/iron,
/area/station/commons/fitness/recreation)
"n" = (
/obj/effect/turf_decal/trimline/neutral/filled/corner{
	dir = 4
	},
/turf/open/floor/iron,
/area/station/commons/fitness/recreation)
"p" = (
/obj/effect/landmark/start/hangover,
/obj/structure/cable,
/obj/machinery/atmospherics/pipe/smart/manifold4w/supply/hidden/layer4,
/obj/machinery/atmospherics/pipe/smart/manifold4w/scrubbers/hidden/layer2,
/turf/open/floor/iron/white,
/area/station/common/cryopods)
"q" = (
/obj/structure/disposalpipe/segment{
	dir = 4
	},
/obj/effect/turf_decal/tile/neutral/half/contrasted,
/obj/structure/table,
/obj/item/toy/ammo/gun,
/obj/item/toy/gun,
/turf/open/floor/iron,
/area/station/commons/fitness/recreation)
"r" = (
/obj/effect/turf_decal/trimline/neutral/filled/corner{
	dir = 1
	},
/obj/effect/landmark/start/hangover,
/turf/open/floor/iron,
/area/station/commons/fitness/recreation)
"t" = (
/obj/machinery/computer/cryopod{
	dir = 8;
	pixel_x = 32
	},
/obj/structure/cable,
/obj/machinery/atmospherics/pipe/smart/manifold4w/supply/hidden/layer4,
/obj/machinery/light/directional/east,
/turf/open/floor/iron/white,
/area/station/common/cryopods)
"u" = (
/obj/effect/spawner/random/engineering/tracking_beacon,
/turf/open/floor/iron,
/area/station/commons/fitness/recreation)
"v" = (
/obj/structure/cable,
/turf/open/floor/iron,
/area/station/commons/fitness/recreation)
"w" = (
/obj/structure/disposalpipe/segment{
	dir = 4
	},
/obj/effect/turf_decal/tile/neutral/half/contrasted,
/turf/open/floor/iron,
/area/station/commons/fitness/recreation)
"x" = (
/obj/machinery/cryopod{
	dir = 1
	},
/obj/effect/turf_decal/siding/white{
	dir = 1
	},
/turf/open/floor/iron/dark,
/area/station/common/cryopods)
"A" = (
/obj/machinery/camera/directional/south{
	c_tag = "Dormitories - Recreation Aft";
	name = "dormitories camera"
	},
/obj/machinery/disposal/bin,
/obj/structure/disposalpipe/trunk{
	dir = 8
	},
/obj/structure/sign/warning/no_smoking/circle/directional/south,
/obj/effect/turf_decal/tile/neutral{
	dir = 8
	},
/obj/effect/turf_decal/bot,
/turf/open/floor/iron/white/side{
	dir = 4
	},
/area/station/commons/fitness/recreation)
"B" = (
/turf/open/floor/glass/reinforced,
/area/station/commons/fitness/recreation)
"C" = (
/obj/effect/spawner/structure/window/reinforced,
/turf/open/floor/plating,
/area/station/common/cryopods)
"E" = (
/obj/structure/disposalpipe/segment{
	dir = 4
	},
/obj/effect/turf_decal/tile/neutral/half/contrasted,
/obj/structure/table,
/obj/item/toy/katana,
/obj/item/gun/ballistic/shotgun/toy/crossbow,
/turf/open/floor/iron,
/area/station/commons/fitness/recreation)
"F" = (
/obj/structure/disposalpipe/segment{
	dir = 4
	},
/obj/effect/turf_decal/tile/neutral/half/contrasted,
/obj/structure/table,
/obj/item/toy/foamblade,
/obj/item/toy/sword{
	pixel_y = 12;
	pixel_x = 3
	},
/turf/open/floor/iron,
/area/station/commons/fitness/recreation)
"G" = (
/obj/effect/landmark/start/hangover,
/obj/machinery/atmospherics/components/unary/vent_pump/on/layer4{
	dir = 8
	},
/obj/structure/cable,
/turf/open/floor/iron/large,
/area/station/commons/fitness/recreation)
"I" = (
/obj/effect/spawner/structure/window/reinforced,
/turf/open/floor/plating,
/area/station/commons/fitness/recreation)
"J" = (
/obj/structure/cable,
/obj/machinery/atmospherics/pipe/smart/manifold4w/supply/hidden/layer4,
/turf/open/floor/iron/white,
/area/station/common/cryopods)
"L" = (
/obj/machinery/light/directional/east,
/obj/effect/turf_decal/tile/neutral/half/contrasted{
	dir = 4
	},
/obj/machinery/atmospherics/pipe/smart/manifold4w/scrubbers/hidden/layer2,
/obj/machinery/atmospherics/pipe/smart/manifold4w/supply/hidden/layer4,
/turf/open/floor/iron,
/area/station/commons/fitness/recreation)
"M" = (
/obj/structure/table,
/obj/item/cane,
/obj/item/clothing/head/bowler{
	pixel_y = 2
	},
/obj/effect/turf_decal/trimline/neutral/filled/corner{
	dir = 4
	},
/turf/open/floor/iron,
/area/station/commons/fitness/recreation)
"N" = (
/turf/closed/wall,
/area/station/common/cryopods)
"O" = (
/obj/machinery/atmospherics/components/unary/vent_scrubber/on/layer2{
	dir = 4
	},
/obj/structure/cable,
/turf/open/floor/iron/large,
/area/station/commons/fitness/recreation)
"P" = (
/obj/structure/disposalpipe/segment{
	dir = 4
	},
/obj/effect/turf_decal/tile/neutral/half/contrasted,
/obj/structure/table,
/obj/item/storage/dice,
/turf/open/floor/iron,
/area/station/commons/fitness/recreation)
"Q" = (
/obj/structure/cable,
/obj/machinery/atmospherics/pipe/smart/manifold4w/supply/hidden/layer4,
/obj/machinery/atmospherics/pipe/smart/manifold4w/scrubbers/hidden/layer2,
/obj/machinery/door/airlock/public/glass{
	name = "Cryopods"
	},
/obj/effect/landmark/navigate_destination,
/turf/open/floor/iron/white,
/area/station/common/cryopods)
"S" = (
/obj/structure/table,
/obj/effect/turf_decal/trimline/neutral/filled/line{
	dir = 1
	},
/obj/item/taperecorder,
/obj/item/tape,
/turf/open/floor/iron,
/area/station/commons/fitness/recreation)
"X" = (
/obj/machinery/atmospherics/pipe/smart/manifold4w/scrubbers/hidden/layer2,
/obj/machinery/atmospherics/pipe/smart/manifold4w/supply/hidden/layer4,
/turf/open/floor/iron/white/side{
	dir = 4
	},
/area/station/commons/fitness/recreation)
"Z" = (
/obj/structure/table,
/obj/effect/turf_decal/trimline/neutral/filled/line{
	dir = 1
	},
/obj/item/stack/package_wrap{
	pixel_x = -4;
	pixel_y = 4
	},
/obj/item/stack/wrapping_paper,
/obj/item/hand_labeler,
/turf/open/floor/iron,
/area/station/commons/fitness/recreation)

(1,1,1) = {"
n
g
G
q
I
"}
(2,1,1) = {"
m
M
v
F
I
"}
(3,1,1) = {"
B
S
v
w
I
"}
(4,1,1) = {"
B
Z
v
k
I
"}
(5,1,1) = {"
l
c
v
P
I
"}
(6,1,1) = {"
r
u
O
E
I
"}
(7,1,1) = {"
L
X
i
A
a
"}
(8,1,1) = {"
N
C
Q
C
N
"}
(9,1,1) = {"
C
h
p
x
C
"}
(10,1,1) = {"
C
d
J
x
C
"}
(11,1,1) = {"
C
b
t
e
C
"}
(12,1,1) = {"
N
N
N
N
N
"}
