//MAP CONVERTED BY dmm2tgm.py THIS HEADER COMMENT PREVENTS RECONVERSION, DO NOT REMOVE
"a" = (
/turf/closed/wall/r_wall,
/area/command/heads_quarters/captain/private/nt_rep)
"b" = (
/obj/structure/table/wood,
/obj/item/stamp{
	pixel_x = -6
	},
/obj/item/stamp/denied{
	pixel_x = 6
	},
/obj/item/stamp/centcom{
	pixel_y = 8
	},
/turf/open/floor/carpet/executive,
/area/command/heads_quarters/captain/private/nt_rep)
"c" = (
/obj/structure/sign/directions/engineering,
/obj/structure/sign/directions/evac{
	pixel_y = -8
	},
/obj/structure/sign/directions/science{
	pixel_y = 8
	},
/turf/closed/wall/r_wall,
/area/command/heads_quarters/captain/private/nt_rep)
"d" = (
/obj/structure/cable,
/turf/open/floor/plating,
/area/station/maintenance/port/fore)
"e" = (
/obj/structure/cable,
/obj/effect/mapping_helpers/broken_floor,
/turf/open/floor/plating,
/area/station/maintenance/port/fore)
"f" = (
/obj/structure/table/wood,
/obj/item/camera_film{
	pixel_x = 6
	},
/obj/item/camera_film{
	pixel_x = 6;
	pixel_y = 4
	},
/obj/item/camera{
	pixel_x = -6;
	pixel_y = 7
	},
/obj/effect/turf_decal/tile/neutral/fourcorners,
/turf/open/floor/iron/dark,
/area/command/heads_quarters/captain/private/nt_rep)
"i" = (
/obj/structure/disposalpipe/trunk{
	dir = 4
	},
/obj/effect/turf_decal/bot,
/obj/machinery/disposal/bin,
/obj/effect/turf_decal/tile/neutral/fourcorners,
/obj/effect/turf_decal/tile/neutral/fourcorners,
/obj/machinery/status_display/ai/directional/west,
/turf/open/floor/iron/dark,
/area/station/hallway/primary/central/fore)
"j" = (
/obj/machinery/light/directional/east,
/obj/machinery/photocopier,
/turf/open/floor/wood,
/area/command/heads_quarters/captain/private/nt_rep)
"k" = (
/obj/effect/turf_decal/siding/wood{
	dir = 1
	},
/obj/effect/landmark/start/nanotrasen_consultant,
/turf/open/floor/wood,
/area/command/heads_quarters/captain/private/nt_rep)
"m" = (
/obj/structure/extinguisher_cabinet/directional/north,
/obj/effect/turf_decal/siding/wood,
/turf/open/floor/wood,
/area/command/heads_quarters/captain/private/nt_rep)
"n" = (
/obj/machinery/atmospherics/pipe/smart/manifold4w/scrubbers/hidden/layer2,
/obj/machinery/atmospherics/components/unary/vent_pump/on/layer4,
/turf/open/floor/wood,
/area/command/heads_quarters/captain/private/nt_rep)
"o" = (
/obj/machinery/button/door/directional/south{
	id = "nt_rep_priv";
	name = "Privacy Shutters Control";
	pixel_x = 8
	},
/obj/item/kirbyplants/random,
/obj/effect/turf_decal/siding/wood/corner{
	dir = 4
	},
/turf/open/floor/wood,
/area/command/heads_quarters/captain/private/nt_rep)
"q" = (
/obj/structure/chair/office{
	dir = 8
	},
/turf/open/floor/carpet/executive,
/area/command/heads_quarters/captain/private/nt_rep)
"r" = (
/obj/structure/cable,
/obj/effect/decal/cleanable/dirt,
/obj/effect/turf_decal/tile/neutral/half/contrasted{
	dir = 4
	},
/turf/open/floor/iron,
/area/station/maintenance/port/fore)
"s" = (
/obj/machinery/atmospherics/pipe/smart/manifold4w/supply/hidden/layer4,
/obj/machinery/door/airlock/maintenance_hatch{
	name = "Maintenance Hatch"
	},
/obj/effect/turf_decal/stripes/line{
	dir = 1
	},
/obj/effect/turf_decal/stripes/line,
/obj/structure/cable,
/obj/effect/mapping_helpers/airlock/access/all/cent_com/rep_door,
/turf/open/floor/iron,
/area/station/maintenance/port/fore)
"t" = (
/obj/effect/turf_decal/siding/wood,
/obj/machinery/light/directional/west,
/obj/structure/sign/poster/official/random/directional/north,
/obj/item/radio/intercom/directional/west,
/turf/open/floor/wood,
/area/command/heads_quarters/captain/private/nt_rep)
"u" = (
/obj/structure/cable,
/obj/structure/filingcabinet/chestdrawer,
/obj/machinery/power/apc/auto_name/directional/west,
/turf/open/floor/wood,
/area/command/heads_quarters/captain/private/nt_rep)
"v" = (
/obj/machinery/newscaster/directional/west,
/obj/structure/chair/office{
	dir = 4
	},
/obj/effect/landmark/start/nanotrasen_consultant,
/turf/open/floor/carpet/executive,
/area/command/heads_quarters/captain/private/nt_rep)
"w" = (
/obj/effect/spawner/structure/window/reinforced,
/obj/machinery/door/poddoor/preopen{
	id = "nt_rep_priv";
	name = "Privacy Shutter"
	},
/turf/open/floor/plating,
/area/command/heads_quarters/captain/private/nt_rep)
"x" = (
/obj/structure/sign/poster/official/random/directional/south,
/obj/structure/disposalpipe/segment{
	dir = 9
	},
/obj/structure/table/wood,
/obj/item/folder/yellow{
	pixel_x = 4
	},
/obj/item/folder/white,
/obj/item/folder/red{
	pixel_x = -4
	},
/obj/item/folder/blue{
	pixel_x = -8
	},
/turf/open/floor/wood,
/area/command/heads_quarters/captain/private/nt_rep)
"y" = (
/obj/machinery/atmospherics/pipe/smart/manifold4w/supply/hidden/layer4,
/obj/machinery/atmospherics/pipe/smart/manifold4w/scrubbers/hidden/layer2,
/obj/structure/cable,
/turf/open/floor/wood,
/area/command/heads_quarters/captain/private/nt_rep)
"z" = (
/obj/structure/cable,
/obj/effect/turf_decal/siding/wood{
	dir = 4
	},
/obj/effect/landmark/start/nanotrasen_consultant,
/obj/machinery/airalarm/directional/north,
/turf/open/floor/wood,
/area/command/heads_quarters/captain/private/nt_rep)
"B" = (
/turf/open/floor/wood,
/area/command/heads_quarters/captain/private/nt_rep)
"C" = (
/obj/machinery/atmospherics/pipe/smart/manifold4w/scrubbers/hidden/layer2,
/obj/effect/turf_decal/siding/wood{
	dir = 8
	},
/obj/structure/cable,
/turf/open/floor/wood,
/area/command/heads_quarters/captain/private/nt_rep)
"D" = (
/obj/structure/closet/secure_closet/nanotrasen_consultant/station,
/obj/item/storage/briefcase,
/obj/item/assembly/flash/handheld,
/obj/effect/turf_decal/tile/neutral/fourcorners,
/turf/open/floor/iron/dark,
/area/command/heads_quarters/captain/private/nt_rep)
"E" = (
/obj/structure/filingcabinet/employment,
/turf/open/floor/wood,
/area/command/heads_quarters/captain/private/nt_rep)
"F" = (
/obj/machinery/atmospherics/pipe/smart/manifold4w/scrubbers/hidden/layer2,
/obj/effect/turf_decal/siding/wood/corner{
	dir = 8
	},
/obj/structure/cable,
/obj/machinery/holopad,
/turf/open/floor/wood,
/area/command/heads_quarters/captain/private/nt_rep)
"H" = (
/turf/closed/wall,
/area/station/maintenance/port/fore)
"I" = (
/obj/effect/turf_decal/siding/wood{
	dir = 1
	},
/obj/structure/chair/comfy{
	dir = 1
	},
/obj/effect/landmark/start/nanotrasen_consultant,
/turf/open/floor/wood,
/area/command/heads_quarters/captain/private/nt_rep)
"J" = (
/obj/structure/table/wood,
/obj/item/paper_bin{
	pixel_y = 4
	},
/obj/item/pen/fountain,
/turf/open/floor/carpet/executive,
/area/command/heads_quarters/captain/private/nt_rep)
"K" = (
/obj/machinery/light_switch/directional/north,
/obj/structure/disposalpipe/segment{
	dir = 4
	},
/obj/effect/turf_decal/siding/wood{
	dir = 4
	},
/turf/open/floor/wood,
/area/command/heads_quarters/captain/private/nt_rep)
"L" = (
/obj/machinery/door/airlock/corporate{
	name = "NT Consultant's Office"
	},
/obj/structure/disposalpipe/segment{
	dir = 4
	},
/obj/effect/mapping_helpers/airlock/access/all/cent_com/rep_door,
/obj/machinery/door/firedoor,
/turf/open/floor/iron,
/area/command/heads_quarters/captain/private/nt_rep)
"M" = (
/obj/machinery/status_display/ai/directional/south,
/obj/machinery/modular_computer/console/preset/command{
	dir = 1
	},
/turf/open/floor/carpet/executive,
/area/command/heads_quarters/captain/private/nt_rep)
"O" = (
/obj/effect/turf_decal/bot,
/obj/machinery/vending/coffee,
/obj/machinery/firealarm/directional/west,
/obj/effect/turf_decal/tile/neutral/fourcorners,
/turf/open/floor/iron/dark,
/area/station/hallway/primary/central/fore)
"P" = (
/obj/machinery/airalarm/directional/south,
/obj/effect/turf_decal/siding/wood{
	dir = 8
	},
/obj/machinery/camera/directional/south{
	c_tag = "NT Consultant's Office";
	name = "command camera"
	},
/obj/structure/cable,
/turf/open/floor/wood,
/area/command/heads_quarters/captain/private/nt_rep)
"Q" = (
/obj/effect/turf_decal/siding/wood{
	dir = 1
	},
/obj/structure/table/wood,
/obj/machinery/fax{
	fax_name = "Nanotrasen Consultant's Office";
	name = "Nanotrasen Consultant's Fax Machine"
	},
/turf/open/floor/wood,
/area/command/heads_quarters/captain/private/nt_rep)
"S" = (
/obj/machinery/disposal/bin,
/obj/structure/disposalpipe/trunk{
	dir = 4
	},
/obj/machinery/firealarm/directional/south,
/turf/open/floor/wood,
/area/command/heads_quarters/captain/private/nt_rep)
"U" = (
/obj/structure/fireplace,
/obj/effect/turf_decal/tile/neutral/fourcorners,
/turf/open/floor/iron/dark,
/area/command/heads_quarters/captain/private/nt_rep)
"V" = (
/obj/machinery/atmospherics/components/unary/vent_scrubber/on/layer2,
/obj/effect/turf_decal/siding/wood/corner{
	dir = 4
	},
/obj/structure/cable,
/obj/effect/landmark/start/nanotrasen_consultant,
/turf/open/floor/wood,
/area/command/heads_quarters/captain/private/nt_rep)
"W" = (
/obj/structure/disposalpipe/segment{
	dir = 6
	},
/turf/open/floor/wood,
/area/command/heads_quarters/captain/private/nt_rep)
"X" = (
/obj/effect/turf_decal/bot,
/obj/machinery/vending/cigarette,
/obj/structure/sign/nanotrasen{
	pixel_x = -32
	},
/obj/effect/turf_decal/tile/neutral/fourcorners,
/turf/open/floor/iron/dark,
/area/station/hallway/primary/central/fore)
"Y" = (
/obj/effect/turf_decal/siding/wood,
/turf/open/floor/wood,
/area/command/heads_quarters/captain/private/nt_rep)

(1,1,1) = {"
H
d
a
a
a
a
a
"}
(2,1,1) = {"
r
e
a
t
v
M
a
"}
(3,1,1) = {"
a
a
a
m
b
J
a
"}
(4,1,1) = {"
a
u
E
Y
q
q
a
"}
(5,1,1) = {"
a
z
V
F
C
P
a
"}
(6,1,1) = {"
a
D
k
B
n
y
s
"}
(7,1,1) = {"
a
U
I
B
B
S
a
"}
(8,1,1) = {"
a
f
Q
j
W
x
a
"}
(9,1,1) = {"
a
a
a
a
K
o
a
"}
(10,1,1) = {"
O
X
i
c
L
w
a
"}
