//MAP CONVERTED BY dmm2tgm.py THIS HEADER COMMENT PREVENTS RECONVERSION, DO NOT REMOVE
"a" = (
/obj/structure/cable,
/obj/machinery/computer/security{
	dir = 4
	},
/obj/effect/turf_decal/tile/red/fourcorners,
/turf/open/floor/iron,
/area/station/security/checkpoint/supply)
"b" = (
/obj/machinery/status_display/evac/directional/north,
/obj/structure/reagent_dispensers/wall/peppertank/directional/west,
/obj/structure/table/reinforced,
/obj/item/book/manual/wiki/security_space_law,
/obj/item/radio,
/obj/machinery/button/door/directional/west{
	id = "cardoor";
	name = "Cargo Cell Control";
	normaldoorcontrol = 1;
	pixel_x = -34;
	pixel_y = -6;
	req_access = list("brig_entrance")
	},
/obj/effect/turf_decal/tile/red/anticorner/contrasted{
	dir = 1
	},
/turf/open/floor/iron,
/area/station/security/checkpoint/supply)
"c" = (
/obj/structure/cable,
/obj/machinery/door/window/brigdoor{
	id = "cargocell";
	name = "Cargo Holding Cell";
	req_access = list("brig_entrance")
	},
/obj/effect/turf_decal/tile/red/fourcorners,
/turf/open/floor/iron,
/area/station/security/checkpoint/supply)
"g" = (
/obj/machinery/door_timer{
	id = "cargocell";
	name = "Cargo Cell";
	pixel_x = -32;
	pixel_y = -32
	},
/obj/item/radio/intercom/directional/west,
/obj/effect/turf_decal/tile/red/anticorner/contrasted{
	dir = 8
	},
/obj/structure/table/reinforced,
/obj/machinery/recharger,
/turf/open/floor/iron,
/area/station/security/checkpoint/supply)
"h" = (
/obj/structure/cable,
/obj/effect/spawner/structure/window/reinforced,
/turf/open/floor/plating,
/area/station/security/checkpoint/supply)
"n" = (
/obj/machinery/atmospherics/pipe/smart/manifold4w/supply/hidden/layer4,
/obj/machinery/atmospherics/pipe/smart/manifold4w/scrubbers/hidden/layer2,
/obj/machinery/door/firedoor,
/obj/machinery/door/airlock/security{
	name = "Custom Agent's Office"
	},
/obj/effect/turf_decal/stripes/line{
	dir = 8
	},
/obj/effect/turf_decal/stripes/line{
	dir = 4
	},
/obj/effect/mapping_helpers/airlock/access/all/supply/customs,
/turf/open/floor/iron,
/area/station/security/checkpoint/supply)
"p" = (
/obj/machinery/atmospherics/pipe/smart/manifold4w/supply/hidden/layer4,
/obj/machinery/atmospherics/pipe/smart/manifold4w/scrubbers/hidden/layer2,
/obj/effect/landmark/start/customs_agent,
/obj/effect/turf_decal/tile/red/half/contrasted{
	dir = 4
	},
/turf/open/floor/iron,
/area/station/security/checkpoint/supply)
"t" = (
/obj/structure/cable,
/obj/structure/disposalpipe/segment{
	dir = 4
	},
/obj/effect/spawner/structure/window/reinforced,
/turf/open/floor/plating,
/area/station/security/checkpoint/supply)
"u" = (
/obj/machinery/status_display/ai/directional/north,
/obj/machinery/firealarm/directional/east,
/obj/machinery/light_switch/directional/east{
	pixel_x = 38
	},
/obj/structure/extinguisher_cabinet/directional/north{
	pixel_x = 32
	},
/obj/structure/closet/secure_closet/security/cargo,
/obj/effect/turf_decal/tile/red/anticorner/contrasted{
	dir = 4
	},
/turf/open/floor/iron,
/area/station/security/checkpoint/supply)
"w" = (
/obj/structure/cable,
/obj/effect/turf_decal/tile/red/half/contrasted{
	dir = 1
	},
/turf/open/floor/iron,
/area/station/security/checkpoint/supply)
"y" = (
/obj/machinery/computer/secure_data{
	dir = 4
	},
/obj/effect/turf_decal/tile/red/anticorner/contrasted{
	dir = 8
	},
/turf/open/floor/iron,
/area/station/security/checkpoint/supply)
"z" = (
/obj/machinery/computer/cargo{
	dir = 4
	},
/obj/effect/turf_decal/tile/red/anticorner/contrasted{
	dir = 1
	},
/turf/open/floor/iron,
/area/station/security/checkpoint/supply)
"A" = (
/obj/structure/table/reinforced,
/obj/machinery/door/firedoor,
/obj/machinery/door/window/brigdoor/right/directional/south{
	dir = 8;
	name = "Security Desk";
	req_access = list("security")
	},
/obj/machinery/door/window/right/directional/north{
	dir = 4;
	name = "Security Desk"
	},
/obj/item/folder/red,
/obj/effect/turf_decal/delivery,
/turf/open/floor/iron,
/area/station/security/checkpoint/supply)
"B" = (
/obj/structure/cable,
/obj/machinery/atmospherics/pipe/smart/manifold4w/scrubbers/hidden/layer2,
/obj/machinery/holopad,
/obj/effect/turf_decal/tile/neutral/fourcorners,
/obj/effect/landmark/start/customs_agent,
/turf/open/floor/iron,
/area/station/security/checkpoint/supply)
"D" = (
/obj/structure/cable,
/obj/machinery/atmospherics/components/unary/vent_scrubber/on/layer2{
	dir = 1
	},
/obj/effect/turf_decal/tile/red/half/contrasted,
/turf/open/floor/iron,
/area/station/security/checkpoint/supply)
"E" = (
/obj/structure/cable,
/obj/machinery/door/firedoor,
/obj/machinery/door/airlock/security/glass{
	id_tag = "cardoor";
	name = "Cargo Holding Cell"
	},
/obj/effect/turf_decal/stripes/line,
/obj/effect/turf_decal/stripes/line{
	dir = 1
	},
/obj/effect/mapping_helpers/airlock/access/all/supply/customs,
/turf/open/floor/iron,
/area/station/security/checkpoint/supply)
"F" = (
/obj/structure/closet/secure_closet/brig{
	id = "cargocell";
	name = "Cargo Cell Locker"
	},
/obj/effect/turf_decal/tile/red/anticorner/contrasted{
	dir = 1
	},
/turf/open/floor/iron,
/area/station/security/checkpoint/supply)
"I" = (
/obj/item/kirbyplants/random,
/obj/machinery/light/directional/east,
/obj/machinery/camera/directional/east{
	c_tag = "Security Post - Cargo"
	},
/obj/machinery/airalarm/directional/east,
/obj/effect/turf_decal/tile/red/anticorner/contrasted,
/turf/open/floor/iron,
/area/station/security/checkpoint/supply)
"K" = (
/obj/machinery/atmospherics/pipe/smart/manifold4w/scrubbers/hidden/layer2,
/obj/structure/cable,
/obj/effect/turf_decal/tile/neutral/fourcorners,
/obj/machinery/atmospherics/components/unary/vent_pump/on/layer4{
	dir = 4
	},
/obj/effect/landmark/start/customs_agent,
/turf/open/floor/iron,
/area/station/security/checkpoint/supply)
"L" = (
/obj/structure/cable,
/obj/machinery/light/directional/north,
/obj/machinery/power/apc/auto_name/directional/north,
/obj/effect/turf_decal/tile/red/half/contrasted{
	dir = 1
	},
/obj/structure/closet/secure_closet/security/cargo,
/turf/open/floor/iron,
/area/station/security/checkpoint/supply)
"O" = (
/turf/closed/wall,
/area/station/security/checkpoint/supply)
"Q" = (
/turf/closed/wall,
/area/station/maintenance/fore)
"R" = (
/obj/structure/cable,
/obj/structure/disposalpipe/segment{
	dir = 4
	},
/obj/structure/chair{
	dir = 8
	},
/obj/effect/turf_decal/tile/red/anticorner/contrasted,
/turf/open/floor/iron,
/area/station/security/checkpoint/supply)
"S" = (
/obj/effect/landmark/start/customs_agent,
/obj/effect/turf_decal/tile/red/half/contrasted{
	dir = 4
	},
/turf/open/floor/iron,
/area/station/security/checkpoint/supply)
"T" = (
/obj/structure/chair{
	dir = 8
	},
/obj/effect/turf_decal/tile/red/anticorner/contrasted{
	dir = 4
	},
/turf/open/floor/iron,
/area/station/security/checkpoint/supply)
"U" = (
/obj/structure/cable,
/obj/structure/disposalpipe/segment{
	dir = 4
	},
/obj/effect/landmark/event_spawn,
/obj/effect/turf_decal/tile/red/anticorner/contrasted{
	dir = 8
	},
/turf/open/floor/iron,
/area/station/security/checkpoint/supply)
"V" = (
/obj/structure/cable,
/obj/machinery/atmospherics/pipe/smart/manifold4w/scrubbers/hidden/layer2,
/obj/structure/chair/office{
	dir = 8
	},
/obj/effect/turf_decal/tile/neutral/fourcorners,
/obj/effect/landmark/start/customs_agent,
/turf/open/floor/iron,
/area/station/security/checkpoint/supply)
"W" = (
/obj/structure/disposalpipe/segment{
	dir = 4
	},
/obj/structure/cable,
/obj/effect/turf_decal/tile/red/half/contrasted,
/turf/open/floor/iron,
/area/station/security/checkpoint/supply)
"Y" = (
/obj/structure/cable,
/obj/effect/landmark/start/customs_agent,
/obj/effect/turf_decal/tile/red/half/contrasted{
	dir = 4
	},
/turf/open/floor/iron,
/area/station/security/checkpoint/supply)

(1,1,1) = {"
Q
h
h
h
O
O
h
t
O
"}
(2,1,1) = {"
b
y
a
z
g
h
F
U
h
"}
(3,1,1) = {"
L
K
V
B
D
c
w
W
E
"}
(4,1,1) = {"
u
p
Y
S
I
h
T
R
h
"}
(5,1,1) = {"
O
n
h
A
O
O
h
t
O
"}
