//MAP CONVERTED BY dmm2tgm.py THIS HEADER COMMENT PREVENTS RECONVERSION, DO NOT REMOVE
"bU" = (
/obj/structure/reagent_dispensers/wall/peppertank/directional/north,
/obj/structure/cable,
/obj/machinery/atmospherics/pipe/smart/manifold4w/supply/hidden/layer4,
/obj/machinery/atmospherics/pipe/smart/manifold4w/scrubbers/hidden/layer2,
/obj/machinery/camera/directional/north{
	c_tag = "Security Post - Medsci";
	dir = 9
	},
/obj/effect/turf_decal/trimline/purple/filled/line{
	dir = 1
	},
/turf/open/floor/iron/white,
/area/station/security/checkpoint/medical/medsci)
"cF" = (
/obj/effect/turf_decal/stripes/line{
	dir = 4
	},
/obj/effect/turf_decal/stripes/line{
	dir = 8
	},
/obj/structure/cable,
/obj/machinery/atmospherics/pipe/smart/manifold4w/scrubbers/hidden/layer2,
/obj/machinery/atmospherics/pipe/smart/manifold4w/supply/hidden/layer4,
/obj/structure/disposalpipe/segment{
	dir = 4
	},
/obj/machinery/door/firedoor,
/obj/effect/mapping_helpers/airlock/access/all/medical/orderly,
/obj/machinery/door/airlock/medical/glass{
	name = "Orderly Office"
	},
/turf/open/floor/iron,
/area/station/security/checkpoint/medical/medsci)
"ec" = (
/obj/effect/turf_decal/trimline/purple/filled/warning,
/turf/open/floor/iron/white,
/area/station/science/research)
"ef" = (
/obj/structure/closet/crate/freezer/surplus_limbs,
/obj/machinery/camera/directional/north{
	c_tag = "Medbay - Coldroom";
	dir = 9;
	name = "medbay camera";
	network = list("ss13","medbay")
	},
/obj/effect/turf_decal/bot_white{
	color = "#435a88"
	},
/turf/open/floor/iron/freezer,
/area/station/security/checkpoint/medical/medsci)
"ey" = (
/obj/item/kirbyplants/random,
/obj/effect/turf_decal/trimline/purple/filled/line{
	dir = 6
	},
/turf/open/floor/iron/white,
/area/station/science/research)
"gE" = (
/obj/machinery/door/window/brigdoor/left/directional/south{
	id = "medsci-cell";
	name = "Med-Sci Cell";
	req_access = list("security")
	},
/obj/machinery/atmospherics/pipe/smart/manifold4w/supply/hidden/layer4,
/obj/machinery/atmospherics/pipe/smart/manifold4w/scrubbers/hidden/layer2,
/obj/effect/turf_decal/trimline/purple/filled/line{
	dir = 1
	},
/obj/effect/turf_decal/trimline/blue/filled/line,
/turf/open/floor/iron/white,
/area/station/security/checkpoint/medical/medsci)
"iV" = (
/obj/machinery/vending/drugs,
/obj/effect/turf_decal/bot,
/obj/effect/turf_decal/tile/blue/fourcorners,
/turf/open/floor/iron,
/area/station/medical/medbay)
"jb" = (
/obj/structure/cable,
/obj/structure/table/reinforced,
/obj/item/paper_bin,
/obj/item/folder/red,
/obj/item/pen,
/obj/effect/turf_decal/trimline/purple/filled/line{
	dir = 1
	},
/obj/item/restraints/handcuffs/cable/pink,
/turf/open/floor/iron/white,
/area/station/security/checkpoint/medical/medsci)
"kC" = (
/obj/machinery/power/apc/auto_name/directional/south,
/obj/structure/cable,
/obj/effect/turf_decal/trimline/purple/filled/line,
/obj/structure/closet/secure_closet/security/med,
/turf/open/floor/iron/white,
/area/station/security/checkpoint/medical/medsci)
"kD" = (
/obj/effect/decal/cleanable/dirt,
/obj/effect/decal/cleanable/dirt,
/turf/closed/wall/r_wall,
/area/station/security/checkpoint/medical/medsci)
"kJ" = (
/obj/structure/cable,
/obj/machinery/atmospherics/pipe/smart/manifold4w/supply/hidden/layer4,
/obj/machinery/atmospherics/pipe/smart/manifold4w/scrubbers/hidden/layer2,
/obj/effect/turf_decal/trimline/blue/filled/line{
	dir = 1
	},
/turf/open/floor/iron/white,
/area/station/security/checkpoint/medical/medsci)
"kW" = (
/obj/effect/turf_decal/trimline/purple/filled/line,
/turf/open/floor/iron/white,
/area/station/science/research)
"mh" = (
/obj/structure/chair/office,
/obj/effect/landmark/start/science_guard,
/turf/open/floor/iron/white,
/area/station/security/checkpoint/medical/medsci)
"mN" = (
/obj/structure/cable,
/obj/machinery/atmospherics/pipe/smart/manifold4w/supply/hidden/layer4,
/obj/machinery/atmospherics/pipe/smart/manifold4w/scrubbers/hidden/layer2,
/obj/structure/disposalpipe/segment{
	dir = 5
	},
/turf/open/floor/iron/white,
/area/station/security/checkpoint/medical/medsci)
"nn" = (
/turf/closed/wall/r_wall,
/area/station/security/checkpoint/medical/medsci)
"oe" = (
/obj/structure/closet/secure_closet/brig{
	id = "scicell";
	name = "Science Cell Locker"
	},
/obj/effect/turf_decal/bot,
/obj/effect/turf_decal/trimline/blue/filled/line{
	dir = 5
	},
/turf/open/floor/iron/white,
/area/station/security/checkpoint/medical/medsci)
"pM" = (
/obj/machinery/atmospherics/pipe/smart/manifold4w/supply/hidden/layer4,
/obj/machinery/atmospherics/pipe/smart/manifold4w/scrubbers/hidden/layer2,
/obj/effect/turf_decal/trimline/purple/filled/line{
	dir = 8
	},
/turf/open/floor/iron/white,
/area/station/security/checkpoint/medical/medsci)
"pP" = (
/obj/machinery/atmospherics/pipe/smart/manifold4w/scrubbers/hidden/layer2,
/obj/machinery/atmospherics/pipe/smart/manifold4w/supply/hidden/layer4,
/obj/effect/turf_decal/trimline/purple/filled/corner{
	dir = 1
	},
/turf/open/floor/iron/white,
/area/station/science/research)
"qx" = (
/obj/item/radio/intercom/directional/south,
/obj/machinery/light/directional/south,
/obj/effect/turf_decal/trimline/blue/filled/line,
/obj/structure/closet/secure_closet/security/med,
/turf/open/floor/iron/white,
/area/station/security/checkpoint/medical/medsci)
"qK" = (
/obj/structure/disposalpipe/segment,
/obj/effect/turf_decal/trimline/blue/filled/corner{
	dir = 4
	},
/turf/open/floor/iron/white,
/area/station/security/checkpoint/medical/medsci)
"rC" = (
/obj/machinery/atmospherics/pipe/smart/manifold4w/scrubbers/hidden/layer2,
/obj/machinery/atmospherics/pipe/smart/manifold4w/supply/hidden/layer4,
/obj/effect/turf_decal/trimline/purple/filled/line{
	dir = 1
	},
/turf/open/floor/iron/white,
/area/station/science/research)
"ss" = (
/obj/structure/closet/secure_closet/brig{
	id = "medcell";
	name = "Medical Cell Locker"
	},
/obj/machinery/status_display/ai/directional/east,
/obj/effect/turf_decal/bot,
/obj/effect/turf_decal/trimline/blue/filled/line{
	dir = 6
	},
/turf/open/floor/iron/white,
/area/station/security/checkpoint/medical/medsci)
"sw" = (
/obj/machinery/firealarm/directional/north{
	pixel_x = -4
	},
/obj/machinery/light_switch/directional/north{
	pixel_x = 10
	},
/obj/structure/rack,
/obj/item/book/manual/wiki/security_space_law{
	pixel_x = -1;
	pixel_y = 4
	},
/obj/item/book/manual/wiki/security_space_law{
	pixel_x = 3
	},
/obj/effect/turf_decal/bot,
/obj/effect/turf_decal/trimline/purple/filled/line{
	dir = 5
	},
/turf/open/floor/iron/white,
/area/station/security/checkpoint/medical/medsci)
"sL" = (
/obj/structure/cable,
/obj/machinery/atmospherics/pipe/smart/manifold4w/supply/hidden/layer4,
/obj/machinery/atmospherics/pipe/smart/manifold4w/scrubbers/hidden/layer2,
/obj/effect/turf_decal/trimline/blue/filled/corner{
	dir = 1
	},
/obj/effect/landmark/start/orderly,
/turf/open/floor/iron/white,
/area/station/security/checkpoint/medical/medsci)
"tc" = (
/obj/structure/cable,
/obj/effect/turf_decal/trimline/purple/filled/line,
/turf/open/floor/iron/white,
/area/station/security/checkpoint/medical/medsci)
"tx" = (
/obj/structure/table/reinforced,
/obj/structure/extinguisher_cabinet/directional/east,
/obj/machinery/airalarm/directional/south,
/obj/item/crowbar,
/obj/item/wrench,
/obj/item/clothing/mask/gas,
/obj/effect/turf_decal/trimline/blue/filled/line{
	dir = 6
	},
/turf/open/floor/iron/white,
/area/station/security/checkpoint/medical/medsci)
"um" = (
/obj/machinery/newscaster/directional/south,
/obj/machinery/computer/mecha{
	dir = 1
	},
/obj/effect/turf_decal/trimline/purple/filled/line,
/turf/open/floor/iron/white,
/area/station/security/checkpoint/medical/medsci)
"wl" = (
/obj/machinery/status_display/door_timer{
	id = "medsci-cell";
	name = "Med-Sci Cell";
	pixel_y = -32
	},
/obj/effect/turf_decal/trimline/blue/filled/line,
/turf/open/floor/iron/white,
/area/station/security/checkpoint/medical/medsci)
"wz" = (
/obj/machinery/portable_atmospherics/canister/anesthetic_mix,
/obj/machinery/light/small/blacklight/directional/north,
/obj/effect/turf_decal/bot_white{
	color = "#435a88"
	},
/turf/open/floor/iron/freezer,
/area/station/security/checkpoint/medical/medsci)
"zk" = (
/obj/structure/cable,
/obj/effect/turf_decal/tile/red/half/contrasted{
	dir = 4
	},
/obj/machinery/atmospherics/pipe/smart/manifold4w/supply/hidden/layer4,
/obj/machinery/atmospherics/pipe/smart/manifold4w/scrubbers/hidden/layer2,
/obj/structure/disposalpipe/segment{
	dir = 4
	},
/obj/effect/turf_decal/trimline/blue/filled/line{
	dir = 4
	},
/turf/open/floor/iron/white,
/area/station/security/checkpoint/medical/medsci)
"zX" = (
/obj/effect/turf_decal/bot_white{
	color = "#435a88"
	},
/obj/structure/closet/crate/freezer/blood,
/turf/open/floor/iron/freezer,
/area/station/security/checkpoint/medical/medsci)
"AK" = (
/obj/structure/chair{
	dir = 4
	},
/obj/machinery/status_display/evac/directional/west,
/obj/effect/turf_decal/trimline/purple/filled/line{
	dir = 10
	},
/turf/open/floor/iron/white,
/area/station/security/checkpoint/medical/medsci)
"AL" = (
/obj/machinery/status_display/evac/directional/north,
/obj/structure/cable,
/obj/structure/table/reinforced,
/obj/machinery/recharger{
	pixel_x = 6
	},
/obj/machinery/recharger{
	pixel_x = -5
	},
/obj/effect/turf_decal/trimline/blue/filled/line{
	dir = 5
	},
/obj/item/restraints/handcuffs/cable/cyan,
/turf/open/floor/iron/white,
/area/station/security/checkpoint/medical/medsci)
"AO" = (
/obj/structure/cable,
/obj/effect/turf_decal/bot,
/obj/effect/turf_decal/trimline/purple/filled/line{
	dir = 10
	},
/obj/structure/closet/secure_closet/security/science,
/turf/open/floor/iron/white,
/area/station/security/checkpoint/medical/medsci)
"Bt" = (
/obj/effect/spawner/structure/window/reinforced,
/obj/structure/cable,
/turf/open/floor/plating,
/area/station/security/checkpoint/medical/medsci)
"CQ" = (
/obj/effect/turf_decal/tile/neutral/fourcorners,
/obj/structure/disposalpipe/segment{
	dir = 4
	},
/obj/structure/cable,
/obj/machinery/duct,
/turf/open/floor/iron,
/area/station/science/research)
"DJ" = (
/obj/structure/chair{
	dir = 4
	},
/obj/item/radio/intercom/directional/west,
/obj/effect/turf_decal/trimline/purple/filled/line{
	dir = 9
	},
/turf/open/floor/iron/white,
/area/station/security/checkpoint/medical/medsci)
"DP" = (
/obj/effect/turf_decal/trimline/purple/filled/line{
	dir = 4
	},
/turf/open/floor/iron/white,
/area/station/science/research)
"EO" = (
/obj/machinery/atmospherics/components/unary/vent_scrubber/on/layer2{
	dir = 1
	},
/obj/machinery/atmospherics/pipe/smart/manifold4w/supply/hidden/layer4,
/obj/effect/turf_decal/trimline/blue/filled/line{
	dir = 1
	},
/turf/open/floor/iron/white,
/area/station/security/checkpoint/medical/medsci)
"FF" = (
/obj/machinery/disposal/bin{
	desc = "A pneumatic waste disposal unit. This one leads to the morgue.";
	name = "corpse disposal"
	},
/obj/effect/turf_decal/bot,
/obj/structure/disposalpipe/trunk,
/obj/effect/turf_decal/trimline/purple/filled/line{
	dir = 4
	},
/turf/open/floor/iron/white,
/area/station/security/checkpoint/medical/medsci)
"FU" = (
/obj/machinery/door/airlock/medical{
	name = "Medbay Cold Room"
	},
/obj/effect/turf_decal/stripes/line{
	dir = 4
	},
/obj/effect/turf_decal/stripes/line{
	dir = 8
	},
/obj/structure/cable,
/obj/effect/mapping_helpers/airlock/access/all/medical/surgery,
/obj/machinery/atmospherics/pipe/smart/manifold4w/supply/hidden/layer4,
/obj/machinery/atmospherics/pipe/smart/manifold4w/scrubbers/hidden/layer2,
/turf/open/floor/iron,
/area/station/security/checkpoint/medical/medsci)
"HR" = (
/obj/machinery/computer/secure_data{
	dir = 4
	},
/obj/machinery/status_display/ai/directional/north,
/obj/structure/cable,
/obj/effect/turf_decal/trimline/blue/filled/line{
	dir = 9
	},
/turf/open/floor/iron/white,
/area/station/security/checkpoint/medical/medsci)
"It" = (
/obj/machinery/atmospherics/components/unary/vent_pump/on/layer4{
	dir = 1
	},
/obj/structure/sign/nanotrasen{
	pixel_y = -32
	},
/obj/machinery/light/small/directional/south,
/obj/effect/turf_decal/trimline/purple/filled/line,
/turf/open/floor/iron/white,
/area/station/security/checkpoint/medical/medsci)
"JJ" = (
/obj/machinery/computer/security{
	dir = 4
	},
/obj/effect/turf_decal/trimline/purple/filled/line{
	dir = 8
	},
/turf/open/floor/iron/white,
/area/station/security/checkpoint/medical/medsci)
"JL" = (
/obj/structure/cable,
/obj/machinery/atmospherics/pipe/smart/manifold4w/supply/hidden/layer4,
/obj/machinery/atmospherics/pipe/smart/manifold4w/scrubbers/hidden/layer2,
/obj/effect/turf_decal/trimline/purple/filled/line{
	dir = 1
	},
/obj/effect/landmark/start/science_guard,
/turf/open/floor/iron/white,
/area/station/security/checkpoint/medical/medsci)
"Ki" = (
/obj/effect/turf_decal/stripes/line,
/obj/effect/turf_decal/stripes/line{
	dir = 1
	},
/obj/machinery/door/firedoor,
/obj/machinery/door/airlock/research/glass{
	name = "Science Guard Post"
	},
/obj/effect/mapping_helpers/airlock/access/all/science/sci_guard,
/turf/open/floor/iron/white,
/area/station/security/checkpoint/medical/medsci)
"Ml" = (
/obj/machinery/atmospherics/pipe/smart/manifold4w/supply/hidden/layer4,
/obj/machinery/atmospherics/pipe/smart/manifold4w/scrubbers/hidden/layer2,
/obj/effect/turf_decal/trimline/purple/filled/line,
/obj/effect/turf_decal/trimline/blue/filled/line,
/obj/effect/landmark/start/science_guard,
/turf/open/floor/iron/white,
/area/station/security/checkpoint/medical/medsci)
"NQ" = (
/obj/structure/cable,
/obj/machinery/atmospherics/components/unary/vent_scrubber/on/layer2,
/turf/open/floor/iron/white,
/area/station/security/checkpoint/medical/medsci)
"Oc" = (
/obj/effect/turf_decal/tile/neutral/fourcorners,
/obj/machinery/atmospherics/pipe/smart/manifold4w/supply/hidden/layer4,
/obj/effect/landmark/event_spawn,
/obj/effect/turf_decal/siding/dark_blue{
	dir = 1
	},
/obj/item/radio/intercom/directional/south,
/obj/machinery/light_switch/directional/south{
	pixel_x = 16
	},
/turf/open/floor/iron/dark,
/area/station/security/checkpoint/medical/medsci)
"Pq" = (
/obj/structure/cable,
/obj/structure/disposalpipe/segment{
	dir = 9
	},
/obj/machinery/duct,
/obj/effect/turf_decal/tile/neutral/half/contrasted{
	dir = 8
	},
/turf/open/floor/iron/white/side{
	dir = 4
	},
/area/station/science/research)
"PY" = (
/obj/structure/disposalpipe/segment{
	dir = 4
	},
/obj/structure/cable,
/obj/machinery/atmospherics/components/unary/vent_pump/on/layer4{
	dir = 1
	},
/obj/machinery/duct,
/obj/effect/turf_decal/tile/purple/full,
/obj/structure/disposalpipe/segment{
	dir = 4
	},
/turf/open/floor/iron/large,
/area/station/science/research)
"Qf" = (
/obj/structure/cable,
/obj/structure/disposalpipe/segment,
/obj/machinery/atmospherics/pipe/smart/manifold4w/supply/hidden/layer4,
/obj/machinery/atmospherics/pipe/smart/manifold4w/scrubbers/hidden/layer2,
/obj/machinery/duct,
/turf/open/floor/iron/white,
/area/station/science/research)
"Qz" = (
/obj/effect/turf_decal/trimline/purple/filled/corner,
/turf/open/floor/iron/white,
/area/station/science/research)
"QG" = (
/turf/closed/wall,
/area/station/security/checkpoint/medical/medsci)
"Rl" = (
/obj/structure/cable,
/obj/machinery/atmospherics/components/unary/vent_pump/on/layer4{
	dir = 1
	},
/obj/effect/landmark/start/orderly,
/turf/open/floor/iron/white,
/area/station/security/checkpoint/medical/medsci)
"Ux" = (
/obj/structure/cable,
/obj/effect/turf_decal/bot,
/obj/effect/turf_decal/trimline/purple/filled/line{
	dir = 9
	},
/obj/effect/turf_decal/trimline/blue/filled/line{
	dir = 9
	},
/obj/structure/closet/secure_closet/security/science,
/turf/open/floor/iron/white,
/area/station/security/checkpoint/medical/medsci)
"Vr" = (
/obj/structure/closet/crate/freezer/blood,
/obj/machinery/light/small/blacklight/directional/north,
/obj/machinery/airalarm/directional/west,
/obj/effect/turf_decal/bot_white{
	color = "#435a88"
	},
/turf/open/floor/iron/freezer,
/area/station/security/checkpoint/medical/medsci)
"VW" = (
/obj/machinery/computer/crew{
	dir = 4
	},
/obj/effect/turf_decal/trimline/blue/filled/line{
	dir = 8
	},
/turf/open/floor/iron/white,
/area/station/security/checkpoint/medical/medsci)
"Wt" = (
/obj/structure/cable,
/obj/machinery/atmospherics/pipe/smart/manifold4w/supply/hidden/layer4,
/obj/machinery/atmospherics/pipe/smart/manifold4w/scrubbers/hidden/layer2,
/obj/effect/turf_decal/bot,
/obj/machinery/holopad,
/turf/open/floor/iron/white,
/area/station/security/checkpoint/medical/medsci)
"Ww" = (
/obj/structure/table/reinforced,
/obj/item/crowbar,
/obj/item/radio{
	pixel_x = 5;
	pixel_y = 2
	},
/obj/item/radio{
	pixel_x = -3;
	pixel_y = 2
	},
/obj/item/radio{
	pixel_x = 1
	},
/obj/effect/turf_decal/trimline/purple/filled/line{
	dir = 4
	},
/turf/open/floor/iron/white,
/area/station/security/checkpoint/medical/medsci)
"Xn" = (
/obj/effect/turf_decal/tile/neutral/fourcorners,
/obj/structure/cable,
/obj/machinery/atmospherics/components/unary/vent_scrubber/on/layer2{
	dir = 4
	},
/obj/machinery/atmospherics/pipe/smart/manifold4w/supply/hidden/layer4,
/obj/effect/turf_decal/siding/dark_blue{
	dir = 1
	},
/turf/open/floor/iron/dark,
/area/station/security/checkpoint/medical/medsci)
"Ye" = (
/obj/effect/turf_decal/tile/neutral/fourcorners,
/obj/machinery/atmospherics/pipe/smart/manifold4w/supply/hidden/layer4,
/obj/effect/turf_decal/siding/dark_blue{
	dir = 1
	},
/obj/machinery/power/apc/auto_name/directional/south,
/obj/structure/cable,
/turf/open/floor/iron/dark,
/area/station/security/checkpoint/medical/medsci)
"Yh" = (
/obj/structure/cable,
/obj/structure/chair/office{
	dir = 8
	},
/obj/effect/landmark/start/orderly,
/turf/open/floor/iron/white,
/area/station/security/checkpoint/medical/medsci)
"YM" = (
/obj/effect/turf_decal/tile/neutral/fourcorners,
/obj/machinery/atmospherics/components/unary/vent_pump/on/layer4{
	dir = 4
	},
/obj/effect/turf_decal/siding/dark_blue{
	dir = 1
	},
/turf/open/floor/iron/dark,
/area/station/security/checkpoint/medical/medsci)

(1,1,1) = {"
rC
CQ
Qz
nn
Bt
Bt
nn
nn
nn
nn
"}
(2,1,1) = {"
pP
PY
kW
Bt
Ux
AO
Bt
DJ
AK
nn
"}
(3,1,1) = {"
Qf
Pq
ec
Ki
JL
Ml
gE
EO
It
nn
"}
(4,1,1) = {"
DP
DP
ey
Bt
kJ
tc
Bt
oe
ss
nn
"}
(5,1,1) = {"
Bt
Bt
Bt
nn
bU
wl
nn
nn
nn
nn
"}
(6,1,1) = {"
HR
JJ
VW
pM
sL
kC
nn
Vr
YM
nn
"}
(7,1,1) = {"
jb
Yh
NQ
Wt
Rl
qx
nn
zX
Oc
nn
"}
(8,1,1) = {"
AL
FF
qK
mN
mh
um
nn
ef
Ye
nn
"}
(9,1,1) = {"
Bt
nn
sw
zk
Ww
tx
nn
wz
Xn
QG
"}
(10,1,1) = {"
iV
nn
Bt
cF
Bt
nn
kD
QG
FU
QG
"}
