//MAP CONVERTED BY dmm2tgm.py THIS HEADER COMMENT PREVENTS RECONVERSION, DO NOT REMOVE
"a" = (
/obj/effect/spawner/structure/window,
/obj/structure/curtain/cloth/fancy/mechanical{
	id = "barbershopcurtains"
	},
/turf/open/floor/plating,
/area/station/service/salon)
"b" = (
/obj/effect/turf_decal/tile/purple{
	dir = 1
	},
/obj/effect/turf_decal/tile/purple,
/obj/effect/landmark/event_spawn,
/obj/machinery/atmospherics/pipe/smart/manifold4w/scrubbers/hidden/layer2,
/obj/machinery/atmospherics/pipe/smart/manifold4w/supply/hidden/layer4,
/turf/open/floor/iron,
/area/station/service/salon)
"c" = (
/obj/effect/turf_decal/tile/purple{
	dir = 1
	},
/obj/effect/turf_decal/tile/purple,
/obj/structure/sink{
	dir = 4;
	pixel_x = -12
	},
/obj/structure/mirror/directional/west,
/obj/machinery/atmospherics/components/unary/vent_scrubber/on/layer2{
	dir = 4
	},
/turf/open/floor/iron,
/area/station/service/salon)
"d" = (
/obj/effect/turf_decal/tile/purple,
/obj/effect/turf_decal/tile/purple{
	dir = 1
	},
/obj/machinery/door/airlock/public/glass{
	name = "Barbershop"
	},
/obj/machinery/atmospherics/pipe/smart/manifold4w/scrubbers/hidden/layer2,
/obj/machinery/atmospherics/pipe/smart/manifold4w/supply/hidden/layer4,
/obj/machinery/door/firedoor,
/turf/open/floor/iron,
/area/station/service/salon)
"e" = (
/obj/effect/turf_decal/tile/purple{
	dir = 1
	},
/obj/effect/turf_decal/tile/purple,
/obj/machinery/light_switch/directional/south,
/turf/open/floor/iron,
/area/station/service/salon)
"f" = (
/obj/machinery/camera/directional/north{
	c_tag = "Salon"
	},
/obj/effect/turf_decal/tile/purple{
	dir = 1
	},
/obj/effect/turf_decal/tile/purple,
/obj/structure/chair/sofa/bench/right,
/turf/open/floor/iron,
/area/station/service/salon)
"g" = (
/obj/effect/turf_decal/tile/purple{
	dir = 1
	},
/obj/effect/turf_decal/tile/purple,
/obj/item/kirbyplants/random,
/turf/open/floor/iron,
/area/station/service/salon)
"h" = (
/obj/effect/spawner/structure/window,
/obj/structure/curtain/cloth/fancy/mechanical{
	id = "barbershopcurtains"
	},
/obj/structure/cable,
/turf/open/floor/plating,
/area/station/service/salon)
"i" = (
/obj/effect/spawner/structure/window/reinforced,
/obj/structure/curtain/cloth/fancy/mechanical{
	id = "barbershopcurtains"
	},
/turf/open/floor/plating,
/area/station/service/salon)
"j" = (
/obj/structure/table/reinforced/rglass,
/obj/item/hairbrush,
/obj/effect/turf_decal/tile/purple{
	dir = 1
	},
/obj/effect/turf_decal/tile/purple,
/obj/item/lipstick/random,
/turf/open/floor/iron,
/area/station/service/salon)
"k" = (
/obj/structure/curtain/cloth/fancy/mechanical{
	id = "barbershopcurtains1"
	},
/obj/effect/spawner/structure/window,
/turf/open/floor/plating,
/area/station/service/salon)
"l" = (
/obj/structure/table/reinforced/rglass,
/obj/effect/turf_decal/tile/purple{
	dir = 1
	},
/obj/effect/turf_decal/tile/purple,
/obj/structure/mirror/directional/east,
/obj/item/reagent_containers/spray/barbers_aid{
	pixel_x = 6
	},
/obj/item/razor{
	pixel_x = -6
	},
/turf/open/floor/iron,
/area/station/service/salon)
"n" = (
/obj/effect/turf_decal/tile/purple{
	dir = 1
	},
/obj/effect/turf_decal/tile/purple,
/obj/machinery/atmospherics/components/unary/vent_pump/on/layer4,
/turf/open/floor/iron,
/area/station/service/salon)
"o" = (
/obj/structure/extinguisher_cabinet/directional/west,
/obj/structure/chair/office/light{
	dir = 4
	},
/obj/effect/turf_decal/tile/purple{
	dir = 1
	},
/obj/effect/turf_decal/tile/purple,
/turf/open/floor/iron,
/area/station/service/salon)
"p" = (
/turf/closed/wall/r_wall,
/area/station/command/gateway)
"s" = (
/obj/effect/turf_decal/tile/purple{
	dir = 1
	},
/obj/effect/turf_decal/tile/purple,
/turf/open/floor/iron,
/area/station/service/salon)
"u" = (
/obj/effect/turf_decal/tile/purple{
	dir = 1
	},
/obj/effect/turf_decal/tile/purple,
/obj/machinery/dryer{
	dir = 4;
	pixel_x = -6;
	pixel_y = -6
	},
/turf/open/floor/iron,
/area/station/service/salon)
"v" = (
/obj/machinery/firealarm/directional/east,
/obj/effect/turf_decal/tile/purple{
	dir = 1
	},
/obj/effect/turf_decal/tile/purple,
/obj/item/kirbyplants/random,
/turf/open/floor/iron,
/area/station/service/salon)
"w" = (
/obj/structure/cable,
/obj/effect/turf_decal/tile/purple{
	dir = 1
	},
/obj/effect/turf_decal/tile/purple,
/obj/machinery/atmospherics/pipe/smart/manifold4w/scrubbers/hidden/layer2,
/obj/machinery/atmospherics/pipe/smart/manifold4w/supply/hidden/layer4,
/turf/open/floor/iron,
/area/station/service/salon)
"x" = (
/obj/effect/turf_decal/tile/purple{
	dir = 1
	},
/obj/effect/turf_decal/tile/purple,
/obj/structure/chair/sofa/bench/right{
	dir = 1
	},
/obj/effect/landmark/start/hangover,
/obj/machinery/atmospherics/pipe/smart/manifold4w/scrubbers/hidden/layer2,
/obj/machinery/atmospherics/pipe/smart/manifold4w/supply/hidden/layer4,
/turf/open/floor/iron,
/area/station/service/salon)
"y" = (
/obj/effect/turf_decal/tile/purple{
	dir = 1
	},
/obj/effect/turf_decal/tile/purple,
/obj/structure/chair/sofa/bench/left{
	dir = 1
	},
/obj/machinery/atmospherics/pipe/smart/manifold4w/scrubbers/hidden/layer2,
/obj/machinery/atmospherics/pipe/smart/manifold4w/supply/hidden/layer4,
/turf/open/floor/iron,
/area/station/service/salon)
"C" = (
/obj/effect/turf_decal/tile/purple{
	dir = 1
	},
/obj/effect/turf_decal/tile/purple,
/obj/structure/closet/secure_closet/barber,
/obj/machinery/airalarm/directional/west,
/turf/open/floor/iron,
/area/station/service/salon)
"D" = (
/obj/item/radio/intercom/directional/north,
/obj/effect/turf_decal/tile/purple{
	dir = 1
	},
/obj/effect/turf_decal/tile/purple,
/obj/machinery/vending/barbervend,
/obj/machinery/button/curtain{
	id = "barbershopcurtains";
	pixel_x = -25;
	pixel_y = 24
	},
/turf/open/floor/iron,
/area/station/service/salon)
"E" = (
/obj/structure/chair/office/light{
	dir = 4
	},
/obj/effect/turf_decal/tile/purple{
	dir = 1
	},
/obj/effect/turf_decal/tile/purple,
/obj/machinery/button/curtain{
	id = "barbershopcurtains1";
	pixel_x = -25;
	pixel_y = 24
	},
/turf/open/floor/iron,
/area/station/service/salon)
"F" = (
/obj/structure/table/reinforced/rglass,
/obj/item/hairbrush,
/obj/effect/turf_decal/tile/purple{
	dir = 1
	},
/obj/effect/turf_decal/tile/purple,
/obj/item/lipstick/random,
/obj/machinery/camera/directional/east{
	c_tag = "Salon - Massage Parlour"
	},
/turf/open/floor/iron,
/area/station/service/salon)
"G" = (
/obj/structure/bed/pod,
/obj/machinery/light/warm/directional/north,
/obj/effect/turf_decal/tile/purple{
	dir = 1
	},
/obj/effect/turf_decal/tile/purple,
/obj/effect/landmark/start/hangover,
/turf/open/floor/iron,
/area/station/service/salon)
"H" = (
/turf/closed/wall,
/area/station/service/salon)
"I" = (
/obj/effect/turf_decal/tile/purple{
	dir = 1
	},
/obj/effect/turf_decal/tile/purple,
/obj/machinery/atmospherics/pipe/smart/manifold4w/scrubbers/hidden/layer2,
/obj/machinery/atmospherics/pipe/smart/manifold4w/supply/hidden/layer4,
/turf/open/floor/iron,
/area/station/service/salon)
"J" = (
/obj/effect/turf_decal/tile/purple{
	dir = 1
	},
/obj/effect/turf_decal/tile/purple,
/obj/structure/chair/sofa/bench/left,
/obj/structure/cable,
/turf/open/floor/iron,
/area/station/service/salon)
"K" = (
/obj/structure/cable,
/obj/effect/turf_decal/tile/purple{
	dir = 1
	},
/obj/effect/turf_decal/tile/purple,
/obj/item/lipstick/random,
/obj/structure/table/wood,
/turf/open/floor/iron,
/area/station/service/salon)
"L" = (
/obj/machinery/atmospherics/pipe/smart/manifold4w/scrubbers/hidden/layer2,
/obj/machinery/atmospherics/pipe/smart/manifold4w/supply/hidden/layer4,
/obj/effect/turf_decal/tile/purple,
/obj/effect/turf_decal/tile/purple{
	dir = 1
	},
/obj/machinery/door/airlock/public{
	name = "Massage Parlour"
	},
/obj/machinery/door/firedoor,
/turf/open/floor/iron,
/area/station/service/salon)
"M" = (
/obj/structure/bed/pod,
/obj/effect/turf_decal/tile/purple{
	dir = 1
	},
/obj/effect/turf_decal/tile/purple,
/turf/open/floor/iron,
/area/station/service/salon)
"N" = (
/turf/closed/wall/r_wall,
/area/station/ai_monitored/command/storage/eva)
"O" = (
/obj/effect/turf_decal/tile/purple{
	dir = 1
	},
/obj/effect/turf_decal/tile/purple,
/obj/item/book/fish_catalog,
/obj/structure/table/wood,
/turf/open/floor/iron,
/area/station/service/salon)
"P" = (
/obj/machinery/light/warm/directional/north,
/obj/effect/turf_decal/tile/purple{
	dir = 1
	},
/obj/effect/turf_decal/tile/purple,
/obj/structure/chair/comfy/barber_chair{
	dir = 4
	},
/turf/open/floor/iron,
/area/station/service/salon)
"Q" = (
/obj/effect/turf_decal/tile/purple{
	dir = 1
	},
/obj/effect/turf_decal/tile/purple,
/obj/structure/chair/comfy/barber_chair{
	dir = 4
	},
/turf/open/floor/iron,
/area/station/service/salon)
"R" = (
/obj/effect/turf_decal/tile/purple{
	dir = 1
	},
/obj/effect/turf_decal/tile/purple,
/obj/machinery/atmospherics/components/unary/vent_pump/on/layer4,
/obj/effect/landmark/start/barber,
/turf/open/floor/iron,
/area/station/service/salon)
"S" = (
/obj/structure/curtain/cloth/fancy/mechanical{
	id = "barbershopcurtains1"
	},
/obj/effect/spawner/structure/window/reinforced,
/turf/open/floor/plating,
/area/station/service/salon)
"T" = (
/obj/structure/table/reinforced/rglass,
/obj/effect/turf_decal/tile/purple{
	dir = 1
	},
/obj/effect/turf_decal/tile/purple,
/obj/structure/mirror/directional/east,
/obj/item/reagent_containers/dropper,
/obj/item/hairbrush/comb{
	pixel_y = 10
	},
/turf/open/floor/iron,
/area/station/service/salon)
"U" = (
/obj/machinery/light/warm/directional/west,
/obj/effect/turf_decal/tile/purple{
	dir = 1
	},
/obj/effect/turf_decal/tile/purple,
/obj/item/kirbyplants/random,
/obj/machinery/button/curtain{
	id = "barbershopcurtains";
	pixel_x = -25;
	pixel_y = -24
	},
/turf/open/floor/iron,
/area/station/service/salon)
"V" = (
/obj/machinery/door/firedoor,
/obj/structure/cable,
/obj/machinery/door/airlock/public/glass{
	name = "Barbershop"
	},
/turf/open/floor/iron,
/area/station/service/salon)
"W" = (
/obj/machinery/holopad,
/obj/effect/turf_decal/tile/purple{
	dir = 1
	},
/obj/effect/turf_decal/tile/purple,
/obj/machinery/atmospherics/pipe/smart/manifold4w/scrubbers/hidden/layer2,
/obj/machinery/atmospherics/pipe/smart/manifold4w/supply/hidden/layer4,
/turf/open/floor/iron,
/area/station/service/salon)
"X" = (
/obj/structure/cable,
/obj/effect/turf_decal/tile/purple{
	dir = 1
	},
/obj/effect/turf_decal/tile/purple,
/obj/effect/landmark/start/barber,
/obj/machinery/atmospherics/components/unary/vent_scrubber/on/layer2{
	dir = 8
	},
/turf/open/floor/iron,
/area/station/service/salon)
"Y" = (
/obj/machinery/light/small/directional/east,
/obj/machinery/power/apc/auto_name/directional/east,
/obj/structure/cable,
/obj/structure/table/reinforced/rglass,
/obj/effect/turf_decal/tile/purple{
	dir = 1
	},
/obj/effect/turf_decal/tile/purple,
/obj/item/lipstick/random,
/obj/item/reagent_containers/spray/quantum_hair_dye{
	pixel_x = 6
	},
/turf/open/floor/iron,
/area/station/service/salon)
"Z" = (
/obj/effect/spawner/structure/window,
/obj/machinery/atmospherics/pipe/smart/manifold4w/scrubbers/hidden/layer2,
/obj/machinery/atmospherics/pipe/smart/manifold4w/supply/hidden/layer4,
/obj/structure/curtain/cloth/fancy/mechanical{
	id = "barbershopcurtains"
	},
/turf/open/floor/plating,
/area/station/service/salon)

(1,1,1) = {"
N
N
N
N
N
N
"}
(2,1,1) = {"
S
E
u
c
o
H
"}
(3,1,1) = {"
H
G
R
b
M
k
"}
(4,1,1) = {"
k
F
g
I
j
H
"}
(5,1,1) = {"
H
H
H
L
H
H
"}
(6,1,1) = {"
H
D
C
I
U
a
"}
(7,1,1) = {"
V
s
n
W
s
a
"}
(8,1,1) = {"
H
f
O
y
e
H
"}
(9,1,1) = {"
h
J
K
x
I
d
"}
(10,1,1) = {"
Z
I
w
I
s
H
"}
(11,1,1) = {"
H
P
X
Q
s
a
"}
(12,1,1) = {"
i
T
Y
l
v
a
"}
(13,1,1) = {"
p
p
p
p
p
p
"}
