//MAP CONVERTED BY dmm2tgm.py THIS HEADER COMMENT PREVENTS RECONVERSION, DO NOT REMOVE
"a" = (
/obj/effect/spawner/structure/window/reinforced,
/obj/structure/cable,
/turf/open/floor/plating,
/area/station/security/checkpoint/medical/medsci)
"r" = (
/obj/structure/closet/secure_closet/security/science,
/obj/structure/cable,
/obj/effect/turf_decal/tile/red/fourcorners,
/obj/effect/turf_decal/bot,
/turf/open/floor/iron,
/area/station/security/checkpoint/medical/medsci)
"E" = (
/obj/structure/cable,
/obj/effect/turf_decal/tile/red/fourcorners,
/obj/effect/turf_decal/bot,
/obj/structure/closet/secure_closet/security/med,
/turf/open/floor/iron,
/area/station/security/checkpoint/medical/medsci)
"Z" = (
/turf/closed/wall/r_wall,
/area/station/security/checkpoint/medical/medsci)

(1,1,1) = {"
Z
a
a
Z
"}
(2,1,1) = {"
a
r
E
a
"}
