//MAP CONVERTED BY dmm2tgm.py THIS HEADER COMMENT PREVENTS RECONVERSION, DO NOT REMOVE
"a" = (
/obj/effect/spawner/structure/window/reinforced,
/obj/structure/cable,
/turf/open/floor/plating,
/area/station/security/checkpoint/medical)
"b" = (
/obj/effect/landmark/start/orderly,
/obj/effect/turf_decal/tile/red/half/contrasted{
	dir = 4
	},
/obj/structure/cable,
/turf/open/floor/iron,
/area/station/security/checkpoint/medical)
"g" = (
/obj/machinery/computer/security{
	dir = 4
	},
/obj/structure/cable,
/obj/effect/turf_decal/tile/red/fourcorners,
/turf/open/floor/iron,
/area/station/security/checkpoint/medical)
"i" = (
/obj/machinery/computer/crew{
	dir = 4
	},
/obj/effect/turf_decal/tile/red/anticorner/contrasted{
	dir = 1
	},
/turf/open/floor/iron,
/area/station/security/checkpoint/medical)
"l" = (
/obj/structure/chair{
	dir = 4
	},
/obj/structure/cable,
/obj/effect/turf_decal/tile/red/anticorner/contrasted{
	dir = 8
	},
/turf/open/floor/iron,
/area/station/security/checkpoint/medical)
"m" = (
/obj/structure/chair{
	dir = 4
	},
/obj/effect/turf_decal/tile/red/anticorner/contrasted{
	dir = 1
	},
/turf/open/floor/iron,
/area/station/security/checkpoint/medical)
"n" = (
/obj/structure/cable,
/obj/effect/turf_decal/tile/red/anticorner/contrasted,
/turf/open/floor/iron,
/area/station/security/checkpoint/medical)
"o" = (
/obj/structure/cable,
/obj/machinery/atmospherics/pipe/smart/manifold4w/supply/hidden/layer4,
/obj/machinery/atmospherics/pipe/smart/manifold4w/scrubbers/hidden/layer2,
/turf/open/floor/iron,
/area/station/security/checkpoint/medical)
"p" = (
/obj/machinery/light/directional/north,
/obj/item/radio/intercom/directional/north,
/obj/effect/turf_decal/tile/red/half/contrasted{
	dir = 1
	},
/obj/structure/closet/secure_closet/security/med,
/turf/open/floor/iron,
/area/station/security/checkpoint/medical)
"q" = (
/obj/machinery/door/firedoor,
/obj/machinery/door/airlock/security{
	name = "Orderly's Office"
	},
/obj/structure/cable,
/obj/effect/turf_decal/stripes/line,
/obj/effect/turf_decal/stripes/line{
	dir = 1
	},
/obj/machinery/atmospherics/pipe/smart/manifold4w/supply/hidden/layer4,
/obj/machinery/atmospherics/pipe/smart/manifold4w/scrubbers/hidden/layer2,
/obj/effect/mapping_helpers/airlock/access/all/medical/orderly,
/turf/open/floor/iron,
/area/station/security/checkpoint/medical)
"s" = (
/obj/structure/chair/office{
	dir = 8
	},
/obj/structure/cable,
/obj/effect/turf_decal/tile/neutral/fourcorners,
/obj/machinery/atmospherics/pipe/smart/manifold4w/scrubbers/hidden/layer2,
/obj/effect/landmark/start/orderly,
/turf/open/floor/iron,
/area/station/security/checkpoint/medical)
"v" = (
/obj/structure/cable,
/obj/machinery/atmospherics/pipe/smart/manifold4w/supply/hidden/layer4,
/obj/machinery/atmospherics/pipe/smart/manifold4w/scrubbers/hidden/layer2,
/obj/effect/turf_decal/tile/red/half/contrasted,
/turf/open/floor/iron,
/area/station/security/checkpoint/medical)
"w" = (
/obj/machinery/door_timer{
	id = "medcell";
	name = "Medical Cell";
	pixel_x = -32;
	pixel_y = -32
	},
/obj/machinery/camera/directional/west{
	c_tag = "Security Post - Medbay"
	},
/obj/structure/cable,
/obj/machinery/light/directional/west,
/obj/machinery/atmospherics/components/unary/vent_pump/on/layer4{
	dir = 4
	},
/obj/machinery/power/apc/auto_name/directional/west,
/obj/effect/turf_decal/tile/red/anticorner/contrasted{
	dir = 8
	},
/obj/structure/table/reinforced,
/obj/machinery/recharger,
/turf/open/floor/iron,
/area/station/security/checkpoint/medical)
"x" = (
/obj/machinery/door/airlock/security{
	name = "Orderly's Office"
	},
/obj/machinery/door/firedoor,
/obj/effect/turf_decal/stripes/line{
	dir = 4
	},
/obj/effect/turf_decal/stripes/line{
	dir = 8
	},
/obj/machinery/atmospherics/pipe/smart/manifold4w/supply/hidden/layer4,
/obj/machinery/atmospherics/pipe/smart/manifold4w/scrubbers/hidden/layer2,
/obj/effect/mapping_helpers/airlock/access/all/medical/orderly,
/turf/open/floor/iron,
/area/station/security/checkpoint/medical)
"y" = (
/obj/effect/landmark/start/orderly,
/obj/effect/turf_decal/tile/red/half/contrasted{
	dir = 4
	},
/turf/open/floor/iron,
/area/station/security/checkpoint/medical)
"z" = (
/obj/machinery/door/window/brigdoor{
	id = "medcell";
	name = "Medical Cell";
	req_access = list("brig_entrance")
	},
/obj/structure/cable,
/obj/effect/turf_decal/tile/red/fourcorners,
/obj/machinery/atmospherics/pipe/smart/manifold4w/supply/hidden/layer4,
/obj/machinery/atmospherics/pipe/smart/manifold4w/scrubbers/hidden/layer2,
/turf/open/floor/iron,
/area/station/security/checkpoint/medical)
"A" = (
/obj/structure/cable,
/obj/machinery/atmospherics/pipe/smart/manifold4w/supply/hidden/layer4,
/obj/machinery/atmospherics/pipe/smart/manifold4w/scrubbers/hidden/layer2,
/obj/effect/landmark/start/orderly,
/obj/effect/turf_decal/tile/red/half/contrasted,
/turf/open/floor/iron,
/area/station/security/checkpoint/medical)
"E" = (
/obj/machinery/holopad,
/obj/structure/cable,
/obj/effect/turf_decal/tile/neutral/fourcorners,
/obj/machinery/atmospherics/pipe/smart/manifold4w/scrubbers/hidden/layer2,
/obj/effect/landmark/start/orderly,
/turf/open/floor/iron,
/area/station/security/checkpoint/medical)
"F" = (
/obj/machinery/computer/secure_data{
	dir = 4
	},
/obj/effect/turf_decal/tile/red/anticorner/contrasted{
	dir = 8
	},
/turf/open/floor/iron,
/area/station/security/checkpoint/medical)
"G" = (
/obj/machinery/atmospherics/pipe/smart/manifold4w/supply/hidden/layer4,
/obj/machinery/atmospherics/pipe/smart/manifold4w/scrubbers/hidden/layer2,
/obj/effect/landmark/start/orderly,
/obj/structure/extinguisher_cabinet/directional/south{
	pixel_x = 26
	},
/obj/effect/turf_decal/tile/red/anticorner/contrasted,
/turf/open/floor/iron,
/area/station/security/checkpoint/medical)
"J" = (
/obj/structure/cable,
/turf/closed/wall,
/area/station/security/checkpoint/medical)
"L" = (
/obj/machinery/status_display/ai/directional/north,
/obj/machinery/light_switch/directional/east{
	pixel_x = 38
	},
/obj/structure/closet/secure_closet/security/med,
/obj/machinery/airalarm/directional/north{
	pixel_x = 32
	},
/obj/machinery/firealarm/directional/east,
/obj/effect/turf_decal/tile/red/anticorner/contrasted{
	dir = 4
	},
/turf/open/floor/iron,
/area/station/security/checkpoint/medical)
"M" = (
/obj/structure/closet/secure_closet/brig{
	id = "medcell";
	name = "Medical Cell Locker"
	},
/obj/effect/turf_decal/tile/red/anticorner/contrasted{
	dir = 4
	},
/turf/open/floor/iron,
/area/station/security/checkpoint/medical)
"P" = (
/obj/machinery/status_display/evac/directional/north,
/obj/structure/reagent_dispensers/wall/peppertank/directional/west,
/obj/structure/table/reinforced,
/obj/item/book/manual/wiki/security_space_law,
/obj/item/radio,
/obj/machinery/button/door/directional/north{
	id = "meddoor";
	name = "Medical Cell Control";
	normaldoorcontrol = 1;
	pixel_x = -36;
	req_access = list("brig_entrance")
	},
/obj/machinery/button/door/directional/north{
	id = "MedbayFoyer";
	name = "Medbay Doors Control";
	normaldoorcontrol = 1;
	pixel_x = -24;
	req_access = list("brig_entrance")
	},
/obj/effect/turf_decal/tile/red/anticorner/contrasted{
	dir = 1
	},
/turf/open/floor/iron,
/area/station/security/checkpoint/medical)
"R" = (
/obj/effect/turf_decal/tile/neutral/fourcorners,
/obj/machinery/atmospherics/components/unary/vent_scrubber/on/layer2,
/obj/effect/landmark/start/orderly,
/obj/structure/cable,
/turf/open/floor/iron,
/area/station/security/checkpoint/medical)
"W" = (
/turf/closed/wall,
/area/station/security/checkpoint/medical)
"Y" = (
/obj/structure/sign/nanotrasen,
/turf/closed/wall,
/area/station/security/checkpoint/medical)

(1,1,1) = {"
W
a
a
a
W
W
a
a
Y
"}
(2,1,1) = {"
P
F
g
i
w
a
m
l
a
"}
(3,1,1) = {"
p
R
s
E
A
z
o
v
q
"}
(4,1,1) = {"
L
b
y
b
G
a
M
n
a
"}
(5,1,1) = {"
W
a
W
a
x
W
J
a
Y
"}
