//MAP CONVERTED BY dmm2tgm.py THIS HEADER COMMENT PREVENTS RECONVERSION, DO NOT REMOVE
"a" = (
/turf/closed/wall/r_wall,
/area/station/security/lockers)
"b" = (
/obj/effect/landmark/start/spacepod_pilot,
/obj/machinery/atmospherics/pipe/smart/manifold4w/scrubbers/hidden/layer2,
/obj/machinery/atmospherics/pipe/smart/manifold4w/supply/hidden/layer4,
/obj/structure/cable,
/turf/open/floor/iron,
/area/station/security/spacepod_hangar)
"c" = (
/turf/closed/wall/r_wall,
/area/station/security/warden)
"d" = (
/obj/structure/cable,
/obj/machinery/holopad/secure,
/obj/effect/turf_decal/bot,
/obj/effect/turf_decal/tile/neutral/full,
/turf/open/floor/iron/large,
/area/station/security/lockers)
"e" = (
/obj/structure/table,
/obj/item/storage/toolbox/mechanical,
/obj/item/weldingtool/largetank,
/obj/machinery/light/directional/south,
/obj/structure/cable,
/obj/machinery/power/apc/auto_name/directional/south,
/turf/open/floor/iron,
/area/station/security/spacepod_hangar)
"f" = (
/obj/structure/cable,
/obj/effect/turf_decal/trimline/red/filled/line{
	dir = 4
	},
/obj/machinery/atmospherics/pipe/smart/manifold4w/scrubbers/hidden/layer2,
/obj/machinery/atmospherics/pipe/smart/manifold4w/supply/hidden/layer4,
/turf/open/floor/iron,
/area/station/security/lockers)
"g" = (
/obj/structure/closet/secure_closet/security/sec,
/obj/structure/sign/poster/official/do_not_question{
	pixel_y = -32
	},
/obj/effect/turf_decal/bot,
/obj/effect/turf_decal/tile/red/fourcorners,
/turf/open/floor/iron/dark,
/area/station/security/lockers)
"h" = (
/obj/machinery/door/airlock/security/glass{
	name = "Spacepod Hangar"
	},
/obj/effect/mapping_helpers/airlock/access/any/security/spacepod_pilot,
/obj/structure/cable,
/obj/machinery/atmospherics/pipe/smart/manifold4w/supply/hidden/layer4,
/obj/machinery/atmospherics/pipe/smart/manifold4w/scrubbers/hidden/layer2,
/turf/open/floor/iron,
/area/station/security/spacepod_hangar)
"i" = (
/obj/effect/turf_decal/trimline/red/filled/line,
/turf/open/floor/iron,
/area/station/security/lockers)
"j" = (
/obj/effect/turf_decal/trimline/red/filled/warning{
	dir = 1
	},
/obj/machinery/atmospherics/pipe/smart/manifold4w/scrubbers/hidden/layer2,
/obj/machinery/atmospherics/pipe/smart/manifold4w/supply/hidden/layer4,
/turf/open/floor/iron,
/area/station/security/lockers)
"l" = (
/obj/machinery/light/directional/north,
/turf/open/floor/engine,
/area/station/security/spacepod_hangar)
"n" = (
/obj/machinery/atmospherics/pipe/smart/manifold4w/supply/hidden/layer4,
/obj/effect/turf_decal/trimline/red/filled/line{
	dir = 1
	},
/obj/machinery/atmospherics/pipe/smart/manifold4w/scrubbers/hidden/layer2,
/turf/open/floor/iron,
/area/station/security/lockers)
"o" = (
/obj/structure/closet/secure_closet/security/sec,
/obj/item/clothing/ears/earmuffs,
/obj/item/clothing/glasses/sunglasses/big,
/obj/item/clothing/head/spacepod_pilot,
/obj/item/clothing/under/rank/spacepod_pilot,
/turf/open/floor/iron,
/area/station/security/spacepod_hangar)
"p" = (
/turf/closed/wall/r_wall,
/area/station/security/spacepod_hangar)
"q" = (
/obj/effect/landmark/start/security_officer,
/obj/effect/turf_decal/trimline/red/filled/line,
/turf/open/floor/iron,
/area/station/security/lockers)
"r" = (
/obj/machinery/newscaster/directional/south,
/obj/machinery/vending/wardrobe/sec_wardrobe,
/obj/effect/turf_decal/tile/red/fourcorners,
/turf/open/floor/iron,
/area/station/security/lockers)
"s" = (
/obj/machinery/atmospherics/components/unary/vent_pump/on/layer4,
/obj/machinery/light/directional/north,
/turf/open/floor/iron,
/area/station/security/spacepod_hangar)
"t" = (
/turf/closed/wall/r_wall,
/area/station/maintenance/department/security)
"w" = (
/obj/effect/turf_decal/stripes/line{
	dir = 4
	},
/turf/open/floor/iron,
/area/station/security/spacepod_hangar)
"x" = (
/obj/structure/fans/tiny/forcefield,
/turf/open/floor/plating,
/area/station/security/spacepod_hangar)
"y" = (
/obj/structure/closet/secure_closet/security/sec,
/obj/effect/turf_decal/bot,
/obj/effect/turf_decal/tile/red/fourcorners,
/turf/open/floor/iron/dark,
/area/station/security/lockers)
"z" = (
/obj/machinery/atmospherics/pipe/smart/manifold4w/supply/hidden/layer4,
/obj/effect/turf_decal/trimline/red/filled/warning{
	dir = 1
	},
/obj/machinery/atmospherics/pipe/smart/manifold4w/scrubbers/hidden/layer2,
/turf/open/floor/iron,
/area/station/security/lockers)
"A" = (
/obj/effect/turf_decal/trimline/red/filled/line{
	dir = 6
	},
/turf/open/floor/iron,
/area/station/security/lockers)
"B" = (
/obj/machinery/atmospherics/pipe/smart/manifold4w/scrubbers/hidden/layer2,
/obj/machinery/atmospherics/pipe/smart/manifold4w/supply/hidden/layer4,
/obj/structure/cable,
/turf/open/floor/iron,
/area/station/security/spacepod_hangar)
"C" = (
/obj/machinery/light/directional/south,
/turf/open/floor/engine,
/area/station/security/spacepod_hangar)
"D" = (
/turf/open/floor/iron,
/area/station/security/spacepod_hangar)
"E" = (
/obj/effect/turf_decal/stripes/line{
	dir = 4
	},
/obj/machinery/suit_storage_unit/security,
/obj/structure/railing{
	dir = 4
	},
/turf/open/floor/iron,
/area/station/security/spacepod_hangar)
"F" = (
/obj/structure/table/reinforced,
/obj/machinery/door/firedoor,
/obj/machinery/door/window/brigdoor/right/directional/north{
	name = "Armoury Desk";
	req_access = list("armory")
	},
/obj/machinery/door/window/right/directional/south{
	name = "Armoury Desk";
	req_access = list("security")
	},
/obj/item/restraints/handcuffs,
/obj/item/assembly/flash/handheld,
/turf/open/floor/iron/dark,
/area/station/ai_monitored/security/armory)
"G" = (
/turf/open/floor/engine,
/area/station/security/spacepod_hangar)
"H" = (
/obj/machinery/camera/directional/north{
	c_tag = "Security - Gear Room"
	},
/obj/structure/cable,
/obj/machinery/atmospherics/pipe/smart/manifold4w/supply/hidden/layer4,
/obj/machinery/power/apc/auto_name/directional/north,
/obj/effect/turf_decal/trimline/red/filled/line{
	dir = 1
	},
/obj/machinery/atmospherics/pipe/smart/manifold4w/scrubbers/hidden/layer2,
/turf/open/floor/iron,
/area/station/security/lockers)
"I" = (
/obj/effect/turf_decal/stripes/line{
	dir = 4
	},
/obj/machinery/atmospherics/components/unary/vent_scrubber/on/layer2{
	dir = 8
	},
/turf/open/floor/iron,
/area/station/security/spacepod_hangar)
"J" = (
/obj/machinery/door/poddoor/multi_tile/four_tile_ver,
/obj/structure/fans/tiny/forcefield,
/turf/open/floor/plating,
/area/station/security/spacepod_hangar)
"K" = (
/obj/structure/sign/nanotrasen{
	pixel_y = -32
	},
/obj/structure/table/reinforced,
/obj/machinery/recharger{
	pixel_x = -6;
	pixel_y = 2
	},
/obj/machinery/recharger{
	pixel_x = 6;
	pixel_y = 2
	},
/obj/effect/turf_decal/tile/red/fourcorners,
/turf/open/floor/iron/dark,
/area/station/security/lockers)
"L" = (
/obj/machinery/status_display/ai/directional/south,
/obj/structure/closet/secure_closet/security/sec,
/obj/machinery/light/directional/south,
/obj/effect/turf_decal/bot,
/obj/effect/turf_decal/tile/red/fourcorners,
/turf/open/floor/iron/dark,
/area/station/security/lockers)
"M" = (
/obj/effect/spawner/structure/window/reinforced,
/obj/structure/cable,
/turf/open/floor/plating,
/area/station/security/spacepod_hangar)
"N" = (
/obj/effect/turf_decal/stripes/line{
	dir = 4
	},
/obj/structure/table,
/obj/structure/railing{
	dir = 4
	},
/turf/open/floor/iron,
/area/station/security/spacepod_hangar)
"O" = (
/obj/spacepod/prebuilt/sec/roundstart,
/turf/open/floor/engine,
/area/station/security/spacepod_hangar)
"P" = (
/obj/structure/table,
/obj/item/spacepod_equipment/weaponry/disabler,
/obj/item/spacepod_equipment/thruster,
/obj/item/spacepod_equipment/lights/security,
/obj/machinery/airalarm/directional/south,
/turf/open/floor/iron,
/area/station/security/spacepod_hangar)
"R" = (
/obj/structure/closet/secure_closet/security/sec,
/obj/machinery/airalarm/directional/south,
/obj/effect/turf_decal/bot,
/obj/effect/turf_decal/tile/red/fourcorners,
/turf/open/floor/iron/dark,
/area/station/security/lockers)
"S" = (
/obj/structure/cable,
/obj/machinery/atmospherics/components/unary/vent_pump/on/layer4{
	dir = 1
	},
/obj/effect/turf_decal/tile/neutral/full,
/turf/open/floor/iron/large,
/area/station/security/lockers)
"T" = (
/obj/structure/cable,
/turf/open/floor/iron,
/area/station/security/spacepod_hangar)
"U" = (
/obj/machinery/door/poddoor{
	id = "armouryaccess";
	name = "Armoury Access"
	},
/obj/effect/turf_decal/stripes/line,
/obj/effect/turf_decal/stripes/line{
	dir = 1
	},
/turf/open/floor/iron,
/area/station/ai_monitored/security/armory)
"V" = (
/obj/effect/turf_decal/trimline/red/filled/line{
	dir = 5
	},
/obj/machinery/atmospherics/pipe/smart/manifold4w/scrubbers/hidden/layer2,
/obj/machinery/atmospherics/pipe/smart/manifold4w/supply/hidden/layer4,
/turf/open/floor/iron,
/area/station/security/lockers)
"W" = (
/turf/closed/wall/r_wall,
/area/station/ai_monitored/security/armory)
"X" = (
/obj/machinery/atmospherics/pipe/smart/manifold4w/supply/hidden/layer4,
/obj/item/radio/intercom/directional/north,
/obj/effect/turf_decal/trimline/red/filled/line{
	dir = 1
	},
/obj/machinery/atmospherics/pipe/smart/manifold4w/scrubbers/hidden/layer2,
/turf/open/floor/iron,
/area/station/security/lockers)
"Y" = (
/obj/structure/cable,
/obj/effect/turf_decal/tile/neutral/fourcorners,
/turf/open/floor/iron,
/area/station/security/lockers)
"Z" = (
/obj/structure/sign/warning/directional/west,
/turf/closed/wall/r_wall,
/area/station/security/spacepod_hangar)

(1,1,1) = {"
c
H
Y
q
g
t
"}
(2,1,1) = {"
W
n
d
i
K
a
"}
(3,1,1) = {"
W
X
Y
q
R
a
"}
(4,1,1) = {"
U
z
S
q
L
a
"}
(5,1,1) = {"
U
j
Y
q
y
a
"}
(6,1,1) = {"
F
V
f
A
r
a
"}
(7,1,1) = {"
W
M
h
M
p
p
"}
(8,1,1) = {"
W
o
B
D
P
p
"}
(9,1,1) = {"
Z
s
b
T
e
p
"}
(10,1,1) = {"
p
E
I
w
N
p
"}
(11,1,1) = {"
p
G
G
G
G
p
"}
(12,1,1) = {"
p
G
G
G
G
p
"}
(13,1,1) = {"
p
l
G
O
C
p
"}
(14,1,1) = {"
p
G
G
G
G
p
"}
(15,1,1) = {"
p
x
x
x
J
p
"}
