//MAP CONVERTED BY dmm2tgm.py THIS HEADER COMMENT PREVENTS RECONVERSION, DO NOT REMOVE
"a" = (
/turf/closed/wall,
/area/station/commons/fitness/recreation)
"b" = (
/obj/machinery/cryopod,
/obj/effect/turf_decal/siding/white,
/obj/machinery/power/apc/auto_name/directional/east,
/obj/structure/cable,
/turf/open/floor/iron/dark,
/area/station/common/cryopods)
"d" = (
/obj/machinery/cryopod,
/obj/effect/turf_decal/siding/white,
/turf/open/floor/iron/dark,
/area/station/common/cryopods)
"e" = (
/obj/machinery/cryopod{
	dir = 1
	},
/obj/effect/turf_decal/siding/white{
	dir = 1
	},
/obj/machinery/airalarm/directional/east,
/obj/machinery/atmospherics/components/unary/vent_pump/on/layer4{
	dir = 1
	},
/obj/machinery/camera/directional/east,
/turf/open/floor/iron/dark,
/area/station/common/cryopods)
"g" = (
/turf/open/floor/iron/dark/corner{
	dir = 4
	},
/area/station/commons/fitness/recreation)
"h" = (
/obj/machinery/cryopod,
/obj/effect/turf_decal/siding/white,
/obj/machinery/atmospherics/components/unary/vent_scrubber/on/layer2,
/turf/open/floor/iron/dark,
/area/station/common/cryopods)
"i" = (
/obj/machinery/atmospherics/pipe/smart/manifold4w/supply/hidden/layer4,
/obj/machinery/atmospherics/pipe/smart/manifold4w/scrubbers/hidden/layer2,
/obj/effect/landmark/start/hangover,
/obj/structure/cable,
/turf/open/floor/iron/white/side{
	dir = 4
	},
/area/station/commons/fitness/recreation)
"l" = (
/obj/structure/window/reinforced,
/obj/machinery/door/window{
	dir = 4;
	name = "Fitness Ring"
	},
/turf/open/floor/iron/dark,
/area/station/commons/fitness/recreation)
"m" = (
/obj/structure/window/reinforced,
/obj/structure/window/reinforced{
	dir = 8
	},
/turf/open/floor/iron/dark,
/area/station/commons/fitness/recreation)
"n" = (
/obj/structure/closet/athletic_mixed,
/obj/effect/turf_decal/box/white,
/turf/open/floor/iron/dark/side{
	dir = 4
	},
/area/station/commons/fitness/recreation)
"p" = (
/obj/effect/landmark/start/hangover,
/obj/structure/cable,
/obj/machinery/atmospherics/pipe/smart/manifold4w/supply/hidden/layer4,
/obj/machinery/atmospherics/pipe/smart/manifold4w/scrubbers/hidden/layer2,
/turf/open/floor/iron/white,
/area/station/common/cryopods)
"q" = (
/obj/structure/disposalpipe/segment{
	dir = 4
	},
/obj/structure/tank_holder/extinguisher,
/turf/open/floor/iron,
/area/station/commons/fitness/recreation)
"r" = (
/obj/machinery/atmospherics/pipe/smart/manifold4w/scrubbers/hidden/layer2,
/turf/open/floor/iron/dark/side{
	dir = 8
	},
/area/station/commons/fitness/recreation)
"t" = (
/obj/machinery/computer/cryopod{
	dir = 8;
	pixel_x = 32
	},
/obj/structure/cable,
/obj/machinery/atmospherics/pipe/smart/manifold4w/supply/hidden/layer4,
/obj/machinery/light/directional/east,
/turf/open/floor/iron/white,
/area/station/common/cryopods)
"u" = (
/obj/machinery/atmospherics/pipe/smart/manifold4w/scrubbers/hidden/layer2,
/turf/open/floor/iron/dark/corner{
	dir = 1
	},
/area/station/commons/fitness/recreation)
"v" = (
/obj/structure/chair{
	dir = 1
	},
/obj/machinery/atmospherics/pipe/smart/manifold4w/scrubbers/hidden/layer2,
/obj/machinery/atmospherics/pipe/smart/manifold4w/supply/hidden/layer4,
/obj/structure/cable,
/turf/open/floor/iron,
/area/station/commons/fitness/recreation)
"w" = (
/obj/machinery/atmospherics/components/unary/vent_pump/on/layer4{
	dir = 1
	},
/obj/structure/disposalpipe/segment{
	dir = 4
	},
/turf/open/floor/iron,
/area/station/commons/fitness/recreation)
"x" = (
/obj/machinery/cryopod{
	dir = 1
	},
/obj/effect/turf_decal/siding/white{
	dir = 1
	},
/turf/open/floor/iron/dark,
/area/station/common/cryopods)
"A" = (
/obj/machinery/camera/directional/south{
	c_tag = "Dormitories - Recreation Aft";
	name = "dormitories camera"
	},
/obj/machinery/disposal/bin,
/obj/effect/turf_decal/box,
/obj/structure/disposalpipe/trunk{
	dir = 8
	},
/obj/structure/sign/warning/no_smoking/circle/directional/south,
/turf/open/floor/iron/white/side{
	dir = 4
	},
/area/station/commons/fitness/recreation)
"B" = (
/obj/structure/window/reinforced,
/turf/open/floor/iron/dark,
/area/station/commons/fitness/recreation)
"C" = (
/obj/effect/spawner/structure/window/reinforced,
/turf/open/floor/plating,
/area/station/common/cryopods)
"F" = (
/obj/structure/disposalpipe/segment{
	dir = 4
	},
/turf/open/floor/iron,
/area/station/commons/fitness/recreation)
"G" = (
/obj/machinery/atmospherics/pipe/smart/manifold4w/scrubbers/hidden/layer2,
/obj/machinery/atmospherics/pipe/smart/manifold4w/supply/hidden/layer4,
/obj/structure/cable,
/turf/open/floor/iron,
/area/station/commons/fitness/recreation)
"I" = (
/obj/effect/spawner/structure/window/reinforced,
/turf/open/floor/plating,
/area/station/commons/fitness/recreation)
"J" = (
/obj/structure/cable,
/obj/machinery/atmospherics/pipe/smart/manifold4w/supply/hidden/layer4,
/turf/open/floor/iron/white,
/area/station/common/cryopods)
"L" = (
/obj/machinery/light/directional/east,
/turf/open/floor/iron,
/area/station/commons/fitness/recreation)
"M" = (
/turf/open/floor/iron/dark/side{
	dir = 1
	},
/area/station/commons/fitness/recreation)
"N" = (
/turf/closed/wall,
/area/station/common/cryopods)
"Q" = (
/obj/structure/cable,
/obj/machinery/atmospherics/pipe/smart/manifold4w/supply/hidden/layer4,
/obj/machinery/atmospherics/pipe/smart/manifold4w/scrubbers/hidden/layer2,
/obj/machinery/door/airlock/public/glass{
	name = "Cryopods"
	},
/obj/effect/landmark/navigate_destination,
/turf/open/floor/iron/white,
/area/station/common/cryopods)
"X" = (
/turf/open/floor/iron/white/side{
	dir = 4
	},
/area/station/commons/fitness/recreation)

(1,1,1) = {"
n
g
G
q
I
"}
(2,1,1) = {"
m
M
v
F
I
"}
(3,1,1) = {"
B
M
v
w
I
"}
(4,1,1) = {"
B
M
v
F
I
"}
(5,1,1) = {"
l
M
v
F
I
"}
(6,1,1) = {"
r
u
G
F
I
"}
(7,1,1) = {"
L
X
i
A
a
"}
(8,1,1) = {"
N
C
Q
C
N
"}
(9,1,1) = {"
C
h
p
x
C
"}
(10,1,1) = {"
C
d
J
x
C
"}
(11,1,1) = {"
C
b
t
e
C
"}
(12,1,1) = {"
N
N
N
N
N
"}
