"bx" = (/obj/effect/turf_decal/sand/plating,/obj/structure/closet/abandoned_cabinet,/turf/open/floor/plating/rust/lowpressure,/area/ruin/unpowered)
"bR" = (/obj/effect/turf_decal/sand/plating,/obj/structure/girder,/turf/open/floor/plating/rust/lowpressure,/area/ruin/unpowered)
"cz" = (/obj/effect/turf_decal/sand/plating,/obj/structure/noticeboard/directional/north,/turf/open/floor/iron/grimy/lowpressure,/area/ruin/unpowered)
"dw" = (/obj/structure/mineral_door/wood,/turf/open/floor/plating/rust/lowpressure,/area/ruin/unpowered)
"eI" = (/obj/effect/turf_decal/sand/plating,/turf/open/floor/plating/rust/lowpressure,/area/ruin/unpowered)
"kA" = (/obj/structure/girder,/turf/open/floor/plating/rust/lowpressure,/area/ruin/unpowered)
"lw" = (/obj/effect/turf_decal/sand/plating,/turf/open/floor/iron/grimy/lowpressure,/area/ruin/unpowered)
"lA" = (/obj/structure/door_assembly/multi_tile/glass{dir = 1},/obj/effect/turf_decal/sand/plating,/obj/structure/barricade/wooden/crude,/turf/open/floor/plating/rust/lowpressure,/area/ruin/unpowered)
"lJ" = (/turf/open/floor/plating/rust/lowpressure,/area/ruin/unpowered)
"lU" = (/obj/effect/turf_decal/sand/plating,/obj/structure/grille/broken,/turf/open/floor/plating/rust/lowpressure,/area/ruin/unpowered)
"oV" = (/obj/effect/turf_decal/sand/plating,/obj/structure/decorative/shelf,/obj/effect/spawner/lootdrop/maintenance/five,/obj/effect/decal/cleanable/cobweb/cobweb2,/turf/open/floor/plating/rust/lowpressure,/area/ruin/unpowered)
"pI" = (/turf/open/floor/plating/asteroid/lowpressure,/area/ruin/unpowered)
"qj" = (/obj/effect/turf_decal/sand/plating,/obj/machinery/photocopier,/turf/open/floor/plating/rust/lowpressure,/area/ruin/unpowered)
"qB" = (/obj/structure/fluff/abandoned/radiator/worn{pixel_y = 30},/turf/open/floor/plating/rust/lowpressure,/area/ruin/unpowered)
"rj" = (/obj/effect/spawner/lootdrop/gross_decal_spawner,/turf/open/floor/plating/rust/lowpressure,/area/ruin/unpowered)
"rH" = (/obj/machinery/light/small/broken/directional/west,/turf/open/floor/iron/grimy/lowpressure,/area/ruin/unpowered)
"sc" = (/obj/effect/turf_decal/sand/plating,/obj/machinery/vending/sovietsoda,/turf/open/floor/iron/grimy/lowpressure,/area/ruin/unpowered)
"sx" = (/obj/structure/barricade/wooden,/obj/structure/barricade/wooden/crude,/obj/effect/turf_decal/sand/plating,/turf/open/floor/plating/rust/lowpressure,/area/ruin/unpowered)
"sU" = (/obj/structure/girder,/obj/effect/turf_decal/sand/plating,/turf/open/floor/plating/rust/lowpressure,/area/ruin/unpowered)
"th" = (/obj/effect/turf_decal/sand/plating,/obj/structure/grille,/turf/open/floor/plating/rust/lowpressure,/area/ruin/unpowered)
"ud" = (/obj/machinery/duct,/turf/open/floor/plating/rust/lowpressure,/area/ruin/unpowered)
"uR" = (/obj/effect/turf_decal/sand/plating,/obj/structure/fluff/abandoned/piping{pixel_y = 18},/obj/structure/sign/plaques/ancient_astronaut{pixel_y = 30},/turf/open/floor/plating/rust/lowpressure,/area/ruin/unpowered)
"vj" = (/obj/effect/turf_decal/sand/plating,/obj/structure/bed/maint/abandoned/randomspawn,/turf/open/floor/plating/rust/lowpressure,/area/ruin/unpowered)
"xh" = (/obj/structure/table_frame,/obj/structure/fluff/abandoned/terminal/old,/turf/open/floor/iron/grimy/lowpressure,/area/ruin/unpowered)
"zr" = (/obj/effect/turf_decal/sand/plating,/obj/structure/barricade/wooden/crude,/turf/open/floor/plating/rust/lowpressure,/area/ruin/unpowered)
"Bd" = (/obj/effect/turf_decal/sand/plating,/obj/structure/sign/plaques/clock_broken{pixel_y = 29},/turf/open/floor/plating/rust/lowpressure,/area/ruin/unpowered)
"Cy" = (/obj/structure/fluff/abandoned/radiator/worn{dir = 1},/turf/open/floor/plating/rust/lowpressure,/area/ruin/unpowered)
"Dn" = (/obj/structure/sign/blank,/turf/closed/wall/rust,/area/ruin/unpowered)
"Dy" = (/obj/structure/light_construct/small/directional/east,/obj/machinery/duct,/turf/open/floor/plating/rust/lowpressure,/area/ruin/unpowered)
"Dz" = (/obj/structure/frame/machine,/turf/open/floor/plating/rust/lowpressure,/area/ruin/unpowered)
"EN" = (/obj/structure/barricade/wooden,/turf/open/floor/plating/rust/lowpressure,/area/ruin/unpowered)
"GC" = (/obj/structure/light_construct/small/directional/east,/turf/open/floor/iron/grimy/lowpressure,/area/ruin/unpowered)
"HA" = (/turf/open/floor/iron/grimy/lowpressure,/area/ruin/unpowered)
"Ii" = (/obj/structure/closet/abandoned_cabinet,/turf/open/floor/iron/grimy/lowpressure,/area/ruin/unpowered)
"Kc" = (/obj/machinery/firealarm/directional/south,/turf/open/floor/plating/rust/lowpressure,/area/ruin/unpowered)
"Kf" = (/obj/structure/grille,/turf/open/floor/plating/rust/lowpressure,/area/ruin/unpowered)
"KB" = (/obj/effect/turf_decal/sand/plating,/obj/structure/dresser,/turf/open/floor/iron/grimy/lowpressure,/area/ruin/unpowered)
"Nz" = (/turf/open/floor/plating/asteroid/lowpressure,/area/template_noop)
"NB" = (/obj/structure/grille/broken,/obj/effect/turf_decal/sand/plating,/turf/open/floor/plating/rust/lowpressure,/area/ruin/unpowered)
"Ps" = (/obj/effect/turf_decal/sand/plating,/obj/structure/table,/obj/structure/fluff/abandoned/terminal/old{dir = 1},/turf/open/floor/plating/rust/lowpressure,/area/ruin/unpowered)
"QC" = (/obj/structure/fluff/abandoned/piping/broken{pixel_x = -4; pixel_y = 30},/turf/open/floor/plating/rust/lowpressure,/area/ruin/unpowered)
"QN" = (/turf/closed/wall/rust,/area/ruin/unpowered)
"QP" = (/obj/effect/decal/cleanable/cobweb,/obj/structure/dresser,/turf/open/floor/plating/rust/lowpressure,/area/ruin/unpowered)
"QT" = (/turf/template_noop,/area/template_noop)
"Ra" = (/obj/structure/fluff/abandoned/breaker/worn{pixel_x = 15},/turf/open/floor/plating/asteroid/lowpressure,/area/template_noop)
"Ri" = (/obj/effect/turf_decal/sand/plating,/obj/structure/flippedtable,/obj/effect/spawner/lootdrop/wildwest/cash,/turf/open/floor/plating/rust/lowpressure,/area/ruin/unpowered)
"RW" = (/obj/effect/spawner/lootdrop/gross_decal_spawner,/obj/machinery/light/small/broken/directional/west,/turf/open/floor/iron/grimy/lowpressure,/area/ruin/unpowered)
"Sl" = (/obj/structure/bedsheetbin/empty,/obj/structure/table,/turf/open/floor/iron/grimy/lowpressure,/area/ruin/unpowered)
"Su" = (/obj/effect/turf_decal/sand/plating,/obj/machinery/washing_machine,/turf/open/floor/plating/rust/lowpressure,/area/ruin/unpowered)
"Sy" = (/mob/living/simple_animal/hostile/cockroach/hauberoach,/obj/structure/fluff/abandoned/radiator/worn{dir = 8},/turf/open/floor/plating/rust/lowpressure,/area/ruin/unpowered)
"TX" = (/obj/effect/turf_decal/sand/plating,/obj/structure/table_frame,/turf/open/floor/iron/grimy/lowpressure,/area/ruin/unpowered)
"TY" = (/obj/effect/turf_decal/sand/plating,/obj/effect/decal/cleanable/cobweb/cobweb2,/turf/open/floor/plating/rust/lowpressure,/area/ruin/unpowered)
"Vr" = (/obj/machinery/light/small/broken/directional/west,/turf/open/floor/plating/rust/lowpressure,/area/ruin/unpowered)
"Xx" = (/obj/structure/bed/maint/abandoned/randomspawn,/turf/open/floor/plating/rust/lowpressure,/area/ruin/unpowered)
"Zw" = (/obj/effect/turf_decal/sand/plating,/obj/structure/dresser,/turf/open/floor/plating/rust/lowpressure,/area/ruin/unpowered)
"ZF" = (/obj/structure/door_assembly/multi_tile/glass{dir = 1},/turf/open/floor/plating/asteroid/lowpressure,/area/ruin/unpowered)
"ZX" = (/obj/machinery/light/small/broken/directional/east,/turf/open/floor/plating/rust/lowpressure,/area/ruin/unpowered)

(1,1,1) = {"
QTQTQTQTQTQTQTQTQTQTQTQTQTQTQTQTQTQTQTQT
QTQTQTQTQTQTQTQTQTQTQTQTQTQTQTQTQTQTQTQT
QTQTQNsUQNQNQNQNQNNBthQNQNQNsUeIQNQNQTQT
QTQTQNQPQCXxQNqjBdeIeIczoVQNvjeIZwQNQTQT
QTQTKfeIlJSyQNlwlweIeIlwlwQNlwlweIlUQTQT
QTQTKfeIHAGCQNlJRiPsTXxhlJQNRWeIeIpIQTQT
QTQTQNDzIirjdwlJHAHAHAHAududlJCybxQNQTQT
QTNzbRQNkAQNQNVrudHAHAudDyQNlJQNQNQNQTQT
QTRaQNeIlJqBlJlJudlJlJlJlJENlJuRTYQNQTQT
QTNzsxeIlwZXQNeIlwHAlJlJlJQNrHlwKBQNQTQT
QTNzQNlwlwlJeIeIlwlwKceIeIQNlwlweIlUQTQT
QTQTQNSuscSlQNlAzrDnQNZFeIQNXxeIbxQNQTQT
QTQTQNQNsUsUQNQTQTQTQTQTQTeIQNQNsUQNQTQT
QTQTQTQTQTQTQTQTQTQTQTQTQTQTQTQTQTQTQTQT
QTQTQTQTQTQTQTQTQTQTQTQTQTQTQTQTQTQTQTQT
"}
