"a" = (/obj/effect/turf_decal/sand/plating,/turf/open/floor/iron/large/lowpressure,/area/template_noop)
"g" = (/obj/effect/turf_decal/sand/plating,/turf/open/floor/plating/rust/lowpressure,/area/template_noop)
"h" = (/obj/structure/fluff/abandoned/cinderblock/large,/obj/effect/turf_decal/sand/plating,/turf/open/floor/iron/large/lowpressure,/area/template_noop)
"i" = (/obj/effect/turf_decal/skyrat_decals/street/full/horizontal,/obj/effect/turf_decal/sand/plating,/turf/open/floor/plating/lowpressure,/area/template_noop)
"l" = (/obj/effect/turf_decal/skyrat_decals/street/full/end{dir = 4},/obj/effect/turf_decal/sand/plating,/turf/open/floor/iron/dark/smooth_large/lowpressure,/area/template_noop)
"m" = (/obj/structure/fluff/abandoned/cinderblock/large,/obj/effect/turf_decal/sand/plating,/turf/open/floor/plating/rust/lowpressure,/area/template_noop)
"o" = (/obj/effect/turf_decal/skyrat_decals/street/full/horizontal,/obj/structure/fluff/abandoned/cinderblock,/obj/effect/turf_decal/sand/plating,/turf/open/floor/iron/dark/smooth_large/lowpressure,/area/template_noop)
"p" = (/obj/effect/turf_decal/skyrat_decals/street/full/end{dir = 4},/obj/effect/turf_decal/sand/plating,/turf/open/floor/plating/lowpressure,/area/template_noop)
"q" = (/obj/effect/turf_decal/skyrat_decals/street/full/horizontal,/obj/structure/fluff/abandoned/cinderblock,/obj/effect/turf_decal/sand/plating,/turf/open/floor/plating/lowpressure,/area/template_noop)
"u" = (/obj/effect/turf_decal/skyrat_decals/street/full/end{dir = 8},/obj/effect/turf_decal/sand/plating,/turf/open/floor/plating/lowpressure,/area/template_noop)
"v" = (/obj/effect/turf_decal/skyrat_decals/street/full/end{dir = 8},/obj/effect/turf_decal/sand/plating,/turf/open/floor/iron/dark/smooth_large/lowpressure,/area/template_noop)
"w" = (/obj/effect/turf_decal/sand/plating,/turf/open/floor/iron/dark/smooth_large/lowpressure,/area/template_noop)
"x" = (/obj/structure/fluff/abandoned/cinderblock{dir = 4},/obj/effect/turf_decal/sand/plating,/turf/open/floor/plating/rust/lowpressure,/area/template_noop)
"A" = (/turf/template_noop,/area/template_noop)
"C" = (/obj/structure/fluff/abandoned/cinderblock/end,/obj/effect/turf_decal/sand/plating,/turf/open/floor/iron/large/lowpressure,/area/template_noop)
"E" = (/obj/structure/fluff/abandoned/cinderblock,/obj/effect/turf_decal/sand/plating,/turf/open/floor/plating/rust/lowpressure,/area/template_noop)
"G" = (/obj/structure/fluff/abandoned/cinderblock/end{dir = 1},/obj/effect/turf_decal/sand/plating,/turf/open/floor/plating/rust/lowpressure,/area/template_noop)
"H" = (/obj/structure/fluff/abandoned/cinderblock/end,/obj/effect/turf_decal/sand/plating,/turf/open/floor/plating/rust/lowpressure,/area/template_noop)
"I" = (/obj/effect/turf_decal/skyrat_decals/street/dashed/end{dir = 4},/obj/effect/turf_decal/sand/plating,/turf/open/floor/plating/lowpressure,/area/template_noop)
"K" = (/obj/effect/turf_decal/sand/plating,/turf/open/floor/plating/lowpressure,/area/template_noop)
"L" = (/obj/structure/fluff/abandoned/cinderblock/end{dir = 1},/obj/effect/turf_decal/sand/plating,/turf/open/floor/iron/large/lowpressure,/area/template_noop)
"M" = (/obj/structure/fluff/abandoned/noentry/worn,/obj/effect/turf_decal/sand/plating,/turf/open/floor/iron/large/lowpressure,/area/template_noop)
"P" = (/obj/effect/turf_decal/skyrat_decals/street/dashed/horizontal,/obj/effect/turf_decal/sand/plating,/turf/open/floor/iron/dark/smooth_large/lowpressure,/area/template_noop)
"V" = (/obj/effect/turf_decal/skyrat_decals/street/full/horizontal,/obj/effect/turf_decal/sand/plating,/turf/open/floor/iron/dark/smooth_large/lowpressure,/area/template_noop)
"Y" = (/obj/structure/fluff/abandoned/cinderblock{dir = 4},/obj/effect/turf_decal/sand/plating,/turf/open/floor/iron/dark/smooth_large/lowpressure,/area/template_noop)
"Z" = (/obj/effect/turf_decal/skyrat_decals/street/dashed/end{dir = 8},/obj/effect/turf_decal/sand/plating,/turf/open/floor/iron/dark/smooth_large/lowpressure,/area/template_noop)

(1,1,1) = {"
AhAAAAAAAgghahAAAAAAAAhaghaahAAAAh
AKwwKKAAAKKwwKAAKKAAAAKKKwwAAAAAAw
AuVVVViiVVVViiiVVVVVVVVVVVipAAvVVl
AAAKwwwwwwwwwwwwwwwwwwwwKKKKKKwwww
AwuiVVVVVVViiiiiiVVVVoVVViiVVVVVlA
wwKwwwwwwwKKKKKKKKKKYwwwwwwwwwwwAA
ACLxgMIPZMEgHLCLCLCLaaCLHGHLCGHLAA
wwwKKwwwwwwYwwwwwwwwwwwwwwwwwwKKAA
wuiiqiVVVViiiiVVVVVVVVVVVVVViiipAA
AKKAKwwwwKKKwwwwwwwwwwwwwwwwwwwKKA
AAAAAuiVVVVVVVVVVViiiiVVViVVVVVVip
AAAAAAKwwwwKKKKKAAAAKKKKAAKKwwwAAA
ahmAAAAAAgghhhhhAAAAAAAAAAAghhgAAA
"}
