"a" = (/turf/template_noop,/area/template_noop)
"c" = (/obj/structure/fluff/abandoned/stopsign/worn{pixel_x = 8},/obj/effect/turf_decal/sand/plating,/turf/open/floor/iron/large/lowpressure,/area/rockplanet/surface/outdoors)
"e" = (/obj/effect/turf_decal/skyrat_decals/street/dashed,/obj/effect/turf_decal/sand/plating,/turf/open/floor/iron/dark/smooth_large/lowpressure,/area/rockplanet/surface/outdoors)
"h" = (/obj/effect/turf_decal/sand/plating,/turf/open/floor/plating/rust/lowpressure,/area/rockplanet/surface/outdoors)
"i" = (/obj/structure/fluff/abandoned/cinderblock/end{dir = 8},/obj/effect/turf_decal/sand/plating,/turf/open/floor/plating/rust/lowpressure,/area/rockplanet/surface/outdoors)
"j" = (/obj/effect/turf_decal/skyrat_decals/street/full,/obj/effect/turf_decal/sand/plating,/turf/open/floor/plating/lowpressure,/area/rockplanet/surface/outdoors)
"l" = (/obj/effect/turf_decal/skyrat_decals/street/full,/obj/effect/turf_decal/sand/plating,/turf/open/floor/iron/dark/smooth_large/lowpressure,/area/rockplanet/surface/outdoors)
"m" = (/obj/effect/turf_decal/skyrat_decals/street/dashed,/obj/effect/turf_decal/skyrat_decals/street/manhole,/obj/effect/turf_decal/sand/plating,/turf/open/floor/iron/dark/smooth_large/lowpressure,/area/rockplanet/surface/outdoors)
"q" = (/obj/effect/turf_decal/skyrat_decals/street/full/end,/obj/effect/turf_decal/sand/plating,/turf/open/floor/plating/lowpressure,/area/rockplanet/surface/outdoors)
"s" = (/obj/structure/chair/sofa/bench/corner,/obj/effect/turf_decal/sand/plating,/turf/open/floor/iron/large/lowpressure,/area/rockplanet/surface/outdoors)
"u" = (/obj/effect/turf_decal/skyrat_decals/street/full/horizontal,/obj/effect/turf_decal/sand/plating,/turf/open/floor/iron/dark/smooth_large/lowpressure,/area/rockplanet/surface/outdoors)
"w" = (/obj/structure/fluff/abandoned/cinderblock/mid{dir = 4},/obj/effect/turf_decal/sand/plating,/turf/open/floor/plating/rust/lowpressure,/area/rockplanet/surface/outdoors)
"x" = (/obj/structure/fluff/abandoned/cinderblock/end{dir = 4},/obj/effect/turf_decal/sand/plating,/turf/open/floor/plating/rust/lowpressure,/area/rockplanet/surface/outdoors)
"y" = (/obj/effect/turf_decal/sand/plating,/turf/open/floor/plating/lowpressure,/area/rockplanet/surface/outdoors)
"z" = (/obj/effect/turf_decal/skyrat_decals/street/full/end{dir = 4},/obj/effect/turf_decal/sand/plating,/turf/open/floor/plating/lowpressure,/area/rockplanet/surface/outdoors)
"C" = (/obj/structure/fluff/abandoned/cinderblock/end,/obj/effect/turf_decal/sand/plating,/turf/open/floor/iron/large/lowpressure,/area/rockplanet/surface/outdoors)
"H" = (/obj/structure/fluff/abandoned/cinderblock/end{dir = 1},/obj/effect/turf_decal/sand/plating,/turf/open/floor/iron/large/lowpressure,/area/rockplanet/surface/outdoors)
"I" = (/obj/effect/turf_decal/skyrat_decals/street/dashed/end,/obj/effect/turf_decal/sand/plating,/turf/open/floor/plating/lowpressure,/area/rockplanet/surface/outdoors)
"L" = (/obj/structure/chair/sofa/bench/right,/obj/effect/turf_decal/sand/plating,/turf/open/floor/iron/large/lowpressure,/area/rockplanet/surface/outdoors)
"M" = (/obj/effect/turf_decal/skyrat_decals/street/full/end{dir = 1},/obj/effect/turf_decal/sand/plating,/turf/open/floor/plating/lowpressure,/area/rockplanet/surface/outdoors)
"N" = (/obj/structure/fluff/abandoned/cinderblock,/obj/effect/turf_decal/sand/plating,/turf/open/floor/plating/rust/lowpressure,/area/rockplanet/surface/outdoors)
"O" = (/obj/structure/chair/sofa/bench/left{dir = 8},/obj/effect/turf_decal/sand/plating,/turf/open/floor/iron/large/lowpressure,/area/rockplanet/surface/outdoors)
"P" = (/obj/effect/turf_decal/sand/plating,/turf/open/floor/iron/large/lowpressure,/area/rockplanet/surface/outdoors)
"Q" = (/obj/structure/fluff/abandoned/cinderblock{dir = 4},/obj/effect/turf_decal/sand/plating,/turf/open/floor/plating/rust/lowpressure,/area/rockplanet/surface/outdoors)
"R" = (/obj/structure/fluff/abandoned/cinderblock{dir = 4},/obj/effect/turf_decal/sand/plating,/turf/open/floor/iron/large/lowpressure,/area/rockplanet/surface/outdoors)
"S" = (/obj/effect/turf_decal/skyrat_decals/street/full/end{dir = 8},/obj/effect/turf_decal/sand/plating,/turf/open/floor/plating/lowpressure,/area/rockplanet/surface/outdoors)
"U" = (/obj/effect/turf_decal/skyrat_decals/street/dashed,/obj/effect/turf_decal/sand/plating,/turf/open/floor/plating/lowpressure,/area/rockplanet/surface/outdoors)
"V" = (/obj/structure/water_source/puddle,/obj/effect/turf_decal/sand/plating,/turf/open/floor/iron/large/lowpressure,/area/rockplanet/surface/outdoors)
"W" = (/obj/effect/turf_decal/sand/plating,/turf/open/floor/iron/dark/smooth_large/lowpressure,/area/rockplanet/surface/outdoors)
"X" = (/obj/structure/chair/sofa/bench{dir = 8},/obj/effect/turf_decal/sand/plating,/turf/open/floor/iron/large/lowpressure,/area/rockplanet/surface/outdoors)
"Y" = (/obj/structure/chair/sofa/bench,/obj/effect/turf_decal/sand/plating,/turf/open/floor/iron/large/lowpressure,/area/rockplanet/surface/outdoors)
"Z" = (/obj/effect/turf_decal/skyrat_decals/street/dashed/end{dir = 1},/obj/effect/turf_decal/sand/plating,/turf/open/floor/iron/dark/smooth_large/lowpressure,/area/rockplanet/surface/outdoors)

(1,1,1) = {"
aaaaaPaaaaa
aPWIycPPhaa
aPWeWyWWyya
aiWmWSuuzaa
awyUWWyWWaa
axyZWPNhCHa
aPWMyPLYsaa
aaWlWhPVXPa
aaWjyQhhOaa
ahWjyQPaaaa
aRWjyPPaaaa
aPaqyPaaaaa
aaaaaaaaaaa
"}
