"a" = (/turf/template_noop,/area/template_noop)
"c" = (/obj/structure/girder,/turf/open/floor/plating/rust/lowpressure,/area/ruin/unpowered)
"d" = (/obj/machinery/door/poddoor/shutters/preopen,/obj/effect/turf_decal/sand/plating,/turf/open/floor/plating/rust/lowpressure,/area/ruin/unpowered)
"e" = (/obj/effect/turf_decal/sand/plating,/turf/open/floor/iron/dark/smooth_large/lowpressure,/area/rockplanet/surface/outdoors)
"f" = (/obj/effect/turf_decal/sand/plating,/obj/structure/fluff/abandoned/piping{pixel_y = 18},/turf/open/floor/iron/white{initial_gas_mix = "o2=14;n2=30;TEMP=293.15"},/area/ruin/unpowered)
"g" = (/obj/structure/rack/shelf,/obj/item/storage/toolbox/mechanical/old,/obj/effect/turf_decal/sand/plating,/turf/open/floor/iron/white{initial_gas_mix = "o2=14;n2=30;TEMP=293.15"},/area/ruin/unpowered)
"h" = (/obj/effect/turf_decal/skyrat_decals/street/dashed,/obj/effect/turf_decal/sand/plating,/turf/open/floor/iron/dark/smooth_large/lowpressure,/area/rockplanet/surface/outdoors)
"i" = (/turf/closed/wall/rust,/area/ruin/unpowered)
"j" = (/turf/open/floor/plating/asteroid/lowpressure,/area/rockplanet/surface/outdoors)
"k" = (/obj/structure/girder,/obj/effect/turf_decal/sand/plating,/turf/open/floor/plating/rust/lowpressure,/area/ruin/unpowered)
"l" = (/obj/effect/spawner/lootdrop/gross_decal_spawner,/obj/effect/turf_decal/sand/plating,/turf/open/floor/iron/white{initial_gas_mix = "o2=14;n2=30;TEMP=293.15"},/area/ruin/unpowered)
"n" = (/obj/item/rack_parts,/obj/effect/turf_decal/sand/plating,/turf/open/floor/plating/rust/lowpressure,/area/ruin/unpowered)
"o" = (/obj/structure/rack/shelf,/turf/open/floor/plating/rust/lowpressure,/area/ruin/unpowered)
"p" = (/obj/effect/turf_decal/sand/plating,/turf/open/floor/plating/lowpressure,/area/rockplanet/surface/outdoors)
"q" = (/turf/open/floor/iron/white{initial_gas_mix = "o2=14;n2=30;TEMP=293.15"},/area/ruin/unpowered)
"s" = (/obj/machinery/door/airlock/public/glass,/obj/effect/turf_decal/sand/plating,/turf/open/floor/iron/white{initial_gas_mix = "o2=14;n2=30;TEMP=293.15"},/area/ruin/unpowered)
"t" = (/obj/structure/table_frame,/obj/effect/turf_decal/sand/plating,/turf/open/floor/plating/rust/lowpressure,/area/ruin/unpowered)
"v" = (/obj/effect/turf_decal/skyrat_decals/street/dashed,/obj/effect/turf_decal/skyrat_decals/street/manhole,/obj/effect/turf_decal/sand/plating,/turf/open/floor/plating/lowpressure,/area/rockplanet/surface/outdoors)
"w" = (/obj/effect/turf_decal/sand/plating,/obj/effect/decal/cleanable/cobweb/cobweb2,/obj/structure/fluff/abandoned/radiator/worn{dir = 8},/turf/open/floor/plating/rust/lowpressure,/area/ruin/unpowered)
"x" = (/obj/effect/turf_decal/sand/plating,/obj/structure/fluff/abandoned/tire,/turf/open/floor/iron/dark/smooth_large/lowpressure,/area/ruin/unpowered)
"y" = (/turf/open/floor/plating/rust/lowpressure,/area/ruin/unpowered)
"z" = (/obj/effect/turf_decal/skyrat_decals/street/full,/obj/effect/turf_decal/sand/plating,/turf/open/floor/iron/dark/smooth_large/lowpressure,/area/rockplanet/surface/outdoors)
"B" = (/obj/structure/light_construct/directional/west,/obj/effect/turf_decal/sand/plating,/turf/open/floor/iron/white{initial_gas_mix = "o2=14;n2=30;TEMP=293.15"},/area/ruin/unpowered)
"C" = (/obj/structure/flora/ausbushes/palebush,/turf/open/floor/plating/asteroid/lowpressure,/area/rockplanet/surface/outdoors)
"D" = (/obj/effect/turf_decal/sand/plating,/obj/structure/fluff/abandoned/tire,/turf/open/floor/plating/rust/lowpressure,/area/ruin/unpowered)
"E" = (/obj/effect/turf_decal/sand/plating,/turf/open/floor/iron/dark/smooth_large/lowpressure,/area/ruin/unpowered)
"F" = (/obj/effect/turf_decal/sand/plating,/turf/open/floor/iron/white{initial_gas_mix = "o2=14;n2=30;TEMP=293.15"},/area/ruin/unpowered)
"G" = (/obj/effect/turf_decal/sand/plating,/obj/structure/fluff/abandoned/tire,/turf/open/floor/iron/large/lowpressure,/area/rockplanet/surface/outdoors)
"H" = (/obj/machinery/door/poddoor/shutters/preopen,/obj/effect/turf_decal/sand/plating,/turf/open/floor/engine{initial_gas_mix = "o2=14;n2=30;TEMP=293.15"},/area/ruin/unpowered)
"J" = (/obj/effect/turf_decal/skyrat_decals/street/full,/obj/effect/turf_decal/sand/plating,/turf/open/floor/plating/lowpressure,/area/rockplanet/surface/outdoors)
"L" = (/obj/structure/flippedtable,/obj/item/coin/iron,/obj/item/coin/iron,/obj/effect/spawner/lootdrop/space/cashmoney,/obj/effect/turf_decal/sand/plating,/obj/structure/fluff/abandoned/terminal/old{dir = 1},/turf/open/floor/plating/rust/lowpressure,/area/ruin/unpowered)
"M" = (/obj/effect/turf_decal/sand/plating,/turf/open/floor/iron/large/lowpressure,/area/rockplanet/surface/outdoors)
"N" = (/obj/effect/turf_decal/sand/plating,/turf/open/floor/plating/rust/lowpressure,/area/rockplanet/surface/outdoors)
"O" = (/obj/effect/turf_decal/sand/plating,/turf/open/floor/plating/rust/lowpressure,/area/ruin/unpowered)
"P" = (/obj/effect/turf_decal/sand/plating,/turf/open/floor/engine{initial_gas_mix = "o2=14;n2=30;TEMP=293.15"},/area/ruin/unpowered)
"Q" = (/obj/structure/frame/computer,/obj/effect/turf_decal/sand/plating,/turf/open/floor/iron/large/lowpressure,/area/ruin/unpowered)
"R" = (/obj/machinery/light/built/directional/west,/turf/open/floor/engine{initial_gas_mix = "o2=14;n2=30;TEMP=293.15"},/area/ruin/unpowered)
"S" = (/turf/open/floor/plating/asteroid/lowpressure,/area/ruin/unpowered)
"T" = (/obj/effect/turf_decal/sand/plating,/turf/open/floor/plating/lowpressure,/area/ruin/unpowered)
"U" = (/obj/effect/spawner/lootdrop/gross_decal_spawner,/turf/open/floor/plating/rust/lowpressure,/area/ruin/unpowered)
"V" = (/obj/structure/frame/machine,/obj/effect/turf_decal/sand/plating,/turf/open/floor/iron/large/lowpressure,/area/ruin/unpowered)
"W" = (/obj/effect/turf_decal/skyrat_decals/street/full/end{dir = 1},/obj/effect/turf_decal/sand/plating,/turf/open/floor/iron/dark/smooth_large/lowpressure,/area/rockplanet/surface/outdoors)
"Y" = (/obj/effect/turf_decal/skyrat_decals/street/full/end,/obj/effect/turf_decal/sand/plating,/turf/open/floor/plating/lowpressure,/area/rockplanet/surface/outdoors)
"Z" = (/obj/structure/grille,/obj/effect/turf_decal/sand/plating,/turf/open/floor/plating/rust/lowpressure,/area/ruin/unpowered)

(1,1,1) = {"
aaaaaaaaaaaa
aiVQSiNaWaNa
aExTTEMphpNa
aSESEEeevpNa
aSTSSEeeheaa
aETTEEGpheMa
aiikiiMpzeMa
akPODHephaaa
aiRPPdephpaa
aiqUgiMeheMa
akyiciMeJeGa
aiyfwiNezeaa
aiBtLZMezeNa
aklOOZMpJeaa
akoOFsCpzeaa
aioFniNezaaa
aiikikjaYaaa
aaaaaaaaaaaa
"}
