"a" = (/turf/open/floor/plating/asteroid/lowpressure,/area/space)
"b" = (/turf/open/floor/iron/stairs{dir = 8},/area/space)
"d" = (/obj/machinery/newscaster/directional/north,/turf/open/floor/plating/cobblestone,/area/space)
"e" = (/obj/structure/chair/sofa/corp/right{dir = 4},/turf/open/floor/plating/cobblestone,/area/space)
"f" = (/obj/machinery/newscaster/directional/south,/turf/open/floor/plating/cobblestone,/area/space)
"g" = (/obj/structure/chair/comfy/corporate{dir = 4},/turf/open/floor/plating/cobblestone,/area/space)
"h" = (/obj/structure/chair/sofa/corp/left{dir = 4},/turf/open/floor/plating/cobblestone,/area/space)
"i" = (/obj/structure/sign/warning/electricshock{pixel_x = -32},/turf/open/floor/plating/asteroid/lowpressure,/area/space)
"j" = (/obj/structure/table/greyscale,/turf/open/floor/plating/cobblestone,/area/space)
"k" = (/obj/structure/chair/comfy/corporate,/turf/open/floor/plating/cobblestone,/area/space)
"l" = (/obj/structure/chair/sofa/corp/left{dir = 8},/turf/open/floor/plating/cobblestone,/area/space)
"n" = (/obj/structure/table/greyscale,/obj/machinery/light/directional/east,/turf/open/floor/plating/cobblestone,/area/space)
"o" = (/obj/structure/chair/sofa/corp/right{dir = 1},/turf/open/floor/plating/cobblestone,/area/space)
"q" = (/obj/item/wallframe/apc,/turf/open/floor/plating/cobblestone,/area/space)
"r" = (/obj/structure/chair/sofa/corp/left{dir = 1},/turf/open/floor/plating/cobblestone,/area/space)
"t" = (/obj/structure/chair/sofa/corp/right{dir = 8},/turf/open/floor/plating/cobblestone,/area/space)
"v" = (/obj/machinery/newscaster,/turf/closed/wall/mineral/sandstone,/area/space)
"w" = (/obj/machinery/door/airlock/hatch,/turf/open/floor/plating/cobblestone,/area/space)
"x" = (/obj/structure/table/greyscale,/obj/machinery/light/directional/north,/turf/open/floor/plating/cobblestone,/area/space)
"y" = (/obj/structure/chair/sofa/corp/right,/turf/open/floor/plating/cobblestone,/area/space)
"z" = (/obj/machinery/scanner_gate,/turf/open/floor/plating/cobblestone,/area/space)
"A" = (/obj/structure/table/greyscale,/obj/machinery/chem_dispenser/drinks/fullupgrade,/turf/open/floor/plating/cobblestone,/area/space)
"C" = (/obj/structure/curtain/bounty,/turf/open/floor/plating/cobblestone,/area/space)
"D" = (/obj/structure/closet/secure_closet/engineering_electrical,/turf/open/floor/plating/cobblestone,/area/space)
"E" = (/obj/item/kirbyplants{icon_state = "plant-09"},/turf/open/floor/plating/cobblestone,/area/space)
"H" = (/obj/structure/table/greyscale,/obj/machinery/light/directional/south,/turf/open/floor/plating/cobblestone,/area/space)
"I" = (/obj/machinery/holopad,/turf/open/floor/plating/cobblestone,/area/space)
"J" = (/obj/machinery/holopad,/obj/machinery/light/directional/north,/turf/open/floor/plating/cobblestone,/area/space)
"K" = (/obj/structure/table/greyscale,/obj/machinery/light/directional/west,/turf/open/floor/plating/cobblestone,/area/space)
"L" = (/obj/machinery/light/directional/west,/obj/structure/table/greyscale,/obj/machinery/chem_dispenser/drinks/beer/fullupgrade,/turf/open/floor/plating/cobblestone,/area/space)
"N" = (/obj/structure/sign/barsign{icon_state = "cantina"; pixel_y = -5},/turf/closed/wall/mineral/sandstone,/area/space)
"O" = (/obj/structure/chair/sofa/corp/left,/turf/open/floor/plating/cobblestone,/area/space)
"P" = (/obj/machinery/light/directional/east,/turf/open/floor/plating/cobblestone,/area/space)
"Q" = (/turf/open/floor/plating/cobblestone,/area/space)
"R" = (/obj/structure/chair/comfy/corporate{dir = 8},/turf/open/floor/plating/cobblestone,/area/space)
"T" = (/obj/machinery/door/airlock/hatch,/turf/open/floor/plating/asteroid/lowpressure,/area/space)
"W" = (/turf/closed/wall/mineral/sandstone,/area/space)
"Y" = (/obj/machinery/vending/boozeomat/all_access,/turf/closed/wall/mineral/sandstone,/area/space)

(1,1,1) = {"
aaaaaaaaaaaaaaaaaaaaaaaaaaaaaa
aaaaaaaaaaaaaaaaaaaaaaaaaaaaaa
aaWWWWWWWWWWWWWWWWWWWaaaaaaaaa
aWWQWhxtWIJIWhxtWhxQWWaaaaaNWa
aWQQWejlWQQQWejlWejQEWWaaaaaaa
aWQPWQQQQQQQQQQQQQQQQQWaaaaaaa
aWQQwQQQQQQQQQQQQQQQjnWWWWaaaa
aWQQWQQQfQQQQQQQQQQQorWqkvWaaa
aWwWWWwWWKjjjjjQQQQPWWWQQRWaaa
aaaWQQQQCQQQQQQjQQQQbzQQQQWaaa
aaaWKjQQYLAjjQQjQQQQbzQQQPWaaa
aaaWQQQQCQQQQQQjQQQQbzQQQQwaaa
aaaWWWWWWKjjjjjQQQQPWWWQQWWaaa
aaaWgxRQdQQQQQQQQQQQyOWWWWaaaa
aaaWQQQQQQQQQQQQQQQQjnWQQWWaaa
aaaWEQQWWQQQQQQQQQQQQQWQQQTaaa
aaaWWQQQWhjtWhjtWhjQEWWQQDWiaa
aaaaWWHRWeHlWeHlWeHQWWWWWWWaaa
aaaaaWWWWWWWWWWWWWWWWaaaaaaaaa
aaaaaaaaaaaaaaaaaaaaaaaaaaaaaa
aaaaaaaaaaaaaaaaaaaaaaaaaaaaaa
"}
