"ab" = (/obj/effect/turf_decal/siding/wideplating/dark/corner,/turf/open/floor/iron/grimy,/area/ruin/powered/cantina)
"aO" = (/obj/machinery/atmospherics/pipe/smart/manifold4w/supply/hidden/layer4{dir = 4},/obj/machinery/airalarm/away{pixel_y = 18},/obj/machinery/atmospherics/pipe/smart/manifold4w/scrubbers/hidden/layer2{dir = 8},/turf/open/floor/iron/dark/textured,/area/ruin/powered/cantina)
"aX" = (/obj/machinery/atmospherics/components/unary/vent_scrubber/on/layer2{dir = 1},/turf/open/floor/iron/dark/textured,/area/ruin/powered/cantina)
"bc" = (/obj/machinery/door/airlock/hatch,/obj/structure/fans/tiny,/turf/open/floor/iron/dark/textured_edge{dir = 4},/area/ruin/powered/cantina)
"bB" = (/obj/machinery/atmospherics/components/unary/vent_pump/on/layer4{dir = 4},/obj/structure/sink/kitchen{pixel_y = 17},/obj/item/reagent_containers/glass/bucket/wooden,/turf/open/floor/iron/grimy,/area/ruin/powered/cantina)
"cd" = (/obj/machinery/atmospherics/pipe/smart/manifold4w/scrubbers/hidden/layer2{dir = 8},/turf/closed/wall/mineral/sandstone,/area/ruin/powered/cantina)
"df" = (/obj/machinery/atmospherics/components/unary/vent_scrubber/on/layer2{dir = 8},/obj/machinery/airalarm/away{pixel_y = 18},/turf/open/floor/iron/grimy,/area/ruin/powered/cantina)
"dL" = (/obj/machinery/light/directional/east,/obj/machinery/atmospherics/components/unary/vent_scrubber/on/layer2,/turf/open/floor/iron/grimy,/area/ruin/powered/cantina)
"eu" = (/obj/machinery/vending/boozeomat/all_access,/turf/open/floor/iron/grimy,/area/ruin/powered/cantina)
"eB" = (/obj/structure/table/greyscale,/obj/machinery/light/directional/west,/turf/open/floor/iron/grimy,/area/ruin/powered/cantina)
"fl" = (/obj/structure/chair/sofa/corp/left{dir = 8},/turf/open/floor/iron/grimy,/area/ruin/powered/cantina)
"gD" = (/obj/structure/table/greyscale,/obj/machinery/light/directional/south,/turf/open/floor/iron/grimy,/area/ruin/powered/cantina)
"gW" = (/obj/effect/turf_decal/siding/wideplating/dark,/obj/machinery/atmospherics/components/unary/vent_scrubber/on/layer2{dir = 1},/turf/open/floor/iron/grimy,/area/ruin/powered/cantina)
"hK" = (/obj/machinery/atmospherics/components/unary/vent_pump/on/layer4{dir = 4},/turf/open/floor/iron/grimy,/area/ruin/powered/cantina)
"jh" = (/obj/machinery/atmospherics/components/unary/vent_scrubber/on/layer2,/turf/open/floor/iron/grimy,/area/ruin/powered/cantina)
"jx" = (/obj/machinery/door/airlock/hatch,/obj/machinery/atmospherics/pipe/smart/manifold4w/scrubbers/hidden/layer2{dir = 8},/obj/machinery/atmospherics/pipe/smart/manifold4w/supply/hidden/layer4{dir = 4},/turf/open/floor/iron/grimy,/area/ruin/powered/cantina)
"jK" = (/obj/structure/chair/comfy/corporate,/turf/open/floor/iron/grimy,/area/ruin/powered/cantina)
"ke" = (/obj/machinery/atmospherics/pipe/smart/manifold4w/scrubbers/hidden/layer2{dir = 8},/obj/machinery/atmospherics/pipe/smart/manifold4w/supply/hidden/layer4{dir = 4},/turf/closed/wall/mineral/sandstone,/area/ruin/powered/cantina)
"la" = (/turf/open/floor/iron/dark/smooth_corner,/area/ruin/powered/cantina)
"ln" = (/obj/structure/curtain/bounty,/turf/open/floor/iron/grimy,/area/ruin/powered/cantina)
"lo" = (/obj/structure/table/greyscale,/obj/machinery/light/directional/west,/obj/item/reagent_containers/hash{desc = "Concentrated spices. Delivers a much better high when used in a bong."; name = "spice"; pixel_x = -3; pixel_y = 2},/obj/item/reagent_containers/hash/dabs{desc = "Spice extracted from rare asteroids. Like cannabis, but more valuable."; name = "dab of spice"; pixel_x = 7},/obj/item/reagent_containers/hash{desc = "Concentrated spices. Delivers a much better high when used in a bong."; name = "spice"},/obj/item/reagent_containers/hash{desc = "Concentrated spices. Delivers a much better high when used in a bong."; name = "spice"; pixel_x = 7; pixel_y = 10},/turf/open/floor/iron/grimy,/area/ruin/powered/cantina)
"lT" = (/obj/structure/closet/secure_closet/engineering_electrical,/turf/open/floor/iron/dark/textured,/area/ruin/powered/cantina)
"nh" = (/obj/structure/chair/sofa/corp/left{dir = 1},/turf/open/floor/iron/grimy,/area/ruin/powered/cantina)
"nO" = (/obj/structure/railing,/turf/open/floor/iron/dark/smooth_corner{dir = 4},/area/ruin/powered/cantina)
"nT" = (/obj/machinery/button/door/directional/south{id = "cantina_backdoor"; name = "Bolt Control"; normaldoorcontrol = 1; specialfunctions = 4},/obj/machinery/atmospherics/components/unary/vent_pump/on/layer4{dir = 1},/turf/open/floor/iron/grimy,/area/ruin/powered/cantina)
"nZ" = (/obj/machinery/atmospherics/pipe/smart/manifold4w/scrubbers/hidden/layer2{dir = 8},/obj/machinery/atmospherics/pipe/smart/manifold4w/supply/hidden/layer4{dir = 4},/turf/open/floor/iron/dark/textured,/area/ruin/powered/cantina)
"oI" = (/obj/structure/table/greyscale,/obj/item/bong{color = "#f57048"; pixel_x = -5; pixel_y = 5},/obj/item/bong,/turf/open/floor/iron/grimy,/area/ruin/powered/cantina)
"oV" = (/obj/structure/decorative/fluff/holo_band,/obj/structure/decorative/fluff/holo_band/member/c,/turf/open/floor/iron/dark/smooth_large,/area/ruin/powered/cantina)
"sn" = (/obj/structure/sign/warning/electricshock{pixel_x = -32},/turf/open/floor/plating/asteroid/lowpressure,/area/rockplanet/surface/outdoors)
"sN" = (/obj/machinery/atmospherics/components/unary/vent_pump/on/layer4{dir = 1},/turf/open/floor/iron/grimy,/area/ruin/powered/cantina)
"tz" = (/turf/closed/wall/mineral/sandstone,/area/ruin/powered/cantina)
"tV" = (/obj/structure/table/greyscale,/turf/open/floor/iron/dark/textured,/area/ruin/powered/cantina)
"vA" = (/obj/machinery/atmospherics/components/unary/vent_pump/on/layer4,/obj/effect/turf_decal/siding/wideplating/dark/corner{dir = 4},/turf/open/floor/iron/grimy,/area/ruin/powered/cantina)
"xx" = (/obj/structure/table/greyscale,/obj/machinery/light/directional/north,/turf/open/floor/iron/grimy,/area/ruin/powered/cantina)
"ye" = (/obj/machinery/atmospherics/pipe/smart/manifold4w/supply/hidden/layer4{dir = 4},/obj/machinery/atmospherics/components/unary/vent_scrubber/on/layer2{dir = 4},/turf/open/floor/iron/grimy,/area/ruin/powered/cantina)
"yt" = (/obj/machinery/atmospherics/components/unary/vent_scrubber/on/layer2{dir = 1},/turf/open/floor/iron/grimy,/area/ruin/powered/cantina)
"yw" = (/obj/structure/table/greyscale,/turf/open/floor/iron/grimy,/area/ruin/powered/cantina)
"zB" = (/obj/effect/turf_decal/siding/wideplating/dark,/obj/machinery/atmospherics/pipe/smart/manifold4w/scrubbers/hidden/layer2{dir = 8},/obj/machinery/atmospherics/pipe/smart/manifold4w/supply/hidden/layer4{dir = 4},/turf/open/floor/iron/grimy,/area/ruin/powered/cantina)
"zK" = (/obj/machinery/atmospherics/components/unary/outlet_injector/layer2{dir = 1},/turf/open/floor/plating/asteroid/lowpressure,/area/ruin/powered/cantina)
"Ac" = (/obj/structure/railing,/turf/open/floor/iron/dark/smooth_half,/area/ruin/powered/cantina)
"Av" = (/obj/machinery/atmospherics/pipe/smart/manifold4w/scrubbers/hidden/layer2{dir = 8},/turf/open/floor/iron/dark/textured,/area/ruin/powered/cantina)
"AW" = (/obj/machinery/hydroponics,/obj/item/seeds/cannabis{desc = "Wait a minute, spice isnt grown... this place is a sham!"},/obj/item/reagent_containers/glass/bottle/saltpetre,/turf/open/floor/iron/grimy,/area/ruin/powered/cantina)
"Bi" = (/obj/machinery/atmospherics/components/unary/vent_pump/on/layer4,/turf/open/floor/iron/grimy,/area/ruin/powered/cantina)
"Bq" = (/obj/structure/fluff/abandoned/breaker{pixel_y = 31},/turf/open/floor/iron/grimy,/area/ruin/powered/cantina)
"Bv" = (/obj/structure/table/greyscale,/obj/item/reagent_containers/hashbrick,/obj/item/reagent_containers/hashbrick{desc = "A brick of spice. Good for transport!"; name = "spice brick"; pixel_y = 9},/obj/item/reagent_containers/hash/dabs{desc = "Spice extracted from rare asteroids. Like cannabis, but more valuable."; name = "dab of spice"; pixel_x = 4; pixel_y = 3},/turf/open/floor/iron/grimy,/area/ruin/powered/cantina)
"BE" = (/obj/structure/decorative/shelf/crates,/turf/open/floor/iron/grimy,/area/ruin/powered/cantina)
"Cw" = (/obj/item/kirbyplants{icon_state = "plant-09"},/turf/open/floor/iron/grimy,/area/ruin/powered/cantina)
"CL" = (/turf/open/floor/iron/stairs{dir = 8},/area/ruin/powered/cantina)
"CT" = (/obj/machinery/atmospherics/components/unary/portables_connector/visible/layer4{dir = 4},/obj/machinery/portable_atmospherics/canister/air{anchored = 1},/turf/open/floor/iron/dark/textured,/area/ruin/powered/cantina)
"De" = (/obj/effect/turf_decal/siding/wideplating/dark{dir = 1},/turf/open/floor/iron/grimy,/area/ruin/powered/cantina)
"Dj" = (/obj/machinery/light/directional/north,/obj/structure/decorative/fluff/holo_band,/obj/structure/decorative/fluff/holo_band/member/b,/turf/open/floor/iron/dark/smooth_large,/area/ruin/powered/cantina)
"Ek" = (/turf/open/floor/plating/asteroid/lowpressure,/area/rockplanet/surface/outdoors)
"FW" = (/obj/structure/table/greyscale,/obj/machinery/light/directional/east,/turf/open/floor/iron/grimy,/area/ruin/powered/cantina)
"FY" = (/obj/machinery/atmospherics/components/unary/vent_pump/on/layer4{dir = 1},/obj/machinery/atmospherics/pipe/smart/manifold4w/scrubbers/hidden/layer2{dir = 8},/turf/open/floor/iron/dark/textured,/area/ruin/powered/cantina)
"Gs" = (/obj/machinery/quantumpad{panel_open = 1; state_open = 1},/turf/open/floor/iron/dark/smooth_half,/area/ruin/powered/cantina)
"Gu" = (/obj/machinery/computer/security/telescreen/entertainment/directional/north,/obj/structure/curtain/bounty,/turf/open/floor/iron/grimy,/area/ruin/powered/cantina)
"Gz" = (/obj/structure/chair/sofa/corp/right{dir = 4},/turf/open/floor/iron/grimy,/area/ruin/powered/cantina)
"Hk" = (/obj/structure/table/greyscale,/obj/machinery/light/directional/south,/obj/item/bong{color = "#f57048"},/obj/item/reagent_containers/hash{desc = "Concentrated spices. Delivers a much better high when used in a bong."; name = "spice"},/obj/item/reagent_containers/hash{desc = "Concentrated spices. Delivers a much better high when used in a bong."; name = "spice"},/turf/open/floor/iron/grimy,/area/ruin/powered/cantina)
"HZ" = (/obj/structure/chair/sofa/corp/right{dir = 1},/turf/open/floor/iron/grimy,/area/ruin/powered/cantina)
"Ic" = (/obj/structure/closet/crate/hydroponics,/obj/item/seeds/cannabis{desc = "Wait a minute, spice isnt grown... this place is a sham!"},/obj/item/seeds/cannabis{desc = "Wait a minute, spice isnt grown... this place is a sham!"},/obj/item/seeds/cannabis{desc = "Wait a minute, spice isnt grown... this place is a sham!"},/obj/item/reagent_containers/glass/bottle/saltpetre,/obj/item/reagent_containers/glass/bottle/saltpetre,/obj/item/reagent_containers/glass/bottle/saltpetre,/turf/open/floor/iron/grimy,/area/ruin/powered/cantina)
"IQ" = (/obj/structure/railing,/turf/open/floor/iron/dark/smooth_corner{dir = 1},/area/ruin/powered/cantina)
"Jz" = (/obj/structure/chair/sofa/corp/right{dir = 8},/turf/open/floor/iron/grimy,/area/ruin/powered/cantina)
"JH" = (/obj/structure/chair/sofa/corp/left,/turf/open/floor/iron/grimy,/area/ruin/powered/cantina)
"Kp" = (/obj/structure/decorative/fluff/holo_band,/obj/structure/decorative/fluff/holo_band/member/a,/turf/open/floor/iron/dark/smooth_large,/area/ruin/powered/cantina)
"KV" = (/obj/machinery/door/airlock/hatch{id_tag = "cantina_backdoor"},/obj/effect/mapping_helpers/airlock/locked,/obj/structure/fans/tiny,/turf/open/floor/iron/grimy,/area/ruin/powered/cantina)
"Lm" = (/obj/structure/curtain/bounty,/obj/machinery/atmospherics/pipe/smart/manifold4w/scrubbers/hidden/layer2{dir = 8},/obj/machinery/atmospherics/pipe/smart/manifold4w/supply/hidden/layer4{dir = 4},/turf/open/floor/iron/grimy,/area/ruin/powered/cantina)
"LD" = (/obj/machinery/light/directional/west,/obj/structure/table/greyscale,/obj/machinery/chem_dispenser/drinks/beer/fullupgrade,/turf/open/floor/iron/grimy,/area/ruin/powered/cantina)
"LG" = (/obj/structure/table/greyscale,/obj/item/bong{color = "#ff8800"; pixel_x = -3; pixel_y = 8},/obj/item/bong{pixel_x = -4; pixel_y = 3},/obj/item/bong/lungbuster{color = "#d6a56d"; pixel_x = -10; pixel_y = 8},/obj/item/bong{color = "#f57048"},/turf/open/floor/iron/grimy,/area/ruin/powered/cantina)
"Mv" = (/obj/structure/table/greyscale,/turf/open/floor/light,/area/ruin/powered/cantina)
"NT" = (/obj/structure/chair/comfy/corporate{dir = 4},/turf/open/floor/iron/grimy,/area/ruin/powered/cantina)
"Ok" = (/obj/structure/table/greyscale,/obj/machinery/chem_dispenser/drinks/fullupgrade,/turf/open/floor/iron/grimy,/area/ruin/powered/cantina)
"Pi" = (/obj/machinery/atmospherics/pipe/smart/manifold4w/scrubbers/hidden/layer2{dir = 8},/obj/machinery/atmospherics/pipe/smart/manifold4w/supply/hidden/layer4{dir = 4},/obj/machinery/scanner_gate/no_droids_allowed,/turf/open/floor/iron/grimy,/area/ruin/powered/cantina)
"Pm" = (/obj/structure/chair/comfy/corporate{dir = 8},/turf/open/floor/iron/grimy,/area/ruin/powered/cantina)
"PD" = (/obj/structure/fluff/abandoned/radiator{pixel_y = 30},/turf/open/floor/iron/grimy,/area/ruin/powered/cantina)
"PH" = (/obj/effect/turf_decal/siding/wideplating/dark,/obj/machinery/atmospherics/components/unary/vent_pump/on/layer4{dir = 1},/turf/open/floor/iron/grimy,/area/ruin/powered/cantina)
"RW" = (/obj/structure/chair/sofa/corp/right,/turf/open/floor/iron/grimy,/area/ruin/powered/cantina)
"RY" = (/obj/structure/sign/barsign{icon_state = "cantina"; pixel_y = -5},/turf/closed/wall/mineral/sandstone,/area/ruin/powered/cantina)
"Sx" = (/obj/machinery/atmospherics/pipe/smart/manifold4w/scrubbers/hidden/layer2{dir = 8},/obj/machinery/atmospherics/pipe/smart/manifold4w/supply/hidden/layer4{dir = 4},/turf/open/floor/iron/grimy,/area/ruin/powered/cantina)
"SL" = (/obj/machinery/scanner_gate/no_droids_allowed,/turf/open/floor/iron/grimy,/area/ruin/powered/cantina)
"SS" = (/obj/machinery/atmospherics/pipe/smart/manifold4w/scrubbers/hidden/layer2{dir = 8},/obj/machinery/atmospherics/pipe/smart/manifold4w/supply/hidden/layer4{dir = 4},/turf/open/floor/iron/dark/smooth_corner{dir = 8},/area/ruin/powered/cantina)
"TB" = (/obj/machinery/computer/security/telescreen/entertainment/directional/south,/obj/machinery/atmospherics/components/unary/vent_scrubber/on/layer2{dir = 1},/turf/open/floor/iron/grimy,/area/ruin/powered/cantina)
"Uc" = (/obj/structure/table/greyscale,/obj/machinery/light/directional/north,/obj/item/bong{color = "#ff8800"},/obj/item/reagent_containers/hash/dabs{desc = "Spice extracted from rare asteroids. Like cannabis, but more valuable."; name = "dab of spice"},/obj/item/reagent_containers/hash/dabs{desc = "Spice extracted from rare asteroids. Like cannabis, but more valuable."; name = "dab of spice"},/obj/item/reagent_containers/hash{desc = "Concentrated spices. Delivers a much better high when used in a bong."; name = "spice"},/turf/open/floor/iron/grimy,/area/ruin/powered/cantina)
"VQ" = (/obj/machinery/door/airlock/hatch,/obj/structure/fans/tiny,/turf/open/floor/iron/grimy,/area/ruin/powered/cantina)
"VS" = (/obj/effect/turf_decal/siding/wideplating/dark/corner{dir = 8},/turf/open/floor/iron/grimy,/area/ruin/powered/cantina)
"Wb" = (/obj/structure/chair/sofa/corp/left{dir = 4},/turf/open/floor/iron/grimy,/area/ruin/powered/cantina)
"Wd" = (/obj/machinery/light/directional/east,/turf/open/floor/iron/grimy,/area/ruin/powered/cantina)
"Wt" = (/obj/machinery/atmospherics/pipe/smart/manifold4w/scrubbers/hidden/layer2{dir = 8},/obj/machinery/atmospherics/pipe/smart/manifold4w/supply/hidden/layer4{dir = 4},/turf/open/floor/iron/stairs{dir = 8},/area/ruin/powered/cantina)
"WA" = (/obj/machinery/atmospherics/components/unary/vent_pump/on/layer4,/obj/effect/turf_decal/siding/wideplating/dark/corner{dir = 1},/turf/open/floor/iron/grimy,/area/ruin/powered/cantina)
"XO" = (/turf/template_noop,/area/template_noop)
"XT" = (/turf/open/floor/iron/grimy,/area/ruin/powered/cantina)

(1,1,1) = {"
XOEkEkEkEkEkEkEkEkEkEkEkEkEkEkEkEkEkEkEkEkEkXOXOXOXOXOXOXOXO
EkEkEkEktzEkEkEktzEkEktzEkEktzEkEkEktzEkEkEkEkXOXOXOXOXOXOXO
EkEktztztztztztztztztztztztztztztztztztztzEkEkEkEkEkEkEkEkEk
EktztzBEtzWbxxJztzKpDjoVtzWbxxJztzWbxxXTtztzEkEkEkEkEkRYtzEk
EktzIcXTtzGzywfltznOAcIQtzGzywfltzGzywXTCwtztzEkEkEkEkEkEkEk
EktzXTdLtzXTXTXTvADeDeDeWAXTXTXTBiXTXTXTXTXTtzEkEkEkEkEkEkEk
EktzXTSxjxSxSxSxSxSxSxSxSxSxSxSxSxSxSxXTywFWtztztztztzEkEkEk
EktzXTnTtzXTSxXTTBXTXTXTytXTXTXTytXTSxXTHZnhtzBqPDjKtztzEkEk
EktzKVtztztzjxtztzeBywywywywywXTXTXTSxWdtztztzXTXTXTPmtzEkEk
EkEkEktzAWbBSxdflnXTXTXTXTXTXTMvXTXTSxXTCLSLXTXTXTXTXTtzEkEk
EkEkEktzloXTXTXTeuLDOkLGywXTXTMvXTXTSxSxWtPiSxSxSxSxWdtzEkEk
XOEkEktzBvoIXTXTlnXTXTXTXTXTXTMvXTXTSxXTCLSLabPHgWzBVSVQEkEk
XOEkEktztztztztztzeBywywywywywXTXTXTSxWdtztztzlaGsSStztzEkEk
XOEkEktzNTUcPmXTGuXTXTXTjhXTXTXTjhXTSxXTRWJHtztztzketzEkEkEk
XOEkEktzXThKyeSxLmSxSxSxSxSxSxSxSxSxSxXTywFWtzCTaOnZtzEkEkEk
XOEkEktzCwXTXTtztzXTXTXTsNXTXTXTsNXTXTXTXTXTtzAvFYaXbcEkEkXO
XOEkEktztzXTXTXTtzWbywJztzWbywJztzWbywXTCwtzcdcdtVlTtzsnEkXO
XOEkEkEktztzHkPmtzGzgDfltzGzgDfltzGzgDXTtztzzKtztztztzEkEkXO
XOXOEkEkEktztztztztztztztztztztztztztztztzEkEkEkEkEkEkEkEkXO
XOXOXOEkEkEkEktzEkEkEktzEkEktzEkEkEktzEkEkEkEkEkEkEkEkEkEkXO
XOXOXOXOEkEkEkEkEkEkEkEkEkEkEkEkEkEkEkEkEkEkXOXOXOXOXOXOXOXO
"}
