"ax" = (/turf/closed/wall/rust,/area/ruin/powered)
"ed" = (/obj/structure/fluff/abandoned/cinderblock/mid{dir = 4},/obj/effect/turf_decal/sand/plating,/turf/open/floor/plating/lowpressure,/area/rockplanet/surface/outdoors)
"fI" = (/turf/template_noop,/area/template_noop)
"fQ" = (/obj/effect/turf_decal/skyrat_decals/street/full/end{dir = 8},/obj/effect/turf_decal/sand/plating,/turf/open/floor/iron/dark/smooth_large/lowpressure,/area/rockplanet/surface/outdoors)
"gn" = (/obj/effect/turf_decal/sand/plating,/obj/structure/fluff/abandoned/blocker/worn,/turf/open/floor/plating/lowpressure,/area/rockplanet/surface/outdoors)
"hp" = (/obj/structure/fluff/abandoned/cinderblock/long{pixel_y = 4},/turf/open/floor/plating/asteroid/lowpressure,/area/rockplanet/surface/outdoors)
"hF" = (/obj/structure/fluff/abandoned/cinderblock/mid{dir = 4},/obj/structure/fluff/abandoned/parking/worn{pixel_x = 10},/turf/open/floor/plating/asteroid/lowpressure,/area/rockplanet/surface/outdoors)
"id" = (/obj/effect/turf_decal/sand/plating,/turf/open/floor/plating/rust/lowpressure,/area/rockplanet/surface/outdoors)
"in" = (/obj/structure/rack/shelf,/obj/item/storage/belt/utility/full/engi{pixel_y = -4},/obj/item/clothing/suit/hazardvest,/obj/item/clothing/suit/hazardvest,/obj/item/storage/belt/utility/full/engi{pixel_y = -2},/obj/item/clothing/suit/hazardvest,/obj/item/clothing/head/hardhat/orange,/obj/item/clothing/head/hardhat/orange,/obj/item/clothing/head/hardhat/orange,/obj/item/taperoll/engi,/turf/open/floor/plating/asteroid/lowpressure,/area/rockplanet/surface/outdoors)
"jG" = (/obj/effect/turf_decal/skyrat_decals/street/full/end{dir = 4},/obj/effect/turf_decal/sand/plating,/turf/open/floor/plating/lowpressure,/area/rockplanet/surface/outdoors)
"kn" = (/obj/effect/turf_decal/sand/plating,/obj/structure/fluff/abandoned/blocker/worn{dir = 4},/turf/open/floor/plating/lowpressure,/area/rockplanet/surface/outdoors)
"lK" = (/obj/effect/turf_decal/sand/plating,/obj/item/stack/sheet/sandblock/twenty,/turf/open/floor/plating/rust/lowpressure,/area/ruin/powered)
"ms" = (/obj/structure/fluff/abandoned/tire,/turf/open/floor/plating/asteroid/lowpressure,/area/rockplanet/surface/outdoors)
"mx" = (/obj/structure/girder,/obj/effect/turf_decal/sand/plating,/turf/open/floor/plating/rust/lowpressure,/area/ruin/powered)
"nx" = (/obj/structure/fluff/abandoned/cinderblock/large{dir = 4},/turf/open/floor/plating/asteroid/lowpressure,/area/ruin/powered)
"nU" = (/obj/structure/fluff/abandoned/cinderblock/tall{pixel_y = 4},/turf/open/floor/plating/asteroid/lowpressure,/area/rockplanet/surface/outdoors)
"nZ" = (/obj/structure/girder,/turf/open/floor/plating/rust/lowpressure,/area/ruin/powered)
"om" = (/obj/structure/fluff/abandoned/cinderblock/tube{dir = 4},/turf/open/floor/iron/large/lowpressure,/area/ruin/powered)
"pk" = (/obj/structure/fluff/abandoned/cinderblock/end{dir = 8},/obj/effect/turf_decal/sand/plating,/turf/open/floor/plating/lowpressure,/area/rockplanet/surface/outdoors)
"ps" = (/turf/closed/wall,/area/ruin/powered)
"qf" = (/obj/effect/turf_decal/skyrat_decals/street/full/end{dir = 8},/obj/effect/turf_decal/sand/plating,/turf/open/floor/plating/lowpressure,/area/rockplanet/surface/outdoors)
"rH" = (/obj/effect/turf_decal/skyrat_decals/street/full/horizontal,/obj/effect/turf_decal/sand/plating,/turf/open/floor/iron/dark/smooth_large/lowpressure,/area/rockplanet/surface/outdoors)
"rI" = (/obj/effect/turf_decal/sand/plating,/turf/open/floor/iron/large/lowpressure,/area/ruin/powered)
"rW" = (/obj/structure/fluff/abandoned/cinderblock/large,/turf/open/floor/plating/rust/lowpressure,/area/ruin/powered)
"uq" = (/obj/item/storage/belt/utility/full/powertools,/obj/effect/mob_spawn/human/skeleton,/obj/item/clothing/under/rank/engineering/engineer/hazard,/obj/item/clothing/suit/hazardvest,/obj/item/clothing/head/hardhat/orange,/obj/structure/closet/crate/abandoned/wooden,/turf/open/floor/iron/large/lowpressure,/area/ruin/powered)
"uJ" = (/turf/open/floor/plating/asteroid/lowpressure,/area/ruin/powered)
"wH" = (/obj/structure/fluff/abandoned/cinderblock/tube/middle,/turf/open/floor/plating/rust/lowpressure,/area/ruin/powered)
"wJ" = (/obj/structure/fluff/abandoned/cinderblock/mid{dir = 4},/turf/open/floor/plating/asteroid/lowpressure,/area/rockplanet/surface/outdoors)
"wK" = (/obj/structure/fluff/abandoned/cinderblock/long,/turf/open/floor/plating/asteroid/lowpressure,/area/rockplanet/surface/outdoors)
"xj" = (/obj/effect/turf_decal/sand/plating,/obj/item/stack/sheet/iron/twenty,/obj/structure/closet/crate/abandoned/wooden/loot,/turf/open/floor/iron/large/lowpressure,/area/ruin/powered)
"xD" = (/turf/open/floor/plating/rust/lowpressure,/area/ruin/powered)
"xR" = (/obj/effect/turf_decal/sand/plating,/turf/open/floor/iron/dark/smooth_large/lowpressure,/area/rockplanet/surface/outdoors)
"yS" = (/obj/structure/fluff/abandoned/cinderblock/large,/obj/effect/turf_decal/sand/plating,/turf/open/floor/plating/rust/lowpressure,/area/ruin/powered)
"zW" = (/obj/effect/turf_decal/sand/plating,/turf/open/floor/iron/large/lowpressure,/area/rockplanet/surface/outdoors)
"As" = (/obj/structure/fluff/abandoned/cinderblock/tall{pixel_x = -12},/turf/open/floor/plating/asteroid/lowpressure,/area/rockplanet/surface/outdoors)
"Bh" = (/obj/structure/fluff/abandoned/cinderblock{dir = 4},/turf/open/floor/iron/large/lowpressure,/area/ruin/powered)
"BB" = (/mob/living/simple_animal/hostile/zombie,/turf/open/floor/iron/large/lowpressure,/area/ruin/powered)
"Ce" = (/obj/effect/turf_decal/skyrat_decals/street/full/horizontal,/obj/effect/turf_decal/skyrat_decals/street/manhole,/obj/effect/turf_decal/sand/plating,/turf/open/floor/iron/dark/smooth_large/lowpressure,/area/rockplanet/surface/outdoors)
"Ex" = (/obj/structure/fluff/abandoned/cinderblock,/turf/open/floor/iron/large/lowpressure,/area/ruin/powered)
"EG" = (/obj/structure/fluff/abandoned/cinderblock/tube/end,/turf/open/floor/plating/rust/lowpressure,/area/ruin/powered)
"Fz" = (/obj/effect/turf_decal/sand/plating,/turf/open/floor/plating/lowpressure,/area/rockplanet/surface/outdoors)
"FD" = (/obj/structure/closet/crate/abandoned/wooden/loot,/turf/open/floor/plating/asteroid/lowpressure,/area/rockplanet/surface/outdoors)
"HE" = (/mob/living/simple_animal/hostile/zombie,/turf/open/floor/plating/rust/lowpressure,/area/ruin/powered)
"HX" = (/obj/effect/turf_decal/sand/plating,/obj/structure/fluff/abandoned/blocker/worn{dir = 1},/turf/open/floor/iron/dark/smooth_large/lowpressure,/area/rockplanet/surface/outdoors)
"Ig" = (/turf/open/floor/plating/asteroid/lowpressure,/area/rockplanet/surface/outdoors)
"IF" = (/mob/living/simple_animal/hostile/zombie,/turf/open/floor/plating/asteroid/lowpressure,/area/rockplanet/surface/outdoors)
"Kb" = (/obj/structure/fluff/abandoned/cinderblock/end{dir = 1},/turf/open/floor/iron/large/lowpressure,/area/ruin/powered)
"Kq" = (/obj/structure/fluff/abandoned/cinderblock/end{dir = 4},/turf/open/floor/plating/asteroid/lowpressure,/area/rockplanet/surface/outdoors)
"Kz" = (/obj/item/stack/sheet/sandblock/twenty,/turf/open/floor/iron/large/lowpressure,/area/ruin/powered)
"Ln" = (/obj/effect/turf_decal/sand/plating,/turf/open/floor/plating/rust/lowpressure,/area/ruin/powered)
"Mn" = (/obj/structure/fluff/abandoned/noentry/worn,/obj/effect/turf_decal/sand/plating,/turf/open/floor/iron/large/lowpressure,/area/rockplanet/surface/outdoors)
"NH" = (/obj/structure/fluff/abandoned/cinderblock/tube/end{dir = 4},/turf/open/floor/plating/asteroid/lowpressure,/area/rockplanet/surface/outdoors)
"NN" = (/obj/structure/fluff/abandoned/cinderblock/end{dir = 1},/turf/open/floor/plating/asteroid/lowpressure,/area/rockplanet/surface/outdoors)
"OX" = (/obj/structure/fluff/abandoned/cinderblock/large,/turf/open/floor/plating/asteroid/lowpressure,/area/ruin/powered)
"PQ" = (/obj/effect/turf_decal/sand/plating,/obj/item/stack/sheet/iron/ten,/turf/open/floor/plating/rust/lowpressure,/area/ruin/powered)
"PT" = (/obj/effect/turf_decal/skyrat_decals/street/full/end{dir = 4},/obj/effect/turf_decal/sand/plating,/turf/open/floor/iron/dark/smooth_large/lowpressure,/area/rockplanet/surface/outdoors)
"Qa" = (/turf/open/floor/iron/large/lowpressure,/area/ruin/powered)
"Qb" = (/obj/structure/fluff/abandoned/cinderblock/large{dir = 4},/obj/effect/turf_decal/sand/plating,/turf/open/floor/plating/rust/lowpressure,/area/ruin/powered)
"QQ" = (/obj/machinery/power/floodlight,/obj/effect/turf_decal/sand/plating,/turf/open/floor/iron/large/lowpressure,/area/ruin/powered)
"QV" = (/obj/structure/fluff/abandoned/cinderblock/tube/end{dir = 8},/turf/open/floor/plating/asteroid/lowpressure,/area/rockplanet/surface/outdoors)
"Ra" = (/obj/structure/fluff/abandoned/cinderblock/end{dir = 4},/obj/effect/turf_decal/sand/plating,/turf/open/floor/plating/lowpressure,/area/rockplanet/surface/outdoors)
"Rc" = (/obj/structure/fluff/abandoned/cinderblock/end,/turf/open/floor/plating/asteroid/lowpressure,/area/rockplanet/surface/outdoors)
"Sc" = (/obj/item/stack/sheet/iron/ten,/turf/open/floor/iron/large/lowpressure,/area/ruin/powered)
"SC" = (/obj/effect/turf_decal/skyrat_decals/street/full/horizontal,/obj/effect/turf_decal/sand/plating,/turf/open/floor/plating/lowpressure,/area/rockplanet/surface/outdoors)
"Tk" = (/obj/structure/fluff/abandoned/cinderblock/tall,/turf/open/floor/plating/asteroid/lowpressure,/area/ruin/powered)
"Tq" = (/obj/effect/turf_decal/skyrat_decals/street/dashed/horizontal,/obj/effect/turf_decal/sand/plating,/turf/open/floor/iron/dark/smooth_large/lowpressure,/area/rockplanet/surface/outdoors)
"Tx" = (/obj/structure/fluff/abandoned/cinderblock{dir = 4; pixel_x = -13},/obj/structure/fluff/abandoned/tire,/turf/open/floor/plating/asteroid/lowpressure,/area/rockplanet/surface/outdoors)
"Uu" = (/obj/machinery/power/floodlight,/turf/open/floor/iron/large/lowpressure,/area/ruin/powered)
"UJ" = (/obj/item/stack/sheet/plastic/fifty,/turf/open/floor/iron/large/lowpressure,/area/ruin/powered)
"VS" = (/obj/structure/fluff/abandoned/cinderblock/end{dir = 8},/turf/open/floor/plating/asteroid/lowpressure,/area/rockplanet/surface/outdoors)
"Xz" = (/obj/structure/fluff/abandoned/cinderblock/end,/turf/open/floor/iron/large/lowpressure,/area/ruin/powered)
"XV" = (/obj/structure/fluff/abandoned/cinderblock/tall{pixel_x = -12; pixel_y = 13},/obj/structure/fluff/abandoned/cinderblock/tall{pixel_x = -7; pixel_y = 4},/obj/structure/fluff/abandoned/cinderblock{pixel_x = -19},/turf/open/floor/plating/asteroid/lowpressure,/area/rockplanet/surface/outdoors)
"Zt" = (/obj/structure/fluff/abandoned/cinderblock/tube/end{dir = 1},/turf/open/floor/plating/rust/lowpressure,/area/ruin/powered)
"Zz" = (/obj/structure/fluff/abandoned/cinderblock/tall,/obj/effect/turf_decal/sand/plating,/turf/open/floor/plating/rust/lowpressure,/area/ruin/powered)

(1,1,1) = {"
fIIgIgIgIgIgIgIgIgIgIgIgIgIgIgIgIgIgfIfI
fIIgTkySySOXOXOXOXOXOXySOXOXOXySTkIgfIfI
fIIgnxaxpsLnLnLnmxaxaxxDxDxDnZpsnxIgfIfI
fIIgQbmxQQScLnLnxDomBBxDxDQauqpsnxIgIgfI
fIIgnxLnrIXzKbxDQaQaQaxDxDxDLnaxnxIgIgfI
fIIgnxLnLnxDQaxDQamxmxLnxDLnmxmxQbIgIgfI
fIIgnxaxUJxDBBBhScmxZzySOXySOXOXTkIgIgIg
fIIgQbpsQaxDQaxDrIpsnxnUAsNHQVinIgIgVSIg
fIIgnxLnLnxDQaLnrImxnxwKTxFDIgmshpXVKqIg
fIIgnxLnLnQaQaLnLnLnLnIgIgidIgIgIgIgIgIg
fIIgnxmxLnQaQaLnLnPQuJIgididIgIgFzFzpkIg
fIIgnxmxlKQaxDUuLnmxQbIgidIgIgFzqfPTedIg
fIIgQbaxBhQaxDrIrIZtnxidIgIgIgFzxRxRhFIg
fIIgQbLnQaxDxDQaQawHnxIgIgIgIgFzfQjGedIg
fIIgQbLnrIExxDQaKzEGQbIgIFIgIgxRxRFzRaIg
fIIgnxmxrIQaHExDQaaxnxIgIgIgIgFzidIgIgIg
IgIgnxmxxjQaQaLnrInZnxIgidFzIgFzIgIgVSIg
IgIgnxaxpsaxLnLnLnaxnxIgidIgFzIgIgIgwJIg
IgIgZzrWrWrWOXOXrWrWZzIgidFzFzxRidIgKqIg
IgIgIgIgIgIgIgIgIgIgRcNNzWgnHXknzWRcNNIg
IgzWidzWzWzWididididzWzWzWxRxRFzMnidzWIg
FzFzxRxRxRxRFzFzFzxRxRxRxRxRFzFzFzxRxRIg
IgqfSCrHrHrHrHrHrHCerHrHTqTqTqTqTqrHrHjG
fIIgIgxRFzFzxRxRxRxRxRxRxRxRxRxRxRFzFzFz
fIfIfIIgIgidzWIgfIfIfIididzWzWidzWidfIfI
"}
