"ax" = (/turf/closed/wall/rust,/area/ruin/powered)
"ed" = (/obj/structure/fluff/abandoned/cinderblock/mid{dir = 4},/obj/effect/turf_decal/sand/plating,/turf/open/floor/plating/lowpressure,/area/template_noop)
"fI" = (/turf/open/floor/plating/asteroid/lowpressure,/area/template_noop)
"fQ" = (/obj/effect/turf_decal/skyrat_decals/street/full/end{dir = 8},/obj/effect/turf_decal/sand/plating,/turf/open/floor/iron/dark/smooth_large/lowpressure,/area/template_noop)
"hp" = (/obj/structure/fluff/abandoned/cinderblock/long{pixel_y = 4},/turf/open/floor/plating/asteroid/lowpressure,/area/template_noop)
"hF" = (/obj/structure/fluff/abandoned/cinderblock/mid{dir = 4},/obj/structure/fluff/abandoned/parking/worn{pixel_x = 10},/turf/open/floor/plating/asteroid/lowpressure,/area/template_noop)
"id" = (/obj/effect/turf_decal/sand/plating,/turf/open/floor/plating/rust/lowpressure,/area/template_noop)
"in" = (/obj/structure/rack/shelf,/obj/item/storage/belt/utility/full/engi{pixel_y = -4},/obj/item/clothing/suit/hazardvest,/obj/item/clothing/suit/hazardvest,/obj/item/storage/belt/utility/full/engi{pixel_y = -2},/obj/item/clothing/suit/hazardvest,/obj/item/clothing/head/hardhat/orange,/obj/item/clothing/head/hardhat/orange,/obj/item/clothing/head/hardhat/orange,/obj/item/taperoll/engi,/turf/open/floor/plating/asteroid/lowpressure,/area/template_noop)
"jG" = (/obj/effect/turf_decal/skyrat_decals/street/full/end{dir = 4},/obj/effect/turf_decal/sand/plating,/turf/open/floor/plating/lowpressure,/area/template_noop)
"lK" = (/obj/effect/turf_decal/sand/plating,/obj/item/stack/sheet/sandblock/twenty,/turf/open/floor/plating/rust/lowpressure,/area/ruin/powered)
"mx" = (/obj/structure/girder,/obj/effect/turf_decal/sand/plating,/turf/open/floor/plating/rust/lowpressure,/area/ruin/powered)
"nx" = (/obj/structure/fluff/abandoned/cinderblock/large{dir = 4},/turf/open/floor/plating/asteroid/lowpressure,/area/ruin/powered)
"nU" = (/obj/structure/fluff/abandoned/cinderblock/tall{pixel_y = 4},/turf/open/floor/plating/asteroid/lowpressure,/area/template_noop)
"nZ" = (/obj/structure/girder,/turf/open/floor/plating/rust/lowpressure,/area/ruin/powered)
"om" = (/obj/structure/fluff/abandoned/cinderblock/tube{dir = 4},/turf/open/floor/iron/large/lowpressure,/area/ruin/powered)
"pk" = (/obj/structure/fluff/abandoned/cinderblock/end{dir = 8},/obj/effect/turf_decal/sand/plating,/turf/open/floor/plating/lowpressure,/area/template_noop)
"ps" = (/turf/closed/wall,/area/ruin/powered)
"qf" = (/obj/effect/turf_decal/skyrat_decals/street/full/end{dir = 8},/obj/effect/turf_decal/sand/plating,/turf/open/floor/plating/lowpressure,/area/template_noop)
"rH" = (/obj/effect/turf_decal/skyrat_decals/street/full/horizontal,/obj/effect/turf_decal/sand/plating,/turf/open/floor/iron/dark/smooth_large/lowpressure,/area/template_noop)
"rI" = (/obj/effect/turf_decal/sand/plating,/turf/open/floor/iron/large/lowpressure,/area/ruin/powered)
"rW" = (/obj/structure/fluff/abandoned/cinderblock/large,/turf/open/floor/plating/rust/lowpressure,/area/ruin/powered)
"uq" = (/obj/item/storage/belt/utility/full/powertools,/obj/effect/mob_spawn/human/skeleton,/obj/item/clothing/under/rank/engineering/engineer/hazard,/obj/item/clothing/suit/hazardvest,/obj/item/clothing/head/hardhat/orange,/turf/open/floor/iron/large/lowpressure,/area/ruin/powered)
"uJ" = (/turf/open/floor/plating/asteroid/lowpressure,/area/ruin/powered)
"wH" = (/obj/structure/fluff/abandoned/cinderblock/tube/middle,/turf/open/floor/plating/rust/lowpressure,/area/ruin/powered)
"wJ" = (/obj/structure/fluff/abandoned/cinderblock/mid{dir = 4},/turf/open/floor/plating/asteroid/lowpressure,/area/template_noop)
"wK" = (/obj/structure/fluff/abandoned/cinderblock/long,/turf/open/floor/plating/asteroid/lowpressure,/area/template_noop)
"xj" = (/obj/effect/turf_decal/sand/plating,/obj/item/stack/sheet/iron/twenty,/turf/open/floor/iron/large/lowpressure,/area/ruin/powered)
"xD" = (/turf/open/floor/plating/rust/lowpressure,/area/ruin/powered)
"xR" = (/obj/effect/turf_decal/sand/plating,/turf/open/floor/iron/dark/smooth_large/lowpressure,/area/template_noop)
"yS" = (/obj/structure/fluff/abandoned/cinderblock/large,/obj/effect/turf_decal/sand/plating,/turf/open/floor/plating/rust/lowpressure,/area/ruin/powered)
"zW" = (/obj/effect/turf_decal/sand/plating,/turf/open/floor/iron/large/lowpressure,/area/template_noop)
"As" = (/obj/structure/fluff/abandoned/cinderblock/tall{pixel_x = -12},/turf/open/floor/plating/asteroid/lowpressure,/area/template_noop)
"Bh" = (/obj/structure/fluff/abandoned/cinderblock{dir = 4},/turf/open/floor/iron/large/lowpressure,/area/ruin/powered)
"BB" = (/mob/living/simple_animal/hostile/zombie,/turf/open/floor/iron/large/lowpressure,/area/ruin/powered)
"Ce" = (/obj/effect/turf_decal/skyrat_decals/street/full/horizontal,/obj/effect/turf_decal/skyrat_decals/street/manhole,/obj/effect/turf_decal/sand/plating,/turf/open/floor/iron/dark/smooth_large/lowpressure,/area/template_noop)
"Ex" = (/obj/structure/fluff/abandoned/cinderblock,/turf/open/floor/iron/large/lowpressure,/area/ruin/powered)
"EG" = (/obj/structure/fluff/abandoned/cinderblock/tube/end,/turf/open/floor/plating/rust/lowpressure,/area/ruin/powered)
"Fz" = (/obj/effect/turf_decal/sand/plating,/turf/open/floor/plating/lowpressure,/area/template_noop)
"HE" = (/mob/living/simple_animal/hostile/zombie,/turf/open/floor/plating/rust/lowpressure,/area/ruin/powered)
"IF" = (/mob/living/simple_animal/hostile/zombie,/turf/open/floor/plating/asteroid/lowpressure,/area/template_noop)
"Kb" = (/obj/structure/fluff/abandoned/cinderblock/end{dir = 1},/turf/open/floor/iron/large/lowpressure,/area/ruin/powered)
"Kq" = (/obj/structure/fluff/abandoned/cinderblock/end{dir = 4},/turf/open/floor/plating/asteroid/lowpressure,/area/template_noop)
"Kz" = (/obj/item/stack/sheet/sandblock/twenty,/turf/open/floor/iron/large/lowpressure,/area/ruin/powered)
"Ln" = (/obj/effect/turf_decal/sand/plating,/turf/open/floor/plating/rust/lowpressure,/area/ruin/powered)
"Mn" = (/obj/structure/fluff/abandoned/noentry/worn,/obj/effect/turf_decal/sand/plating,/turf/open/floor/plating/rust/lowpressure,/area/template_noop)
"NH" = (/obj/structure/fluff/abandoned/cinderblock/tube/end{dir = 4},/turf/open/floor/plating/asteroid/lowpressure,/area/template_noop)
"NN" = (/obj/structure/fluff/abandoned/cinderblock/end{dir = 1},/turf/open/floor/plating/asteroid/lowpressure,/area/template_noop)
"OX" = (/obj/structure/fluff/abandoned/cinderblock/large,/turf/open/floor/plating/asteroid/lowpressure,/area/ruin/powered)
"PQ" = (/obj/effect/turf_decal/sand/plating,/obj/item/stack/sheet/iron/ten,/turf/open/floor/plating/rust/lowpressure,/area/ruin/powered)
"PT" = (/obj/effect/turf_decal/skyrat_decals/street/full/end{dir = 4},/obj/effect/turf_decal/sand/plating,/turf/open/floor/iron/dark/smooth_large/lowpressure,/area/template_noop)
"Qa" = (/turf/open/floor/iron/large/lowpressure,/area/ruin/powered)
"Qb" = (/obj/structure/fluff/abandoned/cinderblock/large{dir = 4},/obj/effect/turf_decal/sand/plating,/turf/open/floor/plating/rust/lowpressure,/area/ruin/powered)
"QQ" = (/obj/machinery/power/floodlight,/obj/effect/turf_decal/sand/plating,/turf/open/floor/iron/large/lowpressure,/area/ruin/powered)
"QV" = (/obj/structure/fluff/abandoned/cinderblock/tube/end{dir = 8},/turf/open/floor/plating/asteroid/lowpressure,/area/template_noop)
"Ra" = (/obj/structure/fluff/abandoned/cinderblock/end{dir = 4},/obj/effect/turf_decal/sand/plating,/turf/open/floor/plating/lowpressure,/area/template_noop)
"Rc" = (/obj/structure/fluff/abandoned/cinderblock/end,/turf/open/floor/plating/asteroid/lowpressure,/area/template_noop)
"Sc" = (/obj/item/stack/sheet/iron/ten,/turf/open/floor/iron/large/lowpressure,/area/ruin/powered)
"SC" = (/obj/effect/turf_decal/skyrat_decals/street/full/horizontal,/obj/effect/turf_decal/sand/plating,/turf/open/floor/plating/lowpressure,/area/template_noop)
"Tk" = (/obj/structure/fluff/abandoned/cinderblock/tall,/turf/open/floor/plating/asteroid/lowpressure,/area/ruin/powered)
"Tq" = (/obj/effect/turf_decal/skyrat_decals/street/dashed/horizontal,/obj/effect/turf_decal/sand/plating,/turf/open/floor/iron/dark/smooth_large/lowpressure,/area/template_noop)
"Tx" = (/obj/structure/fluff/abandoned/cinderblock{dir = 4; pixel_x = -13},/turf/open/floor/plating/asteroid/lowpressure,/area/template_noop)
"Uu" = (/obj/machinery/power/floodlight,/turf/open/floor/iron/large/lowpressure,/area/ruin/powered)
"UJ" = (/obj/item/stack/sheet/plastic/fifty,/turf/open/floor/iron/large/lowpressure,/area/ruin/powered)
"VS" = (/obj/structure/fluff/abandoned/cinderblock/end{dir = 8},/turf/open/floor/plating/asteroid/lowpressure,/area/template_noop)
"Xz" = (/obj/structure/fluff/abandoned/cinderblock/end,/turf/open/floor/iron/large/lowpressure,/area/ruin/powered)
"XV" = (/obj/structure/fluff/abandoned/cinderblock/tall{pixel_x = -12; pixel_y = 13},/obj/structure/fluff/abandoned/cinderblock/tall{pixel_x = -7; pixel_y = 4},/obj/structure/fluff/abandoned/cinderblock{pixel_x = -19},/turf/open/floor/plating/asteroid/lowpressure,/area/template_noop)
"Zt" = (/obj/structure/fluff/abandoned/cinderblock/tube/end{dir = 1},/turf/open/floor/plating/rust/lowpressure,/area/ruin/powered)
"Zz" = (/obj/structure/fluff/abandoned/cinderblock/tall,/obj/effect/turf_decal/sand/plating,/turf/open/floor/plating/rust/lowpressure,/area/ruin/powered)

(1,1,1) = {"
fIfITkySySOXOXOXOXOXOXySOXOXOXySTkfIfIfI
fIfInxaxpsLnLnLnmxaxaxxDxDxDnZpsnxfIfIfI
fIfIQbmxQQScLnLnxDomBBxDxDQauqpsnxfIfIfI
fIfInxLnrIXzKbxDQaQaQaxDxDxDLnaxnxfIfIfI
fIfInxLnLnxDQaxDQamxmxLnxDLnmxmxQbfIfIfI
fIfInxaxUJxDBBBhScmxZzySOXySOXOXTkfIfIfI
fIfIQbpsQaxDQaxDrIpsnxnUAsNHQVinfIfIVSfI
fIfInxLnLnxDQaLnrImxnxwKTxfIfIfIhpXVKqfI
fIfInxLnLnQaQaLnLnLnLnfIfIidfIfIfIfIfIfI
fIfInxmxLnQaQaLnLnPQuJfIididfIfIFzFzpkfI
fIfInxmxlKQaxDUuLnmxQbfIidfIfIFzqfPTedfI
fIfIQbaxBhQaxDrIrIZtnxidfIfIfIFzxRxRhFfI
fIfIQbLnQaxDxDQaQawHnxfIfIfIfIFzfQjGedfI
fIfIQbLnrIExxDQaKzEGQbfIIFfIfIxRxRFzRafI
fIfInxmxrIQaHExDQaaxnxfIfIfIfIFzidfIfIfI
fIfInxmxxjQaQaLnrInZnxfIidfIfIFzfIfIVSfI
fIfInxaxpsaxLnLnLnaxnxfIidfIfIfIfIfIwJfI
fIfIZzrWrWrWOXOXrWrWZzfIfIFzFzxRfIfIKqfI
fIfIfIfIfIfIfIfIfIfIRcNNidFzxRFzidRcNNfI
fIzWidzWzWzWididididzWzWzWxRxRFzMnidzWfI
FzFzxRxRxRxRFzFzFzxRxRxRxRxRFzFzFzxRxRfI
fIqfSCrHrHrHrHrHrHCerHrHTqTqTqTqTqrHrHjG
fIfIfIxRFzFzxRxRxRxRxRxRxRxRxRxRxRFzFzFz
fIfIfIfIfIidzWfIfIfIfIididzWzWidzWidfIfI
"}
