"a" = (/turf/template_noop,/area/template_noop)
"b" = (/obj/effect/turf_decal/skyrat_decals/street/full/horizontal,/obj/effect/turf_decal/sand/plating,/turf/open/floor/iron/dark/smooth_large/lowpressure,/area/rockplanet/surface/outdoors)
"c" = (/obj/structure/fluff/metalpole{desc = "This is holding up a tent that you can definitely see, it's there, yep."; dir = 6; name = "tent pole"},/turf/open/floor/iron/large/lowpressure,/area/ruin/powered)
"e" = (/obj/effect/turf_decal/skyrat_decals/street/full,/obj/effect/turf_decal/sand/plating,/turf/open/floor/plating/lowpressure,/area/rockplanet/surface/outdoors)
"f" = (/obj/structure/fluff/abandoned/cinderblock,/turf/open/floor/plating/lowpressure,/area/ruin/powered)
"g" = (/obj/effect/turf_decal/skyrat_decals/street/full/end{dir = 4},/obj/effect/turf_decal/sand/plating,/turf/open/floor/plating/lowpressure,/area/rockplanet/surface/outdoors)
"j" = (/turf/open/floor/plating/lowpressure,/area/ruin/powered)
"m" = (/obj/effect/turf_decal/skyrat_decals/street/full/end{dir = 1},/obj/effect/turf_decal/sand/plating,/turf/open/floor/plating/lowpressure,/area/rockplanet/surface/outdoors)
"n" = (/obj/effect/turf_decal/skyrat_decals/street/full/horizontal,/obj/effect/turf_decal/sand/plating,/turf/open/floor/plating/lowpressure,/area/rockplanet/surface/outdoors)
"o" = (/turf/open/floor/plating/asteroid/lowpressure,/area/rockplanet/surface/outdoors)
"p" = (/obj/effect/turf_decal/skyrat_decals/street/full/end{dir = 1},/obj/structure/fluff/abandoned/cinderblock/end{dir = 1},/turf/open/floor/plating/lowpressure,/area/ruin/powered)
"q" = (/obj/effect/turf_decal/sand/plating,/turf/open/floor/iron/large/lowpressure,/area/rockplanet/surface/outdoors)
"r" = (/obj/effect/turf_decal/skyrat_decals/street/manhole,/turf/open/floor/iron/dark/smooth_large/lowpressure,/area/ruin/powered)
"s" = (/turf/open/floor/iron/dark/smooth_large/lowpressure,/area/ruin/powered)
"t" = (/obj/effect/turf_decal/skyrat_decals/street/full/end{dir = 8},/obj/structure/barricade/sandbags,/turf/open/floor/plating/lowpressure,/area/ruin/powered)
"y" = (/obj/effect/turf_decal/sand/plating,/obj/structure/fluff/abandoned/stopsign/worn,/turf/open/floor/iron/large/lowpressure,/area/rockplanet/surface/outdoors)
"A" = (/obj/effect/turf_decal/sand/plating,/obj/structure/fluff/abandoned/tire,/turf/open/floor/plating/lowpressure,/area/rockplanet/surface/outdoors)
"C" = (/obj/structure/fluff/metalpole{desc = "This is holding up a tent that you can definitely see, it's there, yep."; dir = 6; name = "tent pole"},/turf/open/floor/plating/rust/lowpressure,/area/ruin/powered)
"D" = (/obj/effect/turf_decal/skyrat_decals/street/full/end,/obj/effect/turf_decal/sand/plating,/turf/open/floor/plating/lowpressure,/area/rockplanet/surface/outdoors)
"E" = (/obj/structure/fluff/abandoned/cinderblock/end,/turf/open/floor/plating/lowpressure,/area/ruin/powered)
"F" = (/mob/living/simple_animal/hostile/zombie,/turf/open/floor/plating/lowpressure,/area/ruin/powered)
"G" = (/obj/effect/turf_decal/skyrat_decals/street/full/end{dir = 8},/obj/effect/turf_decal/sand/plating,/turf/open/floor/plating/lowpressure,/area/rockplanet/surface/outdoors)
"H" = (/obj/effect/turf_decal/skyrat_decals/street/full,/obj/effect/turf_decal/sand/plating,/turf/open/floor/iron/dark/smooth_large/lowpressure,/area/rockplanet/surface/outdoors)
"K" = (/obj/structure/table,/turf/open/floor/plating/lowpressure,/area/ruin/powered)
"L" = (/obj/effect/turf_decal/skyrat_decals/street/full/end,/turf/open/floor/iron/dark/smooth_large/lowpressure,/area/ruin/powered)
"M" = (/obj/effect/turf_decal/sand/plating,/turf/open/floor/iron/dark/smooth_large/lowpressure,/area/rockplanet/surface/outdoors)
"N" = (/obj/structure/table,/obj/item/radio/ancient_military,/turf/open/floor/plating/lowpressure,/area/ruin/powered)
"O" = (/obj/structure/fluff/abandoned/cinderblock{dir = 4},/turf/open/floor/iron/dark/smooth_large/lowpressure,/area/ruin/powered)
"Q" = (/obj/effect/turf_decal/skyrat_decals/street/full/end{dir = 4},/obj/structure/fluff/abandoned/cinderblock{dir = 4},/turf/open/floor/plating/lowpressure,/area/ruin/powered)
"R" = (/obj/effect/turf_decal/sand/plating,/turf/open/floor/plating/rust/lowpressure,/area/rockplanet/surface/outdoors)
"S" = (/obj/structure/barricade/sandbags,/turf/open/floor/plating/lowpressure,/area/ruin/powered)
"T" = (/obj/effect/turf_decal/skyrat_decals/street/full/end{dir = 1},/obj/effect/turf_decal/sand/plating,/turf/open/floor/iron/dark/smooth_large/lowpressure,/area/rockplanet/surface/outdoors)
"U" = (/obj/effect/turf_decal/sand/plating,/turf/open/floor/plating/lowpressure,/area/rockplanet/surface/outdoors)
"V" = (/obj/effect/turf_decal/sand/plating,/obj/structure/fluff/abandoned/stopsign/worn,/turf/open/floor/plating/rust/lowpressure,/area/rockplanet/surface/outdoors)
"W" = (/obj/structure/fluff/abandoned/cinderblock,/turf/open/floor/iron/dark/smooth_large/lowpressure,/area/ruin/powered)
"X" = (/obj/effect/turf_decal/sand/plating,/obj/structure/fluff/abandoned/tire,/turf/open/floor/plating/rust/lowpressure,/area/rockplanet/surface/outdoors)
"Y" = (/obj/structure/closet/crate/abandoned/wooden/loot,/obj/item/storage/belt/military,/obj/item/clothing/gloves/military,/turf/open/floor/iron/dark/smooth_large/lowpressure,/area/ruin/powered)

(1,1,1) = {"
aaaaaaaaaaaaaa
aaaaaUTMRaaaaa
aaaoqMDooaaaaa
aaaoqooooaaaaa
aaooVomUXoaaaa
aoqqcWLfCyoaaa
aUUMOYssFUooaa
aGbbQsrNtbngoa
aoAUsFjKSMMUUa
aaqVcEpScqqRoa
aaaoqMHMyoooaa
aaaoRMeURoaaaa
aaaaRMeooaaaaa
aaaaoUHUaaaaaa
aaaaRUDoaaaaaa
aaaaaaaaaaaaaa
"}
