//MAP CONVERTED BY dmm2tgm.py THIS HEADER COMMENT PREVENTS RECONVERSION, DO NOT REMOVE
"aJ" = (
/obj/effect/turf_decal/stripes/red/line{
	dir = 8
	},
/turf/open/floor/plating,
/area/station/engineering/supermatter/room)
"aR" = (
/obj/machinery/power/emitter{
	dir = 4
	},
/obj/structure/cable,
/turf/open/floor/plating,
/area/icemoon/surface/outdoors/nospawn)
"bx" = (
/obj/structure/particle_accelerator/particle_emitter/left,
/obj/effect/turf_decal/stripes/line{
	dir = 10
	},
/obj/structure/cable,
/turf/open/floor/engine,
/area/station/engineering/supermatter/room)
"ce" = (
/obj/structure/tank_dispenser,
/turf/open/floor/iron/dark,
/area/station/engineering/supermatter/room)
"cj" = (
/obj/effect/turf_decal/siding/yellow{
	dir = 1
	},
/obj/effect/decal/cleanable/dirt,
/obj/machinery/atmospherics/pipe/smart/manifold4w/scrubbers/hidden/layer2,
/turf/open/floor/iron,
/area/station/engineering/storage_shared)
"dx" = (
/obj/structure/cable,
/obj/machinery/atmospherics/pipe/smart/manifold4w/supply/hidden/layer4,
/obj/machinery/door/airlock/engineering/glass{
	name = "Engineering Secondary Storage"
	},
/obj/machinery/door/firedoor,
/obj/machinery/atmospherics/pipe/smart/manifold4w/scrubbers/hidden/layer2,
/obj/effect/mapping_helpers/airlock/access/any/engineering/construction,
/obj/effect/mapping_helpers/airlock/access/any/engineering/general,
/turf/open/floor/iron,
/area/station/engineering/storage_shared)
"dB" = (
/turf/open/floor/plating,
/area/icemoon/surface/outdoors/nospawn)
"dS" = (
/obj/structure/particle_accelerator/particle_emitter/center,
/obj/effect/turf_decal/stripes/line,
/obj/structure/cable,
/turf/open/floor/engine,
/area/station/engineering/supermatter/room)
"dV" = (
/obj/structure/lattice/catwalk,
/turf/open/floor/plating,
/area/icemoon/surface/outdoors/nospawn)
"eG" = (
/obj/structure/cable,
/obj/machinery/atmospherics/pipe/smart/manifold4w/supply/hidden/layer4,
/obj/machinery/atmospherics/pipe/smart/manifold4w/scrubbers/hidden/layer2,
/turf/open/floor/iron,
/area/station/engineering/main)
"ff" = (
/obj/machinery/light/directional/west,
/obj/structure/closet/crate/bin,
/turf/open/floor/iron/dark,
/area/station/engineering/supermatter/room)
"fE" = (
/obj/effect/spawner/structure/window/reinforced/plasma,
/obj/machinery/atmospherics/pipe/smart/manifold4w/orange/visible,
/turf/open/floor/plating,
/area/station/engineering/supermatter/room)
"gQ" = (
/obj/machinery/power/energy_accumulator/rad_collector/anchored,
/obj/structure/cable,
/turf/open/floor/plating,
/area/icemoon/surface/outdoors/nospawn)
"hw" = (
/obj/machinery/vending/wardrobe/engi_wardrobe,
/obj/machinery/computer/security/telescreen/entertainment/directional/north,
/turf/open/floor/iron/dark,
/area/station/engineering/storage_shared)
"hz" = (
/obj/effect/turf_decal/stripes/line{
	dir = 8
	},
/turf/open/floor/engine,
/area/station/engineering/supermatter/room)
"jE" = (
/obj/machinery/light/directional/south,
/obj/structure/tank_dispenser,
/turf/open/floor/iron/dark,
/area/station/engineering/supermatter/room)
"kp" = (
/obj/machinery/door/airlock/external/glass/emp_proof,
/obj/effect/mapping_helpers/airlock/cyclelink_helper{
	dir = 8
	},
/turf/open/floor/plating,
/area/station/engineering/supermatter/room)
"lx" = (
/turf/open/floor/iron/dark,
/area/station/engineering/supermatter/room)
"ml" = (
/obj/machinery/atmospherics/pipe/smart/manifold4w/supply/hidden/layer4,
/turf/open/floor/iron/dark,
/area/station/engineering/supermatter/room)
"mZ" = (
/obj/structure/cable,
/obj/machinery/light/directional/west,
/turf/open/floor/plating,
/area/station/engineering/supermatter/room)
"nR" = (
/obj/structure/grille,
/turf/open/misc/asteroid/snow/icemoon,
/area/icemoon/surface/outdoors/nospawn)
"nS" = (
/obj/machinery/atmospherics/pipe/smart/manifold4w/orange/visible,
/obj/structure/cable,
/obj/effect/turf_decal/tile/yellow,
/obj/machinery/atmospherics/pipe/smart/manifold4w/supply/hidden/layer4,
/turf/open/floor/iron,
/area/station/engineering/storage_shared)
"pc" = (
/obj/machinery/atmospherics/pipe/smart/manifold4w/supply/hidden/layer4,
/obj/machinery/power/apc/auto_name/directional/north,
/obj/structure/cable,
/obj/effect/turf_decal/siding/yellow/corner{
	dir = 4
	},
/obj/machinery/light_switch/directional/north{
	pixel_x = 12
	},
/obj/machinery/atmospherics/pipe/smart/manifold4w/scrubbers/hidden/layer2,
/turf/open/floor/iron,
/area/station/engineering/storage_shared)
"qS" = (
/obj/structure/closet/emcloset/anchored,
/turf/open/floor/plating,
/area/station/engineering/supermatter/room)
"rf" = (
/obj/structure/particle_accelerator/end_cap,
/obj/effect/turf_decal/stripes/line{
	dir = 1
	},
/obj/structure/cable,
/turf/open/floor/engine,
/area/station/engineering/supermatter/room)
"rB" = (
/obj/machinery/atmospherics/pipe/smart/manifold4w/orange/visible,
/obj/machinery/meter,
/obj/effect/turf_decal/tile/yellow{
	dir = 8
	},
/turf/open/floor/iron,
/area/station/engineering/storage_shared)
"sj" = (
/obj/machinery/light/directional/north,
/turf/open/floor/iron/dark,
/area/station/engineering/supermatter/room)
"ti" = (
/obj/machinery/door/airlock/external/glass/emp_proof,
/obj/effect/mapping_helpers/airlock/cyclelink_helper,
/turf/open/floor/plating,
/area/station/engineering/supermatter/room)
"tI" = (
/obj/machinery/light/small/directional/north,
/obj/structure/cable,
/turf/open/floor/plating,
/area/station/engineering/supermatter/room)
"ub" = (
/obj/structure/cable,
/obj/machinery/atmospherics/components/unary/vent_pump/on/layer4{
	dir = 4
	},
/turf/open/floor/iron/dark,
/area/station/engineering/supermatter/room)
"uy" = (
/obj/effect/turf_decal/caution/stand_clear/red,
/turf/open/floor/plating,
/area/station/engineering/supermatter/room)
"uF" = (
/obj/machinery/atmospherics/pipe/heat_exchanging/junction{
	dir = 8
	},
/turf/closed/wall/r_wall,
/area/station/engineering/supermatter/room)
"va" = (
/turf/closed/wall/r_wall,
/area/icemoon/surface/outdoors/nospawn)
"vi" = (
/obj/structure/cable,
/turf/closed/wall/r_wall,
/area/station/engineering/supermatter/room)
"vu" = (
/obj/structure/cable,
/turf/open/floor/iron/dark,
/area/station/engineering/supermatter/room)
"wK" = (
/obj/structure/cable,
/obj/machinery/atmospherics/pipe/smart/manifold4w/supply/hidden/layer4,
/obj/machinery/atmospherics/pipe/smart/manifold4w/scrubbers/hidden/layer2,
/turf/open/floor/iron,
/area/station/engineering/storage_shared)
"xb" = (
/obj/structure/rack,
/obj/item/clothing/mask/gas{
	pixel_x = 3;
	pixel_y = 3
	},
/obj/item/clothing/mask/gas,
/obj/item/clothing/mask/gas{
	pixel_x = -3;
	pixel_y = -3
	},
/obj/machinery/atmospherics/pipe/smart/manifold4w/orange/visible,
/obj/effect/turf_decal/tile/yellow/half/contrasted{
	dir = 8
	},
/obj/machinery/light/small/directional/west,
/turf/open/floor/iron,
/area/station/engineering/storage_shared)
"xq" = (
/obj/effect/turf_decal/caution/red,
/obj/effect/turf_decal/caution/red{
	dir = 1
	},
/turf/open/floor/plating,
/area/icemoon/surface/outdoors/nospawn)
"ya" = (
/obj/machinery/door/poddoor/shutters/radiation/preopen{
	id = "engsm";
	name = "Radiation Chamber Shutters"
	},
/turf/open/floor/plating,
/area/station/engineering/supermatter/room)
"yc" = (
/obj/effect/turf_decal/stripes/red/line{
	dir = 4
	},
/turf/open/floor/plating,
/area/station/engineering/supermatter/room)
"ye" = (
/turf/closed/wall/r_wall,
/area/station/engineering/supermatter/room)
"yt" = (
/obj/structure/cable,
/obj/machinery/light/directional/north,
/turf/open/floor/iron/dark,
/area/station/engineering/supermatter/room)
"Ae" = (
/obj/machinery/atmospherics/pipe/smart/manifold4w/supply/hidden/layer4,
/obj/machinery/atmospherics/pipe/smart/manifold4w/orange/visible,
/obj/structure/cable,
/turf/open/floor/iron,
/area/station/engineering/storage_shared)
"Al" = (
/obj/effect/spawner/structure/window/reinforced/plasma,
/obj/structure/cable,
/turf/open/floor/plating,
/area/station/engineering/supermatter/room)
"Ar" = (
/obj/machinery/door/airlock/external/glass/emp_proof,
/obj/effect/mapping_helpers/airlock/cyclelink_helper{
	dir = 1
	},
/turf/open/floor/plating,
/area/station/engineering/supermatter/room)
"AF" = (
/obj/machinery/atmospherics/pipe/smart/manifold4w/supply/hidden/layer4,
/obj/effect/decal/cleanable/dirt,
/obj/structure/cable,
/turf/open/floor/iron,
/area/station/engineering/storage_shared)
"Bv" = (
/obj/machinery/atmospherics/components/unary/vent_pump/on/layer4{
	dir = 8
	},
/turf/open/floor/iron/large,
/area/station/engineering/storage_shared)
"Cx" = (
/turf/closed/wall/r_wall,
/area/station/engineering/storage_shared)
"Dp" = (
/obj/machinery/airalarm/directional/west,
/turf/open/floor/iron/dark,
/area/station/engineering/supermatter/room)
"FE" = (
/obj/effect/turf_decal/stripes/line{
	dir = 9
	},
/turf/open/floor/engine,
/area/station/engineering/supermatter/room)
"FK" = (
/obj/structure/table/reinforced,
/turf/open/floor/iron/dark,
/area/station/engineering/supermatter/room)
"Jb" = (
/obj/structure/cable,
/turf/open/floor/plating,
/area/icemoon/surface/outdoors/nospawn)
"Jh" = (
/obj/machinery/atmospherics/components/unary/vent_scrubber/on/layer2{
	dir = 1
	},
/obj/machinery/atmospherics/pipe/smart/manifold4w/supply/hidden/layer4,
/turf/open/floor/iron/dark,
/area/station/engineering/supermatter/room)
"Jk" = (
/obj/structure/particle_accelerator/power_box,
/obj/structure/cable,
/turf/open/floor/engine,
/area/station/engineering/supermatter/room)
"JK" = (
/obj/machinery/power/emitter{
	dir = 8
	},
/obj/structure/cable,
/turf/open/floor/plating,
/area/icemoon/surface/outdoors/nospawn)
"JM" = (
/obj/item/radio/intercom/directional/west,
/obj/machinery/light/directional/west,
/turf/open/floor/iron/dark,
/area/station/engineering/supermatter/room)
"Ks" = (
/obj/machinery/incident_display/delam,
/turf/closed/wall/r_wall,
/area/station/engineering/supermatter/room)
"KY" = (
/obj/machinery/singularity_generator,
/obj/item/wrench,
/turf/open/floor/plating,
/area/icemoon/surface/outdoors/nospawn)
"Lk" = (
/turf/open/floor/iron,
/area/station/engineering/main)
"LX" = (
/obj/structure/particle_accelerator/fuel_chamber,
/obj/structure/cable,
/turf/open/floor/engine,
/area/station/engineering/supermatter/room)
"MJ" = (
/obj/machinery/light/directional/east,
/turf/open/floor/iron/dark,
/area/station/engineering/supermatter/room)
"MX" = (
/obj/machinery/light/directional/east,
/turf/open/floor/plating,
/area/station/engineering/supermatter/room)
"Nj" = (
/obj/effect/turf_decal/caution/red{
	dir = 1
	},
/obj/effect/turf_decal/caution/red,
/obj/structure/cable,
/turf/open/floor/plating,
/area/icemoon/surface/outdoors/nospawn)
"Oy" = (
/obj/effect/turf_decal/stripes/line{
	dir = 5
	},
/turf/open/floor/engine,
/area/station/engineering/supermatter/room)
"OQ" = (
/turf/open/misc/asteroid/snow/icemoon,
/area/icemoon/surface/outdoors/nospawn)
"Pi" = (
/obj/machinery/field/generator/singularity,
/obj/effect/turf_decal/bot_red,
/turf/open/floor/plating,
/area/icemoon/surface/outdoors/nospawn)
"Ps" = (
/obj/structure/closet/firecloset,
/turf/open/floor/iron/dark,
/area/station/engineering/supermatter/room)
"Pv" = (
/obj/structure/table/reinforced,
/obj/item/storage/toolbox/mechanical,
/obj/item/analyzer,
/obj/item/pipe_dispenser,
/obj/item/flashlight,
/turf/open/floor/iron/dark,
/area/station/engineering/supermatter/room)
"PC" = (
/obj/machinery/door/firedoor,
/obj/machinery/door/airlock/engineering/glass{
	name = "Supermatter Engine Room"
	},
/obj/machinery/atmospherics/pipe/smart/manifold4w/scrubbers/hidden/layer2,
/obj/machinery/atmospherics/pipe/smart/manifold4w/supply/hidden/layer4,
/obj/effect/mapping_helpers/airlock/access/all/engineering/general,
/turf/open/floor/engine,
/area/station/engineering/supermatter/room)
"PW" = (
/obj/effect/turf_decal/caution/red{
	dir = 1
	},
/obj/effect/turf_decal/caution/red,
/turf/open/floor/plating,
/area/icemoon/surface/outdoors/nospawn)
"Qq" = (
/obj/machinery/door/firedoor,
/obj/machinery/door/airlock/engineering/glass{
	name = "Supermatter Engine Room"
	},
/obj/machinery/atmospherics/pipe/smart/manifold4w/scrubbers/hidden/layer2,
/obj/effect/mapping_helpers/airlock/access/all/engineering/general,
/turf/open/floor/engine,
/area/station/engineering/supermatter/room)
"Qw" = (
/obj/effect/turf_decal/caution/red,
/obj/effect/turf_decal/caution/red{
	dir = 1
	},
/obj/structure/cable,
/turf/open/floor/plating,
/area/icemoon/surface/outdoors/nospawn)
"QA" = (
/obj/structure/cable,
/turf/open/floor/plating,
/area/station/engineering/supermatter/room)
"Rp" = (
/obj/machinery/atmospherics/components/unary/passive_vent{
	dir = 1
	},
/turf/open/floor/plating/snowed/icemoon,
/area/icemoon/surface/outdoors/nospawn)
"RT" = (
/obj/machinery/button/door/directional/east{
	id = "engsm";
	name = "Radiation Shutters Control";
	req_access = list("engineering")
	},
/turf/open/floor/iron/dark,
/area/station/engineering/supermatter/room)
"Sl" = (
/obj/machinery/door/poddoor/shutters/radiation/preopen{
	id = "engsm";
	name = "Radiation Chamber Shutters"
	},
/obj/structure/cable,
/turf/open/floor/plating,
/area/station/engineering/supermatter/room)
"SM" = (
/obj/machinery/door/firedoor,
/obj/machinery/door/airlock/engineering/glass{
	name = "Supermatter Engine Room"
	},
/obj/machinery/atmospherics/pipe/smart/manifold4w/supply/hidden/layer4,
/obj/effect/mapping_helpers/airlock/access/all/engineering/general,
/turf/open/floor/iron/dark,
/area/station/engineering/supermatter/room)
"Tc" = (
/obj/effect/spawner/structure/window/reinforced/plasma,
/turf/open/floor/plating,
/area/station/engineering/supermatter/room)
"Tz" = (
/obj/effect/turf_decal/stripes/line{
	dir = 4
	},
/turf/open/floor/engine,
/area/station/engineering/supermatter/room)
"TW" = (
/obj/effect/spawner/structure/window/reinforced/plasma,
/obj/machinery/atmospherics/pipe/smart/manifold4w/scrubbers/visible,
/turf/open/floor/plating,
/area/station/engineering/supermatter/room)
"Ud" = (
/obj/structure/cable,
/obj/machinery/light/directional/south,
/turf/open/floor/iron/dark,
/area/station/engineering/supermatter/room)
"Va" = (
/obj/machinery/door/airlock/external/glass/emp_proof,
/obj/effect/mapping_helpers/airlock/cyclelink_helper{
	dir = 4
	},
/turf/open/floor/plating,
/area/station/engineering/supermatter/room)
"WL" = (
/obj/machinery/atmospherics/pipe/smart/manifold4w/scrubbers/visible,
/turf/open/floor/plating/snowed/icemoon,
/area/icemoon/surface/outdoors/nospawn)
"WP" = (
/obj/machinery/button/door/directional/west{
	id = "engsm"
	},
/turf/open/floor/iron/dark,
/area/station/engineering/supermatter/room)
"XM" = (
/obj/structure/closet/emcloset/anchored,
/obj/machinery/light/small/directional/west,
/turf/open/floor/plating,
/area/station/engineering/supermatter/room)
"XV" = (
/turf/open/floor/plating,
/area/station/engineering/supermatter/room)
"Yk" = (
/obj/machinery/door/firedoor,
/obj/structure/cable,
/obj/machinery/door/airlock/engineering/glass{
	name = "Supermatter Engine Room"
	},
/obj/effect/mapping_helpers/airlock/access/all/engineering/general,
/turf/open/floor/engine,
/area/station/engineering/supermatter/room)
"YF" = (
/obj/effect/turf_decal/stripes/line{
	dir = 4
	},
/obj/structure/cable,
/turf/open/floor/engine,
/area/station/engineering/supermatter/room)
"ZJ" = (
/obj/structure/particle_accelerator/particle_emitter/right,
/obj/effect/turf_decal/stripes/line{
	dir = 6
	},
/obj/structure/cable,
/turf/open/floor/engine,
/area/station/engineering/supermatter/room)

(1,1,1) = {"
Lk
Tc
Qq
Tc
ye
ye
ye
uF
ye
ye
uF
va
va
va
OQ
OQ
OQ
OQ
OQ
OQ
OQ
"}
(2,1,1) = {"
Tc
Tc
lx
lx
JM
lx
Dp
ff
ye
XM
ye
dB
dB
va
va
va
va
va
va
va
va
"}
(3,1,1) = {"
ye
FK
lx
lx
lx
lx
lx
lx
ti
XV
Ar
dB
aR
Jb
Jb
Jb
Jb
Jb
aR
Jb
va
"}
(4,1,1) = {"
Tc
lx
lx
RT
lx
lx
lx
lx
ye
qS
ye
dB
xq
dB
dB
dB
dB
dB
PW
Jb
va
"}
(5,1,1) = {"
Tc
lx
ye
ye
ya
ya
ya
ya
ye
ye
ye
Jb
Qw
gQ
Jb
gQ
Jb
gQ
PW
Jb
va
"}
(6,1,1) = {"
Ks
yt
vi
mZ
QA
QA
QA
QA
mZ
Al
Jb
Jb
Pi
dV
dV
dB
dV
dV
Pi
Jb
va
"}
(7,1,1) = {"
ye
vu
ya
XV
XV
XV
XV
XV
yc
Tc
dB
Jb
dV
dB
dB
dB
dB
dB
dV
Jb
va
"}
(8,1,1) = {"
Yk
ub
ya
XV
FE
hz
hz
bx
uy
Tc
dB
Jb
dV
dB
dB
dB
dB
dB
dV
Jb
va
"}
(9,1,1) = {"
Tc
ml
ya
XV
rf
LX
Jk
dS
uy
Tc
dB
Jb
dB
dB
dB
KY
dB
dB
dB
Jb
va
"}
(10,1,1) = {"
PC
Jh
ya
XV
Oy
YF
Tz
ZJ
uy
Tc
dB
Jb
dV
dB
dB
dB
dB
dB
dV
Jb
va
"}
(11,1,1) = {"
ye
lx
ya
XV
XV
QA
XV
XV
aJ
Tc
dB
Jb
dV
dB
dB
dB
dB
dB
dV
Jb
va
"}
(12,1,1) = {"
ye
sj
ye
MX
XV
QA
XV
XV
MX
Tc
dB
Jb
Pi
dV
dV
dB
dV
dV
Pi
Jb
va
"}
(13,1,1) = {"
Tc
lx
ye
ye
ya
Sl
ya
ya
ye
ye
dB
Jb
Nj
gQ
Jb
gQ
Jb
gQ
PW
Jb
va
"}
(14,1,1) = {"
Tc
lx
lx
WP
lx
vu
lx
lx
lx
ye
Va
ye
PW
dB
dB
dB
dB
dB
PW
Jb
va
"}
(15,1,1) = {"
ye
Pv
vu
vu
vu
vu
vu
vu
Ud
vi
tI
vi
JK
Jb
Jb
Jb
Jb
Jb
JK
Jb
va
"}
(16,1,1) = {"
Tc
Tc
vu
lx
lx
lx
lx
lx
lx
ye
kp
ye
ye
ye
va
va
va
va
va
va
va
"}
(17,1,1) = {"
Lk
Tc
Yk
fE
ye
ye
ye
lx
lx
lx
lx
lx
Ps
TW
WL
WL
WL
WL
WL
WL
Rp
"}
(18,1,1) = {"
eG
dx
wK
rB
xb
Tc
lx
lx
lx
lx
lx
lx
jE
ye
OQ
OQ
OQ
OQ
OQ
OQ
OQ
"}
(19,1,1) = {"
Cx
Cx
pc
AF
Ae
SM
MJ
lx
lx
MJ
lx
lx
ce
ye
OQ
OQ
OQ
OQ
OQ
OQ
nR
"}
(20,1,1) = {"
Cx
hw
cj
Bv
nS
ye
ye
ye
ye
ye
Tc
Tc
Tc
ye
OQ
OQ
OQ
OQ
OQ
OQ
nR
"}
