//MAP CONVERTED BY dmm2tgm.py THIS HEADER COMMENT PREVENTS RECONVERSION, DO NOT REMOVE
"bI" = (
/obj/structure/cable,
/turf/open/floor/iron/dark,
/area/station/engineering/supermatter/room)
"bR" = (
/obj/structure/table/reinforced,
/obj/machinery/airalarm/directional/north,
/turf/open/floor/iron/dark,
/area/station/engineering/supermatter/room)
"cS" = (
/obj/effect/turf_decal/stripes/line{
	dir = 9
	},
/obj/structure/particle_accelerator/particle_emitter/left{
	dir = 4
	},
/turf/open/floor/engine,
/area/station/engineering/supermatter/room)
"dU" = (
/obj/structure/cable,
/obj/effect/turf_decal/stripes/red/full,
/turf/open/floor/plating,
/area/icemoon/surface/outdoors/nospawn)
"el" = (
/obj/effect/turf_decal/stripes/red/line{
	dir = 4
	},
/turf/open/floor/plating,
/area/station/engineering/supermatter/room)
"fc" = (
/obj/machinery/atmospherics/components/unary/passive_vent{
	dir = 1
	},
/turf/open/floor/plating/snowed/icemoon,
/area/icemoon/surface/outdoors/nospawn)
"fl" = (
/obj/structure/cable,
/obj/effect/turf_decal/stripes/line{
	dir = 8
	},
/turf/open/floor/iron/dark,
/area/station/engineering/supermatter/room)
"fE" = (
/obj/structure/cable,
/turf/open/floor/plating,
/area/station/engineering/supermatter/room)
"gz" = (
/obj/structure/cable,
/obj/machinery/light/directional/north,
/turf/open/floor/iron/dark,
/area/station/engineering/supermatter/room)
"gK" = (
/obj/machinery/door/firedoor,
/obj/machinery/door/airlock/engineering/glass{
	name = "Supermatter Engine Room"
	},
/obj/machinery/atmospherics/pipe/smart/manifold4w/supply/hidden/layer4,
/obj/effect/mapping_helpers/airlock/access/all/engineering/general,
/turf/open/floor/iron/dark,
/area/station/engineering/supermatter/room)
"hg" = (
/obj/machinery/atmospherics/pipe/smart/manifold4w/supply/hidden/layer4,
/obj/effect/decal/cleanable/dirt,
/obj/structure/cable,
/turf/open/floor/iron,
/area/station/engineering/storage_shared)
"hS" = (
/obj/machinery/field/generator/singularity,
/obj/effect/turf_decal/bot_red,
/turf/open/floor/plating,
/area/icemoon/surface/outdoors/nospawn)
"iC" = (
/obj/machinery/door/airlock/external/glass/emp_proof,
/obj/effect/mapping_helpers/airlock/cyclelink_helper{
	dir = 8
	},
/turf/open/floor/plating,
/area/station/engineering/supermatter/room)
"iH" = (
/turf/open/floor/plating,
/area/icemoon/surface/outdoors/nospawn)
"jb" = (
/obj/effect/turf_decal/caution/red{
	dir = 1
	},
/obj/effect/turf_decal/caution/red,
/turf/open/floor/plating,
/area/icemoon/surface/outdoors/nospawn)
"jw" = (
/obj/effect/spawner/structure/window/reinforced/plasma,
/turf/open/floor/plating,
/area/station/engineering/supermatter/room)
"jU" = (
/obj/machinery/atmospherics/components/unary/vent_pump/on/layer4{
	dir = 8
	},
/turf/open/floor/iron/large,
/area/station/engineering/storage_shared)
"kL" = (
/obj/machinery/power/emitter{
	dir = 8
	},
/obj/structure/cable,
/obj/effect/turf_decal/bot_white,
/turf/open/floor/plating,
/area/icemoon/surface/outdoors/nospawn)
"lV" = (
/obj/structure/cable,
/obj/structure/particle_accelerator/particle_emitter/center,
/turf/open/floor/engine,
/area/station/engineering/supermatter/room)
"mc" = (
/obj/effect/turf_decal/stripes/line{
	dir = 6
	},
/obj/structure/cable,
/turf/open/floor/engine,
/area/station/engineering/supermatter/room)
"mG" = (
/obj/structure/cable,
/turf/closed/wall/r_wall,
/area/station/engineering/supermatter/room)
"mZ" = (
/obj/machinery/door/firedoor,
/obj/structure/cable,
/obj/machinery/door/airlock/engineering/glass{
	name = "Supermatter Engine Room"
	},
/obj/effect/mapping_helpers/airlock/access/all/engineering/general,
/turf/open/floor/engine,
/area/station/engineering/supermatter/room)
"nh" = (
/obj/effect/turf_decal/stripes/line{
	dir = 10
	},
/obj/structure/cable,
/obj/structure/particle_accelerator/particle_emitter/right,
/turf/open/floor/engine,
/area/station/engineering/supermatter/room)
"oQ" = (
/obj/machinery/button/door/directional/west{
	id = "engsm";
	name = "Radiation Shutters Control"
	},
/turf/open/floor/iron/dark,
/area/station/engineering/supermatter/room)
"oT" = (
/obj/machinery/atmospherics/pipe/smart/manifold4w/supply/hidden/layer4,
/obj/effect/turf_decal/stripes/line,
/turf/open/floor/iron/dark,
/area/station/engineering/supermatter/room)
"oW" = (
/obj/machinery/atmospherics/pipe/heat_exchanging/junction{
	dir = 8
	},
/turf/closed/wall/r_wall,
/area/station/engineering/supermatter/room)
"pc" = (
/obj/machinery/atmospherics/pipe/smart/manifold4w/scrubbers/visible,
/turf/open/floor/plating/snowed/icemoon,
/area/icemoon/surface/outdoors/nospawn)
"pL" = (
/turf/open/floor/plating,
/area/station/engineering/supermatter/room)
"qC" = (
/obj/machinery/light/directional/east,
/turf/open/floor/plating,
/area/station/engineering/supermatter/room)
"qY" = (
/obj/effect/turf_decal/stripes/line{
	dir = 1
	},
/obj/structure/cable,
/turf/open/floor/engine,
/area/station/engineering/supermatter/room)
"ro" = (
/obj/effect/turf_decal/stripes/red/line{
	dir = 8
	},
/turf/open/floor/plating,
/area/station/engineering/supermatter/room)
"rF" = (
/obj/machinery/button/door/directional/east{
	id = "engsm";
	name = "Radiation Shutters Control";
	req_access = list("engineering")
	},
/turf/open/floor/iron/dark,
/area/station/engineering/supermatter/room)
"sK" = (
/obj/item/screwdriver,
/turf/open/floor/plating,
/area/station/engineering/supermatter/room)
"tB" = (
/obj/structure/table/reinforced,
/obj/item/storage/toolbox/mechanical,
/obj/item/analyzer,
/obj/item/pipe_dispenser,
/obj/item/flashlight,
/turf/open/floor/iron/dark,
/area/station/engineering/supermatter/room)
"ud" = (
/obj/machinery/door/airlock/external/glass/emp_proof,
/obj/effect/mapping_helpers/airlock/cyclelink_helper{
	dir = 1
	},
/turf/open/floor/plating,
/area/station/engineering/supermatter/room)
"uN" = (
/obj/structure/cable,
/obj/machinery/atmospherics/pipe/smart/manifold4w/supply/hidden/layer4,
/obj/machinery/door/airlock/engineering/glass{
	name = "Engineering Secondary Storage"
	},
/obj/machinery/door/firedoor,
/obj/machinery/atmospherics/pipe/smart/manifold4w/scrubbers/hidden/layer2,
/obj/effect/mapping_helpers/airlock/access/any/engineering/construction,
/obj/effect/mapping_helpers/airlock/access/any/engineering/general,
/turf/open/floor/iron,
/area/station/engineering/storage_shared)
"uQ" = (
/obj/effect/turf_decal/stripes/line{
	dir = 8
	},
/obj/structure/particle_accelerator/power_box{
	dir = 4
	},
/turf/open/floor/engine,
/area/station/engineering/supermatter/room)
"uV" = (
/obj/structure/lattice/catwalk,
/turf/open/floor/plating,
/area/icemoon/surface/outdoors/nospawn)
"vk" = (
/obj/structure/sign/warning/directional,
/turf/closed/wall/r_wall,
/area/icemoon/surface/outdoors/nospawn)
"vR" = (
/obj/machinery/door/airlock/external/glass/emp_proof,
/obj/effect/mapping_helpers/airlock/cyclelink_helper{
	dir = 4
	},
/turf/open/floor/plating,
/area/station/engineering/supermatter/room)
"vU" = (
/turf/closed/wall/r_wall,
/area/icemoon/surface/outdoors/nospawn)
"wl" = (
/obj/effect/spawner/structure/window/reinforced/plasma,
/obj/machinery/atmospherics/pipe/smart/manifold4w/orange/visible,
/turf/open/floor/plating,
/area/station/engineering/supermatter/room)
"wA" = (
/obj/machinery/door/firedoor,
/obj/machinery/door/airlock/engineering/glass{
	name = "Supermatter Engine Room"
	},
/obj/machinery/atmospherics/pipe/smart/manifold4w/scrubbers/hidden/layer2,
/obj/machinery/atmospherics/pipe/smart/manifold4w/supply/hidden/layer4,
/obj/effect/mapping_helpers/airlock/access/all/engineering/general,
/turf/open/floor/engine,
/area/station/engineering/supermatter/room)
"wI" = (
/obj/structure/rack,
/obj/item/clothing/mask/gas{
	pixel_x = 3;
	pixel_y = 3
	},
/obj/item/clothing/mask/gas,
/obj/item/clothing/mask/gas{
	pixel_x = -3;
	pixel_y = -3
	},
/obj/machinery/atmospherics/pipe/smart/manifold4w/orange/visible,
/obj/effect/turf_decal/tile/yellow/half/contrasted{
	dir = 8
	},
/obj/machinery/light/small/directional/west,
/turf/open/floor/iron,
/area/station/engineering/storage_shared)
"wJ" = (
/turf/open/misc/asteroid/snow/icemoon,
/area/icemoon/surface/outdoors/nospawn)
"wM" = (
/obj/machinery/atmospherics/pipe/smart/manifold4w/orange/visible,
/obj/machinery/meter,
/obj/effect/turf_decal/tile/yellow{
	dir = 8
	},
/turf/open/floor/iron,
/area/station/engineering/storage_shared)
"xn" = (
/obj/structure/cable,
/obj/machinery/atmospherics/pipe/smart/manifold4w/supply/hidden/layer4,
/obj/machinery/atmospherics/pipe/smart/manifold4w/scrubbers/hidden/layer2,
/turf/open/floor/iron,
/area/station/engineering/main)
"xV" = (
/obj/effect/turf_decal/caution/red,
/obj/effect/turf_decal/caution/red{
	dir = 1
	},
/turf/open/floor/plating,
/area/icemoon/surface/outdoors/nospawn)
"zo" = (
/obj/machinery/atmospherics/pipe/smart/manifold4w/supply/hidden/layer4,
/obj/machinery/atmospherics/pipe/smart/manifold4w/orange/visible,
/obj/structure/cable,
/turf/open/floor/iron,
/area/station/engineering/storage_shared)
"zT" = (
/obj/machinery/light/directional/east,
/turf/open/floor/iron/dark,
/area/station/engineering/supermatter/room)
"CA" = (
/obj/structure/cable,
/obj/machinery/light/directional/west,
/turf/open/floor/plating,
/area/station/engineering/supermatter/room)
"CO" = (
/obj/structure/closet/firecloset,
/turf/open/floor/iron/dark,
/area/station/engineering/supermatter/room)
"Dt" = (
/obj/effect/turf_decal/stripes/line{
	dir = 8
	},
/turf/open/floor/iron/dark,
/area/station/engineering/supermatter/room)
"EB" = (
/obj/machinery/singularity_generator,
/obj/item/wrench,
/turf/open/floor/plating,
/area/icemoon/surface/outdoors/nospawn)
"EI" = (
/obj/structure/cable,
/obj/effect/turf_decal/stripes/line,
/turf/open/floor/iron/dark,
/area/station/engineering/supermatter/room)
"EV" = (
/obj/structure/grille,
/turf/open/misc/asteroid/snow/icemoon,
/area/icemoon/surface/outdoors/nospawn)
"EZ" = (
/obj/structure/cable,
/turf/open/floor/engine,
/area/station/engineering/supermatter/room)
"Fr" = (
/turf/closed/wall/r_wall,
/area/station/engineering/storage_shared)
"FI" = (
/obj/item/stack/cable_coil,
/turf/open/floor/plating,
/area/station/engineering/supermatter/room)
"FM" = (
/obj/machinery/light/directional/south,
/obj/structure/tank_dispenser,
/turf/open/floor/iron/dark,
/area/station/engineering/supermatter/room)
"FX" = (
/obj/effect/turf_decal/caution/stand_clear/red,
/turf/open/floor/plating,
/area/station/engineering/supermatter/room)
"Hp" = (
/obj/machinery/door/airlock/external/glass/emp_proof,
/obj/effect/mapping_helpers/airlock/cyclelink_helper,
/turf/open/floor/plating,
/area/station/engineering/supermatter/room)
"HN" = (
/obj/structure/reagent_dispensers/fueltank/large,
/turf/open/floor/iron/dark,
/area/station/engineering/supermatter/room)
"HR" = (
/obj/structure/cable,
/turf/open/floor/plating,
/area/icemoon/surface/outdoors/nospawn)
"IV" = (
/obj/structure/sign/warning/radiation,
/turf/closed/wall/r_wall,
/area/station/engineering/supermatter/room)
"JY" = (
/obj/effect/spawner/structure/window/reinforced/plasma,
/obj/machinery/atmospherics/pipe/smart/manifold4w/scrubbers/visible,
/turf/open/floor/plating,
/area/station/engineering/supermatter/room)
"Kp" = (
/obj/structure/cable,
/obj/machinery/atmospherics/components/unary/vent_pump/on/layer4{
	dir = 4
	},
/obj/effect/turf_decal/stripes/line,
/turf/open/floor/iron/dark,
/area/station/engineering/supermatter/room)
"KY" = (
/obj/machinery/door/firedoor,
/obj/machinery/door/airlock/engineering/glass{
	name = "Supermatter Engine Room"
	},
/obj/machinery/atmospherics/pipe/smart/manifold4w/scrubbers/hidden/layer2,
/obj/effect/mapping_helpers/airlock/access/all/engineering/general,
/turf/open/floor/engine,
/area/station/engineering/supermatter/room)
"Li" = (
/obj/machinery/light/directional/north,
/turf/open/floor/iron/dark,
/area/station/engineering/supermatter/room)
"Lu" = (
/obj/effect/turf_decal/stripes/line,
/obj/machinery/firealarm/directional/north,
/turf/open/floor/iron/dark,
/area/station/engineering/supermatter/room)
"Md" = (
/obj/machinery/atmospherics/components/unary/vent_scrubber/on/layer2{
	dir = 1
	},
/obj/machinery/atmospherics/pipe/smart/manifold4w/supply/hidden/layer4,
/obj/effect/turf_decal/stripes/line,
/turf/open/floor/iron/dark,
/area/station/engineering/supermatter/room)
"MK" = (
/obj/structure/cable,
/obj/machinery/power/energy_accumulator/rad_collector,
/obj/effect/turf_decal/bot_blue,
/turf/open/floor/plating,
/area/icemoon/surface/outdoors/nospawn)
"ND" = (
/obj/machinery/light/small/directional/north,
/obj/structure/cable,
/obj/structure/sign/warning/vacuum/external/directional/north,
/turf/open/floor/plating,
/area/station/engineering/supermatter/room)
"NF" = (
/obj/structure/tank_dispenser,
/turf/open/floor/iron/dark,
/area/station/engineering/supermatter/room)
"NT" = (
/obj/effect/turf_decal/stripes/red/full,
/turf/open/floor/plating,
/area/icemoon/surface/outdoors/nospawn)
"NZ" = (
/obj/machinery/power/apc/auto_name/emp_proof/directional/east,
/obj/structure/cable,
/obj/effect/mapping_helpers/apc/cell_10k,
/turf/open/floor/iron/dark,
/area/station/engineering/supermatter/room)
"Of" = (
/obj/machinery/power/emitter{
	dir = 4
	},
/obj/structure/cable,
/obj/effect/turf_decal/bot_white,
/turf/open/floor/plating,
/area/icemoon/surface/outdoors/nospawn)
"Op" = (
/obj/effect/turf_decal/stripes/line{
	dir = 4
	},
/obj/structure/particle_accelerator/end_cap,
/turf/open/floor/engine,
/area/station/engineering/supermatter/room)
"OD" = (
/turf/open/floor/iron/dark,
/area/station/engineering/supermatter/room)
"OI" = (
/obj/effect/turf_decal/stripes/line{
	dir = 5
	},
/obj/structure/particle_accelerator/fuel_chamber{
	dir = 4
	},
/turf/open/floor/engine,
/area/station/engineering/supermatter/room)
"Pd" = (
/obj/effect/spawner/structure/window/reinforced/plasma,
/obj/structure/cable,
/turf/open/floor/plating,
/area/station/engineering/supermatter/room)
"Pv" = (
/obj/machinery/light/directional/west,
/obj/structure/closet/crate/bin,
/turf/open/floor/iron/dark,
/area/station/engineering/supermatter/room)
"Qc" = (
/obj/effect/turf_decal/stripes/line,
/obj/structure/cable,
/turf/open/floor/engine,
/area/station/engineering/supermatter/room)
"Qp" = (
/obj/machinery/door/poddoor/shutters/radiation/preopen{
	id = "engsm";
	name = "Radiation Chamber Shutters"
	},
/turf/open/floor/plating,
/area/station/engineering/supermatter/room)
"Qs" = (
/obj/structure/closet/emcloset/anchored,
/obj/machinery/light/small/directional/west,
/obj/structure/sign/warning/vacuum/external/directional/north,
/turf/open/floor/plating,
/area/station/engineering/supermatter/room)
"Rr" = (
/turf/open/floor/iron,
/area/station/engineering/main)
"Sk" = (
/obj/structure/cable,
/obj/machinery/light/directional/south,
/turf/open/floor/iron/dark,
/area/station/engineering/supermatter/room)
"SR" = (
/obj/machinery/atmospherics/pipe/smart/manifold4w/supply/hidden/layer4,
/obj/machinery/power/apc/auto_name/directional/north,
/obj/structure/cable,
/obj/effect/turf_decal/siding/yellow/corner{
	dir = 4
	},
/obj/machinery/light_switch/directional/north{
	pixel_x = 12
	},
/obj/machinery/atmospherics/pipe/smart/manifold4w/scrubbers/hidden/layer2,
/turf/open/floor/iron,
/area/station/engineering/storage_shared)
"SU" = (
/obj/machinery/incident_display/delam,
/turf/closed/wall/r_wall,
/area/station/engineering/supermatter/room)
"Th" = (
/obj/effect/turf_decal/stripes/line{
	dir = 4
	},
/obj/structure/cable,
/turf/open/floor/engine,
/area/station/engineering/supermatter/room)
"Uz" = (
/obj/structure/closet/emcloset/anchored,
/obj/structure/sign/warning/vacuum/external/directional/north,
/turf/open/floor/plating,
/area/station/engineering/supermatter/room)
"UP" = (
/obj/effect/turf_decal/stripes/line{
	dir = 4
	},
/turf/open/floor/iron/dark,
/area/station/engineering/supermatter/room)
"UZ" = (
/obj/machinery/vending/wardrobe/engi_wardrobe,
/obj/machinery/computer/security/telescreen/entertainment/directional/north,
/turf/open/floor/iron/dark,
/area/station/engineering/storage_shared)
"Ve" = (
/turf/closed/wall/r_wall,
/area/station/engineering/supermatter/room)
"Vg" = (
/obj/effect/turf_decal/stripes/line{
	dir = 4
	},
/obj/machinery/camera/directional/south{
	c_tag = "Engineering Supermatter Fore";
	network = list("ss13","engine");
	pixel_x = 23
	},
/turf/open/floor/iron/dark,
/area/station/engineering/supermatter/room)
"VD" = (
/obj/structure/cable,
/obj/machinery/atmospherics/pipe/smart/manifold4w/supply/hidden/layer4,
/obj/machinery/atmospherics/pipe/smart/manifold4w/scrubbers/hidden/layer2,
/turf/open/floor/iron,
/area/station/engineering/storage_shared)
"VK" = (
/obj/machinery/atmospherics/pipe/smart/manifold4w/orange/visible,
/obj/structure/cable,
/obj/effect/turf_decal/tile/yellow,
/obj/machinery/atmospherics/pipe/smart/manifold4w/supply/hidden/layer4,
/turf/open/floor/iron,
/area/station/engineering/storage_shared)
"VZ" = (
/obj/item/wrench,
/turf/open/floor/plating,
/area/station/engineering/supermatter/room)
"Wj" = (
/obj/machinery/door/poddoor/shutters/radiation/preopen{
	id = "engsm";
	name = "Radiation Chamber Shutters"
	},
/obj/structure/cable,
/turf/open/floor/plating,
/area/station/engineering/supermatter/room)
"WM" = (
/obj/effect/turf_decal/stripes/line{
	dir = 8
	},
/turf/open/floor/engine,
/area/station/engineering/supermatter/room)
"XF" = (
/obj/effect/turf_decal/siding/yellow{
	dir = 1
	},
/obj/effect/decal/cleanable/dirt,
/obj/machinery/atmospherics/pipe/smart/manifold4w/scrubbers/hidden/layer2,
/turf/open/floor/iron,
/area/station/engineering/storage_shared)
"Zy" = (
/obj/item/radio/intercom/directional/west,
/obj/machinery/light/directional/west,
/turf/open/floor/iron/dark,
/area/station/engineering/supermatter/room)

(1,1,1) = {"
Rr
jw
KY
jw
Ve
Ve
Ve
oW
Ve
Ve
oW
vU
vU
vU
wJ
wJ
wJ
wJ
wJ
wJ
wJ
"}
(2,1,1) = {"
jw
jw
OD
OD
Zy
OD
OD
Pv
Ve
Qs
Ve
iH
iH
vU
vk
vU
vU
vk
vU
vU
vU
"}
(3,1,1) = {"
Ve
bR
OD
OD
OD
OD
OD
OD
Hp
pL
ud
iH
Of
HR
HR
HR
HR
HR
Of
HR
vU
"}
(4,1,1) = {"
jw
OD
OD
rF
UP
UP
UP
Vg
Ve
Uz
Ve
iH
xV
iH
iH
iH
iH
iH
jb
HR
vU
"}
(5,1,1) = {"
jw
OD
IV
Ve
Qp
Qp
Qp
Qp
IV
Ve
IV
HR
dU
MK
HR
MK
HR
MK
NT
HR
vk
"}
(6,1,1) = {"
SU
gz
mG
CA
fE
fE
fE
fE
CA
Pd
HR
HR
hS
uV
uV
iH
uV
uV
hS
HR
vU
"}
(7,1,1) = {"
Ve
EI
Qp
pL
pL
pL
FI
pL
el
jw
iH
HR
uV
iH
iH
iH
iH
iH
uV
HR
vU
"}
(8,1,1) = {"
mZ
Kp
Qp
pL
cS
uQ
WM
nh
FX
jw
iH
HR
uV
iH
iH
iH
iH
iH
uV
HR
vU
"}
(9,1,1) = {"
jw
oT
Qp
pL
qY
lV
EZ
Qc
FX
jw
iH
HR
iH
iH
iH
EB
iH
iH
iH
HR
vU
"}
(10,1,1) = {"
wA
Md
Qp
pL
OI
Th
Op
mc
FX
jw
iH
HR
uV
iH
iH
iH
iH
iH
uV
HR
vU
"}
(11,1,1) = {"
Ve
Lu
Qp
VZ
pL
fE
pL
pL
ro
jw
iH
HR
uV
iH
iH
iH
iH
iH
uV
HR
vU
"}
(12,1,1) = {"
Ve
Li
Ve
qC
pL
fE
pL
sK
qC
jw
iH
HR
hS
uV
uV
iH
uV
uV
hS
HR
vU
"}
(13,1,1) = {"
jw
OD
IV
Ve
Qp
Wj
Qp
Qp
IV
Ve
iH
HR
dU
MK
HR
MK
HR
MK
NT
HR
vk
"}
(14,1,1) = {"
jw
OD
OD
oQ
Dt
fl
Dt
Dt
OD
Ve
vR
IV
jb
iH
iH
iH
iH
iH
jb
HR
vU
"}
(15,1,1) = {"
Ve
tB
bI
bI
bI
bI
bI
bI
Sk
mG
ND
mG
kL
HR
HR
HR
HR
HR
kL
HR
vU
"}
(16,1,1) = {"
jw
jw
bI
OD
OD
NZ
OD
OD
OD
Ve
iC
Ve
Ve
Ve
vk
vU
vU
vk
vU
vU
vU
"}
(17,1,1) = {"
Rr
jw
mZ
wl
Ve
Ve
Ve
OD
OD
OD
OD
OD
CO
JY
pc
pc
pc
pc
pc
pc
fc
"}
(18,1,1) = {"
xn
uN
VD
wM
wI
jw
HN
OD
OD
OD
OD
OD
FM
Ve
wJ
wJ
wJ
wJ
wJ
wJ
wJ
"}
(19,1,1) = {"
Fr
Fr
SR
hg
zo
gK
zT
OD
OD
zT
OD
OD
NF
Ve
wJ
wJ
wJ
wJ
wJ
wJ
EV
"}
(20,1,1) = {"
Fr
UZ
XF
jU
VK
Ve
Ve
Ve
Ve
Ve
jw
jw
jw
Ve
wJ
wJ
wJ
wJ
wJ
wJ
EV
"}
