//MAP CONVERTED BY dmm2tgm.py THIS HEADER COMMENT PREVENTS RECONVERSION, DO NOT REMOVE
"a" = (
/turf/template_noop,
/area/template_noop)
"c" = (
/turf/open/floor/iron/dark,
/area/ruin)
"r" = (
/turf/closed/mineral/random/asteroid,
/area/ruin)
"w" = (
/obj/structure/shuttle/engine/propulsion{
	dir = 1
	},
/turf/open/space/basic,
/area/ruin)
"z" = (
/obj/structure/mecha_wreckage/ripley/mk2,
/turf/open/floor/plating/airless,
/area/ruin)
"F" = (
/turf/closed/wall/r_wall,
/area/ruin)
"G" = (
/turf/open/floor/plating/airless,
/area/ruin)
"I" = (
/obj/structure/mecha_wreckage/ripley/mk2,
/turf/open/floor/iron/dark,
/area/ruin)
"R" = (
/turf/closed/mineral/random/high_chance,
/area/ruin)
"S" = (
/obj/structure/mecha_wreckage/ripley/firefighter,
/turf/open/floor/iron/dark,
/area/ruin)
"W" = (
/obj/structure/mecha_wreckage/phazon,
/turf/open/floor/plating/airless,
/area/ruin)
"Y" = (
/obj/structure/mecha_wreckage/clarke,
/turf/open/floor/plating/airless,
/area/ruin)
"Z" = (
/obj/structure/lattice,
/turf/template_noop,
/area/ruin)

(1,1,1) = {"
a
a
a
r
a
a
r
r
r
r
r
r
r
a
a
a
a
a
a
a
a
a
"}
(2,1,1) = {"
a
a
a
r
r
r
r
R
R
R
R
R
r
r
a
a
a
a
a
a
r
r
"}
(3,1,1) = {"
a
w
F
F
F
F
r
r
r
r
r
r
r
a
a
a
a
r
r
r
r
r
"}
(4,1,1) = {"
a
w
F
c
G
G
Z
r
r
F
F
r
r
r
a
a
a
r
r
r
r
a
"}
(5,1,1) = {"
a
a
a
Z
Z
Z
a
r
r
S
F
F
F
F
a
a
F
F
r
r
r
r
"}
(6,1,1) = {"
a
a
a
a
F
F
c
a
Z
c
F
F
G
G
Z
Z
c
F
F
F
r
r
"}
(7,1,1) = {"
a
a
a
a
a
F
I
c
Z
Z
a
F
G
c
c
Z
G
Z
G
F
r
r
"}
(8,1,1) = {"
a
a
a
r
r
F
G
c
Z
c
a
F
c
Z
c
G
G
G
Z
F
r
r
"}
(9,1,1) = {"
a
a
a
r
R
F
G
c
c
R
r
a
Z
Z
G
c
Z
G
G
F
r
r
"}
(10,1,1) = {"
a
a
r
R
R
F
c
c
R
r
r
a
a
Z
G
c
G
Z
G
F
r
r
"}
(11,1,1) = {"
a
a
r
R
R
F
Z
Z
r
r
a
Z
a
a
c
Z
Z
G
G
F
r
a
"}
(12,1,1) = {"
a
a
r
r
R
R
a
r
r
a
Z
G
Z
a
c
Z
a
G
G
F
a
a
"}
(13,1,1) = {"
a
a
Z
Z
a
r
r
r
R
Z
G
W
Z
Z
a
a
a
F
F
F
a
a
"}
(14,1,1) = {"
a
a
z
G
Z
a
r
r
R
R
F
F
F
F
F
F
F
F
a
a
a
a
"}
(15,1,1) = {"
a
w
F
G
Y
Z
a
r
R
R
R
r
r
r
r
r
a
a
a
a
a
a
"}
(16,1,1) = {"
a
w
F
F
G
Z
a
a
a
a
R
R
r
r
r
r
a
a
a
a
a
a
"}
(17,1,1) = {"
a
a
a
a
a
a
a
a
a
a
a
a
a
a
a
a
a
a
a
a
a
a
"}
(18,1,1) = {"
a
a
a
a
a
a
a
a
a
a
a
a
a
a
a
a
a
a
a
a
a
a
"}
