//MAP CONVERTED BY dmm2tgm.py THIS HEADER COMMENT PREVENTS RECONVERSION, DO NOT REMOVE
"bo" = (
/obj/effect/turf_decal/bot,
/obj/structure/closet/crate,
/obj/effect/spawner/lootdrop/space/fancytech,
/turf/open/floor/iron,
/area/ruin)
"bK" = (
/turf/closed/mineral/random/asteroid,
/area/ruin)
"eN" = (
/obj/structure/closet/crate/freezer/blood,
/obj/effect/turf_decal/bot,
/turf/open/floor/iron,
/area/ruin)
"fu" = (
/obj/effect/mob_spawn/human/miner/explorer,
/turf/open/floor/iron,
/area/ruin)
"fD" = (
/obj/effect/turf_decal/bot,
/obj/structure/closet/crate,
/obj/effect/spawner/lootdrop/memeorgans,
/obj/effect/spawner/lootdrop/memeorgans,
/obj/effect/spawner/lootdrop/memeorgans,
/obj/effect/spawner/lootdrop/memeorgans,
/turf/open/floor/iron,
/area/ruin)
"hM" = (
/obj/effect/spawner/lootdrop/whiteship_cere_ripley,
/turf/open/floor/iron,
/area/ruin)
"hV" = (
/obj/structure/window/reinforced,
/turf/open/floor/iron,
/area/ruin)
"iM" = (
/obj/effect/turf_decal/bot,
/turf/open/floor/iron,
/area/ruin)
"jW" = (
/obj/effect/turf_decal/bot,
/obj/structure/closet/crate/secure/loot,
/turf/open/floor/iron,
/area/ruin)
"kE" = (
/obj/machinery/computer{
	dir = 8
	},
/turf/open/floor/iron,
/area/ruin)
"lw" = (
/obj/machinery/door/window,
/turf/open/floor/iron,
/area/ruin)
"lz" = (
/obj/structure/chair/comfy/shuttle{
	dir = 4
	},
/obj/effect/mob_spawn/human/corpse/cargo_tech,
/turf/open/floor/iron,
/area/ruin)
"lN" = (
/obj/structure/bed,
/obj/structure/curtain,
/turf/open/floor/iron,
/area/ruin)
"mm" = (
/obj/structure/chair/comfy/shuttle{
	dir = 1
	},
/turf/open/floor/iron,
/area/ruin)
"nX" = (
/obj/structure/chair/comfy/shuttle,
/turf/open/floor/iron,
/area/ruin)
"pj" = (
/obj/structure/chair/comfy/shuttle{
	dir = 4
	},
/turf/open/floor/iron,
/area/ruin)
"pz" = (
/obj/structure/table/reinforced,
/obj/item/storage/box/drinkingglasses,
/turf/open/floor/iron,
/area/ruin)
"qQ" = (
/obj/effect/turf_decal/bot,
/obj/structure/closet/crate/secure/tradership_cargo_valuable,
/turf/open/floor/iron,
/area/ruin)
"rf" = (
/obj/structure/window/reinforced{
	dir = 4
	},
/turf/open/floor/iron,
/area/ruin)
"sY" = (
/turf/closed/wall/mineral/titanium,
/area/ruin)
"te" = (
/mob/living/simple_animal/hostile/hivebot,
/turf/open/floor/iron,
/area/ruin)
"tT" = (
/obj/effect/mob_spawn/human/corpse/damaged,
/turf/open/floor/iron,
/area/ruin)
"tW" = (
/obj/structure/closet/crate/internals,
/obj/effect/turf_decal/bot,
/turf/open/floor/iron,
/area/ruin)
"uU" = (
/obj/effect/turf_decal/bot,
/obj/structure/closet/crate,
/obj/effect/spawner/lootdrop/maintenance/four,
/obj/effect/spawner/lootdrop/space/languagebook,
/obj/effect/spawner/lootdrop/space/languagebook,
/obj/structure/window/reinforced{
	dir = 4
	},
/turf/open/floor/iron,
/area/ruin)
"vg" = (
/turf/template_noop,
/area/template_noop)
"vu" = (
/obj/effect/turf_decal/bot,
/obj/structure/closet/crate,
/obj/effect/spawner/lootdrop/maintenance/eight,
/obj/effect/spawner/lootdrop/space/rareseed,
/obj/effect/spawner/lootdrop/space/rareseed,
/turf/open/floor/iron,
/area/ruin)
"wE" = (
/obj/effect/spawner/structure/window/reinforced,
/turf/open/floor/plating/airless,
/area/ruin)
"wX" = (
/obj/effect/mob_spawn/human/miner/rig,
/turf/open/floor/iron,
/area/ruin)
"xb" = (
/turf/open/floor/plating/airless,
/area/ruin)
"xV" = (
/obj/structure/bed,
/obj/structure/window/reinforced/tinted{
	dir = 4;
	pixel_x = 2
	},
/obj/structure/curtain,
/turf/open/floor/iron,
/area/ruin)
"zv" = (
/obj/machinery/suit_storage_unit/open,
/turf/open/floor/plating/airless,
/area/ruin)
"zX" = (
/turf/open/floor/iron,
/area/ruin)
"Co" = (
/obj/structure/table/reinforced,
/obj/effect/spawner/lootdrop/wallet_loot,
/turf/open/floor/iron,
/area/ruin)
"DC" = (
/obj/machinery/power/port_gen/pacman/super,
/turf/open/floor/plating/airless,
/area/ruin)
"DQ" = (
/obj/effect/turf_decal/bot,
/obj/structure/closet/crate/secure/freezer/pizza,
/obj/item/pizzabox/infinite,
/turf/open/floor/iron,
/area/ruin)
"DY" = (
/obj/machinery/computer,
/turf/open/floor/iron,
/area/ruin)
"En" = (
/obj/effect/mob_spawn/human/corpse/cargo_tech,
/turf/open/floor/iron,
/area/ruin)
"Ep" = (
/obj/structure/table/reinforced,
/obj/machinery/microwave,
/turf/open/floor/iron,
/area/ruin)
"Ez" = (
/obj/structure/window/reinforced{
	dir = 4
	},
/obj/machinery/door/window,
/turf/open/floor/iron,
/area/ruin)
"EA" = (
/obj/structure/table/reinforced,
/obj/item/megaphone/cargo,
/turf/open/floor/iron,
/area/ruin)
"Ge" = (
/obj/effect/turf_decal/bot,
/obj/structure/closet/crate/secure/plasma,
/turf/open/floor/iron,
/area/ruin)
"Gm" = (
/mob/living/simple_animal/hostile/hivebot/strong,
/turf/open/floor/iron,
/area/ruin)
"GE" = (
/obj/effect/spawner/lootdrop/donkpockets,
/obj/effect/spawner/lootdrop/donkpockets{
	pixel_x = 4;
	pixel_y = 3
	},
/obj/structure/table/reinforced,
/turf/open/floor/iron,
/area/ruin)
"Hm" = (
/obj/structure/table/reinforced,
/obj/effect/spawner/lootdrop/three_course_meal,
/turf/open/floor/iron,
/area/ruin)
"Jw" = (
/obj/effect/turf_decal/bot,
/obj/structure/closet/crate/secure/engineering,
/obj/machinery/satellite/meteor_shield,
/obj/machinery/satellite/meteor_shield,
/obj/machinery/satellite/meteor_shield,
/obj/machinery/satellite/meteor_shield,
/obj/machinery/satellite/meteor_shield,
/turf/open/floor/iron,
/area/ruin)
"JH" = (
/obj/machinery/power/smes,
/turf/open/floor/plating/airless,
/area/ruin)
"KL" = (
/mob/living/simple_animal/hostile/hivebot/mechanic,
/turf/open/floor/iron,
/area/ruin)
"Ma" = (
/obj/effect/mob_spawn/human/miner,
/turf/open/floor/iron,
/area/ruin)
"ME" = (
/obj/machinery/door/airlock/external,
/turf/open/floor/plating/airless,
/area/ruin)
"NN" = (
/mob/living/simple_animal/hostile/hivebot/range,
/turf/open/floor/iron,
/area/ruin)
"NW" = (
/obj/structure/window/reinforced,
/obj/structure/chair/comfy/shuttle{
	dir = 1
	},
/turf/open/floor/iron,
/area/ruin)
"NY" = (
/obj/structure/chair/comfy/shuttle{
	dir = 4
	},
/mob/living/simple_animal/hostile/hivebot/range,
/turf/open/floor/iron,
/area/ruin)
"Oh" = (
/obj/effect/turf_decal/bot,
/obj/structure/closet/crate,
/obj/effect/spawner/lootdrop/space/material,
/obj/effect/spawner/lootdrop/space/material,
/obj/effect/spawner/lootdrop/space/material,
/obj/effect/spawner/lootdrop/space/material,
/obj/effect/spawner/lootdrop/space/material,
/turf/open/floor/iron,
/area/ruin)
"PV" = (
/obj/structure/reagent_dispensers/watertank,
/turf/open/floor/plating/airless,
/area/ruin)
"Rc" = (
/obj/machinery/suit_storage_unit/pirate,
/turf/open/floor/plating/airless,
/area/ruin)
"Ua" = (
/obj/structure/window/reinforced,
/obj/structure/window/reinforced{
	dir = 4
	},
/turf/open/floor/iron,
/area/ruin)
"Uh" = (
/obj/structure/table/reinforced,
/obj/machinery/cell_charger,
/turf/open/floor/iron,
/area/ruin)
"VG" = (
/obj/effect/turf_decal/bot,
/obj/structure/closet/crate,
/obj/effect/spawner/lootdrop/space/cashmoney,
/obj/effect/spawner/lootdrop/space/cashmoney,
/obj/effect/spawner/lootdrop/space/cashmoney,
/obj/effect/spawner/lootdrop/space/cashmoney,
/obj/effect/spawner/lootdrop/space/cashmoney,
/turf/open/floor/iron,
/area/ruin)
"VJ" = (
/obj/structure/reagent_dispensers/fueltank,
/turf/open/floor/plating/airless,
/area/ruin)
"VY" = (
/obj/effect/turf_decal/bot,
/obj/structure/closet/crate,
/obj/effect/spawner/lootdrop/space/cashmoney,
/obj/effect/spawner/lootdrop/space/cashmoney,
/obj/effect/spawner/lootdrop/space/cashmoney,
/obj/effect/spawner/lootdrop/space/cashmoney,
/turf/open/floor/iron,
/area/ruin)
"Ya" = (
/obj/machinery/door/airlock/engineering,
/turf/open/floor/plating/airless,
/area/ruin)
"YI" = (
/obj/effect/turf_decal/bot,
/obj/structure/closet/crate/radiation,
/obj/effect/spawner/lootdrop/space/fancytool,
/obj/effect/spawner/lootdrop/space/fancytool,
/obj/effect/spawner/lootdrop/space/fancytool,
/obj/structure/window/reinforced,
/turf/open/floor/iron,
/area/ruin)
"YK" = (
/obj/structure/closet/crate/freezer/tradership_cargo_freezer,
/obj/effect/turf_decal/bot,
/turf/open/floor/iron,
/area/ruin)
"Zb" = (
/obj/effect/mob_spawn/human/engineer,
/turf/open/floor/plating/airless,
/area/ruin)
"ZE" = (
/obj/structure/table/reinforced,
/obj/machinery/chem_dispenser/drinks/fullupgrade,
/turf/open/floor/iron,
/area/ruin)

(1,1,1) = {"
vg
vg
vg
vg
vg
bK
vg
vg
vg
vg
sY
sY
sY
sY
vg
vg
vg
vg
vg
vg
"}
(2,1,1) = {"
vg
vg
vg
bK
bK
bK
bK
bK
bK
sY
sY
JH
PV
sY
sY
vg
vg
vg
vg
vg
"}
(3,1,1) = {"
vg
vg
vg
vg
bK
bK
bK
bK
sY
sY
JH
xb
xb
Rc
sY
sY
vg
vg
vg
vg
"}
(4,1,1) = {"
vg
vg
vg
vg
sY
sY
sY
sY
sY
sY
sY
sY
Zb
xb
zv
sY
sY
vg
vg
vg
"}
(5,1,1) = {"
vg
vg
vg
vg
ME
xb
xb
xb
ME
zX
fu
sY
xb
xb
xb
xb
sY
sY
vg
vg
"}
(6,1,1) = {"
vg
vg
vg
vg
sY
sY
sY
sY
sY
nX
zX
sY
Ya
sY
DC
xb
zv
sY
sY
vg
"}
(7,1,1) = {"
vg
vg
vg
vg
sY
sY
hM
pj
pj
zX
zX
zX
zX
sY
sY
xb
Zb
Rc
sY
sY
"}
(8,1,1) = {"
vg
vg
vg
sY
sY
GE
zX
zX
zX
zX
zX
te
zX
zX
Ya
xb
xb
xb
VJ
sY
"}
(9,1,1) = {"
vg
vg
sY
sY
Ep
Ma
zX
zX
NN
zX
zX
wX
zX
zX
sY
sY
sY
xb
JH
sY
"}
(10,1,1) = {"
vg
sY
sY
ZE
zX
zX
Hm
zX
zX
zX
zX
YK
zX
hV
jW
Oh
sY
JH
sY
sY
"}
(11,1,1) = {"
vg
sY
xV
KL
zX
pz
Uh
zX
tT
zX
eN
zX
zX
lw
zX
fD
sY
sY
sY
vg
"}
(12,1,1) = {"
vg
sY
lN
zX
zX
zX
zX
zX
zX
tW
zX
zX
VY
hV
zX
jW
sY
sY
vg
vg
"}
(13,1,1) = {"
vg
sY
sY
sY
sY
zX
KL
zX
tW
zX
zX
iM
rf
Ua
jW
sY
sY
vg
vg
vg
"}
(14,1,1) = {"
vg
wE
lz
pj
NY
zX
zX
zX
zX
te
uU
Ez
zX
vu
sY
sY
vg
vg
vg
vg
"}
(15,1,1) = {"
vg
wE
DY
mm
zX
zX
zX
tT
zX
YI
zX
zX
VG
sY
sY
vg
vg
vg
vg
vg
"}
(16,1,1) = {"
vg
wE
DY
mm
En
mm
sY
bo
zX
NW
zX
jW
sY
sY
vg
vg
vg
vg
vg
vg
"}
(17,1,1) = {"
vg
wE
wE
kE
Co
mm
sY
Jw
Gm
NW
qQ
sY
sY
vg
vg
vg
bK
vg
vg
vg
"}
(18,1,1) = {"
vg
vg
wE
wE
DY
mm
sY
Ge
zX
DQ
sY
sY
vg
vg
vg
vg
bK
bK
bK
vg
"}
(19,1,1) = {"
vg
vg
vg
wE
wE
EA
sY
qQ
iM
sY
sY
vg
vg
vg
vg
bK
bK
bK
bK
vg
"}
(20,1,1) = {"
vg
vg
vg
vg
wE
wE
sY
sY
sY
sY
vg
vg
vg
vg
vg
vg
vg
vg
vg
vg
"}
