//MAP CONVERTED BY dmm2tgm.py THIS HEADER COMMENT PREVENTS RECONVERSION, DO NOT REMOVE
"aF" = (
/obj/structure/camera_assembly,
/turf/open/floor/engine,
/area/ruin/space/has_grav/powered/skyrat/brokexenosat)
"aP" = (
/obj/item/cultivator,
/turf/open/floor/iron/white/side/airless{
	dir = 1
	},
/area/ruin/space/has_grav/powered/skyrat/brokexenosat)
"aZ" = (
/obj/machinery/door/airlock/research/glass,
/obj/effect/turf_decal/siding/blue{
	dir = 8
	},
/turf/open/floor/iron/white,
/area/ruin/space/has_grav/powered/skyrat/brokexenosat)
"bN" = (
/obj/structure/table,
/obj/item/stack/sheet/iron/five,
/obj/item/stack/sheet/glass,
/turf/open/floor/iron/white/airless,
/area/ruin/space/has_grav/powered/skyrat/brokexenosat)
"gy" = (
/obj/structure/sign/departments/xenobio{
	pixel_x = 32
	},
/turf/open/floor/plating/airless,
/area/ruin/space/has_grav/powered/skyrat/brokexenosat)
"gI" = (
/obj/item/circuitboard/machine/processor/slime,
/obj/structure/frame/machine,
/obj/item/stack/cable_coil/five,
/turf/open/floor/iron/white/airless,
/area/ruin/space/has_grav/powered/skyrat/brokexenosat)
"hB" = (
/obj/structure/chair/office/light,
/turf/open/floor/iron/white/airless,
/area/ruin/space/has_grav/powered/skyrat/brokexenosat)
"hH" = (
/obj/structure/table,
/obj/machinery/reagentgrinder,
/obj/item/stack/sheet/mineral/plasma/five,
/turf/open/floor/iron/white/airless,
/area/ruin/space/has_grav/powered/skyrat/brokexenosat)
"lS" = (
/obj/machinery/biogenerator,
/turf/open/floor/iron/airless,
/area/ruin/space/has_grav/powered/skyrat/brokexenosat)
"nc" = (
/obj/structure/lattice/catwalk,
/obj/item/toy/plush/space_lizard_plushie,
/turf/template_noop,
/area/template_noop)
"pV" = (
/obj/item/storage/toolbox/mechanical,
/turf/open/floor/iron/white/airless,
/area/ruin/space/has_grav/powered/skyrat/brokexenosat)
"qq" = (
/obj/machinery/hydroponics/constructable,
/turf/open/floor/iron/airless,
/area/ruin/space/has_grav/powered/skyrat/brokexenosat)
"qQ" = (
/obj/effect/spawner/structure/window/reinforced,
/turf/open/floor/plating,
/area/ruin/space/has_grav/powered/skyrat/brokexenosat)
"rv" = (
/obj/machinery/door/window/eastleft,
/obj/machinery/door/window/westright,
/obj/effect/turf_decal/stripes/line{
	dir = 4
	},
/turf/open/floor/engine,
/area/ruin/space/has_grav/powered/skyrat/brokexenosat)
"su" = (
/obj/structure/lattice/catwalk,
/turf/template_noop,
/area/template_noop)
"sx" = (
/obj/machinery/door/airlock/research,
/turf/open/floor/iron/white,
/area/ruin/space/has_grav/powered/skyrat/brokexenosat)
"vJ" = (
/turf/open/floor/iron/white/airless,
/area/ruin/space/has_grav/powered/skyrat/brokexenosat)
"vT" = (
/turf/open/floor/circuit/telecomms,
/area/ruin/space/has_grav/powered/skyrat/brokexenosat)
"yy" = (
/obj/structure/girder/reinforced,
/turf/open/floor/plating/airless,
/area/ruin/space/has_grav/powered/skyrat/brokexenosat)
"yB" = (
/obj/effect/turf_decal/stripes/line{
	dir = 1
	},
/turf/open/floor/engine/airless,
/area/ruin/space/has_grav/powered/skyrat/brokexenosat)
"yI" = (
/turf/open/floor/iron/airless,
/area/ruin/space/has_grav/powered/skyrat/brokexenosat)
"zf" = (
/obj/structure/girder,
/turf/open/floor/plating/airless,
/area/ruin/space/has_grav/powered/skyrat/brokexenosat)
"zv" = (
/turf/template_noop,
/area/template_noop)
"Aw" = (
/obj/machinery/portable_atmospherics/canister/bz,
/turf/open/floor/engine/airless,
/area/ruin/space/has_grav/powered/skyrat/brokexenosat)
"AS" = (
/obj/structure/girder/displaced,
/turf/open/floor/plating/airless,
/area/ruin/space/has_grav/powered/skyrat/brokexenosat)
"Bo" = (
/obj/item/stack/cable_coil/cut,
/turf/open/floor/engine/airless,
/area/ruin/space/has_grav/powered/skyrat/brokexenosat)
"CI" = (
/obj/machinery/autolathe,
/turf/open/floor/iron/white/airless,
/area/ruin/space/has_grav/powered/skyrat/brokexenosat)
"Dl" = (
/obj/item/stack/tile/iron/white,
/turf/open/floor/plating/airless,
/area/ruin/space/has_grav/powered/skyrat/brokexenosat)
"Eu" = (
/obj/structure/window/reinforced/spawner/east,
/obj/machinery/smartfridge/extract/preloaded,
/turf/open/floor/iron/white/airless,
/area/ruin/space/has_grav/powered/skyrat/brokexenosat)
"ED" = (
/obj/machinery/hydroponics/constructable,
/obj/item/seeds/watermelon,
/turf/open/floor/iron/airless,
/area/ruin/space/has_grav/powered/skyrat/brokexenosat)
"EJ" = (
/obj/machinery/door/window/eastleft,
/turf/open/floor/iron/white/airless,
/area/ruin/space/has_grav/powered/skyrat/brokexenosat)
"FY" = (
/obj/structure/frame/computer{
	dir = 8
	},
/obj/item/circuitboard/computer/xenobiology,
/obj/structure/window/reinforced/spawner/east,
/turf/open/floor/iron/white/airless,
/area/ruin/space/has_grav/powered/skyrat/brokexenosat)
"Ge" = (
/turf/open/floor/engine,
/area/ruin/space/has_grav/powered/skyrat/brokexenosat)
"ID" = (
/obj/item/slimecross/reproductive/grey,
/turf/open/floor/iron/white/airless,
/area/ruin/space/has_grav/powered/skyrat/brokexenosat)
"Je" = (
/turf/open/floor/iron/white/side/airless{
	dir = 1
	},
/area/ruin/space/has_grav/powered/skyrat/brokexenosat)
"Jz" = (
/obj/item/stack/rods/ten,
/turf/open/floor/engine/airless,
/area/ruin/space/has_grav/powered/skyrat/brokexenosat)
"JF" = (
/turf/open/floor/plating/airless,
/area/ruin/space/has_grav/powered/skyrat/brokexenosat)
"KQ" = (
/obj/structure/lattice,
/turf/template_noop,
/area/ruin/space/has_grav/powered/skyrat/brokexenosat)
"Ol" = (
/turf/template_noop,
/area/ruin/space/has_grav/powered/skyrat/brokexenosat)
"OK" = (
/obj/item/crowbar,
/turf/open/floor/iron/white/airless,
/area/ruin/space/has_grav/powered/skyrat/brokexenosat)
"Pk" = (
/obj/structure/sink{
	dir = 4;
	pixel_x = -12
	},
/turf/open/floor/iron/white/side/airless{
	dir = 1
	},
/area/ruin/space/has_grav/powered/skyrat/brokexenosat)
"Po" = (
/obj/machinery/seed_extractor,
/turf/open/floor/iron/airless,
/area/ruin/space/has_grav/powered/skyrat/brokexenosat)
"Pz" = (
/obj/machinery/door/window/northleft,
/obj/machinery/door/window/southleft,
/obj/effect/turf_decal/stripes/line,
/turf/open/floor/engine,
/area/ruin/space/has_grav/powered/skyrat/brokexenosat)
"QC" = (
/turf/closed/wall/r_wall/rust,
/area/ruin/space/has_grav/powered/skyrat/brokexenosat)
"RF" = (
/turf/closed/wall/r_wall,
/area/ruin/space/has_grav/powered/skyrat/brokexenosat)
"RN" = (
/turf/open/floor/engine/airless,
/area/ruin/space/has_grav/powered/skyrat/brokexenosat)
"Sv" = (
/obj/machinery/vending/hydronutrients,
/turf/open/floor/iron/airless,
/area/ruin/space/has_grav/powered/skyrat/brokexenosat)
"SC" = (
/obj/item/circuitboard/machine/monkey_recycler,
/obj/structure/frame/machine,
/obj/item/stack/cable_coil/five,
/turf/open/floor/iron/white/airless,
/area/ruin/space/has_grav/powered/skyrat/brokexenosat)
"VC" = (
/obj/machinery/door/window/eastleft,
/obj/machinery/door/window/westright,
/obj/effect/turf_decal/stripes/line{
	dir = 8
	},
/turf/open/floor/engine,
/area/ruin/space/has_grav/powered/skyrat/brokexenosat)
"VW" = (
/turf/closed/wall,
/area/ruin/space/has_grav/powered/skyrat/brokexenosat)
"WF" = (
/obj/structure/lattice,
/turf/template_noop,
/area/template_noop)
"WH" = (
/obj/item/electronics/airlock,
/obj/effect/turf_decal/stripes/line{
	dir = 8
	},
/turf/open/floor/engine/airless,
/area/ruin/space/has_grav/powered/skyrat/brokexenosat)
"WV" = (
/obj/structure/lattice/catwalk/plated,
/turf/open/floor/plating/airless,
/area/ruin/space/has_grav/powered/skyrat/brokexenosat)

(1,1,1) = {"
zv
zv
zv
zv
zv
zv
zv
zv
zv
WF
zv
zv
zv
zv
zv
zv
zv
zv
zv
"}
(2,1,1) = {"
zv
zv
zv
zv
zv
zv
zv
zv
zv
vJ
WF
zv
zv
zv
zv
zv
zv
zv
zv
"}
(3,1,1) = {"
zv
zv
zv
zv
zv
zv
zv
zv
WF
vJ
gy
zv
zv
zv
zv
zv
zv
zv
zv
"}
(4,1,1) = {"
zv
zv
zv
RF
RF
RF
RF
RF
RF
sx
RF
RF
RF
QC
QC
QC
zv
zv
zv
"}
(5,1,1) = {"
zv
zv
zv
RF
Ge
Ge
Ge
RF
CI
vJ
gI
RF
aF
Ge
Ge
RF
zv
zv
zv
"}
(6,1,1) = {"
zv
nc
WF
RF
Ge
Ge
Ge
RF
bN
JF
hH
RF
Ge
Ge
Ge
RF
WF
su
zv
"}
(7,1,1) = {"
zv
WF
zv
QC
Ge
Ge
Ge
RF
SC
ID
vJ
RF
Ge
Ge
Ge
RF
zv
WF
zv
"}
(8,1,1) = {"
QC
QC
QC
QC
QC
rv
qQ
RF
Eu
EJ
FY
RF
qQ
rv
RF
RF
RF
RF
RF
"}
(9,1,1) = {"
QC
Ge
Ge
Ge
qQ
vJ
vJ
vJ
vJ
vJ
vJ
JF
JF
vJ
qQ
RN
RN
Aw
RF
"}
(10,1,1) = {"
QC
Ge
Ge
Ge
Pz
vJ
Dl
vJ
vJ
vJ
vJ
vJ
vJ
vJ
yB
RN
RN
RN
QC
"}
(11,1,1) = {"
RF
Ge
Ge
Ge
qQ
vJ
vJ
VW
qQ
qQ
qQ
VW
vJ
vJ
yB
RN
RN
RN
QC
"}
(12,1,1) = {"
RF
RF
RF
RF
RF
vJ
vJ
qQ
vT
vT
vT
qQ
vJ
vJ
qQ
RN
RN
RN
QC
"}
(13,1,1) = {"
WF
zv
zv
su
qQ
vJ
vJ
qQ
vT
vT
vT
qQ
vJ
vJ
RF
RF
RF
RF
QC
"}
(14,1,1) = {"
RF
RF
RF
RF
RF
vJ
vJ
qQ
vT
vT
vT
qQ
Dl
vJ
Pk
lS
Po
Sv
RF
"}
(15,1,1) = {"
RF
Ge
Ge
Ge
qQ
vJ
vJ
VW
qQ
aZ
qQ
VW
vJ
vJ
Je
yI
WV
yI
RF
"}
(16,1,1) = {"
QC
Ge
Ge
Ge
Pz
vJ
JF
OK
vJ
vJ
vJ
vJ
vJ
vJ
Je
yI
WV
yI
RF
"}
(17,1,1) = {"
QC
Ge
Ge
Ge
qQ
vJ
vJ
vJ
vJ
vJ
vJ
hB
vJ
pV
aP
qq
qq
ED
QC
"}
(18,1,1) = {"
RF
QC
QC
RF
QC
qQ
VC
qQ
RF
qQ
QC
JF
WH
qQ
RF
QC
QC
QC
QC
"}
(19,1,1) = {"
zv
zv
WF
zv
QC
Ge
Ge
Ge
RF
su
RF
Bo
RN
RN
JF
zv
WF
zv
zv
"}
(20,1,1) = {"
zv
zv
su
WF
QC
Ge
Ge
Ge
RF
zv
zf
RN
Jz
Ol
KQ
WF
su
zv
zv
"}
(21,1,1) = {"
zv
zv
zv
zv
RF
Ge
Ge
Ge
QC
zv
yy
RN
RN
Ol
JF
zv
zv
zv
zv
"}
(22,1,1) = {"
zv
zv
zv
zv
RF
QC
QC
RF
QC
WF
RF
AS
JF
KQ
KQ
zv
zv
zv
zv
"}
