//MAP CONVERTED BY dmm2tgm.py THIS HEADER COMMENT PREVENTS RECONVERSION, DO NOT REMOVE
"ak" = (
/obj/machinery/light/cold/directional/west,
/obj/effect/turf_decal/tile/brown{
	dir = 8
	},
/obj/effect/turf_decal/tile/yellow{
	dir = 1
	},
/turf/open/floor/iron,
/area/template_noop)
"aC" = (
/obj/structure/window/reinforced/survival_pod{
	dir = 4
	},
/obj/structure/chair{
	dir = 8
	},
/turf/open/floor/mineral/plastitanium/red,
/area/template_noop)
"bk" = (
/obj/item/stack/rods/ten,
/obj/structure/lattice/catwalk/plated,
/turf/open/floor/plating,
/area/template_noop)
"bp" = (
/obj/structure/lattice/catwalk,
/turf/template_noop,
/area/template_noop)
"bU" = (
/obj/effect/turf_decal/box/corners{
	dir = 8
	},
/obj/machinery/light/floor,
/turf/open/floor/plating,
/area/template_noop)
"cy" = (
/obj/structure/lattice/catwalk/plated/dark,
/turf/open/floor/plating,
/area/template_noop)
"cP" = (
/obj/machinery/suit_storage_unit/open,
/turf/open/floor/iron,
/area/template_noop)
"dE" = (
/turf/open/floor/iron/smooth_large,
/area/template_noop)
"fb" = (
/turf/open/floor/iron/dark/smooth_edge,
/area/template_noop)
"fz" = (
/obj/effect/turf_decal/tile/brown{
	dir = 4
	},
/obj/effect/turf_decal/tile/yellow{
	dir = 1
	},
/obj/structure/rack,
/obj/effect/spawner/lootdrop/maintenance/two,
/obj/effect/decal/cleanable/oil,
/obj/effect/decal/cleanable/dirt,
/turf/open/floor/iron,
/area/template_noop)
"fC" = (
/obj/effect/turf_decal/stripes/line{
	dir = 8
	},
/obj/effect/turf_decal/trimline/brown/line{
	dir = 8
	},
/turf/open/floor/iron/smooth_large,
/area/template_noop)
"fH" = (
/obj/effect/turf_decal/tile/brown{
	dir = 8
	},
/obj/effect/turf_decal/tile/brown{
	dir = 4
	},
/obj/effect/turf_decal/tile/yellow,
/turf/open/floor/iron,
/area/template_noop)
"fV" = (
/turf/open/floor/iron/dark/smooth_corner{
	dir = 1
	},
/area/template_noop)
"gk" = (
/turf/open/floor/iron/dark/textured_edge{
	dir = 1
	},
/area/template_noop)
"gz" = (
/turf/open/floor/iron/dark/textured_large,
/area/template_noop)
"gB" = (
/obj/effect/turf_decal/tile/yellow,
/turf/open/floor/iron,
/area/template_noop)
"gR" = (
/obj/effect/decal/cleanable/dirt,
/obj/effect/turf_decal/tile/brown{
	dir = 8
	},
/obj/effect/turf_decal/tile/brown{
	dir = 4
	},
/obj/effect/turf_decal/tile/yellow{
	dir = 1
	},
/turf/open/floor/iron,
/area/template_noop)
"gT" = (
/obj/structure/trash_pile,
/obj/effect/decal/cleanable/cobweb,
/turf/open/floor/iron,
/area/template_noop)
"hd" = (
/obj/effect/decal/cleanable/blood/old,
/turf/open/floor/iron,
/area/template_noop)
"hv" = (
/obj/machinery/door/airlock/external{
	req_access_txt = "150"
	},
/obj/effect/mapping_helpers/airlock/cyclelink_helper{
	dir = 1
	},
/turf/open/floor/plating,
/area/template_noop)
"hD" = (
/obj/effect/turf_decal/vg_decals/numbers/zero,
/turf/open/floor/plating,
/area/template_noop)
"hU" = (
/obj/effect/turf_decal/stripes/corner,
/obj/effect/turf_decal/trimline/brown/corner,
/obj/effect/turf_decal/siding/thinplating/dark{
	dir = 1
	},
/turf/open/floor/iron/smooth_large,
/area/template_noop)
"ib" = (
/obj/structure/rack,
/obj/item/clothing/shoes/magboots/syndie,
/turf/open/floor/iron,
/area/template_noop)
"iq" = (
/obj/item/stack/tile/iron,
/obj/effect/decal/cleanable/dirt,
/turf/open/floor/plating,
/area/template_noop)
"iC" = (
/obj/structure/lattice/catwalk/plated,
/obj/effect/decal/cleanable/dirt,
/turf/open/floor/plating,
/area/template_noop)
"iM" = (
/obj/effect/turf_decal/tile/brown,
/obj/effect/decal/cleanable/dirt,
/turf/open/floor/iron,
/area/template_noop)
"iX" = (
/obj/machinery/light/cold/directional/north,
/turf/open/floor/iron/dark/textured_edge{
	dir = 1
	},
/area/template_noop)
"jA" = (
/obj/effect/decal/cleanable/dirt,
/obj/item/stack/tile/iron,
/turf/open/floor/plating,
/area/template_noop)
"jF" = (
/obj/effect/turf_decal/tile/brown{
	dir = 8
	},
/obj/effect/turf_decal/tile/yellow{
	dir = 1
	},
/obj/effect/decal/cleanable/oil/streak,
/turf/open/floor/iron,
/area/template_noop)
"lC" = (
/obj/structure/railing/corner{
	dir = 8
	},
/turf/open/floor/iron/dark,
/area/template_noop)
"lD" = (
/obj/effect/decal/cleanable/dirt,
/obj/effect/decal/cleanable/dirt,
/turf/open/floor/plating,
/area/template_noop)
"lG" = (
/obj/docking_port/stationary{
	dir = 8;
	dwidth = 8;
	height = 7;
	id = "interdyne_cargo_away";
	name = "Interdyne Forward Operating Base";
	roundstart_template = /datum/map_template/shuttle/ruin/interdyne_cargo;
	width = 20
	},
/turf/open/floor/plating,
/area/template_noop)
"mc" = (
/turf/template_noop,
/area/template_noop)
"my" = (
/obj/effect/turf_decal/tile/brown{
	dir = 8
	},
/obj/effect/turf_decal/tile/yellow{
	dir = 1
	},
/obj/effect/decal/cleanable/dirt,
/turf/open/floor/iron,
/area/template_noop)
"mG" = (
/obj/effect/turf_decal/vg_decals/numbers/three,
/turf/open/floor/plating,
/area/template_noop)
"mI" = (
/turf/open/floor/iron/dark,
/area/template_noop)
"nv" = (
/obj/effect/turf_decal/box/corners,
/obj/machinery/light/floor,
/turf/open/floor/plating,
/area/template_noop)
"nN" = (
/obj/machinery/light/cold/directional/east,
/turf/open/floor/iron/smooth_large,
/area/template_noop)
"nY" = (
/obj/effect/turf_decal/tile/brown{
	dir = 4
	},
/turf/open/floor/iron,
/area/template_noop)
"od" = (
/obj/effect/decal/cleanable/cobweb/cobweb2,
/obj/effect/decal/cleanable/dirt,
/obj/effect/turf_decal/tile/brown{
	dir = 4
	},
/obj/effect/turf_decal/tile/yellow{
	dir = 1
	},
/obj/effect/turf_decal/tile/yellow,
/turf/open/floor/iron,
/area/template_noop)
"oh" = (
/turf/open/floor/iron/dark/textured_edge{
	dir = 8
	},
/area/template_noop)
"or" = (
/obj/structure/rack,
/turf/open/floor/iron,
/area/template_noop)
"pH" = (
/obj/effect/turf_decal/tile/brown{
	dir = 8
	},
/obj/effect/turf_decal/tile/yellow,
/turf/open/floor/iron,
/area/template_noop)
"pY" = (
/obj/structure/lattice/catwalk/plated,
/turf/open/floor/plating,
/area/template_noop)
"qb" = (
/obj/effect/turf_decal/stripes/line,
/obj/effect/turf_decal/trimline/brown/line,
/obj/effect/turf_decal/caution/stand_clear{
	dir = 1
	},
/obj/effect/turf_decal/siding/thinplating/dark{
	dir = 1
	},
/turf/open/floor/iron/smooth_large,
/area/template_noop)
"qw" = (
/turf/closed/wall/r_wall/syndicate/nodiagonal,
/area/template_noop)
"qE" = (
/obj/effect/decal/cleanable/dirt,
/obj/effect/turf_decal/tile/brown{
	dir = 8
	},
/obj/effect/turf_decal/tile/yellow,
/turf/open/floor/iron,
/area/template_noop)
"rP" = (
/turf/open/floor/iron/dark/smooth_half,
/area/template_noop)
"sx" = (
/obj/machinery/light/cold/directional/west,
/turf/open/floor/iron/smooth_half{
	dir = 1
	},
/area/template_noop)
"sz" = (
/obj/effect/turf_decal/stripes/line{
	dir = 8
	},
/obj/effect/turf_decal/trimline/brown/line{
	dir = 8
	},
/obj/effect/turf_decal/caution/stand_clear{
	dir = 4
	},
/turf/open/floor/iron/smooth_large,
/area/template_noop)
"ty" = (
/obj/effect/turf_decal/siding/wideplating{
	dir = 8
	},
/obj/machinery/door/airlock/mining{
	req_access_txt = "150"
	},
/turf/open/floor/iron/smooth_large,
/area/template_noop)
"tB" = (
/obj/effect/turf_decal/siding/wideplating{
	dir = 8
	},
/obj/machinery/door/airlock/maintenance_hatch{
	req_access_txt = "150"
	},
/turf/open/floor/iron/smooth_large,
/area/template_noop)
"tO" = (
/obj/effect/turf_decal/tile/brown{
	dir = 4
	},
/obj/effect/turf_decal/tile/yellow{
	dir = 1
	},
/turf/open/floor/iron,
/area/template_noop)
"tP" = (
/obj/effect/turf_decal/tile/brown{
	dir = 8
	},
/obj/effect/turf_decal/tile/yellow,
/obj/effect/turf_decal/tile/yellow{
	dir = 1
	},
/obj/effect/decal/cleanable/dirt,
/turf/open/floor/iron,
/area/template_noop)
"tT" = (
/turf/open/floor/iron/dark/smooth_edge{
	dir = 4
	},
/area/template_noop)
"tU" = (
/obj/effect/spawner/structure/window/plasma/reinforced/plastitanium,
/turf/open/floor/plating,
/area/template_noop)
"uO" = (
/obj/effect/decal/cleanable/glass,
/turf/open/floor/iron,
/area/template_noop)
"uR" = (
/turf/open/floor/iron/dark/textured_corner{
	dir = 8
	},
/area/template_noop)
"uS" = (
/obj/structure/lattice/catwalk,
/obj/structure/marker_beacon/burgundy,
/turf/open/floor/plating/airless,
/area/template_noop)
"vU" = (
/obj/effect/turf_decal/siding/red{
	color = "#fc0303";
	dir = 8
	},
/turf/open/floor/mineral/plastitanium,
/area/template_noop)
"wa" = (
/turf/open/floor/plating,
/area/template_noop)
"ww" = (
/obj/item/storage/toolbox/mechanical,
/turf/open/floor/iron,
/area/template_noop)
"wx" = (
/obj/effect/turf_decal/siding/thinplating/dark{
	dir = 1
	},
/turf/open/floor/iron/smooth_half{
	dir = 1
	},
/area/template_noop)
"wS" = (
/obj/structure/railing{
	dir = 4
	},
/turf/open/floor/iron/stairs/right,
/area/template_noop)
"wV" = (
/obj/item/rack_parts,
/turf/open/floor/iron,
/area/template_noop)
"xa" = (
/turf/open/floor/iron,
/area/template_noop)
"xr" = (
/obj/machinery/status_display/syndie{
	pixel_y = 32
	},
/turf/open/floor/iron/dark/textured_edge{
	dir = 1
	},
/area/template_noop)
"xN" = (
/obj/effect/turf_decal/stripes/line{
	dir = 4
	},
/obj/effect/turf_decal/trimline/brown/line{
	dir = 4
	},
/turf/open/floor/iron/smooth_large,
/area/template_noop)
"xX" = (
/obj/effect/decal/cleanable/dirt,
/obj/effect/loot_site_spawner,
/turf/open/floor/plating,
/area/template_noop)
"yb" = (
/turf/open/floor/iron/stairs/left,
/area/template_noop)
"yd" = (
/obj/machinery/door/airlock/maintenance_hatch{
	req_access_txt = "150"
	},
/turf/open/floor/iron,
/area/template_noop)
"yO" = (
/obj/effect/decal/cleanable/dirt,
/obj/effect/loot_site_spawner,
/turf/open/floor/iron,
/area/template_noop)
"zk" = (
/turf/open/floor/iron/dark/smooth_corner,
/area/template_noop)
"zq" = (
/obj/effect/turf_decal/siding/red{
	color = "#fc0303";
	dir = 8
	},
/obj/structure/table/reinforced,
/turf/open/floor/mineral/plastitanium,
/area/template_noop)
"zC" = (
/turf/open/floor/iron/dark/textured_corner,
/area/template_noop)
"zJ" = (
/obj/effect/turf_decal/tile/brown{
	dir = 4
	},
/obj/effect/turf_decal/tile/yellow{
	dir = 1
	},
/obj/effect/decal/cleanable/dirt,
/turf/open/floor/iron,
/area/template_noop)
"Au" = (
/obj/effect/turf_decal/tile/brown{
	dir = 8
	},
/obj/effect/turf_decal/tile/yellow{
	dir = 1
	},
/obj/effect/turf_decal/tile/yellow,
/turf/open/floor/iron,
/area/template_noop)
"Ay" = (
/obj/structure/tank_dispenser,
/turf/open/floor/iron,
/area/template_noop)
"Bh" = (
/obj/effect/turf_decal/tile/brown,
/obj/effect/turf_decal/tile/yellow{
	dir = 8
	},
/obj/machinery/button/door/directional/east{
	id = "interdynecommisary"
	},
/obj/item/storage/toolbox/mechanical,
/turf/open/floor/iron,
/area/template_noop)
"Bp" = (
/obj/effect/decal/cleanable/dirt,
/turf/open/floor/iron,
/area/template_noop)
"Cf" = (
/obj/effect/decal/cleanable/dirt,
/obj/effect/turf_decal/tile/brown{
	dir = 4
	},
/obj/effect/turf_decal/tile/yellow{
	dir = 1
	},
/turf/open/floor/iron,
/area/template_noop)
"Dl" = (
/obj/effect/turf_decal/stripes/line{
	dir = 8
	},
/obj/effect/turf_decal/trimline/brown/line{
	dir = 8
	},
/obj/effect/turf_decal/caution{
	dir = 4
	},
/turf/open/floor/iron/smooth_large,
/area/template_noop)
"Dw" = (
/turf/open/floor/mineral/plastitanium,
/area/template_noop)
"Es" = (
/obj/structure/closet/crate/large,
/obj/item/disk{
	desc = "A cheap, plastic hard-disk labelled 'good tunes to assault ops to'. It looks disused.";
	icon_state = "nucleardisk";
	name = "dat fukken disk"
	},
/turf/open/floor/iron/smooth_half{
	dir = 1
	},
/area/template_noop)
"ED" = (
/turf/open/floor/mineral/plastitanium/red,
/area/template_noop)
"FD" = (
/obj/machinery/door/airlock/grunge{
	name = "Hangar";
	req_access_txt = "150"
	},
/turf/open/floor/iron/dark,
/area/template_noop)
"FX" = (
/obj/machinery/door/firedoor,
/obj/structure/table/reinforced,
/obj/machinery/door/poddoor/shutters/preopen{
	id = "interdynecommisary"
	},
/turf/open/floor/plating,
/area/template_noop)
"Gy" = (
/obj/machinery/light/cold/directional/east,
/obj/effect/turf_decal/tile/brown{
	dir = 4
	},
/obj/effect/turf_decal/tile/yellow,
/turf/open/floor/iron,
/area/template_noop)
"HX" = (
/turf/open/floor/iron/dark/smooth_large,
/area/template_noop)
"Ib" = (
/obj/effect/turf_decal/tile/brown{
	dir = 4
	},
/obj/effect/turf_decal/tile/yellow{
	dir = 1
	},
/obj/structure/rack/shelf,
/turf/open/floor/iron,
/area/template_noop)
"Jh" = (
/obj/effect/turf_decal/tile/yellow{
	dir = 1
	},
/obj/effect/decal/cleanable/dirt,
/turf/open/floor/iron,
/area/template_noop)
"JA" = (
/obj/effect/decal/cleanable/dirt,
/obj/effect/turf_decal/tile/brown{
	dir = 8
	},
/obj/effect/turf_decal/tile/yellow{
	dir = 1
	},
/turf/open/floor/iron,
/area/template_noop)
"Kf" = (
/obj/structure/lattice/catwalk/plated,
/obj/effect/decal/cleanable/vomit/old,
/turf/open/floor/plating,
/area/template_noop)
"KS" = (
/obj/structure/chair/office,
/turf/open/floor/mineral/plastitanium,
/area/template_noop)
"Lc" = (
/obj/structure/railing/corner,
/turf/open/floor/iron/dark,
/area/template_noop)
"Ln" = (
/obj/effect/turf_decal/tile/brown{
	dir = 8
	},
/obj/effect/turf_decal/tile/yellow{
	dir = 1
	},
/turf/open/floor/iron,
/area/template_noop)
"Lp" = (
/turf/open/floor/iron/dark/smooth_edge{
	dir = 8
	},
/area/template_noop)
"Lr" = (
/obj/machinery/door/window/survival_pod{
	dir = 4;
	req_access_txt = "151"
	},
/turf/open/floor/mineral/plastitanium/red,
/area/template_noop)
"LG" = (
/obj/machinery/computer/security{
	dir = 1;
	network = list("fsci")
	},
/turf/open/floor/mineral/plastitanium,
/area/template_noop)
"LH" = (
/obj/effect/decal/cleanable/dirt,
/turf/open/floor/plating,
/area/template_noop)
"Ml" = (
/turf/open/floor/iron/dark/smooth_corner{
	dir = 8
	},
/area/template_noop)
"Mp" = (
/obj/effect/turf_decal/stripes/line,
/obj/effect/turf_decal/trimline/brown/line,
/obj/effect/turf_decal/caution{
	dir = 1
	},
/obj/effect/turf_decal/siding/thinplating/dark{
	dir = 1
	},
/turf/open/floor/iron/smooth_large,
/area/template_noop)
"MN" = (
/turf/open/floor/iron/stairs/right,
/area/template_noop)
"Nr" = (
/obj/effect/turf_decal/stripes/line{
	dir = 4
	},
/obj/effect/turf_decal/trimline/brown/line{
	dir = 4
	},
/obj/effect/turf_decal/caution{
	dir = 8
	},
/turf/open/floor/iron/smooth_large,
/area/template_noop)
"NE" = (
/obj/machinery/door/airlock/command{
	name = "E.V.A.";
	req_access_txt = "150"
	},
/obj/structure/barricade/wooden/crude,
/turf/open/floor/iron,
/area/template_noop)
"NX" = (
/obj/machinery/door/airlock/security/old{
	name = "Security Checkpoint";
	req_access_txt = "151"
	},
/turf/open/floor/iron/dark/textured_large,
/area/template_noop)
"Oe" = (
/obj/effect/turf_decal/tile/brown{
	dir = 8
	},
/obj/effect/turf_decal/tile/brown{
	dir = 4
	},
/obj/effect/turf_decal/tile/yellow{
	dir = 1
	},
/obj/structure/rack/shelf,
/obj/effect/decal/cleanable/cobweb,
/turf/open/floor/iron,
/area/template_noop)
"Pd" = (
/obj/effect/turf_decal/vg_decals/numbers/four,
/turf/open/floor/plating,
/area/template_noop)
"Pt" = (
/obj/machinery/suit_storage_unit/standard_unit,
/turf/open/floor/iron,
/area/template_noop)
"PM" = (
/obj/structure/table/reinforced,
/turf/open/floor/mineral/plastitanium,
/area/template_noop)
"PT" = (
/turf/open/floor/iron/smooth_half{
	dir = 1
	},
/area/template_noop)
"QV" = (
/turf/open/floor/iron/dark/smooth_edge{
	dir = 1
	},
/area/template_noop)
"RC" = (
/obj/effect/decal/cleanable/dirt,
/obj/machinery/light/cold/directional/east,
/obj/effect/turf_decal/tile/brown{
	dir = 4
	},
/obj/effect/turf_decal/tile/yellow,
/turf/open/floor/iron,
/area/template_noop)
"RH" = (
/obj/structure/railing,
/turf/open/floor/iron/dark,
/area/template_noop)
"RM" = (
/obj/effect/turf_decal/delivery,
/obj/machinery/light/floor,
/turf/open/floor/iron/smooth_half{
	dir = 1
	},
/area/template_noop)
"St" = (
/turf/open/floor/iron/dark/textured_edge{
	dir = 4
	},
/area/template_noop)
"Tg" = (
/obj/effect/decal/cleanable/dirt,
/obj/effect/turf_decal/tile/brown{
	dir = 4
	},
/obj/effect/turf_decal/tile/yellow,
/turf/open/floor/iron,
/area/template_noop)
"TC" = (
/obj/structure/closet/crate,
/obj/effect/spawner/lootdrop/maintenance,
/turf/open/floor/iron/smooth_half{
	dir = 1
	},
/area/template_noop)
"UI" = (
/obj/item/wirecutters/makeshift,
/turf/open/floor/iron,
/area/template_noop)
"Vt" = (
/obj/structure/lattice,
/turf/template_noop,
/area/template_noop)
"VI" = (
/obj/structure/fans/tiny/forcefield,
/obj/effect/turf_decal/stripes/line,
/turf/open/floor/plating,
/area/template_noop)
"We" = (
/obj/effect/turf_decal/stripes/line{
	dir = 4
	},
/obj/effect/turf_decal/trimline/brown/line{
	dir = 4
	},
/obj/effect/turf_decal/caution/stand_clear{
	dir = 8
	},
/turf/open/floor/iron/smooth_large,
/area/template_noop)
"Wg" = (
/obj/effect/turf_decal/vg_decals/numbers/one,
/turf/open/floor/plating,
/area/template_noop)
"Ws" = (
/obj/structure/barricade/wooden,
/turf/open/floor/iron,
/area/template_noop)
"Wy" = (
/obj/structure/railing,
/turf/open/floor/iron/dark/textured_edge,
/area/template_noop)
"WB" = (
/obj/structure/railing{
	dir = 8
	},
/turf/open/floor/iron/stairs/left,
/area/template_noop)
"Xf" = (
/obj/item/kirbyplants/random,
/turf/open/floor/iron,
/area/template_noop)
"Xj" = (
/obj/machinery/door/airlock/external{
	req_access_txt = "150"
	},
/obj/effect/mapping_helpers/airlock/cyclelink_helper,
/turf/open/floor/plating,
/area/template_noop)
"XL" = (
/obj/effect/turf_decal/stripes/line,
/obj/effect/turf_decal/trimline/brown/line,
/obj/effect/turf_decal/siding/thinplating/dark{
	dir = 1
	},
/turf/open/floor/iron/smooth_large,
/area/template_noop)
"YJ" = (
/obj/structure/barricade/wooden/crude,
/turf/open/floor/iron,
/area/template_noop)
"YQ" = (
/obj/machinery/door/airlock/grunge{
	name = "Commisary";
	req_access_txt = "150"
	},
/turf/open/floor/iron,
/area/template_noop)
"Ze" = (
/obj/effect/turf_decal/stripes/line,
/obj/structure/fans/tiny/forcefield,
/turf/open/floor/plating,
/area/template_noop)
"Zf" = (
/turf/open/floor/iron/dark/smooth_corner{
	dir = 4
	},
/area/template_noop)
"Zu" = (
/obj/machinery/computer/security/telescreen/entertainment/directional/north,
/turf/open/floor/iron/dark/textured_edge{
	dir = 1
	},
/area/template_noop)
"Zv" = (
/obj/effect/turf_decal/stripes/corner{
	dir = 8
	},
/obj/effect/turf_decal/trimline/brown/corner{
	dir = 8
	},
/obj/effect/turf_decal/siding/thinplating/dark{
	dir = 1
	},
/turf/open/floor/iron/smooth_large,
/area/template_noop)
"ZX" = (
/obj/effect/turf_decal/tile/brown{
	dir = 8
	},
/obj/effect/decal/cleanable/dirt,
/turf/open/floor/iron,
/area/template_noop)

(1,1,1) = {"
mc
mc
mc
mc
mc
mc
mc
mc
mc
mc
mc
mc
mc
mc
mc
mc
mc
mc
mc
mc
mc
mc
mc
mc
mc
mc
mc
mc
mc
mc
mc
mc
qw
qw
qw
qw
qw
qw
qw
qw
qw
qw
qw
qw
qw
mc
mc
mc
mc
mc
"}
(2,1,1) = {"
mc
mc
mc
mc
mc
mc
mc
mc
mc
mc
mc
mc
mc
mc
mc
mc
mc
mc
mc
mc
mc
mc
mc
mc
mc
mc
mc
mc
mc
mc
mc
mc
qw
gT
xa
xa
xa
Ws
xa
cP
or
or
cP
xa
qw
mc
mc
mc
mc
mc
"}
(3,1,1) = {"
mc
mc
mc
mc
mc
mc
mc
mc
mc
mc
mc
mc
mc
mc
mc
mc
mc
mc
mc
mc
mc
mc
mc
mc
mc
mc
mc
mc
mc
mc
mc
mc
qw
pY
xa
xa
xa
YJ
xa
wa
wa
wa
bk
xa
qw
mc
mc
mc
mc
mc
"}
(4,1,1) = {"
mc
mc
mc
mc
mc
mc
mc
mc
mc
mc
mc
mc
mc
mc
mc
mc
mc
mc
mc
mc
mc
mc
mc
mc
mc
mc
mc
mc
mc
mc
mc
mc
qw
pY
xa
xa
xa
qw
xa
ww
Ay
wV
xa
UI
qw
mc
mc
mc
mc
mc
"}
(5,1,1) = {"
mc
mc
mc
mc
mc
mc
mc
mc
mc
mc
mc
mc
mc
mc
mc
mc
mc
mc
mc
mc
mc
mc
mc
mc
mc
mc
mc
mc
mc
mc
mc
mc
qw
pY
xa
xa
xa
NE
xa
pY
wa
pY
wa
xa
qw
mc
mc
mc
mc
mc
"}
(6,1,1) = {"
mc
mc
mc
mc
mc
mc
mc
mc
mc
mc
mc
mc
mc
mc
mc
mc
mc
mc
mc
mc
mc
mc
mc
mc
mc
mc
mc
mc
mc
mc
mc
mc
qw
xa
xa
xa
xa
qw
Xf
cP
ib
or
Pt
xa
qw
mc
mc
mc
mc
mc
"}
(7,1,1) = {"
mc
mc
mc
mc
mc
mc
mc
mc
mc
mc
mc
mc
mc
mc
mc
mc
mc
mc
mc
mc
mc
mc
mc
mc
mc
mc
mc
qw
qw
qw
qw
qw
qw
xa
xa
qw
qw
qw
qw
qw
qw
qw
qw
qw
qw
mc
mc
mc
mc
mc
"}
(8,1,1) = {"
mc
mc
mc
mc
mc
mc
mc
mc
mc
mc
mc
mc
mc
mc
mc
mc
mc
mc
mc
mc
mc
mc
mc
mc
mc
mc
mc
qw
Oe
my
jF
tP
qw
xa
Bp
qw
gR
ak
Ln
Ln
Ln
JA
ak
Au
qw
mc
mc
mc
mc
mc
"}
(9,1,1) = {"
mc
mc
mc
mc
mc
mc
mc
mc
mc
mc
mc
mc
mc
mc
mc
mc
mc
mc
mc
mc
mc
mc
mc
mc
mc
mc
mc
qw
Ib
Bp
wa
ZX
qw
Kf
Bp
yd
Cf
yO
jA
Bp
Bp
Bp
xX
qE
qw
mc
mc
mc
mc
mc
"}
(10,1,1) = {"
mc
mc
mc
mc
mc
mc
mc
mc
mc
mc
mc
mc
mc
mc
mc
mc
mc
mc
mc
mc
mc
mc
mc
mc
mc
mc
mc
qw
fz
lD
LH
Bp
YQ
pY
Bp
qw
tO
Bp
LH
Bp
LH
Bp
Bp
qE
qw
mc
mc
mc
mc
mc
"}
(11,1,1) = {"
mc
mc
mc
mc
mc
mc
mc
mc
mc
mc
mc
mc
mc
mc
mc
mc
mc
mc
mc
mc
mc
mc
mc
mc
mc
mc
mc
qw
zJ
iq
hd
iM
qw
iC
uO
qw
Cf
LH
Bp
xX
jA
Bp
Bp
pH
qw
mc
mc
mc
mc
mc
"}
(12,1,1) = {"
mc
mc
mc
mc
mc
mc
mc
mc
mc
mc
mc
mc
mc
mc
mc
mc
mc
mc
mc
mc
mc
mc
mc
mc
mc
mc
mc
qw
Jh
xa
xa
Bh
qw
Bp
Bp
qw
od
RC
nY
xa
gB
Tg
Gy
fH
qw
mc
mc
mc
mc
mc
"}
(13,1,1) = {"
mc
mc
mc
mc
mc
mc
mc
mc
mc
mc
mc
mc
mc
mc
mc
mc
mc
mc
mc
mc
mc
mc
mc
qw
qw
qw
qw
qw
FX
FX
FX
qw
qw
tB
qw
qw
qw
qw
qw
ty
qw
qw
qw
qw
qw
Vt
mc
mc
mc
mc
"}
(14,1,1) = {"
mc
mc
mc
mc
mc
mc
mc
mc
mc
mc
mc
mc
mc
mc
mc
mc
mc
mc
mc
mc
mc
mc
mc
qw
ED
ED
ED
qw
zC
oh
mI
yb
PT
PT
sx
PT
PT
PT
PT
PT
PT
sx
TC
Es
qw
Vt
Vt
mc
mc
mc
"}
(15,1,1) = {"
mc
mc
mc
mc
mc
mc
mc
mc
mc
mc
mc
mc
mc
mc
mc
mc
mc
mc
mc
mc
mc
mc
mc
qw
Lr
aC
aC
qw
iX
mI
Lc
wS
dE
dE
dE
dE
dE
dE
dE
dE
dE
dE
dE
dE
qw
bp
bp
uS
mc
mc
"}
(16,1,1) = {"
mc
mc
mc
mc
mc
mc
mc
mc
mc
mc
mc
mc
mc
mc
mc
mc
mc
mc
mc
mc
mc
mc
mc
qw
vU
zq
zq
tU
gk
cy
RH
hU
xN
We
xN
xN
xN
Nr
xN
xN
xN
We
xN
xN
qw
Vt
mc
Vt
mc
mc
"}
(17,1,1) = {"
mc
mc
mc
mc
mc
mc
mc
mc
mc
mc
mc
mc
mc
mc
mc
mc
mc
mc
mc
mc
mc
mc
mc
qw
Dw
KS
PM
tU
gk
cy
Wy
XL
wa
wa
wa
wa
wa
wa
wa
wa
wa
wa
wa
bU
Ze
mc
mc
Vt
mc
mc
"}
(18,1,1) = {"
mc
mc
mc
mc
mc
mc
mc
mc
mc
mc
mc
mc
mc
mc
mc
mc
mc
mc
mc
mc
mc
mc
mc
qw
Dw
Dw
LG
tU
gk
cy
Wy
qb
wa
wa
wa
wa
wa
wa
wa
wa
wa
wa
wa
wa
VI
mc
mc
Vt
mc
mc
"}
(19,1,1) = {"
mc
mc
mc
mc
mc
mc
mc
mc
mc
mc
mc
mc
mc
mc
mc
mc
mc
mc
mc
mc
mc
mc
mc
qw
qw
NX
qw
qw
gk
mI
Wy
XL
wa
wa
wa
wa
wa
wa
wa
wa
wa
wa
wa
hD
VI
mc
mc
Vt
mc
mc
"}
(20,1,1) = {"
mc
mc
mc
mc
mc
mc
mc
mc
mc
mc
mc
mc
mc
mc
mc
mc
mc
mc
mc
mc
mc
mc
mc
mc
fV
tT
Ml
qw
gk
gz
Wy
Mp
wa
wa
wa
wa
wa
wa
wa
wa
wa
wa
wa
Wg
VI
Vt
Vt
Vt
mc
mc
"}
(21,1,1) = {"
mc
mc
mc
mc
mc
mc
mc
mc
mc
mc
mc
mc
mc
mc
mc
mc
mc
mc
mc
mc
mc
mc
mc
mc
fb
HX
QV
qw
xr
rP
Wy
XL
wa
wa
wa
wa
wa
wa
wa
wa
wa
wa
wa
mG
VI
mc
mc
Vt
mc
mc
"}
(22,1,1) = {"
mc
mc
mc
mc
mc
mc
mc
mc
mc
mc
mc
mc
mc
mc
mc
mc
mc
mc
mc
mc
mc
mc
mc
mc
Zf
Lp
zk
qw
iX
gz
Wy
qb
wa
wa
wa
wa
wa
wa
wa
wa
wa
wa
wa
wa
VI
mc
mc
Vt
mc
mc
"}
(23,1,1) = {"
mc
mc
mc
mc
mc
mc
mc
mc
mc
mc
mc
mc
mc
mc
mc
mc
mc
mc
mc
mc
mc
mc
mc
mc
mI
mI
mI
qw
mI
mI
Wy
XL
wa
wa
wa
wa
wa
wa
lG
wa
wa
wa
wa
nv
Ze
mc
mc
Vt
mc
mc
"}
(24,1,1) = {"
mc
mc
mc
mc
mc
mc
mc
mc
mc
mc
mc
mc
mc
mc
mc
mc
mc
mc
mc
mc
mc
mc
mc
mc
fV
tT
Ml
FD
mI
cy
Wy
Zv
fC
sz
fC
fC
fC
Dl
fC
fC
fC
sz
fC
fC
qw
qw
qw
Vt
Vt
mc
"}
(25,1,1) = {"
mc
mc
mc
mc
mc
mc
mc
mc
mc
mc
mc
mc
mc
mc
mc
mc
mc
mc
mc
mc
mc
mc
mc
mc
fb
HX
QV
tU
mI
cy
Wy
wx
PT
RM
PT
PT
PT
RM
PT
PT
PT
RM
PT
PT
Xj
wa
hv
bp
bp
uS
"}
(26,1,1) = {"
mc
mc
mc
mc
mc
mc
mc
mc
mc
mc
mc
mc
mc
mc
mc
mc
mc
mc
mc
mc
mc
mc
mc
mc
Zf
Lp
zk
FD
mI
cy
Wy
hU
xN
We
xN
xN
xN
Nr
xN
xN
xN
We
xN
xN
qw
qw
qw
Vt
Vt
mc
"}
(27,1,1) = {"
mc
mc
mc
mc
mc
mc
mc
mc
mc
mc
mc
mc
mc
mc
mc
mc
mc
mc
mc
mc
mc
mc
mc
mc
mI
mI
mI
qw
mI
mI
Wy
XL
wa
wa
wa
wa
wa
wa
wa
wa
wa
wa
wa
bU
Ze
mc
mc
Vt
mc
mc
"}
(28,1,1) = {"
mc
mc
mc
mc
mc
mc
mc
mc
mc
mc
mc
mc
mc
mc
mc
mc
mc
mc
mc
mc
mc
mc
mc
mc
fV
tT
Ml
qw
iX
gz
Wy
qb
wa
wa
wa
wa
wa
wa
wa
wa
wa
wa
wa
wa
VI
mc
mc
Vt
mc
mc
"}
(29,1,1) = {"
mc
mc
mc
mc
mc
mc
mc
mc
mc
mc
mc
mc
mc
mc
mc
mc
mc
mc
mc
mc
mc
mc
mc
mc
fb
HX
QV
qw
Zu
rP
Wy
XL
wa
wa
wa
wa
wa
wa
wa
wa
wa
wa
wa
hD
VI
mc
mc
Vt
mc
mc
"}
(30,1,1) = {"
mc
mc
mc
mc
mc
mc
mc
mc
mc
mc
mc
mc
mc
mc
mc
mc
mc
mc
mc
mc
mc
mc
mc
mc
Zf
Lp
zk
qw
gk
gz
Wy
Mp
wa
wa
wa
wa
wa
wa
wa
wa
wa
wa
wa
Wg
VI
Vt
Vt
Vt
mc
mc
"}
(31,1,1) = {"
mc
mc
mc
mc
mc
mc
mc
mc
mc
mc
mc
mc
mc
mc
mc
mc
mc
mc
mc
mc
mc
mc
mc
mc
mc
mc
mc
qw
gk
mI
Wy
XL
wa
wa
wa
wa
wa
wa
wa
wa
wa
wa
wa
Pd
VI
mc
mc
Vt
mc
mc
"}
(32,1,1) = {"
mc
mc
mc
mc
mc
mc
mc
mc
mc
mc
mc
mc
mc
mc
mc
mc
mc
mc
mc
mc
mc
mc
mc
mc
mc
mc
mc
qw
gk
cy
Wy
qb
wa
wa
wa
wa
wa
wa
wa
wa
wa
wa
wa
wa
VI
mc
mc
Vt
mc
mc
"}
(33,1,1) = {"
mc
mc
mc
mc
mc
mc
mc
mc
mc
mc
mc
mc
mc
mc
mc
mc
mc
mc
mc
mc
mc
mc
mc
mc
mc
mc
mc
qw
gk
cy
Wy
XL
wa
wa
wa
wa
wa
wa
wa
wa
wa
wa
wa
nv
Ze
mc
mc
Vt
mc
mc
"}
(34,1,1) = {"
mc
mc
mc
mc
mc
mc
mc
mc
mc
mc
mc
mc
mc
mc
mc
mc
mc
mc
mc
mc
mc
mc
mc
mc
mc
mc
mc
qw
gk
cy
RH
Zv
fC
sz
fC
fC
fC
Dl
fC
fC
fC
sz
fC
fC
qw
Vt
mc
Vt
mc
mc
"}
(35,1,1) = {"
mc
mc
mc
mc
mc
mc
mc
mc
mc
mc
mc
mc
mc
mc
mc
mc
mc
mc
mc
mc
mc
mc
mc
mc
mc
mc
mc
qw
iX
mI
lC
WB
PT
PT
PT
PT
PT
PT
PT
PT
PT
PT
PT
PT
qw
bp
bp
uS
mc
mc
"}
(36,1,1) = {"
mc
mc
mc
mc
mc
mc
mc
mc
mc
mc
mc
mc
mc
mc
mc
mc
mc
mc
mc
mc
mc
mc
mc
mc
mc
mc
mc
qw
uR
St
mI
MN
dE
dE
nN
dE
dE
dE
dE
dE
dE
nN
dE
dE
qw
Vt
Vt
mc
mc
mc
"}
(37,1,1) = {"
mc
mc
mc
mc
mc
mc
mc
mc
mc
mc
mc
mc
mc
mc
mc
mc
mc
mc
mc
mc
mc
mc
mc
mc
mc
mc
mc
qw
qw
qw
qw
qw
qw
qw
qw
qw
qw
qw
qw
qw
qw
qw
qw
qw
qw
Vt
mc
mc
mc
mc
"}
(38,1,1) = {"
mc
mc
mc
mc
mc
mc
mc
mc
mc
mc
mc
mc
mc
mc
mc
mc
mc
mc
mc
mc
mc
mc
mc
mc
mc
mc
mc
mc
mc
mc
mc
mc
mc
mc
mc
mc
mc
mc
mc
mc
mc
mc
mc
mc
mc
mc
mc
mc
mc
mc
"}
(39,1,1) = {"
mc
mc
mc
mc
mc
mc
mc
mc
mc
mc
mc
mc
mc
mc
mc
mc
mc
mc
mc
mc
mc
mc
mc
mc
mc
mc
mc
mc
mc
mc
mc
mc
mc
mc
mc
mc
mc
mc
mc
mc
mc
mc
mc
mc
mc
mc
mc
mc
mc
mc
"}
(40,1,1) = {"
mc
mc
mc
mc
mc
mc
mc
mc
mc
mc
mc
mc
mc
mc
mc
mc
mc
mc
mc
mc
mc
mc
mc
mc
mc
mc
mc
mc
mc
mc
mc
mc
mc
mc
mc
mc
mc
mc
mc
mc
mc
mc
mc
mc
mc
mc
mc
mc
mc
mc
"}
(41,1,1) = {"
mc
mc
mc
mc
mc
mc
mc
mc
mc
mc
mc
mc
mc
mc
mc
mc
mc
mc
mc
mc
mc
mc
mc
mc
mc
mc
mc
mc
mc
mc
mc
mc
mc
mc
mc
mc
mc
mc
mc
mc
mc
mc
mc
mc
mc
mc
mc
mc
mc
mc
"}
(42,1,1) = {"
mc
mc
mc
mc
mc
mc
mc
mc
mc
mc
mc
mc
mc
mc
mc
mc
mc
mc
mc
mc
mc
mc
mc
mc
mc
mc
mc
mc
mc
mc
mc
mc
mc
mc
mc
mc
mc
mc
mc
mc
mc
mc
mc
mc
mc
mc
mc
mc
mc
mc
"}
(43,1,1) = {"
mc
mc
mc
mc
mc
mc
mc
mc
mc
mc
mc
mc
mc
mc
mc
mc
mc
mc
mc
mc
mc
mc
mc
mc
mc
mc
mc
mc
mc
mc
mc
mc
mc
mc
mc
mc
mc
mc
mc
mc
mc
mc
mc
mc
mc
mc
mc
mc
mc
mc
"}
(44,1,1) = {"
mc
mc
mc
mc
mc
mc
mc
mc
mc
mc
mc
mc
mc
mc
mc
mc
mc
mc
mc
mc
mc
mc
mc
mc
mc
mc
mc
mc
mc
mc
mc
mc
mc
mc
mc
mc
mc
mc
mc
mc
mc
mc
mc
mc
mc
mc
mc
mc
mc
mc
"}
(45,1,1) = {"
mc
mc
mc
mc
mc
mc
mc
mc
mc
mc
mc
mc
mc
mc
mc
mc
mc
mc
mc
mc
mc
mc
mc
mc
mc
mc
mc
mc
mc
mc
mc
mc
mc
mc
mc
mc
mc
mc
mc
mc
mc
mc
mc
mc
mc
mc
mc
mc
mc
mc
"}
(46,1,1) = {"
mc
mc
mc
mc
mc
mc
mc
mc
mc
mc
mc
mc
mc
mc
mc
mc
mc
mc
mc
mc
mc
mc
mc
mc
mc
mc
mc
mc
mc
mc
mc
mc
mc
mc
mc
mc
mc
mc
mc
mc
mc
mc
mc
mc
mc
mc
mc
mc
mc
mc
"}
(47,1,1) = {"
mc
mc
mc
mc
mc
mc
mc
mc
mc
mc
mc
mc
mc
mc
mc
mc
mc
mc
mc
mc
mc
mc
mc
mc
mc
mc
mc
mc
mc
mc
mc
mc
mc
mc
mc
mc
mc
mc
mc
mc
mc
mc
mc
mc
mc
mc
mc
mc
mc
mc
"}
(48,1,1) = {"
mc
mc
mc
mc
mc
mc
mc
mc
mc
mc
mc
mc
mc
mc
mc
mc
mc
mc
mc
mc
mc
mc
mc
mc
mc
mc
mc
mc
mc
mc
mc
mc
mc
mc
mc
mc
mc
mc
mc
mc
mc
mc
mc
mc
mc
mc
mc
mc
mc
mc
"}
(49,1,1) = {"
mc
mc
mc
mc
mc
mc
mc
mc
mc
mc
mc
mc
mc
mc
mc
mc
mc
mc
mc
mc
mc
mc
mc
mc
mc
mc
mc
mc
mc
mc
mc
mc
mc
mc
mc
mc
mc
mc
mc
mc
mc
mc
mc
mc
mc
mc
mc
mc
mc
mc
"}
(50,1,1) = {"
mc
mc
mc
mc
mc
mc
mc
mc
mc
mc
mc
mc
mc
mc
mc
mc
mc
mc
mc
mc
mc
mc
mc
mc
mc
mc
mc
mc
mc
mc
mc
mc
mc
mc
mc
mc
mc
mc
mc
mc
mc
mc
mc
mc
mc
mc
mc
mc
mc
mc
"}
