//MAP CONVERTED BY dmm2tgm.py THIS HEADER COMMENT PREVENTS RECONVERSION, DO NOT REMOVE
"bp" = (
/obj/structure/lattice/catwalk,
/turf/template_noop,
/area/template_noop)
"bU" = (
/obj/effect/turf_decal/box/corners{
	dir = 8
	},
/turf/open/floor/plating,
/area/template_noop)
"cy" = (
/obj/structure/lattice/catwalk/plated/dark,
/turf/open/floor/plating,
/area/template_noop)
"dE" = (
/turf/open/floor/iron/smooth_large,
/area/template_noop)
"fb" = (
/turf/open/floor/iron/dark/smooth_edge,
/area/template_noop)
"fC" = (
/obj/effect/turf_decal/stripes/line{
	dir = 8
	},
/obj/effect/turf_decal/trimline/brown/line{
	dir = 8
	},
/turf/open/floor/iron/smooth_large,
/area/template_noop)
"fV" = (
/turf/open/floor/iron/dark/smooth_corner{
	dir = 1
	},
/area/template_noop)
"gk" = (
/turf/open/floor/iron/dark/textured_edge{
	dir = 1
	},
/area/template_noop)
"gz" = (
/turf/open/floor/iron/dark/textured_large,
/area/template_noop)
"hv" = (
/obj/machinery/door/airlock/external{
	req_access_txt = "150"
	},
/obj/effect/mapping_helpers/airlock/cyclelink_helper{
	dir = 1
	},
/turf/open/floor/plating,
/area/template_noop)
"hU" = (
/obj/effect/turf_decal/stripes/corner,
/obj/effect/turf_decal/trimline/brown/corner,
/obj/effect/turf_decal/siding/thinplating/dark{
	dir = 1
	},
/turf/open/floor/iron/smooth_large,
/area/template_noop)
"lC" = (
/obj/structure/railing/corner{
	dir = 8
	},
/turf/open/floor/iron/dark,
/area/template_noop)
"lG" = (
/obj/docking_port/stationary{
	dir = 8;
	dwidth = 8;
	height = 7;
	id = "interdyne_cargo_away";
	name = "Interdyne Forward Operating Base";
	roundstart_template = /datum/map_template/shuttle/ruin/interdyne_cargo;
	width = 20
	},
/turf/open/floor/plating,
/area/template_noop)
"mc" = (
/turf/template_noop,
/area/template_noop)
"mI" = (
/turf/open/floor/iron/dark,
/area/template_noop)
"nv" = (
/obj/effect/turf_decal/box/corners,
/turf/open/floor/plating,
/area/template_noop)
"oh" = (
/turf/open/floor/iron/dark/textured_edge{
	dir = 8
	},
/area/template_noop)
"qb" = (
/obj/effect/turf_decal/stripes/line,
/obj/effect/turf_decal/trimline/brown/line,
/obj/effect/turf_decal/caution/stand_clear{
	dir = 1
	},
/obj/effect/turf_decal/siding/thinplating/dark{
	dir = 1
	},
/turf/open/floor/iron/smooth_large,
/area/template_noop)
"qw" = (
/turf/closed/wall/r_wall/syndicate/nodiagonal,
/area/template_noop)
"rP" = (
/turf/open/floor/iron/dark/smooth_half,
/area/template_noop)
"sz" = (
/obj/effect/turf_decal/stripes/line{
	dir = 8
	},
/obj/effect/turf_decal/trimline/brown/line{
	dir = 8
	},
/obj/effect/turf_decal/caution/stand_clear{
	dir = 4
	},
/turf/open/floor/iron/smooth_large,
/area/template_noop)
"tT" = (
/turf/open/floor/iron/dark/smooth_edge{
	dir = 4
	},
/area/template_noop)
"tU" = (
/obj/effect/spawner/structure/window/plasma/reinforced/plastitanium,
/turf/open/floor/plating,
/area/template_noop)
"uR" = (
/turf/open/floor/iron/dark/textured_corner{
	dir = 8
	},
/area/template_noop)
"uS" = (
/obj/structure/lattice/catwalk,
/obj/structure/marker_beacon/burgundy,
/turf/open/floor/plating/airless,
/area/template_noop)
"wa" = (
/turf/open/floor/plating,
/area/template_noop)
"wx" = (
/obj/effect/turf_decal/siding/thinplating/dark{
	dir = 1
	},
/turf/open/floor/iron/smooth_half{
	dir = 1
	},
/area/template_noop)
"wS" = (
/obj/structure/railing{
	dir = 4
	},
/turf/open/floor/iron/stairs/right,
/area/template_noop)
"xN" = (
/obj/effect/turf_decal/stripes/line{
	dir = 4
	},
/obj/effect/turf_decal/trimline/brown/line{
	dir = 4
	},
/turf/open/floor/iron/smooth_large,
/area/template_noop)
"yb" = (
/turf/open/floor/iron/stairs/left,
/area/template_noop)
"zk" = (
/turf/open/floor/iron/dark/smooth_corner,
/area/template_noop)
"zC" = (
/turf/open/floor/iron/dark/textured_corner,
/area/template_noop)
"Dl" = (
/obj/effect/turf_decal/stripes/line{
	dir = 8
	},
/obj/effect/turf_decal/trimline/brown/line{
	dir = 8
	},
/obj/effect/turf_decal/caution{
	dir = 4
	},
/turf/open/floor/iron/smooth_large,
/area/template_noop)
"Es" = (
/obj/structure/closet/crate/large,
/obj/item/disk{
	desc = "A cheap, plastic hard-disk labelled 'good tunes to assault ops to'. It looks disused.";
	icon_state = "nucleardisk";
	name = "dat fukken disk"
	},
/turf/open/floor/iron/smooth_half{
	dir = 1
	},
/area/template_noop)
"FD" = (
/obj/machinery/door/airlock/grunge{
	name = "Hangar";
	req_access_txt = "150"
	},
/turf/open/floor/iron/dark,
/area/template_noop)
"HX" = (
/turf/open/floor/iron/dark/smooth_large,
/area/template_noop)
"Lc" = (
/obj/structure/railing/corner,
/turf/open/floor/iron/dark,
/area/template_noop)
"Lp" = (
/turf/open/floor/iron/dark/smooth_edge{
	dir = 8
	},
/area/template_noop)
"Ml" = (
/turf/open/floor/iron/dark/smooth_corner{
	dir = 8
	},
/area/template_noop)
"Mp" = (
/obj/effect/turf_decal/stripes/line,
/obj/effect/turf_decal/trimline/brown/line,
/obj/effect/turf_decal/caution{
	dir = 1
	},
/obj/effect/turf_decal/siding/thinplating/dark{
	dir = 1
	},
/turf/open/floor/iron/smooth_large,
/area/template_noop)
"MN" = (
/turf/open/floor/iron/stairs/right,
/area/template_noop)
"Nr" = (
/obj/effect/turf_decal/stripes/line{
	dir = 4
	},
/obj/effect/turf_decal/trimline/brown/line{
	dir = 4
	},
/obj/effect/turf_decal/caution{
	dir = 8
	},
/turf/open/floor/iron/smooth_large,
/area/template_noop)
"PT" = (
/turf/open/floor/iron/smooth_half{
	dir = 1
	},
/area/template_noop)
"QV" = (
/turf/open/floor/iron/dark/smooth_edge{
	dir = 1
	},
/area/template_noop)
"RH" = (
/obj/structure/railing,
/turf/open/floor/iron/dark,
/area/template_noop)
"RM" = (
/obj/effect/turf_decal/delivery,
/turf/open/floor/iron/smooth_half{
	dir = 1
	},
/area/template_noop)
"St" = (
/turf/open/floor/iron/dark/textured_edge{
	dir = 4
	},
/area/template_noop)
"TC" = (
/obj/structure/closet/crate,
/obj/effect/spawner/lootdrop/maintenance,
/turf/open/floor/iron/smooth_half{
	dir = 1
	},
/area/template_noop)
"Vt" = (
/obj/structure/lattice,
/turf/template_noop,
/area/template_noop)
"VI" = (
/obj/structure/fans/tiny/forcefield,
/obj/effect/turf_decal/stripes/line,
/turf/open/floor/plating,
/area/template_noop)
"We" = (
/obj/effect/turf_decal/stripes/line{
	dir = 4
	},
/obj/effect/turf_decal/trimline/brown/line{
	dir = 4
	},
/obj/effect/turf_decal/caution/stand_clear{
	dir = 8
	},
/turf/open/floor/iron/smooth_large,
/area/template_noop)
"Wy" = (
/obj/structure/railing,
/turf/open/floor/iron/dark/textured_edge,
/area/template_noop)
"WB" = (
/obj/structure/railing{
	dir = 8
	},
/turf/open/floor/iron/stairs/left,
/area/template_noop)
"Xj" = (
/obj/machinery/door/airlock/external{
	req_access_txt = "150"
	},
/obj/effect/mapping_helpers/airlock/cyclelink_helper,
/turf/open/floor/plating,
/area/template_noop)
"XL" = (
/obj/effect/turf_decal/stripes/line,
/obj/effect/turf_decal/trimline/brown/line,
/obj/effect/turf_decal/siding/thinplating/dark{
	dir = 1
	},
/turf/open/floor/iron/smooth_large,
/area/template_noop)
"Zf" = (
/turf/open/floor/iron/dark/smooth_corner{
	dir = 4
	},
/area/template_noop)
"Zv" = (
/obj/effect/turf_decal/stripes/corner{
	dir = 8
	},
/obj/effect/turf_decal/trimline/brown/corner{
	dir = 8
	},
/obj/effect/turf_decal/siding/thinplating/dark{
	dir = 1
	},
/turf/open/floor/iron/smooth_large,
/area/template_noop)

(1,1,1) = {"
mc
mc
mc
mc
mc
mc
mc
mc
mc
mc
mc
mc
mc
mc
mc
mc
mc
mc
mc
mc
mc
mc
mc
mc
mc
mc
mc
mc
mc
mc
mc
mc
mc
mc
mc
mc
mc
mc
mc
mc
mc
mc
mc
mc
mc
mc
mc
mc
mc
mc
"}
(2,1,1) = {"
mc
mc
mc
mc
mc
mc
mc
mc
mc
mc
mc
mc
mc
mc
mc
mc
mc
mc
mc
mc
mc
mc
mc
mc
mc
mc
mc
mc
mc
mc
mc
mc
mc
mc
mc
mc
mc
mc
mc
mc
mc
mc
mc
mc
mc
mc
mc
mc
mc
mc
"}
(3,1,1) = {"
mc
mc
mc
mc
mc
mc
mc
mc
mc
mc
mc
mc
mc
mc
mc
mc
mc
mc
mc
mc
mc
mc
mc
mc
mc
mc
mc
mc
mc
mc
mc
mc
mc
mc
mc
mc
mc
mc
mc
mc
mc
mc
mc
mc
mc
mc
mc
mc
mc
mc
"}
(4,1,1) = {"
mc
mc
mc
mc
mc
mc
mc
mc
mc
mc
mc
mc
mc
mc
mc
mc
mc
mc
mc
mc
mc
mc
mc
mc
mc
mc
mc
mc
mc
mc
mc
mc
mc
mc
mc
mc
mc
mc
mc
mc
mc
mc
mc
mc
mc
mc
mc
mc
mc
mc
"}
(5,1,1) = {"
mc
mc
mc
mc
mc
mc
mc
mc
mc
mc
mc
mc
mc
mc
mc
mc
mc
mc
mc
mc
mc
mc
mc
mc
mc
mc
mc
mc
mc
mc
mc
mc
mc
mc
mc
mc
mc
mc
mc
mc
mc
mc
mc
mc
mc
mc
mc
mc
mc
mc
"}
(6,1,1) = {"
mc
mc
mc
mc
mc
mc
mc
mc
mc
mc
mc
mc
mc
mc
mc
mc
mc
mc
mc
mc
mc
mc
mc
mc
mc
mc
mc
mc
mc
mc
mc
mc
mc
mc
mc
mc
mc
mc
mc
mc
mc
mc
mc
mc
mc
mc
mc
mc
mc
mc
"}
(7,1,1) = {"
mc
mc
mc
mc
mc
mc
mc
mc
mc
mc
mc
mc
mc
mc
mc
mc
mc
mc
mc
mc
mc
mc
mc
mc
mc
mc
mc
mc
mc
mc
mc
mc
mc
mc
mc
mc
mc
mc
mc
mc
mc
mc
mc
mc
mc
mc
mc
mc
mc
mc
"}
(8,1,1) = {"
mc
mc
mc
mc
mc
mc
mc
mc
mc
mc
mc
mc
mc
mc
mc
mc
mc
mc
mc
mc
mc
mc
mc
mc
mc
mc
mc
mc
mc
mc
mc
mc
mc
mc
mc
mc
mc
mc
mc
mc
mc
mc
mc
mc
mc
mc
mc
mc
mc
mc
"}
(9,1,1) = {"
mc
mc
mc
mc
mc
mc
mc
mc
mc
mc
mc
mc
mc
mc
mc
mc
mc
mc
mc
mc
mc
mc
mc
mc
mc
mc
mc
mc
mc
mc
mc
mc
mc
mc
mc
mc
mc
mc
mc
mc
mc
mc
mc
mc
mc
mc
mc
mc
mc
mc
"}
(10,1,1) = {"
mc
mc
mc
mc
mc
mc
mc
mc
mc
mc
mc
mc
mc
mc
mc
mc
mc
mc
mc
mc
mc
mc
mc
mc
mc
mc
mc
mc
mc
mc
mc
mc
mc
mc
mc
mc
mc
mc
mc
mc
mc
mc
mc
mc
mc
mc
mc
mc
mc
mc
"}
(11,1,1) = {"
mc
mc
mc
mc
mc
mc
mc
mc
mc
mc
mc
mc
mc
mc
mc
mc
mc
mc
mc
mc
mc
mc
mc
mc
mc
mc
mc
mc
mc
mc
mc
mc
mc
mc
mc
mc
mc
mc
mc
mc
mc
mc
mc
mc
mc
mc
mc
mc
mc
mc
"}
(12,1,1) = {"
mc
mc
mc
mc
mc
mc
mc
mc
mc
mc
mc
mc
mc
mc
mc
mc
mc
mc
mc
mc
mc
mc
mc
mc
mc
mc
mc
mc
mc
mc
mc
mc
mc
mc
mc
mc
mc
mc
mc
mc
mc
mc
mc
mc
mc
mc
mc
mc
mc
mc
"}
(13,1,1) = {"
mc
mc
mc
mc
mc
mc
mc
mc
mc
mc
mc
mc
mc
mc
mc
mc
mc
mc
mc
mc
mc
mc
mc
mc
mc
mc
mc
qw
qw
qw
qw
qw
qw
qw
qw
qw
qw
qw
qw
qw
qw
qw
qw
qw
qw
Vt
mc
mc
mc
mc
"}
(14,1,1) = {"
mc
mc
mc
mc
mc
mc
mc
mc
mc
mc
mc
mc
mc
mc
mc
mc
mc
mc
mc
mc
mc
mc
mc
mc
mc
mc
mc
qw
zC
oh
mI
yb
PT
PT
PT
PT
PT
PT
PT
PT
PT
PT
TC
Es
qw
Vt
Vt
mc
mc
mc
"}
(15,1,1) = {"
mc
mc
mc
mc
mc
mc
mc
mc
mc
mc
mc
mc
mc
mc
mc
mc
mc
mc
mc
mc
mc
mc
mc
mc
mc
mc
mc
qw
gk
mI
Lc
wS
dE
dE
dE
dE
dE
dE
dE
dE
dE
dE
dE
dE
qw
bp
bp
uS
mc
mc
"}
(16,1,1) = {"
mc
mc
mc
mc
mc
mc
mc
mc
mc
mc
mc
mc
mc
mc
mc
mc
mc
mc
mc
mc
mc
mc
mc
mc
mc
mc
mc
qw
gk
cy
RH
hU
xN
We
xN
xN
xN
Nr
xN
xN
xN
We
xN
xN
qw
Vt
mc
Vt
mc
mc
"}
(17,1,1) = {"
mc
mc
mc
mc
mc
mc
mc
mc
mc
mc
mc
mc
mc
mc
mc
mc
mc
mc
mc
mc
mc
mc
mc
mc
mc
mc
mc
qw
gk
cy
Wy
XL
wa
wa
wa
wa
wa
wa
wa
wa
wa
wa
wa
bU
VI
mc
mc
Vt
mc
mc
"}
(18,1,1) = {"
mc
mc
mc
mc
mc
mc
mc
mc
mc
mc
mc
mc
mc
mc
mc
mc
mc
mc
mc
mc
mc
mc
mc
mc
mc
mc
mc
qw
gk
cy
Wy
qb
wa
wa
wa
wa
wa
wa
wa
wa
wa
wa
wa
wa
VI
mc
mc
Vt
mc
mc
"}
(19,1,1) = {"
mc
mc
mc
mc
mc
mc
mc
mc
mc
mc
mc
mc
mc
mc
mc
mc
mc
mc
mc
mc
mc
mc
mc
mc
mc
mc
mc
qw
gk
mI
Wy
XL
wa
wa
wa
wa
wa
wa
wa
wa
wa
wa
wa
wa
VI
mc
mc
Vt
mc
mc
"}
(20,1,1) = {"
mc
mc
mc
mc
mc
mc
mc
mc
mc
mc
mc
mc
mc
mc
mc
mc
fV
tT
Ml
mI
fV
tT
Ml
mI
fV
tT
Ml
qw
gk
gz
Wy
Mp
wa
wa
wa
wa
wa
wa
wa
wa
wa
wa
wa
wa
VI
Vt
Vt
Vt
mc
mc
"}
(21,1,1) = {"
mc
mc
mc
mc
mc
mc
mc
mc
mc
mc
mc
mc
mc
mc
mc
mc
fb
HX
QV
mI
fb
HX
QV
mI
fb
HX
QV
qw
gk
rP
Wy
XL
wa
wa
wa
wa
wa
wa
wa
wa
wa
wa
wa
wa
VI
mc
mc
Vt
mc
mc
"}
(22,1,1) = {"
mc
mc
mc
mc
mc
mc
mc
mc
mc
mc
mc
mc
mc
mc
mc
mc
Zf
Lp
zk
mI
Zf
Lp
zk
mI
Zf
Lp
zk
qw
gk
gz
Wy
qb
wa
wa
wa
wa
wa
wa
wa
wa
wa
wa
wa
wa
VI
mc
mc
Vt
mc
mc
"}
(23,1,1) = {"
mc
mc
mc
mc
mc
mc
mc
mc
mc
mc
mc
mc
mc
mc
mc
mc
mI
mI
mI
wa
wa
wa
wa
wa
mI
mI
mI
qw
mI
mI
Wy
XL
wa
wa
wa
wa
wa
wa
lG
wa
wa
wa
wa
nv
VI
mc
mc
Vt
mc
mc
"}
(24,1,1) = {"
mc
mc
mc
mc
mc
mc
mc
mc
mc
mc
mc
mc
mc
mc
mc
mc
fV
tT
Ml
wa
mc
mc
mc
wa
fV
tT
Ml
FD
mI
cy
Wy
Zv
fC
sz
fC
fC
fC
Dl
fC
fC
fC
sz
fC
fC
qw
qw
qw
Vt
Vt
mc
"}
(25,1,1) = {"
mc
mc
mc
mc
mc
mc
mc
mc
mc
mc
mc
mc
mc
mc
mc
mc
fb
HX
QV
wa
mc
mc
mc
wa
fb
HX
QV
tU
mI
cy
Wy
wx
PT
RM
PT
PT
PT
RM
PT
PT
PT
RM
PT
PT
Xj
wa
hv
bp
bp
uS
"}
(26,1,1) = {"
mc
mc
mc
mc
mc
mc
mc
mc
mc
mc
mc
mc
mc
mc
mc
mc
Zf
Lp
zk
wa
mc
mc
mc
wa
Zf
Lp
zk
FD
mI
cy
Wy
hU
xN
We
xN
xN
xN
Nr
xN
xN
xN
We
xN
xN
qw
qw
qw
Vt
Vt
mc
"}
(27,1,1) = {"
mc
mc
mc
mc
mc
mc
mc
mc
mc
mc
mc
mc
mc
mc
mc
mc
mI
mI
mI
wa
wa
wa
wa
wa
mI
mI
mI
qw
mI
mI
Wy
XL
wa
wa
wa
wa
wa
wa
wa
wa
wa
wa
wa
bU
VI
mc
mc
Vt
mc
mc
"}
(28,1,1) = {"
mc
mc
mc
mc
mc
mc
mc
mc
mc
mc
mc
mc
mc
mc
mc
mc
fV
tT
Ml
mI
fV
tT
Ml
mI
fV
tT
Ml
qw
gk
gz
Wy
qb
wa
wa
wa
wa
wa
wa
wa
wa
wa
wa
wa
wa
VI
mc
mc
Vt
mc
mc
"}
(29,1,1) = {"
mc
mc
mc
mc
mc
mc
mc
mc
mc
mc
mc
mc
mc
mc
mc
mc
fb
HX
QV
mI
fb
HX
QV
mI
fb
HX
QV
qw
gk
rP
Wy
XL
wa
wa
wa
wa
wa
wa
wa
wa
wa
wa
wa
wa
VI
mc
mc
Vt
mc
mc
"}
(30,1,1) = {"
mc
mc
mc
mc
mc
mc
mc
mc
mc
mc
mc
mc
mc
mc
mc
mc
Zf
Lp
zk
mI
Zf
Lp
zk
mI
Zf
Lp
zk
qw
gk
gz
Wy
Mp
wa
wa
wa
wa
wa
wa
wa
wa
wa
wa
wa
wa
VI
Vt
Vt
Vt
mc
mc
"}
(31,1,1) = {"
mc
mc
mc
mc
mc
mc
mc
mc
mc
mc
mc
mc
mc
mc
mc
mc
mc
mc
mc
mc
mc
mc
mc
mc
mc
mc
mc
qw
gk
mI
Wy
XL
wa
wa
wa
wa
wa
wa
wa
wa
wa
wa
wa
wa
VI
mc
mc
Vt
mc
mc
"}
(32,1,1) = {"
mc
mc
mc
mc
mc
mc
mc
mc
mc
mc
mc
mc
mc
mc
mc
mc
mc
mc
mc
mc
mc
mc
mc
mc
mc
mc
mc
qw
gk
cy
Wy
qb
wa
wa
wa
wa
wa
wa
wa
wa
wa
wa
wa
wa
VI
mc
mc
Vt
mc
mc
"}
(33,1,1) = {"
mc
mc
mc
mc
mc
mc
mc
mc
mc
mc
mc
mc
mc
mc
mc
mc
mc
mc
mc
mc
mc
mc
mc
mc
mc
mc
mc
qw
gk
cy
Wy
XL
wa
wa
wa
wa
wa
wa
wa
wa
wa
wa
wa
nv
VI
mc
mc
Vt
mc
mc
"}
(34,1,1) = {"
mc
mc
mc
mc
mc
mc
mc
mc
mc
mc
mc
mc
mc
mc
mc
mc
mc
mc
mc
mc
mc
mc
mc
mc
mc
mc
mc
qw
gk
cy
RH
Zv
fC
sz
fC
fC
fC
Dl
fC
fC
fC
sz
fC
fC
qw
Vt
mc
Vt
mc
mc
"}
(35,1,1) = {"
mc
mc
mc
mc
mc
mc
mc
mc
mc
mc
mc
mc
mc
mc
mc
mc
mc
mc
mc
mc
mc
mc
mc
mc
mc
mc
mc
qw
gk
mI
lC
WB
PT
PT
PT
PT
PT
PT
PT
PT
PT
PT
PT
PT
qw
bp
bp
uS
mc
mc
"}
(36,1,1) = {"
mc
mc
mc
mc
mc
mc
mc
mc
mc
mc
mc
mc
mc
mc
mc
mc
mc
mc
mc
mc
mc
mc
mc
mc
mc
mc
mc
qw
uR
St
mI
MN
dE
dE
dE
dE
dE
dE
dE
dE
dE
dE
dE
dE
qw
Vt
Vt
mc
mc
mc
"}
(37,1,1) = {"
mc
mc
mc
mc
mc
mc
mc
mc
mc
mc
mc
mc
mc
mc
mc
mc
mc
mc
mc
mc
mc
mc
mc
mc
mc
mc
mc
qw
qw
qw
qw
qw
qw
qw
qw
qw
qw
qw
qw
qw
qw
qw
qw
qw
qw
Vt
mc
mc
mc
mc
"}
(38,1,1) = {"
mc
mc
mc
mc
mc
mc
mc
mc
mc
mc
mc
mc
mc
mc
mc
mc
mc
mc
mc
mc
mc
mc
mc
mc
mc
mc
mc
mc
mc
mc
mc
mc
mc
mc
mc
mc
mc
mc
mc
mc
mc
mc
mc
mc
mc
mc
mc
mc
mc
mc
"}
(39,1,1) = {"
mc
mc
mc
mc
mc
mc
mc
mc
mc
mc
mc
mc
mc
mc
mc
mc
mc
mc
mc
mc
mc
mc
mc
mc
mc
mc
mc
mc
mc
mc
mc
mc
mc
mc
mc
mc
mc
mc
mc
mc
mc
mc
mc
mc
mc
mc
mc
mc
mc
mc
"}
(40,1,1) = {"
mc
mc
mc
mc
mc
mc
mc
mc
mc
mc
mc
mc
mc
mc
mc
mc
mc
mc
mc
mc
mc
mc
mc
mc
mc
mc
mc
mc
mc
mc
mc
mc
mc
mc
mc
mc
mc
mc
mc
mc
mc
mc
mc
mc
mc
mc
mc
mc
mc
mc
"}
(41,1,1) = {"
mc
mc
mc
mc
mc
mc
mc
mc
mc
mc
mc
mc
mc
mc
mc
mc
mc
mc
mc
mc
mc
mc
mc
mc
mc
mc
mc
mc
mc
mc
mc
mc
mc
mc
mc
mc
mc
mc
mc
mc
mc
mc
mc
mc
mc
mc
mc
mc
mc
mc
"}
(42,1,1) = {"
mc
mc
mc
mc
mc
mc
mc
mc
mc
mc
mc
mc
mc
mc
mc
mc
mc
mc
mc
mc
mc
mc
mc
mc
mc
mc
mc
mc
mc
mc
mc
mc
mc
mc
mc
mc
mc
mc
mc
mc
mc
mc
mc
mc
mc
mc
mc
mc
mc
mc
"}
(43,1,1) = {"
mc
mc
mc
mc
mc
mc
mc
mc
mc
mc
mc
mc
mc
mc
mc
mc
mc
mc
mc
mc
mc
mc
mc
mc
mc
mc
mc
mc
mc
mc
mc
mc
mc
mc
mc
mc
mc
mc
mc
mc
mc
mc
mc
mc
mc
mc
mc
mc
mc
mc
"}
(44,1,1) = {"
mc
mc
mc
mc
mc
mc
mc
mc
mc
mc
mc
mc
mc
mc
mc
mc
mc
mc
mc
mc
mc
mc
mc
mc
mc
mc
mc
mc
mc
mc
mc
mc
mc
mc
mc
mc
mc
mc
mc
mc
mc
mc
mc
mc
mc
mc
mc
mc
mc
mc
"}
(45,1,1) = {"
mc
mc
mc
mc
mc
mc
mc
mc
mc
mc
mc
mc
mc
mc
mc
mc
mc
mc
mc
mc
mc
mc
mc
mc
mc
mc
mc
mc
mc
mc
mc
mc
mc
mc
mc
mc
mc
mc
mc
mc
mc
mc
mc
mc
mc
mc
mc
mc
mc
mc
"}
(46,1,1) = {"
mc
mc
mc
mc
mc
mc
mc
mc
mc
mc
mc
mc
mc
mc
mc
mc
mc
mc
mc
mc
mc
mc
mc
mc
mc
mc
mc
mc
mc
mc
mc
mc
mc
mc
mc
mc
mc
mc
mc
mc
mc
mc
mc
mc
mc
mc
mc
mc
mc
mc
"}
(47,1,1) = {"
mc
mc
mc
mc
mc
mc
mc
mc
mc
mc
mc
mc
mc
mc
mc
mc
mc
mc
mc
mc
mc
mc
mc
mc
mc
mc
mc
mc
mc
mc
mc
mc
mc
mc
mc
mc
mc
mc
mc
mc
mc
mc
mc
mc
mc
mc
mc
mc
mc
mc
"}
(48,1,1) = {"
mc
mc
mc
mc
mc
mc
mc
mc
mc
mc
mc
mc
mc
mc
mc
mc
mc
mc
mc
mc
mc
mc
mc
mc
mc
mc
mc
mc
mc
mc
mc
mc
mc
mc
mc
mc
mc
mc
mc
mc
mc
mc
mc
mc
mc
mc
mc
mc
mc
mc
"}
(49,1,1) = {"
mc
mc
mc
mc
mc
mc
mc
mc
mc
mc
mc
mc
mc
mc
mc
mc
mc
mc
mc
mc
mc
mc
mc
mc
mc
mc
mc
mc
mc
mc
mc
mc
mc
mc
mc
mc
mc
mc
mc
mc
mc
mc
mc
mc
mc
mc
mc
mc
mc
mc
"}
(50,1,1) = {"
mc
mc
mc
mc
mc
mc
mc
mc
mc
mc
mc
mc
mc
mc
mc
mc
mc
mc
mc
mc
mc
mc
mc
mc
mc
mc
mc
mc
mc
mc
mc
mc
mc
mc
mc
mc
mc
mc
mc
mc
mc
mc
mc
mc
mc
mc
mc
mc
mc
mc
"}
