//MAP CONVERTED BY dmm2tgm.py THIS HEADER COMMENT PREVENTS RECONVERSION, DO NOT REMOVE
"a" = (
/turf/closed/wall/r_wall/syndicate/nodiagonal,
/area/template_noop)
"b" = (
/obj/effect/turf_decal/stripes/line{
	dir = 8
	},
/obj/effect/turf_decal/trimline/brown/line{
	dir = 8
	},
/obj/effect/turf_decal/caution{
	dir = 4
	},
/turf/open/floor/iron/smooth_large,
/area/template_noop)
"c" = (
/turf/open/floor/iron/smooth_half{
	dir = 1
	},
/area/template_noop)
"d" = (
/obj/effect/turf_decal/box/corners,
/turf/open/floor/plating,
/area/template_noop)
"f" = (
/turf/open/floor/iron/dark,
/area/template_noop)
"g" = (
/obj/structure/railing/corner,
/turf/open/floor/iron/dark,
/area/template_noop)
"j" = (
/obj/structure/railing,
/turf/open/floor/iron/dark,
/area/template_noop)
"k" = (
/obj/structure/railing/corner{
	dir = 8
	},
/turf/open/floor/iron/dark,
/area/template_noop)
"l" = (
/obj/effect/turf_decal/stripes/line{
	dir = 8
	},
/obj/effect/turf_decal/trimline/brown/line{
	dir = 8
	},
/obj/effect/turf_decal/caution/stand_clear{
	dir = 4
	},
/turf/open/floor/iron/smooth_large,
/area/template_noop)
"m" = (
/turf/open/floor/iron/stairs/left,
/area/template_noop)
"q" = (
/obj/effect/turf_decal/delivery,
/turf/open/floor/iron/smooth_half{
	dir = 1
	},
/area/template_noop)
"s" = (
/turf/template_noop,
/area/template_noop)
"t" = (
/obj/structure/railing{
	dir = 4
	},
/turf/open/floor/iron/stairs/right,
/area/template_noop)
"u" = (
/obj/structure/lattice/catwalk,
/obj/structure/marker_beacon/burgundy,
/turf/open/floor/plating/airless,
/area/template_noop)
"v" = (
/obj/docking_port/stationary{
	dir = 8;
	dwidth = 8;
	height = 7;
	id = "interdyne_cargo_away";
	name = "Interdyne Forward Operating Base";
	roundstart_template = /datum/map_template/shuttle/ruin/interdyne_cargo;
	width = 20
	},
/turf/open/floor/plating,
/area/template_noop)
"x" = (
/obj/effect/turf_decal/stripes/corner,
/obj/effect/turf_decal/trimline/brown/corner,
/obj/effect/turf_decal/siding/thinplating/dark{
	dir = 1
	},
/turf/open/floor/iron/smooth_large,
/area/template_noop)
"A" = (
/obj/effect/turf_decal/stripes/line,
/obj/effect/turf_decal/trimline/brown/line,
/obj/effect/turf_decal/siding/thinplating/dark{
	dir = 1
	},
/turf/open/floor/iron/smooth_large,
/area/template_noop)
"B" = (
/obj/machinery/door/airlock/external{
	req_access_txt = "150"
	},
/turf/open/floor/plating,
/area/template_noop)
"C" = (
/obj/effect/turf_decal/stripes/line,
/obj/effect/turf_decal/trimline/brown/line,
/obj/effect/turf_decal/caution/stand_clear{
	dir = 1
	},
/obj/effect/turf_decal/siding/thinplating/dark{
	dir = 1
	},
/turf/open/floor/iron/smooth_large,
/area/template_noop)
"D" = (
/obj/effect/turf_decal/stripes/line,
/obj/effect/turf_decal/trimline/brown/line,
/obj/effect/turf_decal/caution{
	dir = 1
	},
/obj/effect/turf_decal/siding/thinplating/dark{
	dir = 1
	},
/turf/open/floor/iron/smooth_large,
/area/template_noop)
"F" = (
/obj/effect/turf_decal/stripes/corner{
	dir = 8
	},
/obj/effect/turf_decal/trimline/brown/corner{
	dir = 8
	},
/obj/effect/turf_decal/siding/thinplating/dark{
	dir = 1
	},
/turf/open/floor/iron/smooth_large,
/area/template_noop)
"G" = (
/obj/effect/turf_decal/siding/thinplating/dark{
	dir = 1
	},
/turf/open/floor/iron/smooth_half{
	dir = 1
	},
/area/template_noop)
"J" = (
/obj/effect/turf_decal/stripes/line{
	dir = 4
	},
/obj/effect/turf_decal/trimline/brown/line{
	dir = 4
	},
/obj/effect/turf_decal/caution{
	dir = 8
	},
/turf/open/floor/iron/smooth_large,
/area/template_noop)
"L" = (
/obj/structure/railing{
	dir = 8
	},
/turf/open/floor/iron/stairs/left,
/area/template_noop)
"M" = (
/turf/open/floor/iron/stairs/right,
/area/template_noop)
"P" = (
/obj/structure/fans/tiny/forcefield,
/obj/effect/turf_decal/stripes/line,
/turf/open/floor/plating,
/area/template_noop)
"Q" = (
/turf/open/floor/iron/smooth_large,
/area/template_noop)
"R" = (
/obj/effect/turf_decal/box/corners{
	dir = 8
	},
/turf/open/floor/plating,
/area/template_noop)
"T" = (
/obj/effect/turf_decal/stripes/line{
	dir = 4
	},
/obj/effect/turf_decal/trimline/brown/line{
	dir = 4
	},
/turf/open/floor/iron/smooth_large,
/area/template_noop)
"U" = (
/obj/structure/lattice,
/turf/template_noop,
/area/template_noop)
"V" = (
/obj/structure/lattice/catwalk,
/turf/template_noop,
/area/template_noop)
"W" = (
/turf/open/floor/plating,
/area/template_noop)
"X" = (
/obj/effect/turf_decal/stripes/line{
	dir = 8
	},
/obj/effect/turf_decal/trimline/brown/line{
	dir = 8
	},
/turf/open/floor/iron/smooth_large,
/area/template_noop)
"Z" = (
/obj/effect/turf_decal/stripes/line{
	dir = 4
	},
/obj/effect/turf_decal/trimline/brown/line{
	dir = 4
	},
/obj/effect/turf_decal/caution/stand_clear{
	dir = 8
	},
/turf/open/floor/iron/smooth_large,
/area/template_noop)

(1,1,1) = {"
s
s
s
s
s
s
s
s
s
s
s
s
s
s
s
s
s
s
s
s
s
s
s
s
s
s
s
s
s
s
s
s
s
s
s
s
s
s
s
s
s
s
s
s
s
s
s
s
s
s
"}
(2,1,1) = {"
s
s
s
s
s
s
s
s
s
s
s
s
s
s
s
s
s
s
s
s
s
s
s
s
s
s
s
s
s
s
s
s
s
s
s
s
s
s
s
s
s
s
s
s
s
s
s
s
s
s
"}
(3,1,1) = {"
s
s
s
s
s
s
s
s
s
s
s
s
s
s
s
s
s
s
s
s
s
s
s
s
s
s
s
s
s
s
s
s
s
s
s
s
s
s
s
s
s
s
s
s
s
s
s
s
s
s
"}
(4,1,1) = {"
s
s
s
s
s
s
s
s
s
s
s
s
s
s
s
s
s
s
s
s
s
s
s
s
s
s
s
s
s
s
s
s
s
s
s
s
s
s
s
s
s
s
s
s
s
s
s
s
s
s
"}
(5,1,1) = {"
s
s
s
s
s
s
s
s
s
s
s
s
s
s
s
s
s
s
s
s
s
s
s
s
s
s
s
s
s
s
s
s
s
s
s
s
s
s
s
s
s
s
s
s
s
s
s
s
s
s
"}
(6,1,1) = {"
s
s
s
s
s
s
s
s
s
s
s
s
s
s
s
s
s
s
s
s
s
s
s
s
s
s
s
s
s
s
s
s
s
s
s
s
s
s
s
s
s
s
s
s
s
s
s
s
s
s
"}
(7,1,1) = {"
s
s
s
s
s
s
s
s
s
s
s
s
s
s
s
s
s
s
s
s
s
s
s
s
s
s
s
s
s
s
s
s
s
s
s
s
s
s
s
s
s
s
s
s
s
s
s
s
s
s
"}
(8,1,1) = {"
s
s
s
s
s
s
s
s
s
s
s
s
s
s
s
s
s
s
s
s
s
s
s
s
s
s
s
s
s
s
s
s
s
s
s
s
s
s
s
s
s
s
s
s
s
s
s
s
s
s
"}
(9,1,1) = {"
s
s
s
s
s
s
s
s
s
s
s
s
s
s
s
s
s
s
s
s
s
s
s
s
s
s
s
s
s
s
s
s
s
s
s
s
s
s
s
s
s
s
s
s
s
s
s
s
s
s
"}
(10,1,1) = {"
s
s
s
s
s
s
s
s
s
s
s
s
s
s
s
s
s
s
s
s
s
s
s
s
s
s
s
s
s
s
s
s
s
s
s
s
s
s
s
s
s
s
s
s
s
s
s
s
s
s
"}
(11,1,1) = {"
s
s
s
s
s
s
s
s
s
s
s
s
s
s
s
s
s
s
s
s
s
s
s
s
s
s
s
s
s
s
s
s
s
s
s
s
s
s
s
s
s
s
s
s
s
s
s
s
s
s
"}
(12,1,1) = {"
s
s
s
s
s
s
s
s
s
s
s
s
s
s
s
s
s
s
s
s
s
s
s
s
s
s
s
s
s
s
s
s
s
s
s
s
s
s
s
s
s
s
s
s
s
s
s
s
s
s
"}
(13,1,1) = {"
s
s
s
s
s
s
s
s
s
s
s
s
s
s
s
s
s
a
a
a
a
a
a
a
a
a
a
a
a
a
a
a
a
a
a
U
s
s
s
s
s
s
s
s
s
s
s
s
s
s
"}
(14,1,1) = {"
s
s
s
s
s
s
s
s
s
s
s
s
s
s
s
s
s
a
f
f
f
m
c
c
c
c
c
c
c
c
c
c
c
c
a
U
U
s
s
s
s
s
s
s
s
s
s
s
s
s
"}
(15,1,1) = {"
s
s
s
s
s
s
s
s
s
s
s
s
s
s
s
s
s
a
f
f
g
t
Q
Q
Q
Q
Q
Q
Q
Q
Q
Q
Q
Q
a
V
V
u
s
s
s
s
s
s
s
s
s
s
s
s
"}
(16,1,1) = {"
s
s
s
s
s
s
s
s
s
s
s
s
s
s
s
s
s
a
f
f
j
x
T
Z
T
T
T
J
T
T
T
Z
T
T
a
U
s
U
s
s
s
s
s
s
s
s
s
s
s
s
"}
(17,1,1) = {"
s
s
s
s
s
s
s
s
s
s
s
s
s
s
s
s
s
a
f
f
j
A
W
W
W
W
W
W
W
W
W
W
W
R
P
s
s
U
s
s
s
s
s
s
s
s
s
s
s
s
"}
(18,1,1) = {"
s
s
s
s
s
s
s
s
s
s
s
s
s
s
s
s
s
a
f
f
j
C
W
W
W
W
W
W
W
W
W
W
W
W
P
s
s
U
s
s
s
s
s
s
s
s
s
s
s
s
"}
(19,1,1) = {"
s
s
s
s
s
s
s
s
s
s
s
s
s
s
s
s
s
a
f
f
j
A
W
W
W
W
W
W
W
W
W
W
W
W
P
s
s
U
s
s
s
s
s
s
s
s
s
s
s
s
"}
(20,1,1) = {"
s
s
s
s
s
s
s
s
s
s
s
s
s
s
s
s
s
a
f
f
j
D
W
W
W
W
W
W
W
W
W
W
W
W
P
U
U
U
s
s
s
s
s
s
s
s
s
s
s
s
"}
(21,1,1) = {"
s
s
s
s
s
s
s
s
s
s
s
s
s
s
s
s
s
a
f
f
j
A
W
W
W
W
W
W
W
W
W
W
W
W
P
s
s
U
s
s
s
s
s
s
s
s
s
s
s
s
"}
(22,1,1) = {"
s
s
s
s
s
s
s
s
s
s
s
s
s
s
s
s
s
a
f
f
j
C
W
W
W
W
W
W
W
W
W
W
W
W
P
s
s
U
s
s
s
s
s
s
s
s
s
s
s
s
"}
(23,1,1) = {"
s
s
s
s
s
s
s
s
s
s
s
s
s
s
s
s
s
a
f
f
j
A
W
W
W
W
W
W
v
W
W
W
W
d
P
s
s
U
s
s
s
s
s
s
s
s
s
s
s
s
"}
(24,1,1) = {"
s
s
s
s
s
s
s
s
s
s
s
s
s
s
s
s
s
a
f
f
j
F
X
l
X
X
X
b
X
X
X
l
X
X
a
a
a
U
U
s
s
s
s
s
s
s
s
s
s
s
"}
(25,1,1) = {"
s
s
s
s
s
s
s
s
s
s
s
s
s
s
s
s
s
a
f
f
j
G
c
q
c
c
c
q
c
c
c
q
c
c
B
W
B
V
V
u
s
s
s
s
s
s
s
s
s
s
"}
(26,1,1) = {"
s
s
s
s
s
s
s
s
s
s
s
s
s
s
s
s
s
a
f
f
j
x
T
Z
T
T
T
J
T
T
T
Z
T
T
a
a
a
U
U
s
s
s
s
s
s
s
s
s
s
s
"}
(27,1,1) = {"
s
s
s
s
s
s
s
s
s
s
s
s
s
s
s
s
s
a
f
f
j
A
W
W
W
W
W
W
W
W
W
W
W
R
P
s
s
U
s
s
s
s
s
s
s
s
s
s
s
s
"}
(28,1,1) = {"
s
s
s
s
s
s
s
s
s
s
s
s
s
s
s
s
s
a
f
f
j
C
W
W
W
W
W
W
W
W
W
W
W
W
P
s
s
U
s
s
s
s
s
s
s
s
s
s
s
s
"}
(29,1,1) = {"
s
s
s
s
s
s
s
s
s
s
s
s
s
s
s
s
s
a
f
f
j
A
W
W
W
W
W
W
W
W
W
W
W
W
P
s
s
U
s
s
s
s
s
s
s
s
s
s
s
s
"}
(30,1,1) = {"
s
s
s
s
s
s
s
s
s
s
s
s
s
s
s
s
s
a
f
f
j
D
W
W
W
W
W
W
W
W
W
W
W
W
P
U
U
U
s
s
s
s
s
s
s
s
s
s
s
s
"}
(31,1,1) = {"
s
s
s
s
s
s
s
s
s
s
s
s
s
s
s
s
s
a
f
f
j
A
W
W
W
W
W
W
W
W
W
W
W
W
P
s
s
U
s
s
s
s
s
s
s
s
s
s
s
s
"}
(32,1,1) = {"
s
s
s
s
s
s
s
s
s
s
s
s
s
s
s
s
s
a
f
f
j
C
W
W
W
W
W
W
W
W
W
W
W
W
P
s
s
U
s
s
s
s
s
s
s
s
s
s
s
s
"}
(33,1,1) = {"
s
s
s
s
s
s
s
s
s
s
s
s
s
s
s
s
s
a
f
f
j
A
W
W
W
W
W
W
W
W
W
W
W
d
P
s
s
U
s
s
s
s
s
s
s
s
s
s
s
s
"}
(34,1,1) = {"
s
s
s
s
s
s
s
s
s
s
s
s
s
s
s
s
s
a
f
f
j
F
X
l
X
X
X
b
X
X
X
l
X
X
a
U
s
U
s
s
s
s
s
s
s
s
s
s
s
s
"}
(35,1,1) = {"
s
s
s
s
s
s
s
s
s
s
s
s
s
s
s
s
s
a
f
f
k
L
c
c
c
c
c
c
c
c
c
c
c
c
a
V
V
u
s
s
s
s
s
s
s
s
s
s
s
s
"}
(36,1,1) = {"
s
s
s
s
s
s
s
s
s
s
s
s
s
s
s
s
s
a
f
f
f
M
Q
Q
Q
Q
Q
Q
Q
Q
Q
Q
Q
Q
a
U
U
s
s
s
s
s
s
s
s
s
s
s
s
s
"}
(37,1,1) = {"
s
s
s
s
s
s
s
s
s
s
s
s
s
s
s
s
s
a
a
a
a
a
a
a
a
a
a
a
a
a
a
a
a
a
a
U
s
s
s
s
s
s
s
s
s
s
s
s
s
s
"}
(38,1,1) = {"
s
s
s
s
s
s
s
s
s
s
s
s
s
s
s
s
s
s
s
s
s
s
s
s
s
s
s
s
s
s
s
s
s
s
s
s
s
s
s
s
s
s
s
s
s
s
s
s
s
s
"}
(39,1,1) = {"
s
s
s
s
s
s
s
s
s
s
s
s
s
s
s
s
s
s
s
s
s
s
s
s
s
s
s
s
s
s
s
s
s
s
s
s
s
s
s
s
s
s
s
s
s
s
s
s
s
s
"}
(40,1,1) = {"
s
s
s
s
s
s
s
s
s
s
s
s
s
s
s
s
s
s
s
s
s
s
s
s
s
s
s
s
s
s
s
s
s
s
s
s
s
s
s
s
s
s
s
s
s
s
s
s
s
s
"}
(41,1,1) = {"
s
s
s
s
s
s
s
s
s
s
s
s
s
s
s
s
s
s
s
s
s
s
s
s
s
s
s
s
s
s
s
s
s
s
s
s
s
s
s
s
s
s
s
s
s
s
s
s
s
s
"}
(42,1,1) = {"
s
s
s
s
s
s
s
s
s
s
s
s
s
s
s
s
s
s
s
s
s
s
s
s
s
s
s
s
s
s
s
s
s
s
s
s
s
s
s
s
s
s
s
s
s
s
s
s
s
s
"}
(43,1,1) = {"
s
s
s
s
s
s
s
s
s
s
s
s
s
s
s
s
s
s
s
s
s
s
s
s
s
s
s
s
s
s
s
s
s
s
s
s
s
s
s
s
s
s
s
s
s
s
s
s
s
s
"}
(44,1,1) = {"
s
s
s
s
s
s
s
s
s
s
s
s
s
s
s
s
s
s
s
s
s
s
s
s
s
s
s
s
s
s
s
s
s
s
s
s
s
s
s
s
s
s
s
s
s
s
s
s
s
s
"}
(45,1,1) = {"
s
s
s
s
s
s
s
s
s
s
s
s
s
s
s
s
s
s
s
s
s
s
s
s
s
s
s
s
s
s
s
s
s
s
s
s
s
s
s
s
s
s
s
s
s
s
s
s
s
s
"}
(46,1,1) = {"
s
s
s
s
s
s
s
s
s
s
s
s
s
s
s
s
s
s
s
s
s
s
s
s
s
s
s
s
s
s
s
s
s
s
s
s
s
s
s
s
s
s
s
s
s
s
s
s
s
s
"}
(47,1,1) = {"
s
s
s
s
s
s
s
s
s
s
s
s
s
s
s
s
s
s
s
s
s
s
s
s
s
s
s
s
s
s
s
s
s
s
s
s
s
s
s
s
s
s
s
s
s
s
s
s
s
s
"}
(48,1,1) = {"
s
s
s
s
s
s
s
s
s
s
s
s
s
s
s
s
s
s
s
s
s
s
s
s
s
s
s
s
s
s
s
s
s
s
s
s
s
s
s
s
s
s
s
s
s
s
s
s
s
s
"}
(49,1,1) = {"
s
s
s
s
s
s
s
s
s
s
s
s
s
s
s
s
s
s
s
s
s
s
s
s
s
s
s
s
s
s
s
s
s
s
s
s
s
s
s
s
s
s
s
s
s
s
s
s
s
s
"}
(50,1,1) = {"
s
s
s
s
s
s
s
s
s
s
s
s
s
s
s
s
s
s
s
s
s
s
s
s
s
s
s
s
s
s
s
s
s
s
s
s
s
s
s
s
s
s
s
s
s
s
s
s
s
s
"}
