"a" = (/turf/open/space/basic,/area/space)
"e" = (/obj/effect/mob_spawn/human/corpse/russian/ranged/trooper,/turf/open/floor/carpet/airless,/area/space)
"g" = (/obj/structure/rack/shelf,/obj/effect/spawner/random/maintenance/three,/turf/open/floor/iron/airless,/area/space)
"h" = (/obj/structure/closet/crate/secure/loot,/turf/open/floor/iron/airless,/area/space)
"j" = (/obj/structure/railing,/obj/machinery/portable_atmospherics/canister/air,/turf/open/floor/iron/airless,/area/space)
"k" = (/obj/structure/railing{dir = 8},/obj/structure/table/wood/fancy/royalblack,/obj/item/reagent_containers/food/drinks/bottle/lizardwine{pixel_x = 8; pixel_y = 1},/obj/item/reagent_containers/food/drinks/drinkingglass/shotglass{pixel_x = 10; pixel_y = 17},/obj/item/reagent_containers/food/drinks/drinkingglass/shotglass{pixel_x = -2; pixel_y = 1},/turf/open/floor/carpet/airless,/area/space)
"l" = (/obj/structure/railing/corner{dir = 8},/turf/open/floor/iron/airless,/area/space)
"n" = (/obj/effect/spawner/random/clothing/wardrobe_closet,/turf/open/floor/iron/airless,/area/space)
"o" = (/turf/open/floor/plating/dirt/dark,/area/space)
"r" = (/turf/open/floor/iron/airless,/area/space)
"s" = (/obj/machinery/door/airlock/external/ruin,/turf/open/floor/plating/asteroid/airless,/area/space)
"t" = (/obj/item/paper{info = "Congrats, we are proud you think outside of the box agent, the solution is up>up>Left*3>up*2>right*3>up*4>right*3>down*4>right*4>up"},/turf/closed/mineral/random/asteroid,/area/space)
"u" = (/obj/effect/decal/cleanable/blood/gibs,/turf/open/floor/carpet/airless,/area/space)
"v" = (/obj/structure/railing{dir = 8},/obj/structure/table/wood/fancy/royalblack,/obj/item/reagent_containers/food/drinks/bottle/wine{pixel_x = 6},/obj/effect/spawner/random/food_or_drink/dinner,/turf/open/floor/carpet/airless,/area/space)
"w" = (/obj/effect/mine/explosive{alpha = 0; desc = "the dirt here is strangely lumpy"; name = "Suspicious dirt"; range_devastation = 1; range_flash = 0; range_heavy = 0; range_light = 0},/turf/open/floor/plating/dirt/dark,/area/space)
"A" = (/obj/structure/railing,/turf/open/floor/iron/airless,/area/space)
"B" = (/turf/closed/mineral/random/asteroid,/area/space)
"D" = (/turf/open/floor/plating/asteroid/airless,/area/space)
"E" = (/obj/structure/rack/shelf,/obj/effect/spawner/random/maintenance/three,/obj/effect/spawner/random/engineering/tool_advanced,/obj/effect/spawner/random/engineering/tool_advanced,/turf/open/floor/iron/airless,/area/space)
"F" = (/obj/structure/fluff/fokoff_sign,/turf/open/floor/plating/asteroid/airless,/area/space)
"G" = (/obj/effect/spawner/random/clothing/wardrobe_closet_colored,/turf/open/floor/iron/airless,/area/space)
"H" = (/obj/effect/mob_spawn/human/corpse/russian,/turf/open/floor/plating/dirt/dark,/area/space)
"I" = (/turf/open/floor/carpet/airless,/area/space)
"M" = (/obj/structure/railing{dir = 8},/obj/effect/decal/cleanable/blood/gibs/limb,/turf/open/floor/carpet/airless,/area/space)
"N" = (/obj/structure/rack/shelf,/obj/item/gps/spaceruin,/turf/open/floor/iron/airless,/area/space)
"O" = (/obj/structure/railing{dir = 8},/obj/structure/chair/wood/wings{dir = 8},/turf/open/floor/carpet/airless,/area/space)
"R" = (/obj/structure/railing{dir = 8},/obj/structure/chair/wood/wings{dir = 8},/obj/effect/mob_spawn/human/corpse/russian,/turf/open/floor/carpet/airless,/area/space)
"S" = (/obj/effect/decal/cleanable/blood/gibs/down,/turf/open/floor/carpet/airless,/area/space)
"Y" = (/obj/structure/trap/eldritch/mad{alpha = 20},/turf/open/floor/plating/dirt/dark,/area/space)
"Z" = (/turf/closed/indestructible/riveted,/area/space)

(1,1,1) = {"
aaaaaaaaaaaBBBaaaaa
aBZZZZZZZZZZZZZZZaa
BZZEgNGnnnnhhhhhZZa
BZjAAAAAAAAAAAAlrZa
BZwwwwwwwwwwwowOeZa
BZwwwwoooowwwowvIZa
BZwwwwowwowwwowRIZa
BZwwwwowwowwwowOIZa
BZwwwwowwowwwowkuZa
BZwoooYwwooooowOSZB
BZwowwwwwwwwwwwMZZB
BZwoooowwwwwwwwZZBB
BZwwwwowwwwwwwwZBBB
BZHooooooooooooZtBB
aZZZZZsZZZZZZZZZBBa
aaDDDDDDDFDDDDDDDDa
aaaaaaaaaaaaaaaaaaa
aaaaaaaaaaaaaaaaaaa
aaaaaaaaaaaaaaaaaaa
"}
