"aa" = (/obj/machinery/vending/donksofttoyvendor,/turf/open/floor/wood,/area/ruin/space/has_grav/pizzaplace)
"as" = (/obj/machinery/atmospherics/components/unary/vent_pump/on/layer4,/turf/open/floor/iron/kitchen,/area/ruin/space/has_grav/pizzaplace)
"aG" = (/obj/structure/reagent_dispensers/watertank/high,/turf/open/floor/plating,/area/ruin/space/has_grav/pizzaplace)
"bj" = (/obj/structure/table,/turf/open/floor/iron,/area/ruin/space/has_grav/pizzaplace)
"bL" = (/obj/machinery/atmospherics/components/unary/vent_pump/on/layer4{dir = 4},/turf/open/floor/iron/kitchen,/area/ruin/space/has_grav/pizzaplace)
"cc" = (/obj/effect/spawner/random/vending/colavend,/turf/open/floor/wood,/area/ruin/space/has_grav/pizzaplace)
"dc" = (/obj/structure/chair/sofa/corp/left,/turf/open/floor/wood,/area/ruin/space/has_grav/pizzaplace)
"dr" = (/obj/structure/chair/sofa/corp/left{dir = 1},/turf/open/floor/wood,/area/ruin/space/has_grav/pizzaplace)
"dE" = (/obj/machinery/atmospherics/pipe/smart/manifold4w/supply/hidden/layer4,/turf/open/floor/iron/vaporwave,/area/ruin/space/has_grav/pizzaplace)
"fe" = (/obj/structure/chair{dir = 8},/turf/open/floor/wood,/area/ruin/space/has_grav/pizzaplace)
"gA" = (/obj/effect/mob_spawn/human/pizza,/turf/open/floor/iron/kitchen,/area/ruin/space/has_grav/pizzaplace)
"hH" = (/obj/structure/cable,/obj/machinery/door/airlock/maintenance,/turf/open/floor/plating,/area/ruin/space/has_grav/pizzaplace)
"hO" = (/obj/structure/table,/obj/item/storage/fancy/nugget_box,/obj/item/storage/fancy/nugget_box,/obj/item/storage/fancy/nugget_box,/obj/item/storage/fancy/nugget_box,/obj/item/storage/fancy/nugget_box,/obj/item/storage/fancy/nugget_box,/obj/machinery/atmospherics/pipe/smart/manifold4w/supply/hidden/layer4,/turf/open/floor/iron/kitchen,/area/ruin/space/has_grav/pizzaplace)
"ie" = (/obj/machinery/light{dir = 8},/obj/effect/mob_spawn/human/pizza{dir = 4},/turf/open/floor/iron/kitchen,/area/ruin/space/has_grav/pizzaplace)
"iz" = (/obj/structure/chair/stool/bar{dir = 1},/obj/machinery/atmospherics/pipe/smart/manifold4w/supply/hidden/layer4,/turf/open/floor/wood,/area/ruin/space/has_grav/pizzaplace)
"iE" = (/obj/structure/chair/sofa/corp/corner{dir = 1},/turf/open/floor/wood,/area/ruin/space/has_grav/pizzaplace)
"iN" = (/obj/machinery/teleport/hub,/turf/open/floor/iron,/area/ruin/space/has_grav/pizzaplace)
"jJ" = (/obj/structure/chair{dir = 1},/turf/open/floor/wood,/area/ruin/space/has_grav/pizzaplace)
"jK" = (/turf/template_noop,/area/template_noop)
"jT" = (/turf/open/floor/iron/vaporwave,/area/ruin/space/has_grav/pizzaplace)
"jW" = (/obj/machinery/seed_extractor,/turf/open/floor/iron/kitchen,/area/ruin/space/has_grav/pizzaplace)
"jZ" = (/obj/structure/closet/crate/secure/freezer/pizza,/obj/machinery/light,/turf/open/floor/iron/kitchen,/area/ruin/space/has_grav/pizzaplace)
"kt" = (/obj/structure/table/wood,/obj/machinery/chem_dispenser/drinks/beer/fullupgrade{dir = 8},/turf/open/floor/wood,/area/ruin/space/has_grav/pizzaplace)
"kw" = (/obj/structure/fans/tiny,/obj/machinery/door/airlock/external/glass,/obj/effect/mapping_helpers/airlock/cyclelink_helper{dir = 1},/turf/open/floor/plating,/area/ruin/space/has_grav/pizzaplace)
"lo" = (/obj/structure/cable,/turf/open/floor/plating,/area/ruin/space/has_grav/pizzaplace)
"lv" = (/obj/structure/cable,/obj/machinery/light{dir = 1},/turf/open/floor/plating,/area/ruin/space/has_grav/pizzaplace)
"lI" = (/obj/structure/chair/sofa/corp/right{dir = 4},/turf/open/floor/wood,/area/ruin/space/has_grav/pizzaplace)
"lN" = (/obj/machinery/hydroponics/constructable,/obj/structure/window/reinforced/tinted,/turf/open/floor/iron/kitchen,/area/ruin/space/has_grav/pizzaplace)
"lQ" = (/obj/machinery/vending/hydroseeds,/turf/open/floor/iron/kitchen,/area/ruin/space/has_grav/pizzaplace)
"mh" = (/obj/machinery/light{dir = 8},/turf/open/floor/iron/kitchen,/area/ruin/space/has_grav/pizzaplace)
"mu" = (/obj/machinery/spaceship_navigation_beacon,/turf/open/floor/iron,/area/ruin/space/has_grav/pizzaplace)
"mD" = (/obj/machinery/vending/boozeomat/all_access,/turf/open/floor/iron/kitchen,/area/ruin/space/has_grav/pizzaplace)
"mH" = (/obj/structure/chair/stool/bar{dir = 1},/turf/open/floor/wood,/area/ruin/space/has_grav/pizzaplace)
"mL" = (/obj/structure/fans/tiny,/obj/machinery/vending/hydronutrients,/turf/open/floor/iron/kitchen,/area/ruin/space/has_grav/pizzaplace)
"nf" = (/obj/structure/table,/obj/machinery/light{dir = 4},/turf/open/floor/iron,/area/ruin/space/has_grav/pizzaplace)
"oD" = (/obj/structure/table/wood,/obj/machinery/atmospherics/pipe/smart/manifold4w/supply/hidden/layer4,/turf/open/floor/wood,/area/ruin/space/has_grav/pizzaplace)
"oG" = (/obj/machinery/light,/turf/open/floor/wood,/area/ruin/space/has_grav/pizzaplace)
"oZ" = (/obj/machinery/door/airlock/maintenance,/obj/structure/cable,/obj/machinery/atmospherics/pipe/smart/manifold4w/supply/hidden/layer4,/turf/open/floor/plating,/area/ruin/space/has_grav/pizzaplace)
"ql" = (/obj/structure/table,/obj/machinery/chem_dispenser/drinks/fullupgrade,/turf/open/floor/iron/kitchen,/area/ruin/space/has_grav/pizzaplace)
"qP" = (/obj/item/reagent_containers/food/condiment/enzyme,/obj/item/reagent_containers/food/condiment/enzyme,/obj/item/reagent_containers/food/condiment/milk{list_reagents = list(/datum/reagent/consumable/milk = 750); name = "the big space milky"; volume = 750},/obj/item/reagent_containers/food/condiment/flour{list_reagents = list(/datum/reagent/consumable/flour = 600); name = "Premium All-Purpose Flour (16KG)"; volume = 600},/obj/item/reagent_containers/food/condiment/flour{list_reagents = list(/datum/reagent/consumable/flour = 600); name = "Premium All-Purpose Flour (16KG)"; volume = 600},/obj/item/reagent_containers/food/condiment/flour{list_reagents = list(/datum/reagent/consumable/flour = 600); name = "Premium All-Purpose Flour (16KG)"; volume = 600},/obj/item/reagent_containers/food/condiment/flour{list_reagents = list(/datum/reagent/consumable/flour = 600); name = "Premium All-Purpose Flour (16KG)"; volume = 600},/obj/item/reagent_containers/food/condiment/flour{list_reagents = list(/datum/reagent/consumable/flour = 600); name = "Premium All-Purpose Flour (16KG)"; volume = 600},/obj/item/reagent_containers/food/condiment/milk{list_reagents = list(/datum/reagent/consumable/milk = 750); name = "the big space milky"; volume = 750},/obj/item/reagent_containers/food/condiment/milk{list_reagents = list(/datum/reagent/consumable/milk = 750); name = "the big space milky"; volume = 750},/obj/item/reagent_containers/food/condiment/milk{list_reagents = list(/datum/reagent/consumable/milk = 750); name = "the big space milky"; volume = 750},/obj/item/reagent_containers/food/condiment/enzyme,/obj/item/reagent_containers/food/condiment/enzyme,/obj/item/reagent_containers/food/condiment/enzyme,/obj/structure/closet/crate/secure/freezer,/obj/machinery/light{dir = 1},/turf/open/floor/iron/freezer,/area/ruin/space/has_grav/pizzaplace)
"re" = (/obj/structure/chair,/obj/machinery/atmospherics/pipe/smart/manifold4w/supply/hidden/layer4,/turf/open/floor/wood,/area/ruin/space/has_grav/pizzaplace)
"rl" = (/obj/machinery/light{dir = 1},/obj/effect/mob_spawn/human/pizza,/turf/open/floor/iron,/area/ruin/space/has_grav/pizzaplace)
"rV" = (/obj/structure/table,/turf/open/floor/iron/kitchen,/area/ruin/space/has_grav/pizzaplace)
"sr" = (/obj/structure/fans/tiny/forcefield,/turf/open/floor/plating,/area/ruin/space/has_grav/pizzaplace)
"sF" = (/obj/machinery/deepfryer,/turf/open/floor/iron/kitchen,/area/ruin/space/has_grav/pizzaplace)
"sH" = (/obj/machinery/teleport/station,/turf/open/floor/iron,/area/ruin/space/has_grav/pizzaplace)
"ty" = (/obj/structure/table,/obj/structure/closet/crate/secure/freezer/pizza,/obj/machinery/light{dir = 1},/turf/open/floor/iron/kitchen,/area/ruin/space/has_grav/pizzaplace)
"tA" = (/obj/machinery/door/airlock/glass,/obj/machinery/atmospherics/pipe/smart/manifold4w/supply/hidden/layer4,/turf/open/floor/iron,/area/ruin/space/has_grav/pizzaplace)
"tP" = (/obj/machinery/paystand,/turf/open/floor/wood,/area/ruin/space/has_grav/pizzaplace)
"uD" = (/obj/structure/table/wood,/obj/machinery/chem_dispenser/drinks/fullupgrade,/turf/open/floor/wood,/area/ruin/space/has_grav/pizzaplace)
"uG" = (/obj/machinery/light{dir = 8},/turf/open/floor/plating,/area/ruin/space/has_grav/pizzaplace)
"uV" = (/obj/machinery/atmospherics/pipe/smart/manifold4w/supply/hidden/layer4,/turf/open/floor/wood,/area/ruin/space/has_grav/pizzaplace)
"xF" = (/obj/machinery/door/airlock/public/glass,/obj/structure/cable,/obj/machinery/atmospherics/pipe/smart/manifold4w/supply/hidden/layer4,/turf/open/floor/iron/kitchen,/area/ruin/space/has_grav/pizzaplace)
"xN" = (/obj/machinery/vending/clothing,/turf/open/floor/wood,/area/ruin/space/has_grav/pizzaplace)
"yi" = (/obj/structure/chair/sofa/corp{dir = 4},/turf/open/floor/wood,/area/ruin/space/has_grav/pizzaplace)
"yl" = (/obj/structure/table/wood,/obj/machinery/light{dir = 1},/turf/open/floor/wood,/area/ruin/space/has_grav/pizzaplace)
"yA" = (/obj/structure/chair,/turf/open/floor/wood,/area/ruin/space/has_grav/pizzaplace)
"yJ" = (/obj/machinery/vending/dinnerware,/turf/open/floor/iron/kitchen,/area/ruin/space/has_grav/pizzaplace)
"yZ" = (/obj/machinery/griddle,/turf/open/floor/iron/kitchen,/area/ruin/space/has_grav/pizzaplace)
"zf" = (/turf/closed/wall,/area/ruin/space/has_grav/pizzaplace)
"zt" = (/obj/machinery/atmospherics/components/unary/vent_pump/on/layer4{dir = 1},/turf/open/floor/iron,/area/ruin/space/has_grav/pizzaplace)
"zx" = (/turf/open/floor/plating,/area/ruin/space/has_grav/pizzaplace)
"zF" = (/obj/item/storage/toolbox/mechanical,/obj/item/storage/toolbox/electrical,/obj/item/multitool,/obj/item/vending_refill/custom,/obj/item/circuitboard/machine/vendor,/obj/structure/closet/crate,/obj/item/storage/belt/utility/full/engi,/obj/item/storage/belt/utility/full/powertools,/turf/open/floor/plating,/area/ruin/space/has_grav/pizzaplace)
"AC" = (/obj/structure/reagent_dispensers/watertank/high,/turf/open/floor/iron/kitchen,/area/ruin/space/has_grav/pizzaplace)
"CA" = (/obj/machinery/door/airlock/glass,/turf/open/floor/iron,/area/ruin/space/has_grav/pizzaplace)
"CD" = (/obj/machinery/atmospherics/components/unary/vent_pump/on/layer4,/turf/open/floor/wood,/area/ruin/space/has_grav/pizzaplace)
"Dj" = (/obj/effect/spawner/structure/window/reinforced,/turf/open/floor/plating,/area/ruin/space/has_grav/pizzaplace)
"DK" = (/obj/structure/fans/tiny,/turf/open/floor/iron/kitchen,/area/ruin/space/has_grav/pizzaplace)
"Ex" = (/obj/machinery/atmospherics/components/unary/vent_pump/on/layer4{dir = 4},/turf/open/floor/iron/vaporwave,/area/ruin/space/has_grav/pizzaplace)
"Ez" = (/obj/item/food/meat/rawbacon,/obj/item/food/meat/rawbacon,/obj/item/food/meat/rawbacon,/obj/item/food/meat/rawbacon,/obj/item/food/meat/rawbacon,/obj/item/food/meat/rawbacon,/obj/item/food/meat/rawbacon,/obj/item/food/meat/rawbacon,/obj/item/food/meat/rawbacon,/obj/item/food/meat/rawbacon,/obj/item/food/meat/rawbacon,/obj/item/food/meat/rawbacon,/obj/item/food/meat/rawbacon,/obj/item/food/meat/rawbacon,/obj/item/food/meat/rawbacon,/obj/item/food/meat/rawcutlet,/obj/item/food/meat/rawcutlet,/obj/item/food/meat/rawcutlet,/obj/item/food/meat/rawcutlet,/obj/item/food/meat/rawcutlet,/obj/item/food/meat/rawcutlet,/obj/item/food/meat/rawcutlet,/obj/item/food/meat/rawcutlet,/obj/item/food/meat/rawcutlet,/obj/item/food/meat/rawcutlet,/obj/item/food/meat/rawcutlet,/obj/item/food/meat/rawcutlet,/obj/item/food/meat/rawcutlet,/obj/item/food/meat/rawcutlet,/obj/item/food/meat/rawcutlet,/obj/item/food/meat/rawcutlet,/obj/item/food/meat/slab,/obj/item/food/meat/slab,/obj/item/food/meat/slab,/obj/item/food/meat/slab,/obj/item/food/meat/slab,/obj/item/food/meat/slab,/obj/item/food/meat/slab,/obj/item/food/meat/slab,/obj/item/food/meat/slab,/obj/item/food/meat/slab,/obj/item/food/meat/slab,/obj/item/food/meat/slab,/obj/item/food/meat/slab,/obj/item/food/meat/slab,/obj/item/food/meat/slab,/obj/item/food/meat/slab,/obj/item/food/meat/slab,/obj/item/food/meat/slab,/obj/structure/closet/crate/secure/freezer,/turf/open/floor/iron/freezer,/area/ruin/space/has_grav/pizzaplace)
"EI" = (/obj/structure/cable,/turf/open/floor/iron/kitchen,/area/ruin/space/has_grav/pizzaplace)
"EN" = (/obj/machinery/light{dir = 1},/obj/effect/mob_spawn/human/pizza,/turf/open/floor/wood,/area/ruin/space/has_grav/pizzaplace)
"EU" = (/obj/machinery/telecomms/relay/preset/station,/obj/machinery/light,/turf/open/floor/plating,/area/ruin/space/has_grav/pizzaplace)
"Fs" = (/obj/machinery/atmospherics/pipe/smart/manifold4w/supply/hidden/layer4,/turf/open/floor/iron/kitchen,/area/ruin/space/has_grav/pizzaplace)
"Fv" = (/obj/effect/mob_spawn/human/pizza,/turf/open/floor/wood,/area/ruin/space/has_grav/pizzaplace)
"FA" = (/obj/machinery/processor,/obj/structure/table,/turf/open/floor/iron/kitchen,/area/ruin/space/has_grav/pizzaplace)
"Gl" = (/obj/effect/mob_spawn/human/pizza{dir = 8},/turf/open/floor/wood,/area/ruin/space/has_grav/pizzaplace)
"GB" = (/obj/machinery/computer/teleporter{dir = 4},/obj/machinery/light{dir = 8},/turf/open/floor/iron,/area/ruin/space/has_grav/pizzaplace)
"GC" = (/obj/structure/cable,/obj/machinery/power/terminal{dir = 8},/turf/open/floor/plating,/area/ruin/space/has_grav/pizzaplace)
"GQ" = (/obj/item/beacon,/turf/open/floor/iron,/area/ruin/space/has_grav/pizzaplace)
"GR" = (/obj/effect/mob_spawn/human/pizza,/turf/open/floor/iron,/area/ruin/space/has_grav/pizzaplace)
"HH" = (/obj/structure/window/reinforced/tinted,/obj/machinery/hydroponics/constructable,/turf/open/floor/iron/kitchen,/area/ruin/space/has_grav/pizzaplace)
"HT" = (/obj/structure/chair/sofa/corp/left{dir = 4},/turf/open/floor/wood,/area/ruin/space/has_grav/pizzaplace)
"Iz" = (/obj/structure/fans/tiny,/obj/machinery/door/airlock/external/glass,/obj/effect/mapping_helpers/airlock/cyclelink_helper,/turf/open/floor/plating,/area/ruin/space/has_grav/pizzaplace)
"IG" = (/obj/machinery/atmospherics/pipe/smart/manifold4w/supply/hidden/layer4,/turf/open/floor/iron,/area/ruin/space/has_grav/pizzaplace)
"JZ" = (/obj/machinery/light{dir = 4},/turf/open/floor/iron/kitchen,/area/ruin/space/has_grav/pizzaplace)
"Lh" = (/turf/open/floor/iron,/area/ruin/space/has_grav/pizzaplace)
"LB" = (/obj/machinery/oven,/turf/open/floor/iron/kitchen,/area/ruin/space/has_grav/pizzaplace)
"LV" = (/obj/machinery/light{dir = 8},/turf/open/floor/wood,/area/ruin/space/has_grav/pizzaplace)
"Na" = (/obj/structure/reagent_dispensers/watertank/high,/obj/machinery/power/apc/auto_name/east,/obj/structure/cable,/turf/open/floor/plating,/area/ruin/space/has_grav/pizzaplace)
"Nm" = (/obj/machinery/vending/coffee,/obj/machinery/light{dir = 4},/turf/open/floor/wood,/area/ruin/space/has_grav/pizzaplace)
"Nr" = (/obj/machinery/grill,/turf/open/floor/iron/kitchen,/area/ruin/space/has_grav/pizzaplace)
"Ns" = (/turf/open/floor/iron/kitchen,/area/ruin/space/has_grav/pizzaplace)
"NX" = (/obj/machinery/power/smes/magical{desc = "A high-capacity superconducting magnetic energy storage (SMES) unit."; name = "power storage unit"},/obj/structure/cable,/turf/open/floor/plating,/area/ruin/space/has_grav/pizzaplace)
"Oa" = (/obj/structure/cable,/obj/machinery/atmospherics/pipe/smart/manifold4w/supply/hidden/layer4,/turf/open/floor/plating,/area/ruin/space/has_grav/pizzaplace)
"Od" = (/obj/item/food/cheese/wheel,/obj/item/food/cheese/wheel,/obj/item/food/cheese/wheel,/obj/item/food/cheese/wheel,/obj/item/food/cheese/wheel,/obj/item/food/cheese/wheel,/obj/item/food/cheese/wheel,/obj/item/food/cheese/wheel,/obj/item/food/cheese/wheel,/obj/item/food/cheese/wheel,/obj/item/food/cheese/wheel,/obj/item/food/cheese/wheel,/obj/item/food/cheese/wheel,/obj/item/food/cheese/wheel,/obj/item/food/cheese/wheel,/obj/item/food/cheese/wheel,/obj/item/food/cheese/wheel,/obj/item/food/cheese/wheel,/obj/structure/closet/crate/secure/freezer,/obj/item/food/grown/potato,/obj/item/food/grown/potato,/obj/item/food/grown/potato,/obj/item/food/grown/potato,/obj/item/food/grown/potato,/obj/item/food/grown/potato,/obj/item/food/grown/potato,/obj/item/food/grown/potato,/obj/item/food/grown/potato,/obj/item/food/grown/potato,/obj/item/food/grown/potato,/obj/item/food/grown/potato,/obj/item/food/grown/potato,/obj/item/food/grown/potato,/obj/item/food/grown/potato,/obj/item/food/grown/potato,/obj/item/food/grown/potato,/obj/item/food/grown/potato,/obj/item/food/grown/potato,/obj/item/food/grown/potato,/obj/item/food/grown/potato,/obj/item/food/grown/potato,/obj/item/food/grown/potato,/turf/open/floor/iron/freezer,/area/ruin/space/has_grav/pizzaplace)
"OR" = (/obj/machinery/computer/arcade/orion_trail,/turf/open/floor/wood,/area/ruin/space/has_grav/pizzaplace)
"Qi" = (/obj/machinery/atmospherics/components/tank/air,/turf/open/floor/plating,/area/ruin/space/has_grav/pizzaplace)
"QI" = (/obj/machinery/light{dir = 4},/turf/open/floor/wood,/area/ruin/space/has_grav/pizzaplace)
"RF" = (/obj/structure/table/wood,/turf/open/floor/wood,/area/ruin/space/has_grav/pizzaplace)
"Su" = (/obj/machinery/atmospherics/pipe/smart/manifold4w/supply/hidden/layer4,/obj/machinery/light,/turf/open/floor/wood,/area/ruin/space/has_grav/pizzaplace)
"SW" = (/obj/item/circuitboard/machine/spaceship_navigation_beacon,/obj/item/circuitboard/machine/spaceship_navigation_beacon,/obj/item/circuitboard/machine/spaceship_navigation_beacon,/obj/item/vending_refill/hydronutrients,/obj/item/vending_refill/hydroseeds,/obj/item/vending_refill/dinnerware,/obj/structure/closet/crate,/obj/item/storage/box/stockparts/deluxe,/obj/item/storage/box/stockparts/deluxe,/obj/item/storage/box/stockparts/deluxe,/obj/item/storage/part_replacer/bluespace/tier4,/obj/item/storage/box/beakers/bluespace,/turf/open/floor/plating,/area/ruin/space/has_grav/pizzaplace)
"Tb" = (/obj/structure/chair/stool/bar{dir = 4},/turf/open/floor/wood,/area/ruin/space/has_grav/pizzaplace)
"TC" = (/obj/structure/cable,/obj/machinery/atmospherics/pipe/smart/manifold4w/supply/hidden/layer4,/turf/open/floor/iron/kitchen,/area/ruin/space/has_grav/pizzaplace)
"Uu" = (/obj/structure/chair{dir = 4},/turf/open/floor/wood,/area/ruin/space/has_grav/pizzaplace)
"UT" = (/turf/open/floor/wood,/area/ruin/space/has_grav/pizzaplace)
"Vu" = (/obj/effect/spawner/random/vending/snackvend,/turf/open/floor/wood,/area/ruin/space/has_grav/pizzaplace)
"Wb" = (/obj/structure/chair/sofa/corp/corner{dir = 4},/obj/machinery/light{dir = 1},/turf/open/floor/wood,/area/ruin/space/has_grav/pizzaplace)
"Wt" = (/obj/structure/table,/obj/item/storage/box/beakers,/obj/item/storage/box/beakers/variety,/obj/item/storage/box/drinkingglasses,/obj/item/storage/box/drinkingglasses,/obj/item/storage/box/drinkingglasses,/turf/open/floor/iron/kitchen,/area/ruin/space/has_grav/pizzaplace)
"Xb" = (/obj/item/stack/sheet/mineral/coal/ten,/obj/item/stack/sheet/mineral/coal/ten,/obj/item/stack/sheet/mineral/coal/ten,/obj/structure/closet/crate,/turf/open/floor/plating,/area/ruin/space/has_grav/pizzaplace)
"Xz" = (/obj/structure/table,/obj/structure/closet/crate/secure/freezer/pizza,/turf/open/floor/iron/kitchen,/area/ruin/space/has_grav/pizzaplace)
"Yh" = (/obj/item/seeds/tomato,/obj/item/seeds/tomato,/obj/item/seeds/tomato,/obj/item/seeds/tomato,/obj/item/seeds/eggplant/eggy,/obj/item/seeds/eggplant/eggy,/obj/item/seeds/eggplant/eggy,/obj/item/seeds/eggplant/eggy,/obj/item/seeds/eggplant/eggy,/obj/item/seeds/eggplant/eggy,/obj/item/seeds/eggplant/eggy,/obj/item/seeds/eggplant/eggy,/obj/item/seeds/eggplant/eggy,/obj/structure/closet/crate/secure/hydroponics,/turf/open/floor/iron/kitchen,/area/ruin/space/has_grav/pizzaplace)

(1,1,1) = {"
jKjKjKzfzfzfzfzfjKjKjKjKjKjKjKjKzfzfzfzf
jKjKjKzfNXGClvzfzfzfDjDjDjzfzfzfzfSWzFzf
jKzfzfzfzfzfhHzfNryZFALBLBtygAyJzfuGzxzf
jKzfOdEzqPmLEIzfmhNsNsasNsXzTCTCoZOaQizf
jKzfDKDKDKFsTCxFTCrVrVhONsNsTCWtzfloNazf
jKzfYhlQbLFsjWzfTCTCTCTCTCTCTCsFzfzxaGzf
jKzfieNsNsNsJZzfmhNsNsFsNsjZACsFzfEUXbzf
jKzflNHHlNlNlNzfrVqlmDFsNszfzfzfzfzfzfzf
jKzfWbdcUTUTTbyljTjTjTdEjTktENFvxNORzfjK
jKDjyiRFUTUTTbRFjTExdEdEjTUTUTUTUTUTzfjK
jKDjlIRFUTUTTbRFtPRFRFoDRFuDUTUTUTccDjjK
jKzfUTUTUTUTUTUTUTmHmHizmHCDUTUTUTVuDjjK
jKDjUuRFfeUTyAyAUTUTyAreuVuVyAyAUTNmzfjK
jKDjUuRFfeUTRFRFUTUTRFRFUTuVRFRFUTaaDjjK
jKzfLVUTUTCDjJjJUTUTjJjJUTuVjJjJUTGlDjjK
jKDjUuRFfeuVuVSuuVuVuVSuuVuVUTUToGUTzfjK
jKDjUuRFfeUTUTzfzfCACAzfzftACAzfzfUTzfjK
jKzfUTUTUTzfIzzfiNLhLhrlGRIGLhbjzfIzzfjK
jKzfHTRFQIzfzxzfsHLhLhLhGQztLhnfzfzxzfjK
jKDjiEdrUTzfzxzfGBLhLhLhLhLhLhmuzfzxzfjK
jKDjDjzfzfzfkwzfzfsrsrsrsrsrsrzfzfkwzfjK
jKjKjKjKjKjKjKjKjKjKjKjKjKjKjKjKjKjKjKjK
"}
