"a" = (/turf/template_noop,/area/template_noop)
"b" = (/obj/effect/spawner/random/engineering/material_cheap,/turf/open/floor/iron/dark/airless,/area/ruin/unpowered/no_grav)
"c" = (/obj/effect/spawner/random/medical/patient_stretcher,/turf/open/floor/iron/dark/airless,/area/ruin/unpowered/no_grav)
"e" = (/obj/machinery/power/smes,/turf/open/floor/plating,/area/ruin/unpowered/no_grav)
"g" = (/obj/effect/spawner/random/structure/crate_loot,/turf/open/floor/iron/dark/airless,/area/ruin/unpowered/no_grav)
"i" = (/turf/closed/wall/mineral/plastitanium,/area/ruin/unpowered/no_grav)
"j" = (/turf/open/floor/plating,/area/ruin/unpowered/no_grav)
"k" = (/turf/closed/wall/mineral/plastitanium,/area/ruin/space/has_grav/skyrat)
"r" = (/obj/machinery/door/airlock/hatch,/turf/open/floor/iron/dark/airless,/area/ruin/unpowered/no_grav)
"t" = (/obj/structure/closet/crate/radiation,/obj/effect/spawner/random/exotic/syndie,/turf/open/floor/iron/dark/airless,/area/ruin/unpowered/no_grav)
"u" = (/obj/structure/closet/crate/secure/engineering,/obj/item/pickaxe/drill/jackhammer,/obj/item/gun/energy/plasmacutter/adv,/obj/effect/spawner/random/medical/firstaid,/turf/open/floor/plating,/area/ruin/unpowered/no_grav)
"v" = (/obj/machinery/door/airlock/external/glass,/turf/open/floor/plating,/area/ruin/unpowered/no_grav)
"w" = (/mob/living/simple_animal/hostile/pirate/melee/space,/turf/open/floor/iron/dark/airless,/area/ruin/unpowered/no_grav)
"y" = (/obj/machinery/door/airlock/maintenance{req_access_txt = "12"},/turf/open/floor/plating,/area/ruin/unpowered/no_grav)
"B" = (/mob/living/simple_animal/hostile/pirate/ranged/space,/turf/open/floor/iron/dark/airless,/area/ruin/unpowered/no_grav)
"H" = (/obj/effect/spawner/random/structure/crate_abandoned,/turf/open/floor/iron/dark/airless,/area/ruin/unpowered/no_grav)
"K" = (/mob/living/simple_animal/hostile/pirate/melee,/turf/open/floor/plating,/area/ruin/unpowered/no_grav)
"L" = (/obj/structure/closet/crate/radiation,/obj/effect/spawner/random/engineering/material_rare,/obj/effect/spawner/random/engineering/material_rare,/obj/effect/spawner/random/engineering/material_cheap,/obj/effect/spawner/random/engineering/material_cheap,/obj/effect/spawner/random/engineering/material_cheap,/obj/effect/spawner/random/engineering/material,/obj/effect/spawner/random/engineering/material,/obj/effect/spawner/random/engineering/material,/obj/effect/spawner/random/engineering/material,/turf/open/floor/iron/dark/airless,/area/ruin/unpowered/no_grav)
"M" = (/obj/structure/lattice,/turf/template_noop,/area/ruin/unpowered/no_grav)
"N" = (/turf/open/floor/iron/dark/airless,/area/ruin/unpowered/no_grav)
"O" = (/obj/structure/shuttle/engine/propulsion{dir = 8},/turf/template_noop,/area/ruin/unpowered/no_grav)
"P" = (/obj/effect/mob_spawn/human/corpse/syndicatecommando,/turf/open/floor/iron/dark/airless,/area/ruin/unpowered/no_grav)
"Q" = (/obj/structure/closet/crate/radiation,/obj/effect/spawner/random/engineering/material,/obj/effect/spawner/random/engineering/material,/obj/effect/spawner/random/engineering/material,/obj/effect/spawner/random/engineering/material,/obj/effect/spawner/random/engineering/material_rare,/obj/effect/spawner/random/engineering/material_rare,/turf/open/floor/iron/dark/airless,/area/ruin/unpowered/no_grav)
"Z" = (/obj/structure/closet/crate/radiation,/obj/effect/spawner/random/contraband/narcotics,/obj/effect/spawner/random/contraband/narcotics,/obj/effect/spawner/random/contraband/narcotics,/turf/open/floor/iron/dark/airless,/area/ruin/unpowered/no_grav)

(1,1,1) = {"
aaaaaaaaaaaaa
aOiiiiviiMaaa
aOiLtNNBNNMaa
aiiiiNNNNiiaa
OieuiwcNNiNMa
OiKjyNNNbrNNM
aiiiiNgNNiiik
aOiZQbNNNHPia
aOiiiiviiiiia
aaaaaaaaaaaaa
"}
