//MAP CONVERTED BY dmm2tgm.py THIS HEADER COMMENT PREVENTS RECONVERSION, DO NOT REMOVE
"a" = (
/turf/template_noop,
/area/template_noop)
"d" = (
/obj/machinery/suit_storage_unit,
/turf/open/floor/iron/dark,
/area/ruin/powered)
"e" = (
/turf/open/floor/plating/asteroid/airless,
/area/ruin)
"h" = (
/obj/structure/shuttle/engine/propulsion{
	dir = 4
	},
/turf/open/space/basic,
/area/ruin/powered)
"j" = (
/obj/machinery/computer{
	dir = 4
	},
/turf/open/floor/pod/dark,
/area/ruin/powered)
"k" = (
/obj/structure/closet/crate/secure/gear,
/obj/item/kitchen/knife/combat,
/turf/open/floor/iron/dark,
/area/ruin/powered)
"n" = (
/turf/open/floor/pod/light,
/area/ruin/powered)
"o" = (
/turf/closed/mineral/random/high_chance,
/area/ruin)
"p" = (
/obj/structure/table/reinforced,
/obj/effect/spawner/lootdrop/donkpockets,
/obj/effect/spawner/lootdrop/donkpockets{
	pixel_x = 4;
	pixel_y = 3
	},
/turf/open/floor/iron/dark,
/area/ruin/powered)
"q" = (
/obj/structure/chair/comfy/shuttle{
	dir = 1
	},
/turf/open/floor/pod/light,
/area/ruin/powered)
"r" = (
/obj/machinery/door/airlock/external,
/obj/structure/fans/tiny,
/turf/open/floor/plating,
/area/ruin/powered)
"s" = (
/obj/structure/table/reinforced,
/obj/machinery/cell_charger_multi,
/turf/open/floor/iron/dark,
/area/ruin/powered)
"u" = (
/obj/structure/chair/comfy/shuttle{
	dir = 8
	},
/turf/open/floor/pod/dark,
/area/ruin/powered)
"w" = (
/mob/living/simple_animal/hostile/syndicate/ranged/space,
/turf/open/floor/plating/asteroid/airless,
/area/ruin)
"x" = (
/obj/structure/table/reinforced,
/obj/item/paper_bin,
/obj/item/pen,
/turf/open/floor/iron/dark,
/area/ruin/powered)
"y" = (
/obj/structure/closet/crate/goldcrate,
/obj/item/stack/sheet/mineral/plasma/thirty,
/obj/item/stack/sheet/mineral/diamond{
	amount = 5
	},
/obj/item/stack/sheet/mineral/gold{
	amount = 25
	},
/turf/open/floor/iron/dark,
/area/ruin/powered)
"A" = (
/obj/structure/mecha_wreckage/ripley/deathripley,
/turf/open/floor/plating/asteroid/airless,
/area/ruin)
"B" = (
/obj/structure/chair/comfy/shuttle{
	dir = 1
	},
/turf/open/floor/pod/dark,
/area/ruin/powered)
"C" = (
/turf/closed/wall/r_wall/syndicate,
/area/ruin/powered)
"E" = (
/turf/open/floor/pod/dark,
/area/ruin/powered)
"F" = (
/obj/structure/shuttle/engine/propulsion,
/turf/open/space/basic,
/area/ruin/powered)
"G" = (
/obj/structure/chair/comfy/shuttle{
	dir = 1
	},
/turf/open/floor/iron/dark,
/area/ruin/powered)
"H" = (
/obj/structure/chair/comfy/shuttle{
	dir = 8
	},
/mob/living/simple_animal/hostile/syndicate/civilian,
/turf/open/floor/pod/light,
/area/ruin/powered)
"I" = (
/obj/machinery/computer,
/turf/open/floor/pod/dark,
/area/ruin/powered)
"J" = (
/obj/structure/closet/crate/secure/gear,
/obj/item/disk/tech_disk/major,
/obj/item/disk/tech_disk/spaceloot,
/obj/item/disk/tech_disk/spaceloot,
/obj/item/ammo_casing/shotgun/techshell,
/obj/item/ammo_casing/shotgun/techshell,
/obj/item/ammo_casing/shotgun/techshell,
/turf/open/floor/iron/dark,
/area/ruin/powered)
"L" = (
/turf/closed/mineral/random/asteroid,
/area/ruin)
"M" = (
/obj/machinery/power/port_gen/pacman,
/turf/open/floor/iron/dark,
/area/ruin/powered)
"N" = (
/obj/effect/spawner/structure/window/plasma/reinforced,
/turf/open/floor/plating,
/area/ruin/powered)
"O" = (
/mob/living/simple_animal/hostile/syndicate/ranged/infiltrator,
/turf/open/floor/iron/dark,
/area/ruin/powered)
"P" = (
/turf/open/floor/iron/dark,
/area/ruin/powered)
"Q" = (
/obj/structure/table/reinforced,
/obj/machinery/microwave,
/turf/open/floor/iron/dark,
/area/ruin/powered)
"S" = (
/mob/living/simple_animal/hostile/syndicate/melee/sword/space,
/turf/open/floor/plating/asteroid/airless,
/area/ruin)
"U" = (
/obj/structure/chair/comfy/shuttle{
	dir = 8
	},
/turf/open/floor/iron/dark,
/area/ruin/powered)
"V" = (
/obj/machinery/sleeper/syndie{
	dir = 4
	},
/turf/open/floor/iron/dark,
/area/ruin/powered)
"W" = (
/mob/living/simple_animal/hostile/syndicate/melee/space,
/turf/open/floor/plating/asteroid/airless,
/area/ruin)
"X" = (
/mob/living/simple_animal/hostile/syndicate/melee,
/turf/open/floor/iron/dark,
/area/ruin/powered)
"Z" = (
/obj/structure/table/reinforced,
/obj/item/paper,
/obj/item/paper{
	pixel_x = 4;
	pixel_y = 2
	},
/obj/item/pen/fountain,
/turf/open/floor/pod/dark,
/area/ruin/powered)

(1,1,1) = {"
a
a
a
a
L
L
L
L
L
L
a
a
a
a
a
a
a
a
a
"}
(2,1,1) = {"
a
a
a
L
L
L
L
L
L
L
L
L
a
a
a
a
a
a
a
"}
(3,1,1) = {"
a
a
a
a
e
e
e
L
L
L
L
L
L
a
a
a
a
a
a
"}
(4,1,1) = {"
a
a
e
e
e
e
e
e
L
L
L
L
L
L
a
a
a
a
a
"}
(5,1,1) = {"
a
a
e
e
e
e
W
e
e
e
e
L
L
L
L
L
a
a
a
"}
(6,1,1) = {"
a
e
e
e
e
e
e
e
e
e
e
e
e
e
L
L
L
a
a
"}
(7,1,1) = {"
a
e
e
e
e
e
e
N
C
r
C
e
e
e
e
L
L
L
a
"}
(8,1,1) = {"
L
e
e
e
e
e
N
I
B
E
C
C
e
e
e
e
L
L
L
"}
(9,1,1) = {"
L
L
e
e
e
N
j
Z
q
E
B
C
C
e
w
e
o
L
L
"}
(10,1,1) = {"
L
L
e
e
e
C
u
H
n
P
X
G
C
C
F
e
L
L
L
"}
(11,1,1) = {"
L
L
e
e
e
r
E
E
P
s
p
P
V
C
C
e
L
o
L
"}
(12,1,1) = {"
L
L
L
e
e
C
C
u
P
x
Q
P
P
J
C
e
o
L
L
"}
(13,1,1) = {"
L
L
L
e
S
e
C
C
U
O
P
P
P
k
C
e
o
L
L
"}
(14,1,1) = {"
a
L
L
e
e
e
e
C
C
d
P
P
y
C
C
e
o
L
L
"}
(15,1,1) = {"
a
L
L
L
e
e
e
e
C
C
d
M
C
C
F
e
o
L
L
"}
(16,1,1) = {"
a
a
L
L
L
L
e
e
h
C
C
C
C
h
e
e
o
L
L
"}
(17,1,1) = {"
a
a
a
L
L
L
L
e
e
e
e
e
e
e
e
e
o
L
L
"}
(18,1,1) = {"
a
a
a
L
L
L
L
L
L
o
o
o
o
e
e
A
L
L
L
"}
(19,1,1) = {"
a
a
a
a
a
L
L
L
L
L
L
L
o
o
L
L
L
L
a
"}
(20,1,1) = {"
a
a
a
a
a
a
L
L
L
L
L
L
L
L
L
L
L
a
a
"}
(21,1,1) = {"
a
a
a
a
a
a
a
a
a
a
a
a
L
L
L
a
a
a
a
"}
