//MAP CONVERTED BY dmm2tgm.py THIS HEADER COMMENT PREVENTS RECONVERSION, DO NOT REMOVE
"a" = (
/turf/closed/wall,
/area/station/command/teleporter)
"b" = (
/obj/effect/turf_decal/tile/purple{
	dir = 1
	},
/obj/effect/turf_decal/tile/purple,
/obj/machinery/atmospherics/components/unary/vent_pump/on/layer4{
	dir = 1
	},
/turf/open/floor/iron,
/area/station/service/barber)
"c" = (
/turf/closed/wall,
/area/station/command/gateway)
"e" = (
/obj/effect/turf_decal/tile/purple{
	dir = 1
	},
/obj/effect/turf_decal/tile/purple,
/obj/item/kirbyplants/random,
/turf/open/floor/iron,
/area/station/service/barber)
"f" = (
/obj/effect/turf_decal/tile/purple{
	dir = 1
	},
/obj/effect/turf_decal/tile/purple,
/obj/structure/chair/sofa/bench/left,
/turf/open/floor/iron,
/area/station/service/barber)
"g" = (
/obj/item/radio/intercom/directional/north,
/obj/effect/turf_decal/tile/purple{
	dir = 1
	},
/obj/effect/turf_decal/tile/purple,
/obj/machinery/vending/barbervend,
/obj/machinery/button/curtain{
	id = "barbershopcurtains";
	pixel_x = -25;
	pixel_y = 24
	},
/turf/open/floor/iron,
/area/station/service/barber)
"h" = (
/obj/structure/curtain/cloth/fancy/mechanical{
	id = "barbershopcurtains1"
	},
/obj/effect/spawner/structure/window,
/turf/open/floor/plating,
/area/station/service/barber)
"i" = (
/obj/effect/turf_decal/tile/purple{
	dir = 1
	},
/obj/effect/turf_decal/tile/purple,
/obj/structure/sink/directional/east,
/obj/structure/mirror/directional/west,
/obj/machinery/atmospherics/components/unary/vent_scrubber/on/layer2{
	dir = 4
	},
/turf/open/floor/iron,
/area/station/service/barber)
"j" = (
/obj/machinery/light/warm/directional/north,
/obj/effect/turf_decal/tile/purple{
	dir = 1
	},
/obj/effect/turf_decal/tile/purple,
/obj/structure/chair/comfy/barber_chair{
	dir = 4
	},
/turf/open/floor/iron,
/area/station/service/barber)
"k" = (
/obj/effect/spawner/structure/window/reinforced,
/obj/structure/curtain/cloth/fancy/mechanical{
	id = "barbershopcurtains"
	},
/turf/open/floor/plating,
/area/station/service/barber)
"m" = (
/obj/effect/turf_decal/tile/purple{
	dir = 1
	},
/obj/effect/turf_decal/tile/purple,
/obj/machinery/atmospherics/components/unary/vent_pump/on/layer4,
/obj/effect/landmark/start/barber,
/turf/open/floor/iron,
/area/station/service/barber)
"n" = (
/obj/structure/cable,
/obj/effect/turf_decal/tile/purple{
	dir = 1
	},
/obj/effect/turf_decal/tile/purple,
/turf/open/floor/iron,
/area/station/service/barber)
"o" = (
/obj/effect/turf_decal/tile/purple{
	dir = 1
	},
/obj/effect/turf_decal/tile/purple,
/obj/structure/chair/sofa/bench/left{
	dir = 1
	},
/obj/machinery/atmospherics/pipe/smart/manifold4w/scrubbers/hidden/layer2,
/obj/machinery/atmospherics/pipe/smart/manifold4w/supply/hidden/layer4,
/turf/open/floor/iron,
/area/station/service/barber)
"p" = (
/obj/machinery/holopad,
/obj/effect/turf_decal/tile/purple{
	dir = 1
	},
/obj/effect/turf_decal/tile/purple,
/obj/machinery/atmospherics/pipe/smart/manifold4w/scrubbers/hidden/layer2,
/obj/machinery/atmospherics/pipe/smart/manifold4w/supply/hidden/layer4,
/turf/open/floor/iron,
/area/station/service/barber)
"q" = (
/obj/structure/bed/pod,
/obj/machinery/light/warm/directional/north,
/obj/effect/turf_decal/tile/purple{
	dir = 1
	},
/obj/effect/turf_decal/tile/purple,
/obj/effect/landmark/start/hangover,
/turf/open/floor/iron,
/area/station/service/barber)
"r" = (
/obj/structure/table/reinforced/rglass,
/obj/item/hairbrush,
/obj/effect/turf_decal/tile/purple{
	dir = 1
	},
/obj/effect/turf_decal/tile/purple,
/obj/item/lipstick/random,
/turf/open/floor/iron,
/area/station/service/barber)
"s" = (
/obj/structure/table/reinforced/rglass,
/obj/effect/turf_decal/tile/purple{
	dir = 1
	},
/obj/effect/turf_decal/tile/purple,
/obj/structure/mirror/directional/east,
/obj/item/reagent_containers/spray/barbers_aid{
	pixel_x = 6
	},
/obj/item/razor{
	pixel_x = -6
	},
/turf/open/floor/iron,
/area/station/service/barber)
"t" = (
/obj/structure/cable,
/obj/effect/turf_decal/tile/purple{
	dir = 1
	},
/obj/effect/turf_decal/tile/purple,
/obj/machinery/atmospherics/pipe/smart/manifold4w/scrubbers/hidden/layer2,
/turf/open/floor/iron,
/area/station/service/barber)
"v" = (
/turf/closed/wall/r_wall,
/area/station/command/gateway)
"w" = (
/obj/structure/extinguisher_cabinet/directional/west,
/obj/structure/chair/office/light{
	dir = 4
	},
/obj/effect/turf_decal/tile/purple{
	dir = 1
	},
/obj/effect/turf_decal/tile/purple,
/turf/open/floor/iron,
/area/station/service/barber)
"x" = (
/obj/structure/table/reinforced/rglass,
/obj/effect/turf_decal/tile/purple{
	dir = 1
	},
/obj/effect/turf_decal/tile/purple,
/obj/structure/mirror/directional/east,
/obj/item/reagent_containers/dropper,
/obj/item/hairbrush/comb{
	pixel_y = 10
	},
/turf/open/floor/iron,
/area/station/service/barber)
"z" = (
/obj/structure/table/reinforced/rglass,
/obj/item/hairbrush,
/obj/effect/turf_decal/tile/purple{
	dir = 1
	},
/obj/effect/turf_decal/tile/purple,
/obj/item/lipstick/random,
/obj/machinery/camera/directional/east{
	c_tag = "Salon - Massage Parlour"
	},
/turf/open/floor/iron,
/area/station/service/barber)
"A" = (
/obj/effect/turf_decal/tile/purple{
	dir = 1
	},
/obj/effect/turf_decal/tile/purple,
/turf/open/floor/iron,
/area/station/service/barber)
"C" = (
/turf/closed/wall,
/area/station/service/barber)
"D" = (
/obj/machinery/atmospherics/pipe/smart/manifold4w/scrubbers/hidden/layer2,
/obj/machinery/atmospherics/pipe/smart/manifold4w/supply/hidden/layer4,
/obj/effect/turf_decal/tile/purple,
/obj/effect/turf_decal/tile/purple{
	dir = 1
	},
/obj/machinery/door/airlock/public{
	name = "Massage Parlour"
	},
/obj/machinery/door/firedoor,
/turf/open/floor/iron,
/area/station/service/barber)
"E" = (
/obj/structure/cable,
/obj/effect/turf_decal/tile/purple{
	dir = 1
	},
/obj/effect/turf_decal/tile/purple,
/obj/effect/landmark/start/barber,
/obj/machinery/atmospherics/components/unary/vent_scrubber/on/layer2{
	dir = 8
	},
/turf/open/floor/iron,
/area/station/service/barber)
"F" = (
/obj/effect/turf_decal/tile/purple{
	dir = 1
	},
/obj/effect/turf_decal/tile/purple,
/obj/machinery/dryer{
	dir = 4;
	pixel_x = -6;
	pixel_y = -6
	},
/turf/open/floor/iron,
/area/station/service/barber)
"G" = (
/obj/structure/chair/office/light{
	dir = 4
	},
/obj/effect/turf_decal/tile/purple{
	dir = 1
	},
/obj/effect/turf_decal/tile/purple,
/obj/machinery/button/curtain{
	id = "barbershopcurtains1";
	pixel_x = -25;
	pixel_y = 24
	},
/turf/open/floor/iron,
/area/station/service/barber)
"H" = (
/obj/effect/turf_decal/tile/purple{
	dir = 1
	},
/obj/effect/turf_decal/tile/purple,
/obj/machinery/light_switch/directional/south,
/turf/open/floor/iron,
/area/station/service/barber)
"I" = (
/obj/machinery/light/small/directional/east,
/obj/machinery/power/apc/auto_name/directional/east,
/obj/structure/cable,
/obj/structure/table/reinforced/rglass,
/obj/effect/turf_decal/tile/purple{
	dir = 1
	},
/obj/effect/turf_decal/tile/purple,
/obj/item/lipstick/random,
/obj/item/reagent_containers/spray/quantum_hair_dye{
	pixel_x = 6
	},
/turf/open/floor/iron,
/area/station/service/barber)
"J" = (
/obj/effect/turf_decal/tile/purple{
	dir = 1
	},
/obj/effect/turf_decal/tile/purple,
/obj/effect/landmark/event_spawn,
/obj/machinery/atmospherics/pipe/smart/manifold4w/scrubbers/hidden/layer2,
/obj/machinery/atmospherics/pipe/smart/manifold4w/supply/hidden/layer4,
/turf/open/floor/iron,
/area/station/service/barber)
"K" = (
/obj/effect/turf_decal/tile/purple,
/obj/effect/turf_decal/tile/purple{
	dir = 1
	},
/obj/machinery/door/airlock/public/glass{
	name = "Barbershop"
	},
/obj/machinery/atmospherics/pipe/smart/manifold4w/scrubbers/hidden/layer2,
/obj/machinery/atmospherics/pipe/smart/manifold4w/supply/hidden/layer4,
/obj/machinery/door/firedoor,
/turf/open/floor/iron,
/area/station/service/barber)
"L" = (
/obj/machinery/light/warm/directional/west,
/obj/effect/turf_decal/tile/purple{
	dir = 1
	},
/obj/effect/turf_decal/tile/purple,
/obj/item/kirbyplants/random,
/obj/machinery/button/curtain{
	id = "barbershopcurtains";
	pixel_x = -25;
	pixel_y = -24
	},
/obj/machinery/light_switch/directional/west,
/turf/open/floor/iron,
/area/station/service/barber)
"M" = (
/obj/effect/turf_decal/tile/purple{
	dir = 1
	},
/obj/effect/turf_decal/tile/purple,
/obj/machinery/atmospherics/pipe/smart/manifold4w/scrubbers/hidden/layer2,
/turf/open/floor/iron,
/area/station/service/barber)
"N" = (
/turf/closed/wall/r_wall,
/area/station/command/teleporter)
"O" = (
/obj/structure/cable,
/obj/effect/turf_decal/tile/purple{
	dir = 1
	},
/obj/effect/turf_decal/tile/purple,
/obj/item/book/fish_catalog,
/obj/structure/table/wood,
/turf/open/floor/iron,
/area/station/service/barber)
"P" = (
/obj/structure/cable,
/obj/effect/turf_decal/tile/purple{
	dir = 1
	},
/obj/effect/turf_decal/tile/purple,
/obj/item/lipstick/random,
/obj/structure/table/wood,
/turf/open/floor/iron,
/area/station/service/barber)
"Q" = (
/obj/effect/spawner/structure/window,
/obj/structure/curtain/cloth/fancy/mechanical{
	id = "barbershopcurtains"
	},
/turf/open/floor/plating,
/area/station/service/barber)
"R" = (
/obj/effect/turf_decal/tile/purple{
	dir = 1
	},
/obj/effect/turf_decal/tile/purple,
/obj/machinery/atmospherics/pipe/smart/manifold4w/scrubbers/hidden/layer2,
/obj/machinery/atmospherics/pipe/smart/manifold4w/supply/hidden/layer4,
/turf/open/floor/iron,
/area/station/service/barber)
"S" = (
/obj/machinery/door/firedoor,
/obj/structure/cable,
/obj/machinery/door/airlock/public/glass{
	name = "Barbershop"
	},
/turf/open/floor/iron,
/area/station/service/barber)
"T" = (
/obj/structure/bed/pod,
/obj/effect/turf_decal/tile/purple{
	dir = 1
	},
/obj/effect/turf_decal/tile/purple,
/turf/open/floor/iron,
/area/station/service/barber)
"U" = (
/obj/machinery/firealarm/directional/east,
/obj/effect/turf_decal/tile/purple{
	dir = 1
	},
/obj/effect/turf_decal/tile/purple,
/obj/item/kirbyplants/random,
/turf/open/floor/iron,
/area/station/service/barber)
"V" = (
/obj/effect/turf_decal/tile/purple{
	dir = 1
	},
/obj/effect/turf_decal/tile/purple,
/obj/structure/chair/sofa/bench/right{
	dir = 1
	},
/obj/effect/landmark/start/hangover,
/obj/machinery/atmospherics/pipe/smart/manifold4w/scrubbers/hidden/layer2,
/obj/machinery/atmospherics/pipe/smart/manifold4w/supply/hidden/layer4,
/turf/open/floor/iron,
/area/station/service/barber)
"W" = (
/obj/structure/curtain/cloth/fancy/mechanical{
	id = "barbershopcurtains1"
	},
/obj/effect/spawner/structure/window/reinforced,
/turf/open/floor/plating,
/area/station/service/barber)
"X" = (
/obj/effect/turf_decal/tile/purple{
	dir = 1
	},
/obj/effect/turf_decal/tile/purple,
/obj/structure/closet/secure_closet/barber,
/obj/machinery/airalarm/directional/west,
/turf/open/floor/iron,
/area/station/service/barber)
"Y" = (
/obj/effect/turf_decal/tile/purple{
	dir = 1
	},
/obj/effect/turf_decal/tile/purple,
/obj/structure/chair/comfy/barber_chair{
	dir = 4
	},
/turf/open/floor/iron,
/area/station/service/barber)
"Z" = (
/obj/machinery/camera/directional/north{
	c_tag = "Salon"
	},
/obj/effect/turf_decal/tile/purple{
	dir = 1
	},
/obj/effect/turf_decal/tile/purple,
/obj/structure/chair/sofa/bench/right,
/turf/open/floor/iron,
/area/station/service/barber)

(1,1,1) = {"
N
N
a
a
a
N
"}
(2,1,1) = {"
W
G
F
i
w
C
"}
(3,1,1) = {"
C
q
m
J
T
h
"}
(4,1,1) = {"
h
z
e
R
r
C
"}
(5,1,1) = {"
C
C
C
D
C
C
"}
(6,1,1) = {"
C
g
X
R
L
Q
"}
(7,1,1) = {"
S
n
n
p
b
Q
"}
(8,1,1) = {"
C
Z
O
o
H
C
"}
(9,1,1) = {"
Q
f
P
V
R
K
"}
(10,1,1) = {"
Q
A
t
M
A
C
"}
(11,1,1) = {"
C
j
E
Y
A
Q
"}
(12,1,1) = {"
k
x
I
s
U
Q
"}
(13,1,1) = {"
v
c
c
c
c
v
"}
