//MAP CONVERTED BY dmm2tgm.py THIS HEADER COMMENT PREVENTS RECONVERSION, DO NOT REMOVE
"a" = (
/obj/machinery/door/poddoor/preopen{
	id = "medsecprivacy";
	name = "Privacy Shutter"
	},
/obj/structure/table/reinforced,
/obj/machinery/door/firedoor,
/obj/machinery/door/window/brigdoor/left/directional/north{
	name = "Orderly Office's Desk";
	req_access = list("brig_entrance")
	},
/turf/open/floor/plating,
/area/station/security/checkpoint/medical)
"g" = (
/obj/machinery/door/firedoor,
/obj/machinery/door/airlock/security{
	name = "Orderly's Office"
	},
/obj/structure/cable,
/obj/machinery/atmospherics/pipe/smart/manifold4w/supply/hidden/layer4,
/obj/machinery/atmospherics/pipe/smart/manifold4w/scrubbers/hidden/layer2,
/obj/effect/turf_decal/tile/red/fourcorners,
/obj/effect/mapping_helpers/airlock/access/all/medical,
/turf/open/floor/iron/dark,
/area/station/security/checkpoint/medical)
"i" = (
/obj/item/radio/intercom/directional/west,
/obj/machinery/computer/secure_data{
	dir = 4
	},
/obj/machinery/button/door/directional/west{
	id = "MedbayFoyer";
	name = "Medbay Doors Control";
	normaldoorcontrol = 1;
	pixel_y = -9
	},
/obj/effect/turf_decal/tile/red/fourcorners,
/turf/open/floor/iron/dark,
/area/station/security/checkpoint/medical)
"j" = (
/obj/effect/turf_decal/trimline/red/filled/line{
	dir = 1
	},
/obj/machinery/holopad,
/obj/effect/landmark/start/orderly,
/turf/open/floor/iron/dark,
/area/station/security/checkpoint/medical)
"k" = (
/obj/machinery/atmospherics/components/unary/vent_scrubber/on/layer2{
	dir = 1
	},
/obj/effect/turf_decal/trimline/red/filled/line{
	dir = 4
	},
/obj/effect/landmark/start/orderly,
/turf/open/floor/iron/dark,
/area/station/security/checkpoint/medical)
"l" = (
/obj/effect/turf_decal/trimline/red/filled/line{
	dir = 9
	},
/obj/machinery/power/apc/auto_name/directional/west,
/obj/structure/cable,
/obj/machinery/atmospherics/components/unary/vent_pump/on/layer4,
/obj/effect/landmark/start/orderly,
/turf/open/floor/iron/dark,
/area/station/security/checkpoint/medical)
"m" = (
/obj/machinery/button/door/directional/east{
	id = "medsecprivacy";
	name = "Privacy Shutters Control";
	req_access = list("brig_entrance")
	},
/obj/effect/turf_decal/trimline/red/filled/line{
	dir = 5
	},
/turf/open/floor/iron/dark,
/area/station/security/checkpoint/medical)
"o" = (
/obj/effect/turf_decal/trimline/red/filled/line{
	dir = 6
	},
/obj/effect/landmark/start/orderly,
/turf/open/floor/iron/dark,
/area/station/security/checkpoint/medical)
"v" = (
/obj/machinery/requests_console/directional/north{
	department = "Security";
	departmentType = 3;
	name = "Security Requests Console"
	},
/obj/machinery/light/directional/north,
/obj/machinery/camera/directional/north{
	c_tag = "Security Post - Medbay";
	network = list("ss13","medbay")
	},
/obj/effect/turf_decal/tile/red/fourcorners,
/obj/structure/closet/secure_closet/security/med,
/obj/item/book/manual/wiki/security_space_law,
/turf/open/floor/iron/dark,
/area/station/security/checkpoint/medical)
"y" = (
/obj/structure/chair/office{
	dir = 8
	},
/obj/effect/turf_decal/trimline/red/filled/line{
	dir = 10
	},
/obj/effect/landmark/start/orderly,
/turf/open/floor/iron/dark,
/area/station/security/checkpoint/medical)
"z" = (
/obj/effect/turf_decal/trimline/red/filled/line{
	dir = 10
	},
/obj/structure/cable,
/obj/machinery/atmospherics/pipe/smart/manifold4w/supply/hidden/layer4,
/obj/machinery/atmospherics/pipe/smart/manifold4w/scrubbers/hidden/layer2,
/turf/open/floor/iron/dark,
/area/station/security/checkpoint/medical)
"B" = (
/obj/machinery/atmospherics/pipe/smart/manifold4w/scrubbers/hidden/layer2,
/obj/effect/turf_decal/trimline/red/filled/line{
	dir = 4
	},
/obj/structure/cable,
/turf/open/floor/iron/dark,
/area/station/security/checkpoint/medical)
"D" = (
/obj/item/pen,
/obj/structure/table/reinforced,
/obj/structure/reagent_dispensers/wall/peppertank/directional/east,
/obj/item/folder/red,
/obj/machinery/newscaster/directional/north,
/obj/item/screwdriver{
	pixel_y = 10
	},
/obj/item/radio/off,
/obj/effect/turf_decal/tile/red/fourcorners,
/obj/machinery/recharger{
	pixel_y = 4
	},
/turf/open/floor/iron/dark,
/area/station/security/checkpoint/medical)
"M" = (
/obj/effect/spawner/structure/window/reinforced,
/obj/structure/cable,
/obj/machinery/door/poddoor/preopen{
	id = "medsecprivacy";
	name = "Privacy Shutter"
	},
/turf/open/floor/plating,
/area/station/security/checkpoint/medical)
"O" = (
/obj/machinery/computer/security/telescreen{
	desc = "Used for monitoring medbay to ensure patient safety.";
	dir = 4;
	name = "Medbay Monitor";
	network = list("medbay");
	pixel_x = -32
	},
/obj/machinery/light_switch/directional/west{
	pixel_x = -20
	},
/obj/machinery/computer/med_data{
	dir = 4
	},
/obj/machinery/light/directional/west,
/obj/effect/turf_decal/tile/red/fourcorners,
/turf/open/floor/iron/dark,
/area/station/security/checkpoint/medical)
"P" = (
/obj/machinery/airalarm/directional/west,
/obj/structure/closet/secure_closet/security/med,
/obj/effect/turf_decal/tile/red/fourcorners,
/turf/open/floor/iron/dark,
/area/station/security/checkpoint/medical)
"R" = (
/turf/closed/wall,
/area/station/security/checkpoint/medical)
"S" = (
/obj/machinery/door/poddoor/preopen{
	id = "medsecprivacy";
	name = "Privacy Shutter"
	},
/obj/structure/table/reinforced,
/obj/machinery/door/firedoor,
/obj/machinery/door/window/brigdoor/right/directional/north{
	name = "Orderly Office's Desk";
	req_access = list("brig_entrance")
	},
/turf/open/floor/plating,
/area/station/security/checkpoint/medical)
"U" = (
/obj/effect/turf_decal/trimline/red/filled/corner{
	dir = 8
	},
/obj/structure/cable,
/obj/machinery/atmospherics/pipe/smart/manifold4w/scrubbers/hidden/layer2,
/turf/open/floor/iron/dark,
/area/station/security/checkpoint/medical)
"X" = (
/obj/effect/turf_decal/trimline/red/filled/line{
	dir = 8
	},
/obj/effect/landmark/start/orderly,
/turf/open/floor/iron/dark,
/area/station/security/checkpoint/medical)

(1,1,1) = {"
R
R
R
g
R
R
R
"}
(2,1,1) = {"
R
P
l
z
O
i
R
"}
(3,1,1) = {"
R
v
j
U
X
y
a
"}
(4,1,1) = {"
R
D
m
B
k
o
S
"}
(5,1,1) = {"
R
R
R
M
M
M
R
"}
