//MAP CONVERTED BY dmm2tgm.py THIS HEADER COMMENT PREVENTS RECONVERSION, DO NOT REMOVE
"a" = (
/obj/machinery/computer/secure_data{
	dir = 8
	},
/obj/structure/reagent_dispensers/wall/peppertank/directional/east,
/turf/open/floor/iron/dark,
/area/station/security/checkpoint/science)
"b" = (
/obj/effect/turf_decal/tile/red,
/obj/effect/turf_decal/tile/red{
	dir = 1
	},
/obj/structure/chair,
/obj/structure/cable,
/obj/effect/turf_decal/siding/red/corner,
/obj/effect/landmark/start/science_guard,
/turf/open/floor/iron,
/area/station/security/checkpoint/science)
"c" = (
/obj/machinery/computer/mecha{
	dir = 8
	},
/turf/open/floor/iron/dark,
/area/station/security/checkpoint/science)
"d" = (
/obj/effect/turf_decal/tile/red,
/obj/effect/turf_decal/tile/red{
	dir = 1
	},
/obj/machinery/atmospherics/components/unary/vent_scrubber/on/layer2{
	dir = 1
	},
/obj/structure/cable,
/turf/open/floor/iron,
/area/station/security/checkpoint/science)
"f" = (
/turf/closed/wall,
/area/station/security/checkpoint/science)
"k" = (
/obj/effect/turf_decal/tile/red,
/obj/effect/turf_decal/tile/red{
	dir = 1
	},
/turf/open/floor/iron,
/area/station/security/checkpoint/science)
"l" = (
/obj/effect/spawner/structure/window/reinforced,
/obj/structure/cable,
/turf/open/floor/plating,
/area/station/security/checkpoint/science)
"m" = (
/obj/effect/spawner/structure/window/reinforced,
/obj/structure/cable,
/turf/open/floor/plating,
/area/station/science/research)
"n" = (
/obj/effect/turf_decal/tile/red,
/obj/effect/turf_decal/tile/red{
	dir = 1
	},
/obj/structure/cable,
/obj/effect/turf_decal/siding/red,
/obj/effect/landmark/start/science_guard,
/turf/open/floor/iron,
/area/station/security/checkpoint/science)
"o" = (
/obj/effect/turf_decal/tile/red,
/obj/effect/turf_decal/tile/red{
	dir = 1
	},
/obj/structure/chair,
/obj/effect/landmark/start/science_guard,
/turf/open/floor/iron,
/area/station/security/checkpoint/science)
"p" = (
/obj/structure/table/reinforced,
/obj/item/folder/red,
/obj/machinery/light/directional/south,
/obj/structure/cable,
/obj/machinery/requests_console/directional/south{
	department = "Security";
	departmentType = 5;
	name = "Security Requests Console"
	},
/obj/item/book/manual/wiki/security_space_law{
	pixel_x = 9;
	pixel_y = 4
	},
/obj/item/radio{
	pixel_x = -6;
	pixel_y = -3
	},
/turf/open/floor/iron/dark,
/area/station/security/checkpoint/science)
"s" = (
/obj/effect/turf_decal/tile/red,
/obj/effect/turf_decal/tile/red{
	dir = 1
	},
/obj/machinery/atmospherics/pipe/smart/manifold4w/supply/hidden/layer4,
/obj/machinery/atmospherics/pipe/smart/manifold4w/scrubbers/hidden/layer2,
/obj/structure/cable,
/turf/open/floor/iron,
/area/station/security/checkpoint/science)
"t" = (
/obj/effect/turf_decal/tile/red,
/obj/effect/turf_decal/tile/red{
	dir = 1
	},
/obj/item/kirbyplants/random,
/obj/machinery/power/apc/auto_name/directional/north,
/obj/machinery/light/small/directional/east,
/obj/structure/cable,
/obj/machinery/airalarm/directional/east,
/obj/effect/turf_decal/siding/red,
/turf/open/floor/iron,
/area/station/security/checkpoint/science)
"v" = (
/obj/effect/spawner/structure/window/reinforced,
/obj/structure/cable,
/turf/open/floor/plating,
/area/station/science/lab)
"w" = (
/obj/structure/table/reinforced,
/obj/machinery/recharger,
/obj/structure/cable,
/obj/machinery/camera/directional/east{
	c_tag = "Security Post - Research Division";
	network = list("ss13","rd")
	},
/turf/open/floor/iron/dark,
/area/station/security/checkpoint/science)
"B" = (
/obj/structure/cable,
/obj/structure/closet/secure_closet/security/science,
/turf/open/floor/iron/dark,
/area/station/security/checkpoint/science)
"E" = (
/turf/closed/wall,
/area/station/science/research)
"G" = (
/obj/effect/turf_decal/tile/red,
/obj/effect/turf_decal/tile/red{
	dir = 1
	},
/obj/machinery/atmospherics/pipe/smart/manifold4w/supply/hidden/layer4,
/obj/structure/cable,
/obj/effect/turf_decal/siding/red{
	dir = 4
	},
/obj/effect/landmark/start/science_guard,
/turf/open/floor/iron,
/area/station/security/checkpoint/science)
"H" = (
/turf/closed/wall,
/area/station/science/lab)
"O" = (
/obj/machinery/computer/security{
	dir = 8
	},
/obj/machinery/firealarm/directional/east,
/turf/open/floor/iron/dark,
/area/station/security/checkpoint/science)
"S" = (
/obj/effect/turf_decal/tile/red,
/obj/effect/turf_decal/tile/red{
	dir = 1
	},
/obj/machinery/atmospherics/components/unary/vent_pump/on/layer4{
	dir = 1
	},
/obj/structure/chair/office{
	dir = 4
	},
/obj/effect/turf_decal/siding/red{
	dir = 4
	},
/obj/effect/landmark/start/science_guard,
/turf/open/floor/iron,
/area/station/security/checkpoint/science)
"T" = (
/obj/effect/turf_decal/tile/red,
/obj/effect/turf_decal/tile/red{
	dir = 1
	},
/obj/structure/rack,
/obj/item/restraints/handcuffs,
/obj/machinery/light/small/directional/west,
/obj/machinery/light_switch/directional/west{
	pixel_y = -4
	},
/obj/machinery/button/door/directional/west{
	id = "rdrnd";
	name = "Research and Development Containment Control";
	pixel_y = 6;
	req_access = list("brig_entrance")
	},
/turf/open/floor/iron,
/area/station/security/checkpoint/science)
"V" = (
/obj/item/radio/intercom/directional/west,
/obj/structure/closet/secure_closet/security/science,
/turf/open/floor/iron/dark,
/area/station/security/checkpoint/science)
"W" = (
/obj/effect/turf_decal/tile/red/fourcorners,
/obj/machinery/door/firedoor,
/obj/machinery/door/airlock/security{
	name = "Science Guard's Office"
	},
/obj/machinery/atmospherics/pipe/smart/manifold4w/supply/hidden/layer4,
/obj/machinery/atmospherics/pipe/smart/manifold4w/scrubbers/hidden/layer2,
/obj/structure/cable,
/obj/effect/mapping_helpers/airlock/access/all/science/sci_guard,
/turf/open/floor/iron,
/area/station/security/checkpoint/science)
"X" = (
/obj/effect/turf_decal/tile/red,
/obj/effect/turf_decal/tile/red{
	dir = 1
	},
/obj/effect/turf_decal/siding/red{
	dir = 6
	},
/obj/effect/landmark/start/science_guard,
/turf/open/floor/iron,
/area/station/security/checkpoint/science)
"Z" = (
/obj/effect/turf_decal/tile/red,
/obj/effect/turf_decal/tile/red{
	dir = 1
	},
/obj/effect/turf_decal/siding/red,
/obj/effect/landmark/start/science_guard,
/turf/open/floor/iron,
/area/station/security/checkpoint/science)

(1,1,1) = {"
H
f
W
l
l
f
E
"}
(2,1,1) = {"
v
T
s
k
Z
V
m
"}
(3,1,1) = {"
v
o
s
d
n
B
m
"}
(4,1,1) = {"
v
b
G
S
X
p
E
"}
(5,1,1) = {"
H
t
a
O
c
w
m
"}
