//MAP CONVERTED BY dmm2tgm.py THIS HEADER COMMENT PREVENTS RECONVERSION, DO NOT REMOVE
"a" = (
/obj/effect/spawner/structure/window/reinforced,
/obj/structure/cable,
/turf/open/floor/plating,
/area/station/security/checkpoint/supply)
"b" = (
/obj/structure/cable,
/obj/machinery/power/apc/auto_name/directional/east,
/obj/machinery/atmospherics/components/unary/vent_pump/on/layer4,
/obj/machinery/atmospherics/pipe/smart/manifold4w/scrubbers/hidden/layer2,
/obj/effect/landmark/start/customs_agent,
/turf/open/floor/iron,
/area/station/security/checkpoint/supply)
"c" = (
/obj/structure/reagent_dispensers/wall/peppertank/directional/east,
/obj/machinery/atmospherics/pipe/smart/manifold4w/supply/hidden/layer4,
/obj/machinery/atmospherics/pipe/smart/manifold4w/scrubbers/hidden/layer2,
/turf/open/floor/iron,
/area/station/security/checkpoint/supply)
"e" = (
/obj/structure/closet/secure_closet/security/cargo,
/obj/machinery/airalarm/directional/north,
/obj/effect/turf_decal/bot_white,
/turf/open/floor/iron,
/area/station/security/checkpoint/supply)
"g" = (
/obj/structure/cable,
/obj/structure/table/reinforced,
/obj/item/paper_bin{
	pixel_x = 1;
	pixel_y = 9
	},
/obj/item/pen{
	pixel_x = 1;
	pixel_y = 9
	},
/turf/open/floor/iron,
/area/station/security/checkpoint/supply)
"j" = (
/obj/structure/table/reinforced,
/obj/machinery/recharger{
	pixel_y = 4
	},
/obj/item/radio/off{
	pixel_x = -11;
	pixel_y = -3
	},
/turf/open/floor/iron,
/area/station/security/checkpoint/supply)
"r" = (
/turf/closed/wall,
/area/station/security/checkpoint/supply)
"D" = (
/obj/machinery/computer/security/mining{
	dir = 4
	},
/obj/machinery/light/directional/north,
/obj/item/radio/intercom/directional/west,
/turf/open/floor/iron,
/area/station/security/checkpoint/supply)
"E" = (
/obj/structure/closet/secure_closet/security/cargo,
/obj/effect/turf_decal/bot_white,
/turf/open/floor/iron,
/area/station/security/checkpoint/supply)
"F" = (
/obj/structure/cable,
/obj/machinery/atmospherics/pipe/smart/manifold4w/scrubbers/hidden/layer2,
/obj/effect/landmark/start/customs_agent,
/turf/open/floor/iron,
/area/station/security/checkpoint/supply)
"R" = (
/obj/machinery/camera/directional/south{
	c_tag = "Security Post - Cargo"
	},
/obj/structure/filingcabinet,
/obj/effect/turf_decal/bot_white,
/turf/open/floor/iron,
/area/station/security/checkpoint/supply)
"S" = (
/obj/structure/chair/office,
/obj/machinery/requests_console/directional/north{
	department = "Security";
	departmentType = 3;
	name = "Security Requests Console"
	},
/obj/effect/landmark/start/customs_agent,
/turf/open/floor/iron,
/area/station/security/checkpoint/supply)
"V" = (
/obj/machinery/door/firedoor,
/obj/machinery/atmospherics/pipe/smart/manifold4w/supply/hidden/layer4,
/obj/machinery/atmospherics/pipe/smart/manifold4w/scrubbers/hidden/layer2,
/obj/effect/mapping_helpers/airlock/access/all/supply/customs,
/obj/machinery/door/airlock/mining/glass{
	name = "Customs Agent Office"
	},
/turf/open/floor/iron,
/area/station/security/checkpoint/supply)
"Z" = (
/obj/structure/cable,
/obj/machinery/atmospherics/components/unary/vent_scrubber/on/layer2{
	dir = 4
	},
/obj/effect/landmark/start/customs_agent,
/turf/open/floor/iron,
/area/station/security/checkpoint/supply)

(1,1,1) = {"
D
g
a
a
"}
(2,1,1) = {"
S
Z
j
a
"}
(3,1,1) = {"
E
F
R
r
"}
(4,1,1) = {"
e
b
c
V
"}
