//MAP CONVERTED BY dmm2tgm.py THIS HEADER COMMENT PREVENTS RECONVERSION, DO NOT REMOVE
"a" = (
/obj/machinery/power/apc/auto_name/directional/south,
/obj/structure/cable,
/obj/machinery/atmospherics/pipe/smart/manifold4w/supply/hidden/layer4,
/obj/machinery/atmospherics/pipe/smart/manifold4w/scrubbers/hidden/layer2,
/turf/open/floor/iron,
/area/station/security/spacepod_hangar)
"c" = (
/obj/machinery/light/directional/west,
/turf/open/floor/engine,
/area/station/security/spacepod_hangar)
"d" = (
/obj/machinery/light/directional/east,
/turf/open/floor/engine,
/area/station/security/spacepod_hangar)
"f" = (
/obj/structure/table,
/obj/item/storage/box/hug{
	pixel_x = 4;
	pixel_y = 3
	},
/obj/item/razor{
	pixel_x = -8;
	pixel_y = 3
	},
/turf/open/floor/iron,
/area/station/security/execution/transfer)
"g" = (
/obj/machinery/door/poddoor/multi_tile/three_tile_hor,
/obj/structure/fans/tiny/forcefield,
/turf/open/floor/plating,
/area/station/security/spacepod_hangar)
"h" = (
/obj/effect/spawner/structure/window/reinforced,
/obj/structure/cable,
/turf/open/floor/plating,
/area/station/security/spacepod_hangar)
"j" = (
/obj/machinery/light/small/directional/north,
/obj/structure/sign/warning/vacuum/external/directional/north,
/obj/structure/cable,
/obj/machinery/atmospherics/pipe/smart/manifold4w/supply/hidden/layer4,
/obj/machinery/atmospherics/pipe/smart/manifold4w/scrubbers/hidden/layer2,
/turf/open/floor/iron,
/area/station/security/spacepod_hangar)
"k" = (
/obj/structure/extinguisher_cabinet/directional/south,
/turf/open/floor/iron,
/area/station/security/spacepod_hangar)
"l" = (
/obj/effect/landmark/start/spacepod_pilot,
/turf/open/floor/iron,
/area/station/security/spacepod_hangar)
"m" = (
/obj/structure/table,
/obj/item/storage/toolbox/mechanical,
/obj/machinery/light/directional/east,
/obj/item/weldingtool/largetank,
/turf/open/floor/iron,
/area/station/security/spacepod_hangar)
"o" = (
/obj/structure/closet/secure_closet/security/sec,
/obj/item/clothing/ears/earmuffs,
/obj/item/clothing/glasses/sunglasses/big,
/obj/machinery/light/directional/west,
/obj/item/clothing/head/spacepod_pilot,
/obj/item/clothing/under/rank/spacepod_pilot,
/turf/open/floor/iron,
/area/station/security/spacepod_hangar)
"r" = (
/turf/closed/wall/r_wall,
/area/station/security/spacepod_hangar)
"t" = (
/turf/open/floor/iron,
/area/station/security/spacepod_hangar)
"u" = (
/obj/structure/cable,
/obj/machinery/atmospherics/pipe/smart/manifold4w/supply/hidden/layer4,
/obj/machinery/atmospherics/pipe/smart/manifold4w/scrubbers/hidden/layer2,
/turf/open/floor/iron,
/area/station/security/spacepod_hangar)
"w" = (
/obj/machinery/door/airlock/security/glass{
	name = "Spacepod Hangar"
	},
/obj/effect/mapping_helpers/airlock/access/any/security/spacepod_pilot,
/obj/structure/cable,
/obj/machinery/atmospherics/pipe/smart/manifold4w/supply/hidden/layer4,
/obj/machinery/atmospherics/pipe/smart/manifold4w/scrubbers/hidden/layer2,
/turf/open/floor/iron,
/area/station/security/spacepod_hangar)
"x" = (
/obj/structure/lattice/catwalk,
/obj/structure/marker_beacon/burgundy,
/turf/open/space/basic,
/area/space/nearstation)
"y" = (
/obj/machinery/atmospherics/components/unary/vent_scrubber/on/layer2{
	dir = 8
	},
/obj/machinery/airalarm/directional/south,
/turf/open/floor/iron,
/area/station/security/spacepod_hangar)
"C" = (
/obj/machinery/atmospherics/components/unary/vent_pump/on/layer4,
/turf/open/floor/iron,
/area/station/security/spacepod_hangar)
"D" = (
/turf/open/floor/engine,
/area/station/security/spacepod_hangar)
"G" = (
/obj/effect/turf_decal/stripes/line{
	dir = 1
	},
/obj/structure/railing{
	dir = 1
	},
/obj/structure/table,
/turf/open/floor/iron,
/area/station/security/spacepod_hangar)
"H" = (
/obj/spacepod/prebuilt/sec/roundstart,
/turf/open/floor/engine,
/area/station/security/spacepod_hangar)
"I" = (
/turf/closed/wall,
/area/station/security/spacepod_hangar)
"K" = (
/obj/item/clothing/suit/jacket/straight_jacket,
/obj/item/electropack,
/obj/structure/table,
/obj/structure/cable,
/turf/open/floor/iron,
/area/station/security/execution/transfer)
"M" = (
/obj/structure/table,
/obj/item/spacepod_equipment/weaponry/disabler,
/obj/item/spacepod_equipment/thruster,
/obj/item/spacepod_equipment/lights/security,
/turf/open/floor/iron,
/area/station/security/spacepod_hangar)
"N" = (
/turf/open/space/basic,
/area/space)
"O" = (
/obj/effect/turf_decal/stripes/line{
	dir = 1
	},
/turf/open/floor/iron,
/area/station/security/spacepod_hangar)
"R" = (
/turf/closed/wall/r_wall,
/area/station/security/execution/transfer)
"S" = (
/obj/structure/lattice,
/turf/open/space/basic,
/area/space/nearstation)
"X" = (
/obj/structure/fans/tiny/forcefield,
/turf/open/floor/plating,
/area/station/security/spacepod_hangar)
"Z" = (
/obj/effect/turf_decal/stripes/line{
	dir = 1
	},
/obj/structure/railing{
	dir = 1
	},
/obj/machinery/suit_storage_unit/security,
/turf/open/floor/iron,
/area/station/security/spacepod_hangar)

(1,1,1) = {"
R
R
R
R
R
K
f
I
w
I
"}
(2,1,1) = {"
N
N
r
r
r
h
h
r
j
I
"}
(3,1,1) = {"
x
S
r
c
D
D
Z
o
u
r
"}
(4,1,1) = {"
N
N
g
D
D
D
O
C
a
r
"}
(5,1,1) = {"
N
N
X
D
H
D
O
l
y
r
"}
(6,1,1) = {"
N
N
X
D
D
D
O
t
k
r
"}
(7,1,1) = {"
x
S
r
d
D
D
G
m
M
r
"}
(8,1,1) = {"
N
N
r
r
r
r
r
r
r
r
"}
