//MAP CONVERTED BY dmm2tgm.py THIS HEADER COMMENT PREVENTS RECONVERSION, DO NOT REMOVE
"ad" = (
/obj/structure/table,
/obj/item/radio{
	frequency = 1455;
	name = "Operator radio"
	},
/obj/machinery/airalarm/directional/north,
/turf/open/floor/iron/large,
/area/station/service/tv_studio)
"aH" = (
/obj/effect/spawner/structure/window/reinforced,
/obj/machinery/door/poddoor/shutters/preopen{
	name = "Record Shutters";
	id = "Record Shutters"
	},
/turf/open/floor/plating,
/area/station/service/tv_studio)
"aN" = (
/obj/machinery/firealarm/directional/west,
/obj/machinery/light/directional/west,
/turf/open/floor/iron/large,
/area/station/service/tv_studio)
"br" = (
/turf/open/floor/iron/large,
/area/station/service/tv_studio)
"dc" = (
/obj/structure/chair/comfy/lime,
/obj/machinery/light/directional/north,
/turf/open/floor/iron/large,
/area/station/service/tv_studio)
"dy" = (
/obj/structure/sign/poster/random/directional/east{
	pixel_y = 32
	},
/turf/open/floor/plating,
/area/station/maintenance/aft/lesser)
"eh" = (
/obj/machinery/atmospherics/pipe/smart/manifold4w/supply/hidden/layer4,
/obj/machinery/atmospherics/pipe/smart/manifold4w/scrubbers/hidden/layer2,
/obj/structure/cable,
/obj/effect/turf_decal/siding/wood{
	dir = 6
	},
/turf/open/floor/wood,
/area/station/service/tv_studio)
"ew" = (
/obj/machinery/vending/clothing,
/obj/machinery/light/directional/north,
/obj/effect/turf_decal/siding/wood{
	dir = 1
	},
/turf/open/floor/wood,
/area/station/service/tv_studio)
"eB" = (
/obj/machinery/atmospherics/pipe/smart/manifold4w/scrubbers/hidden/layer2,
/obj/machinery/atmospherics/pipe/smart/manifold4w/supply/hidden/layer4,
/obj/structure/cable,
/obj/effect/turf_decal/siding/wood{
	dir = 10
	},
/turf/open/floor/wood,
/area/station/service/tv_studio)
"fh" = (
/obj/machinery/door/airlock{
	name = "TV and Radio Studio"
	},
/obj/effect/mapping_helpers/airlock/access/all/service/library,
/obj/machinery/door/firedoor,
/turf/open/floor/wood,
/area/station/hallway/secondary/exit/departure_lounge)
"fF" = (
/obj/machinery/atmospherics/pipe/smart/manifold4w/scrubbers/hidden/layer2,
/turf/open/floor/iron/large,
/area/station/service/tv_studio)
"fY" = (
/obj/effect/mapping_helpers/burnt_floor,
/turf/open/floor/plating,
/area/station/maintenance/aft/lesser)
"iw" = (
/obj/structure/table,
/obj/item/circuitboard/computer/wooden_tv,
/obj/item/circuitboard/computer/wooden_tv,
/obj/item/circuitboard/computer/wooden_tv,
/turf/open/floor/iron/large,
/area/station/service/tv_studio)
"iX" = (
/obj/machinery/airalarm/directional/north,
/turf/open/floor/iron/large,
/area/station/service/tv_studio)
"jy" = (
/obj/machinery/firealarm/directional/south,
/obj/structure/cable,
/obj/machinery/atmospherics/pipe/smart/manifold4w/supply/hidden/layer4,
/obj/effect/turf_decal/tile/red/anticorner/contrasted{
	dir = 8
	},
/obj/machinery/atmospherics/pipe/smart/manifold4w/scrubbers/hidden/layer2,
/turf/open/floor/iron,
/area/station/hallway/secondary/exit/departure_lounge)
"jK" = (
/obj/structure/table/wood,
/obj/item/radio/intercom/tv,
/turf/open/floor/wood,
/area/station/service/tv_studio)
"jX" = (
/obj/machinery/atmospherics/pipe/smart/manifold4w/scrubbers/hidden/layer2,
/obj/machinery/atmospherics/pipe/smart/manifold4w/supply/hidden/layer4,
/obj/structure/chair/sofa/corp/corner{
	dir = 4
	},
/obj/structure/cable,
/obj/effect/turf_decal/siding/wood{
	dir = 9
	},
/obj/effect/decal/cleanable/dirt,
/turf/open/floor/wood,
/area/station/service/tv_studio)
"kl" = (
/obj/effect/spawner/random/trash/garbage,
/turf/open/floor/plating,
/area/station/maintenance/aft/lesser)
"kI" = (
/obj/effect/landmark/event_spawn,
/turf/open/floor/plating,
/area/station/maintenance/aft/lesser)
"kY" = (
/obj/machinery/atmospherics/pipe/smart/manifold4w/scrubbers/hidden/layer2,
/obj/machinery/atmospherics/pipe/smart/manifold4w/supply/hidden/layer4,
/obj/structure/chair/sofa/corp/right{
	dir = 4
	},
/obj/structure/cable,
/obj/effect/turf_decal/siding/wood{
	dir = 8
	},
/turf/open/floor/wood,
/area/station/service/tv_studio)
"lj" = (
/obj/machinery/atmospherics/pipe/smart/manifold4w/supply/hidden/layer4,
/obj/machinery/atmospherics/components/unary/vent_scrubber/on/layer2,
/obj/effect/decal/cleanable/dirt,
/turf/open/floor/iron/large,
/area/station/service/tv_studio)
"lA" = (
/obj/structure/chair/sofa/corp/left,
/obj/effect/turf_decal/siding/wood{
	dir = 1
	},
/turf/open/floor/wood,
/area/station/service/tv_studio)
"lM" = (
/obj/effect/decal/cleanable/dirt,
/turf/open/floor/iron/large,
/area/station/service/tv_studio)
"mo" = (
/obj/machinery/light/small/directional/west,
/turf/open/floor/plating,
/area/station/maintenance/aft/lesser)
"mS" = (
/obj/effect/mapping_helpers/airlock/cyclelink_helper{
	dir = 4
	},
/obj/effect/mapping_helpers/airlock/access/all/engineering/external,
/obj/machinery/door/airlock/external,
/turf/open/floor/plating,
/area/station/maintenance/aft/lesser)
"nb" = (
/obj/effect/turf_decal/stripes/line{
	dir = 8
	},
/turf/open/floor/iron/checker,
/area/station/maintenance/aft/lesser)
"nA" = (
/obj/structure/table,
/obj/machinery/button/door{
	pixel_x = -6;
	id = "TV Show Shutters";
	name = "TV Show Shutters"
	},
/obj/machinery/button/door{
	name = "Record Shutters";
	id = "Record Shutters";
	pixel_x = 6
	},
/obj/effect/decal/cleanable/dirt,
/turf/open/floor/iron/large,
/area/station/service/tv_studio)
"nI" = (
/obj/machinery/atmospherics/pipe/smart/manifold4w/scrubbers/hidden/layer2,
/obj/machinery/atmospherics/pipe/smart/manifold4w/supply/hidden/layer4,
/obj/structure/cable,
/obj/effect/turf_decal/siding/wood{
	dir = 8
	},
/turf/open/floor/wood,
/area/station/service/tv_studio)
"nP" = (
/obj/machinery/atmospherics/pipe/smart/manifold4w/scrubbers/hidden/layer2,
/obj/machinery/atmospherics/pipe/smart/manifold4w/supply/hidden/layer4,
/obj/structure/cable,
/turf/closed/wall,
/area/station/hallway/secondary/exit/departure_lounge)
"nT" = (
/obj/structure/chair/sofa/corp,
/obj/machinery/airalarm/directional/north,
/obj/effect/turf_decal/siding/wood{
	dir = 1
	},
/turf/open/floor/wood,
/area/station/service/tv_studio)
"qv" = (
/turf/open/floor/plating,
/area/station/maintenance/aft/lesser)
"qS" = (
/turf/closed/wall/r_wall,
/area/station/maintenance/aft/lesser)
"sE" = (
/obj/machinery/atmospherics/pipe/smart/manifold4w/supply/hidden/layer4,
/obj/machinery/atmospherics/pipe/smart/manifold4w/scrubbers/hidden/layer2,
/obj/machinery/door/airlock{
	name = "TV Show Room"
	},
/obj/effect/mapping_helpers/airlock/access/all/service/library,
/obj/machinery/door/firedoor,
/turf/open/floor/iron/large,
/area/station/service/tv_studio)
"sJ" = (
/obj/machinery/atmospherics/components/unary/vent_pump/on/layer4{
	dir = 8
	},
/obj/effect/decal/cleanable/dirt,
/turf/open/floor/wood,
/area/station/service/tv_studio)
"sM" = (
/obj/machinery/vending/autodrobe,
/obj/effect/turf_decal/siding/wood{
	dir = 5
	},
/turf/open/floor/wood,
/area/station/service/tv_studio)
"uB" = (
/obj/machinery/atmospherics/pipe/smart/manifold4w/supply/hidden/layer4,
/obj/machinery/atmospherics/pipe/smart/manifold4w/scrubbers/hidden/layer2,
/obj/structure/cable,
/obj/effect/turf_decal/siding/wood,
/turf/open/floor/wood,
/area/station/service/tv_studio)
"uN" = (
/obj/effect/turf_decal/stripes/line{
	dir = 4
	},
/turf/open/floor/plating,
/area/station/maintenance/aft/lesser)
"uR" = (
/obj/machinery/atmospherics/components/unary/vent_scrubber/on/layer2{
	dir = 8
	},
/turf/open/floor/iron/large,
/area/station/service/tv_studio)
"ve" = (
/obj/effect/spawner/structure/window/reinforced,
/turf/open/floor/plating,
/area/station/hallway/secondary/exit/departure_lounge)
"vi" = (
/obj/machinery/atmospherics/pipe/smart/manifold4w/supply/hidden/layer4,
/obj/machinery/atmospherics/pipe/smart/manifold4w/scrubbers/hidden/layer2,
/obj/structure/cable,
/obj/machinery/light/directional/south,
/obj/effect/turf_decal/siding/wood,
/turf/open/floor/wood,
/area/station/service/tv_studio)
"wh" = (
/obj/machinery/atmospherics/pipe/smart/manifold4w/scrubbers/hidden/layer2,
/obj/machinery/atmospherics/components/unary/vent_pump/on/layer4{
	dir = 8
	},
/obj/effect/decal/cleanable/dirt,
/turf/open/floor/iron/large,
/area/station/service/tv_studio)
"ww" = (
/turf/open/floor/wood,
/area/station/service/tv_studio)
"wL" = (
/obj/effect/turf_decal/siding/wood{
	dir = 4
	},
/turf/open/floor/wood,
/area/station/service/tv_studio)
"xC" = (
/obj/structure/table,
/obj/machinery/newscaster/directional/east,
/obj/machinery/camera/directional/south{
	c_tag = "Departure Lounge - Security Post"
	},
/obj/item/book/manual/wiki/security_space_law{
	pixel_x = -4;
	pixel_y = 4
	},
/obj/item/taperecorder{
	pixel_x = 4
	},
/obj/item/radio/intercom/directional/south,
/obj/effect/turf_decal/tile/red/anticorner/contrasted,
/turf/open/floor/iron,
/area/station/hallway/secondary/exit/departure_lounge)
"zE" = (
/obj/structure/table/glass,
/obj/item/modular_computer/laptop,
/turf/open/floor/iron/large,
/area/station/service/tv_studio)
"zU" = (
/obj/machinery/atmospherics/components/unary/vent_scrubber/on/layer2{
	dir = 8
	},
/obj/effect/decal/cleanable/dirt,
/turf/open/floor/wood,
/area/station/service/tv_studio)
"zZ" = (
/obj/machinery/door/poddoor/shutters/preopen{
	id = "ordnancebridge";
	dir = 4
	},
/obj/machinery/button/door{
	id = "ordnancebridge";
	pixel_y = 24;
	req_one_access_txt = list("maint_tunnels","science")
	},
/obj/effect/turf_decal/caution/stand_clear{
	dir = 4
	},
/turf/open/floor/plating,
/area/station/maintenance/aft/lesser)
"AJ" = (
/obj/structure/table/wood,
/obj/item/radio/intercom/tv,
/obj/effect/decal/cleanable/dirt,
/turf/open/floor/wood,
/area/station/service/tv_studio)
"CB" = (
/obj/structure/table/wood,
/obj/item/radio/intercom/tv,
/obj/effect/turf_decal/siding/wood{
	dir = 4
	},
/turf/open/floor/wood,
/area/station/service/tv_studio)
"CI" = (
/obj/machinery/atmospherics/components/unary/vent_pump/on/layer4,
/obj/machinery/newscaster/directional/north,
/obj/effect/decal/cleanable/dirt,
/turf/open/floor/iron/large,
/area/station/service/tv_studio)
"Dn" = (
/obj/structure/chair/office{
	dir = 1
	},
/obj/effect/decal/cleanable/dirt,
/turf/open/floor/wood,
/area/station/service/tv_studio)
"Em" = (
/turf/closed/wall,
/area/station/hallway/secondary/exit/departure_lounge)
"Fk" = (
/obj/structure/chair/office{
	dir = 4
	},
/obj/machinery/atmospherics/pipe/smart/manifold4w/supply/hidden/layer4,
/turf/open/floor/iron/large,
/area/station/service/tv_studio)
"Hs" = (
/obj/structure/extinguisher_cabinet/directional/north,
/obj/effect/turf_decal/siding/wood{
	dir = 1
	},
/turf/open/floor/wood,
/area/station/service/tv_studio)
"Hu" = (
/obj/machinery/power/apc/auto_name/directional/east,
/obj/structure/cable,
/obj/effect/turf_decal/siding/wood{
	dir = 4
	},
/turf/open/floor/wood,
/area/station/service/tv_studio)
"Jx" = (
/obj/structure/table/glass,
/obj/item/folder,
/turf/open/floor/iron/large,
/area/station/service/tv_studio)
"KS" = (
/turf/closed/wall,
/area/station/maintenance/aft/lesser)
"KT" = (
/obj/machinery/atmospherics/pipe/smart/manifold4w/supply/hidden/layer4,
/obj/structure/table/glass,
/turf/open/floor/wood,
/area/station/service/tv_studio)
"Lk" = (
/obj/structure/cable,
/obj/machinery/atmospherics/pipe/smart/manifold4w/supply/hidden/layer4,
/obj/effect/turf_decal/tile/red/half/contrasted,
/obj/machinery/atmospherics/components/unary/vent_scrubber/on/layer2{
	dir = 8
	},
/turf/open/floor/iron,
/area/station/hallway/secondary/exit/departure_lounge)
"Mb" = (
/obj/machinery/light/small/directional/north,
/turf/open/floor/plating,
/area/station/maintenance/aft/lesser)
"Ms" = (
/obj/structure/table/glass,
/obj/item/radio{
	frequency = 1455;
	name = "Operator radio"
	},
/turf/open/floor/iron/large,
/area/station/service/tv_studio)
"Mt" = (
/obj/structure/lattice,
/turf/open/space/basic,
/area/space/nearstation)
"MZ" = (
/obj/machinery/atmospherics/pipe/smart/manifold4w/supply/hidden/layer4,
/obj/structure/table/glass,
/obj/item/toy/plush/beeplushie,
/turf/open/floor/wood,
/area/station/service/tv_studio)
"Nt" = (
/obj/machinery/door/firedoor,
/obj/machinery/door/airlock/security/glass{
	name = "Departure Lounge Security Post"
	},
/obj/effect/turf_decal/tile/red/fourcorners,
/obj/structure/cable,
/obj/machinery/atmospherics/pipe/smart/manifold4w/supply/hidden/layer4,
/obj/machinery/atmospherics/pipe/smart/manifold4w/scrubbers/hidden/layer2,
/turf/open/floor/iron,
/area/station/hallway/secondary/exit/departure_lounge)
"NA" = (
/obj/effect/mapping_helpers/broken_floor,
/turf/open/floor/plating/airless,
/area/space/nearstation)
"Ol" = (
/obj/structure/table,
/obj/item/device/pocket_tvcamera,
/obj/item/device/pocket_tvcamera,
/obj/item/device/pocket_tvcamera,
/turf/open/floor/iron/large,
/area/station/service/tv_studio)
"OB" = (
/obj/structure/table,
/obj/item/paper_bin{
	pixel_x = -3;
	pixel_y = 7
	},
/obj/item/pen,
/obj/effect/turf_decal/tile/red/half/contrasted,
/turf/open/floor/iron,
/area/station/hallway/secondary/exit/departure_lounge)
"PB" = (
/obj/machinery/atmospherics/pipe/smart/manifold4w/supply/hidden/layer4,
/obj/machinery/atmospherics/pipe/smart/manifold4w/scrubbers/hidden/layer2,
/obj/effect/decal/cleanable/dirt,
/turf/open/floor/iron/large,
/area/station/service/tv_studio)
"QW" = (
/obj/structure/chair/sofa/corp,
/obj/machinery/light/directional/north,
/obj/effect/turf_decal/siding/wood{
	dir = 1
	},
/turf/open/floor/wood,
/area/station/service/tv_studio)
"RC" = (
/obj/effect/spawner/structure/window/reinforced,
/turf/open/floor/plating,
/area/station/maintenance/aft/lesser)
"RT" = (
/obj/machinery/atmospherics/pipe/smart/manifold4w/supply/hidden/layer4,
/turf/open/floor/wood,
/area/station/service/tv_studio)
"RV" = (
/obj/machinery/atmospherics/pipe/smart/manifold4w/supply/hidden/layer4,
/obj/machinery/atmospherics/pipe/smart/manifold4w/scrubbers/hidden/layer2,
/turf/open/floor/iron/large,
/area/station/service/tv_studio)
"SM" = (
/obj/machinery/camera/tv_camera,
/obj/machinery/atmospherics/pipe/smart/manifold4w/scrubbers/hidden/layer2,
/turf/open/floor/iron/large,
/area/station/service/tv_studio)
"Ta" = (
/obj/effect/turf_decal/stripes/line{
	dir = 8
	},
/turf/open/floor/plating,
/area/station/maintenance/aft/lesser)
"Vg" = (
/turf/closed/wall,
/area/station/service/tv_studio)
"Vx" = (
/obj/effect/spawner/structure/window/reinforced,
/turf/open/floor/plating,
/area/station/service/tv_studio)
"VC" = (
/obj/effect/mapping_helpers/burnt_floor,
/turf/open/floor/plating/airless,
/area/space/nearstation)
"VZ" = (
/obj/effect/decal/cleanable/dirt,
/turf/open/floor/wood,
/area/station/service/tv_studio)
"Wx" = (
/obj/structure/chair/office,
/turf/open/floor/wood,
/area/station/service/tv_studio)
"Xz" = (
/obj/machinery/firealarm/directional/east,
/obj/effect/turf_decal/siding/wood{
	dir = 4
	},
/turf/open/floor/wood,
/area/station/service/tv_studio)
"YH" = (
/obj/structure/table,
/obj/machinery/firealarm/directional/west,
/obj/machinery/light/directional/west,
/obj/item/pocket_tv{
	pixel_y = 10;
	sound = 0
	},
/obj/item/pocket_tv{
	pixel_y = 6;
	sound = 0
	},
/obj/item/pocket_tv{
	pixel_y = 2;
	sound = 0
	},
/turf/open/floor/iron/large,
/area/station/service/tv_studio)
"YT" = (
/obj/structure/table,
/obj/machinery/computer/security/telescreen{
	dir = 8;
	name = "TV Record Screen";
	network = list("tv","thunder")
	},
/turf/open/floor/iron/large,
/area/station/service/tv_studio)
"ZX" = (
/obj/machinery/light/directional/east,
/turf/open/floor/iron/large,
/area/station/service/tv_studio)
"ZY" = (
/obj/effect/spawner/structure/window/reinforced,
/obj/machinery/door/poddoor/shutters/preopen{
	name = "TV Show Shutters";
	id = "TV Show Shutters"
	},
/turf/open/floor/plating,
/area/station/service/tv_studio)

(1,1,1) = {"
Nt
Em
ve
Em
fh
Em
ve
ve
Em
"}
(2,1,1) = {"
jy
nP
jX
kY
nI
nI
nI
eB
Vx
"}
(3,1,1) = {"
Lk
Em
QW
KT
ww
ww
zU
uB
Vx
"}
(4,1,1) = {"
OB
Em
nT
MZ
ww
ww
VZ
uB
Vx
"}
(5,1,1) = {"
xC
Em
lA
KT
VZ
ww
ww
vi
Vg
"}
(6,1,1) = {"
Em
Vg
Hs
RT
ww
jK
ww
uB
Vx
"}
(7,1,1) = {"
NA
Vg
ew
sJ
Wx
AJ
Dn
uB
Vx
"}
(8,1,1) = {"
VC
Vg
sM
wL
Xz
CB
Hu
eh
Vx
"}
(9,1,1) = {"
RC
RC
KS
KS
Vg
Vg
Vg
sE
Vg
"}
(10,1,1) = {"
qv
kI
dy
KS
Ol
YH
iw
PB
Vx
"}
(11,1,1) = {"
RC
KS
Mb
KS
CI
Fk
lj
RV
Vx
"}
(12,1,1) = {"
Mt
RC
kl
KS
ad
YT
nA
RV
Vx
"}
(13,1,1) = {"
Mt
RC
qv
KS
aH
aH
Vg
sE
Vg
"}
(14,1,1) = {"
Mt
RC
qv
KS
lM
br
aN
RV
ZY
"}
(15,1,1) = {"
Mt
RC
qv
KS
iX
lM
br
wh
ZY
"}
(16,1,1) = {"
Mt
RC
qv
KS
br
zE
lM
fF
ZY
"}
(17,1,1) = {"
Mt
RC
uN
KS
dc
Jx
br
SM
Vg
"}
(18,1,1) = {"
qS
qS
zZ
KS
br
Ms
br
fF
ZY
"}
(19,1,1) = {"
qv
mo
Ta
KS
lM
br
lM
uR
ZY
"}
(20,1,1) = {"
qv
fY
qv
KS
lM
lM
ZX
lM
ZY
"}
(21,1,1) = {"
nb
KS
mS
KS
Vg
Vg
Vg
Vg
Vg
"}
