//MAP CONVERTED BY dmm2tgm.py THIS HEADER COMMENT PREVENTS RECONVERSION, DO NOT REMOVE
"a" = (
/turf/closed/wall,
/area/station/security/checkpoint/science)
"b" = (
/obj/item/radio/intercom/directional/west,
/obj/structure/closet/secure_closet/security/science,
/turf/open/floor/iron/white,
/area/station/security/checkpoint/science)
"d" = (
/obj/machinery/atmospherics/pipe/smart/manifold4w/supply/hidden/layer4,
/obj/machinery/atmospherics/pipe/smart/manifold4w/scrubbers/hidden/layer2,
/obj/structure/cable,
/turf/open/floor/iron/white,
/area/station/security/checkpoint/science)
"e" = (
/obj/structure/table/reinforced,
/obj/item/folder/red,
/obj/machinery/light/directional/south,
/obj/structure/cable,
/obj/item/radio{
	pixel_x = -6;
	pixel_y = -3
	},
/turf/open/floor/iron/white,
/area/station/security/checkpoint/science)
"g" = (
/turf/open/floor/iron/white,
/area/station/security/checkpoint/science)
"i" = (
/obj/structure/chair,
/turf/open/floor/iron/white,
/area/station/security/checkpoint/science)
"k" = (
/obj/machinery/atmospherics/components/unary/vent_pump/on/layer4{
	dir = 1
	},
/obj/structure/chair/office{
	dir = 4
	},
/obj/effect/landmark/start/science_guard,
/turf/open/floor/iron/white,
/area/station/security/checkpoint/science)
"p" = (
/obj/structure/cable,
/turf/open/floor/iron/white,
/area/station/security/checkpoint/science)
"q" = (
/obj/structure/chair,
/obj/structure/cable,
/turf/open/floor/iron/white,
/area/station/security/checkpoint/science)
"t" = (
/obj/effect/landmark/start/science_guard,
/turf/open/floor/iron/white,
/area/station/security/checkpoint/science)
"w" = (
/obj/structure/rack,
/obj/machinery/light/small/directional/west,
/obj/machinery/light_switch/directional/west{
	pixel_y = -4
	},
/obj/machinery/button/door/directional/west{
	id = "rdrnd";
	name = "Research and Development Containment Control";
	pixel_y = 6;
	req_access = list("rd")
	},
/obj/item/restraints/handcuffs/cable/pink,
/turf/open/floor/iron/white,
/area/station/security/checkpoint/science)
"x" = (
/obj/structure/table/reinforced,
/obj/machinery/recharger,
/obj/structure/cable,
/obj/machinery/camera/directional/east{
	c_tag = "Security Post - Research Division";
	network = list("ss13","rd")
	},
/turf/open/floor/iron/white,
/area/station/security/checkpoint/science)
"y" = (
/obj/machinery/atmospherics/pipe/smart/manifold4w/supply/hidden/layer4,
/obj/structure/cable,
/turf/open/floor/iron/white,
/area/station/security/checkpoint/science)
"z" = (
/obj/machinery/atmospherics/pipe/smart/manifold4w/supply/hidden/layer4,
/obj/machinery/atmospherics/pipe/smart/manifold4w/scrubbers/hidden/layer2,
/obj/structure/cable,
/obj/effect/landmark/start/science_guard,
/turf/open/floor/iron/white,
/area/station/security/checkpoint/science)
"I" = (
/obj/structure/cable,
/obj/structure/closet/secure_closet/security/science,
/turf/open/floor/iron/white,
/area/station/security/checkpoint/science)
"J" = (
/obj/machinery/door/firedoor,
/obj/machinery/atmospherics/pipe/smart/manifold4w/supply/hidden/layer4,
/obj/machinery/atmospherics/pipe/smart/manifold4w/scrubbers/hidden/layer2,
/obj/structure/cable,
/obj/effect/mapping_helpers/airlock/access/all/science/sci_guard,
/obj/machinery/door/airlock/research/glass{
	name = "Science Guard Post"
	},
/turf/open/floor/iron,
/area/station/security/checkpoint/science)
"K" = (
/obj/machinery/firealarm/directional/east,
/turf/open/floor/iron/white,
/area/station/security/checkpoint/science)
"N" = (
/obj/effect/spawner/structure/window/reinforced,
/obj/structure/cable,
/turf/open/floor/plating,
/area/station/security/checkpoint/science)
"O" = (
/obj/machinery/computer/mecha{
	dir = 8
	},
/turf/open/floor/iron/white,
/area/station/security/checkpoint/science)
"Q" = (
/obj/machinery/computer/security{
	dir = 8
	},
/turf/open/floor/iron/white,
/area/station/security/checkpoint/science)
"U" = (
/obj/item/kirbyplants/random,
/obj/machinery/power/apc/auto_name/directional/north,
/obj/machinery/light/small/directional/east,
/obj/structure/cable,
/obj/machinery/airalarm/directional/east,
/turf/open/floor/iron/white,
/area/station/security/checkpoint/science)
"X" = (
/obj/machinery/atmospherics/components/unary/vent_scrubber/on/layer2{
	dir = 1
	},
/obj/structure/cable,
/turf/open/floor/iron/white,
/area/station/security/checkpoint/science)

(1,1,1) = {"
a
J
N
N
a
"}
(2,1,1) = {"
w
d
t
g
b
"}
(3,1,1) = {"
i
z
X
p
I
"}
(4,1,1) = {"
q
y
k
t
e
"}
(5,1,1) = {"
U
K
Q
O
x
"}
