//MAP CONVERTED BY dmm2tgm.py THIS HEADER COMMENT PREVENTS RECONVERSION, DO NOT REMOVE
"a" = (
/turf/open/floor/engine,
/area/station/security/spacepod_hangar)
"b" = (
/obj/effect/turf_decal/stripes/line{
	dir = 1
	},
/turf/open/floor/iron,
/area/station/security/spacepod_hangar)
"c" = (
/obj/structure/railing{
	dir = 8
	},
/turf/open/space/basic,
/area/space)
"d" = (
/obj/machinery/atmospherics/components/unary/vent_scrubber/on/layer2{
	dir = 8
	},
/obj/machinery/airalarm/directional/south,
/turf/open/floor/iron,
/area/station/security/spacepod_hangar)
"e" = (
/obj/spacepod/prebuilt/sec,
/turf/open/floor/engine,
/area/station/security/spacepod_hangar)
"f" = (
/obj/effect/turf_decal/stripes/line{
	dir = 1
	},
/obj/structure/railing{
	dir = 1
	},
/obj/structure/closet/secure_closet/security/sec,
/obj/item/clothing/ears/earmuffs,
/obj/item/clothing/glasses/sunglasses/big,
/obj/machinery/light/directional/west,
/obj/item/clothing/head/spacepod_pilot,
/obj/item/clothing/under/rank/spacepod_pilot,
/turf/open/floor/iron,
/area/station/security/spacepod_hangar)
"h" = (
/obj/effect/spawner/structure/window/reinforced,
/obj/structure/cable,
/turf/open/floor/plating,
/area/station/security/spacepod_hangar)
"i" = (
/turf/closed/wall/r_wall,
/area/station/security/spacepod_hangar)
"k" = (
/turf/closed/wall,
/area/station/security/spacepod_hangar)
"m" = (
/obj/structure/fans/tiny/forcefield,
/turf/open/floor/plating,
/area/station/security/spacepod_hangar)
"n" = (
/obj/machinery/door/airlock/security/glass{
	name = "Prison Wing"
	},
/obj/effect/mapping_helpers/airlock/access/any/security/spacepod_pilot,
/obj/structure/cable,
/obj/machinery/atmospherics/pipe/smart/manifold4w/supply/hidden/layer4,
/obj/machinery/atmospherics/pipe/smart/manifold4w/scrubbers/hidden/layer2,
/turf/open/floor/iron,
/area/station/security/spacepod_hangar)
"q" = (
/obj/machinery/light/directional/east,
/turf/open/floor/engine,
/area/station/security/spacepod_hangar)
"s" = (
/obj/effect/turf_decal/stripes/line{
	dir = 1
	},
/obj/structure/railing{
	dir = 1
	},
/obj/structure/table,
/obj/item/storage/toolbox/mechanical,
/obj/machinery/light/directional/east,
/obj/item/weldingtool/largetank,
/turf/open/floor/iron,
/area/station/security/spacepod_hangar)
"u" = (
/obj/structure/lattice,
/turf/open/space/basic,
/area/space/nearstation)
"x" = (
/obj/structure/extinguisher_cabinet/directional/south,
/turf/open/floor/iron,
/area/station/security/spacepod_hangar)
"z" = (
/obj/effect/turf_decal/stripes/line{
	dir = 1
	},
/obj/machinery/atmospherics/components/unary/vent_pump/on/layer4,
/turf/open/floor/iron,
/area/station/security/spacepod_hangar)
"B" = (
/obj/structure/lattice/catwalk,
/obj/structure/marker_beacon/burgundy,
/turf/open/space/basic,
/area/space/nearstation)
"E" = (
/obj/machinery/power/apc/auto_name/directional/south,
/obj/structure/cable,
/obj/machinery/atmospherics/pipe/smart/manifold4w/supply/hidden/layer4,
/obj/machinery/atmospherics/pipe/smart/manifold4w/scrubbers/hidden/layer2,
/turf/open/floor/iron,
/area/station/security/spacepod_hangar)
"I" = (
/obj/machinery/light/small/directional/north,
/obj/structure/sign/warning/vacuum/external/directional/north,
/obj/structure/cable,
/obj/machinery/atmospherics/pipe/smart/manifold4w/supply/hidden/layer4,
/obj/machinery/atmospherics/pipe/smart/manifold4w/scrubbers/hidden/layer2,
/turf/open/floor/iron,
/area/station/security/spacepod_hangar)
"K" = (
/obj/machinery/light/directional/west,
/turf/open/floor/engine,
/area/station/security/spacepod_hangar)
"L" = (
/turf/open/space/basic,
/area/space)
"M" = (
/obj/machinery/door/poddoor/multi_tile/three_tile_hor,
/obj/structure/fans/tiny/forcefield,
/turf/open/floor/plating,
/area/station/security/spacepod_hangar)
"R" = (
/obj/effect/turf_decal/stripes/line{
	dir = 1
	},
/obj/effect/landmark/start/spacepod_pilot,
/turf/open/floor/iron,
/area/station/security/spacepod_hangar)
"S" = (
/turf/open/floor/iron,
/area/station/security/execution/transfer)
"U" = (
/turf/closed/wall/r_wall,
/area/station/security/execution/transfer)
"W" = (
/obj/structure/cable,
/turf/open/floor/iron,
/area/station/security/execution/transfer)
"X" = (
/obj/structure/cable,
/obj/machinery/atmospherics/pipe/smart/manifold4w/supply/hidden/layer4,
/obj/machinery/atmospherics/pipe/smart/manifold4w/scrubbers/hidden/layer2,
/turf/open/floor/iron,
/area/station/security/spacepod_hangar)
"Y" = (
/obj/structure/table,
/obj/item/spacepod_equipment/weaponry/disabler,
/obj/item/spacepod_equipment/thruster,
/turf/open/floor/iron,
/area/station/security/spacepod_hangar)

(1,1,1) = {"
U
U
U
U
U
W
S
k
n
k
"}
(2,1,1) = {"
L
L
c
i
i
h
h
i
I
k
"}
(3,1,1) = {"
B
u
u
i
K
a
a
f
X
i
"}
(4,1,1) = {"
L
L
L
M
a
a
a
z
E
i
"}
(5,1,1) = {"
L
L
L
m
a
e
a
R
d
i
"}
(6,1,1) = {"
L
L
L
m
a
a
a
b
x
i
"}
(7,1,1) = {"
B
u
u
i
q
a
a
s
Y
i
"}
(8,1,1) = {"
L
L
L
i
i
i
i
i
i
i
"}
