//MAP CONVERTED BY dmm2tgm.py THIS HEADER COMMENT PREVENTS RECONVERSION, DO NOT REMOVE
"a" = (
/turf/template_noop,
/area/template_noop)
"c" = (
/obj/structure/girder,
/turf/open/floor/plating/rust/lowpressure,
/area/ruin/unpowered)
"d" = (
/obj/machinery/door/poddoor/shutters/preopen,
/obj/effect/turf_decal/sand/plating,
/turf/open/floor/plating/rust/lowpressure,
/area/ruin/unpowered)
"g" = (
/obj/structure/rack/shelf,
/obj/item/storage/toolbox/mechanical/old,
/obj/effect/turf_decal/sand/plating,
/turf/open/floor/iron/white{
	initial_gas_mix = "o2=14;n2=30;TEMP=293.15"
	},
/area/ruin/unpowered)
"h" = (
/obj/effect/turf_decal/trimline/yellow/warning{
	dir = 8
	},
/obj/effect/turf_decal/sand/plating,
/turf/open/floor/iron/dark/smooth_large/lowpressure,
/area/ruin/unpowered)
"i" = (
/turf/closed/wall/rust,
/area/ruin/unpowered)
"j" = (
/turf/open/misc/asteroid/lowpressure,
/area/ruin/unpowered)
"k" = (
/obj/structure/girder,
/obj/effect/turf_decal/sand/plating,
/turf/open/floor/plating/rust/lowpressure,
/area/ruin/unpowered)
"l" = (
/obj/effect/spawner/random/trash/mess,
/obj/effect/turf_decal/sand/plating,
/turf/open/floor/iron/white{
	initial_gas_mix = "o2=14;n2=30;TEMP=293.15"
	},
/area/ruin/unpowered)
"n" = (
/obj/item/rack_parts,
/obj/effect/turf_decal/sand/plating,
/turf/open/floor/plating/rust/lowpressure,
/area/ruin/unpowered)
"o" = (
/obj/structure/rack/shelf,
/turf/open/floor/plating/rust/lowpressure,
/area/ruin/unpowered)
"q" = (
/turf/open/floor/iron/white{
	initial_gas_mix = "o2=14;n2=30;TEMP=293.15"
	},
/area/ruin/unpowered)
"s" = (
/obj/machinery/door/airlock/public/glass,
/obj/effect/turf_decal/sand/plating,
/turf/open/floor/iron/white{
	initial_gas_mix = "o2=14;n2=30;TEMP=293.15"
	},
/area/ruin/unpowered)
"t" = (
/obj/structure/table_frame,
/obj/effect/turf_decal/sand/plating,
/turf/open/floor/plating/rust/lowpressure,
/area/ruin/unpowered)
"v" = (
/obj/effect/turf_decal/trimline/yellow/warning{
	dir = 4
	},
/obj/effect/turf_decal/sand/plating,
/turf/open/floor/plating/lowpressure,
/area/ruin/unpowered)
"w" = (
/obj/effect/turf_decal/sand/plating,
/obj/effect/decal/cleanable/cobweb/cobweb2,
/turf/open/floor/plating/rust/lowpressure,
/area/ruin/unpowered)
"y" = (
/turf/open/floor/plating/rust/lowpressure,
/area/ruin/unpowered)
"z" = (
/obj/effect/turf_decal/trimline/yellow/line{
	dir = 4
	},
/obj/effect/turf_decal/sand/plating,
/turf/open/floor/iron/dark/smooth_large/lowpressure,
/area/ruin/unpowered)
"B" = (
/obj/structure/light_construct/directional/west,
/obj/effect/turf_decal/sand/plating,
/turf/open/floor/iron/white{
	initial_gas_mix = "o2=14;n2=30;TEMP=293.15"
	},
/area/ruin/unpowered)
"C" = (
/obj/structure/flora/bush/pale,
/turf/open/misc/asteroid/lowpressure,
/area/ruin/unpowered)
"E" = (
/obj/effect/turf_decal/sand/plating,
/turf/open/floor/iron/dark/smooth_large/lowpressure,
/area/ruin/unpowered)
"F" = (
/obj/effect/turf_decal/sand/plating,
/turf/open/floor/iron/white{
	initial_gas_mix = "o2=14;n2=30;TEMP=293.15"
	},
/area/ruin/unpowered)
"H" = (
/obj/machinery/door/poddoor/shutters/preopen,
/obj/effect/turf_decal/sand/plating,
/turf/open/floor/engine{
	initial_gas_mix = "o2=14;n2=30;TEMP=293.15"
	},
/area/ruin/unpowered)
"J" = (
/obj/effect/turf_decal/trimline/yellow/line{
	dir = 4
	},
/obj/effect/turf_decal/sand/plating,
/turf/open/floor/plating/lowpressure,
/area/ruin/unpowered)
"L" = (
/obj/structure/flippedtable,
/obj/structure/frame/computer{
	dir = 1
	},
/obj/item/coin/iron,
/obj/item/coin/iron,
/obj/effect/spawner/random/entertainment/money_large,
/obj/effect/turf_decal/sand/plating,
/turf/open/floor/plating/rust/lowpressure,
/area/ruin/unpowered)
"M" = (
/obj/effect/turf_decal/sand/plating,
/turf/open/floor/iron/large/lowpressure,
/area/ruin/unpowered)
"O" = (
/obj/effect/turf_decal/sand/plating,
/turf/open/floor/plating/rust/lowpressure,
/area/ruin/unpowered)
"P" = (
/obj/effect/turf_decal/sand/plating,
/turf/open/floor/engine{
	initial_gas_mix = "o2=14;n2=30;TEMP=293.15"
	},
/area/ruin/unpowered)
"Q" = (
/obj/structure/frame/computer,
/obj/effect/turf_decal/sand/plating,
/turf/open/floor/iron/large/lowpressure,
/area/ruin/unpowered)
"R" = (
/obj/machinery/light/built/directional/west,
/turf/open/floor/engine{
	initial_gas_mix = "o2=14;n2=30;TEMP=293.15"
	},
/area/ruin/unpowered)
"T" = (
/obj/effect/turf_decal/sand/plating,
/turf/open/floor/plating/lowpressure,
/area/ruin/unpowered)
"U" = (
/obj/effect/spawner/random/trash/mess,
/turf/open/floor/plating/rust/lowpressure,
/area/ruin/unpowered)
"V" = (
/obj/structure/frame/machine,
/obj/effect/turf_decal/sand/plating,
/turf/open/floor/iron/large/lowpressure,
/area/ruin/unpowered)
"W" = (
/obj/effect/turf_decal/trimline/yellow/line{
	dir = 8
	},
/obj/effect/turf_decal/sand/plating,
/turf/open/floor/iron/dark/smooth_large/lowpressure,
/area/ruin/unpowered)
"Y" = (
/obj/effect/turf_decal/trimline/yellow/warning{
	dir = 4
	},
/obj/effect/turf_decal/sand/plating,
/turf/open/floor/iron/dark/smooth_large/lowpressure,
/area/ruin/unpowered)
"Z" = (
/obj/structure/grille,
/obj/effect/turf_decal/sand/plating,
/turf/open/floor/plating/rust/lowpressure,
/area/ruin/unpowered)

(1,1,1) = {"
a
a
a
a
a
a
a
a
a
a
a
a
a
a
a
a
a
a
"}
(2,1,1) = {"
a
i
E
a
a
E
i
k
i
i
k
i
i
k
k
i
i
a
"}
(3,1,1) = {"
a
V
E
E
T
T
i
P
R
q
y
y
B
l
o
o
i
a
"}
(4,1,1) = {"
a
Q
T
a
a
T
k
O
P
U
i
F
t
O
O
F
k
a
"}
(5,1,1) = {"
a
a
T
E
a
E
i
O
P
g
c
w
L
O
F
n
i
a
"}
(6,1,1) = {"
a
i
E
E
E
E
i
H
d
i
i
i
Z
Z
s
i
k
a
"}
(7,1,1) = {"
a
O
M
E
E
M
M
E
E
M
M
O
M
M
C
O
j
a
"}
(8,1,1) = {"
a
a
v
E
Y
T
J
T
T
z
z
E
z
T
T
z
a
a
"}
(9,1,1) = {"
a
W
h
a
h
h
E
a
a
a
a
W
W
a
W
E
T
a
"}
(10,1,1) = {"
a
O
a
a
a
M
M
a
a
a
a
a
O
a
a
a
a
a
"}
(11,1,1) = {"
a
a
a
a
a
a
a
a
a
a
a
a
a
a
a
a
a
a
"}
