//MAP CONVERTED BY dmm2tgm.py THIS HEADER COMMENT PREVENTS RECONVERSION, DO NOT REMOVE
"a" = (
/turf/template_noop,
/area/template_noop)
"e" = (
/obj/effect/turf_decal/trimline/yellow/warning{
	dir = 4
	},
/obj/effect/turf_decal/sand/plating,
/turf/open/floor/iron/dark/smooth_large/lowpressure,
/area/ruin/unpowered)
"f" = (
/obj/effect/turf_decal/trimline/yellow/line,
/obj/effect/turf_decal/sand/plating,
/turf/open/floor/iron/dark/smooth_large/lowpressure,
/area/ruin/unpowered)
"h" = (
/obj/structure/chair/sofa/bench/left{
	dir = 8
	},
/obj/effect/turf_decal/sand/plating,
/turf/open/floor/iron/large/lowpressure,
/area/ruin/unpowered)
"k" = (
/obj/effect/turf_decal/trimline/yellow/line{
	dir = 1
	},
/obj/effect/turf_decal/sand/plating,
/turf/open/floor/plating/lowpressure,
/area/ruin/unpowered)
"n" = (
/obj/effect/turf_decal/trimline/yellow/warning{
	dir = 10
	},
/obj/effect/turf_decal/sand/plating,
/turf/open/floor/iron/dark/smooth_large/lowpressure,
/area/ruin/unpowered)
"t" = (
/obj/structure/chair/sofa/bench/right,
/obj/effect/turf_decal/sand/plating,
/turf/open/floor/iron/large/lowpressure,
/area/ruin/unpowered)
"u" = (
/obj/effect/turf_decal/trimline/yellow/line{
	dir = 1
	},
/obj/effect/turf_decal/sand/plating,
/turf/open/floor/iron/dark/smooth_large/lowpressure,
/area/ruin/unpowered)
"x" = (
/obj/effect/turf_decal/trimline/yellow/line,
/obj/effect/turf_decal/sand/plating,
/turf/open/floor/plating/lowpressure,
/area/ruin/unpowered)
"y" = (
/obj/effect/turf_decal/trimline/yellow/line{
	dir = 4
	},
/obj/effect/turf_decal/sand/plating,
/turf/open/floor/plating/lowpressure,
/area/ruin/unpowered)
"A" = (
/obj/effect/turf_decal/trimline/yellow/line{
	dir = 4
	},
/obj/effect/turf_decal/sand/plating,
/turf/open/floor/iron/dark/smooth_large/lowpressure,
/area/ruin/unpowered)
"D" = (
/obj/effect/turf_decal/sand/plating,
/turf/open/floor/iron/large/lowpressure,
/area/ruin/unpowered)
"L" = (
/obj/structure/chair/sofa/bench,
/obj/effect/turf_decal/sand/plating,
/turf/open/floor/iron/large/lowpressure,
/area/ruin/unpowered)
"M" = (
/obj/effect/turf_decal/sand/plating,
/turf/open/floor/plating/rust/lowpressure,
/area/ruin/unpowered)
"P" = (
/obj/structure/water_source/puddle,
/obj/effect/turf_decal/sand/plating,
/turf/open/floor/iron/large/lowpressure,
/area/ruin/unpowered)
"T" = (
/obj/effect/turf_decal/trimline/yellow/line{
	dir = 8
	},
/obj/effect/turf_decal/sand/plating,
/turf/open/floor/plating/lowpressure,
/area/ruin/unpowered)
"V" = (
/obj/structure/chair/sofa/bench{
	dir = 8
	},
/obj/effect/turf_decal/sand/plating,
/turf/open/floor/iron/large/lowpressure,
/area/ruin/unpowered)
"W" = (
/obj/effect/turf_decal/trimline/yellow/line{
	dir = 8
	},
/obj/effect/turf_decal/sand/plating,
/turf/open/floor/iron/dark/smooth_large/lowpressure,
/area/ruin/unpowered)
"Y" = (
/obj/structure/chair/sofa/bench/corner,
/obj/effect/turf_decal/sand/plating,
/turf/open/floor/iron/large/lowpressure,
/area/ruin/unpowered)
"Z" = (
/obj/effect/turf_decal/trimline/yellow/warning{
	dir = 4
	},
/obj/effect/turf_decal/sand/plating,
/turf/open/floor/plating/lowpressure,
/area/ruin/unpowered)

(1,1,1) = {"
a
a
a
a
a
a
a
a
a
a
a
a
a
"}
(2,1,1) = {"
a
D
D
M
M
M
D
a
a
M
D
D
a
"}
(3,1,1) = {"
a
A
a
e
Z
y
A
A
A
A
A
a
a
"}
(4,1,1) = {"
a
T
W
n
a
W
T
W
T
T
T
T
a
"}
(5,1,1) = {"
a
D
D
f
u
D
D
M
M
M
D
D
a
"}
(6,1,1) = {"
a
a
D
x
u
M
t
D
M
D
D
a
a
"}
(7,1,1) = {"
a
a
D
f
k
M
L
P
M
a
a
a
a
"}
(8,1,1) = {"
a
a
M
f
a
D
Y
V
h
a
a
a
a
"}
(9,1,1) = {"
a
a
a
x
u
D
a
D
a
a
a
a
a
"}
(10,1,1) = {"
a
a
a
a
a
a
a
a
a
a
a
a
a
"}
(11,1,1) = {"
a
a
a
a
a
a
a
a
a
a
a
a
a
"}
