//MAP CONVERTED BY dmm2tgm.py THIS HEADER COMMENT PREVENTS RECONVERSION, DO NOT REMOVE
"ab" = (
/obj/structure/railing,
/turf/open/floor/iron/sepia/lowpressure,
/area/ruin/unpowered)
"ad" = (
/obj/structure/fluff{
	desc = "Some sort of broken machine, beyond repair.";
	icon = 'icons/obj/machines/mining_machines.dmi';
	icon_state = "unloader-corner";
	name = "broken machine"
	},
/obj/machinery/conveyor{
	dir = 4
	},
/obj/effect/decal/cleanable/dirt/dust,
/turf/open/floor/iron/smooth_large/lowpressure,
/area/ruin/unpowered)
"aM" = (
/obj/structure/closet/crate/secure/loot,
/turf/open/floor/iron/sepia/lowpressure,
/area/ruin/unpowered)
"aN" = (
/obj/effect/turf_decal/sand,
/turf/open/floor/engine/lowpressure,
/area/ruin/unpowered)
"bu" = (
/obj/machinery/door/poddoor/shutters,
/turf/open/floor/engine/lowpressure,
/area/ruin/unpowered)
"bJ" = (
/obj/structure/table_frame,
/obj/structure/fluff{
	desc = "Some sort of broken machine, beyond repair.";
	icon = 'icons/obj/computer.dmi';
	icon_state = "television";
	name = "broken machine";
	pixel_x = -1
	},
/turf/open/floor/iron/grimy/lowpressure,
/area/ruin/unpowered)
"cm" = (
/obj/structure/light_construct/directional/south,
/obj/effect/turf_decal/sand/plating,
/turf/open/floor/iron/sepia/lowpressure,
/area/ruin/unpowered)
"cZ" = (
/obj/structure/frame/machine,
/turf/open/floor/iron/smooth_large/lowpressure,
/area/ruin/unpowered)
"dj" = (
/obj/structure/rack/shelf,
/obj/item/book/granter/crafting_recipe/pipegun_prime,
/turf/open/floor/iron/sepia/lowpressure,
/area/ruin/unpowered)
"dn" = (
/obj/structure/railing,
/obj/machinery/light/broken/directional/east,
/turf/open/floor/iron/sepia/lowpressure,
/area/ruin/unpowered)
"dp" = (
/obj/effect/turf_decal/trimline/yellow/warning{
	dir = 1
	},
/obj/effect/turf_decal/sand/plating,
/turf/open/floor/iron/dark/smooth_large/lowpressure,
/area/ruin/unpowered)
"ed" = (
/obj/effect/decal/cleanable/oil/slippery,
/turf/open/floor/iron/smooth_large/lowpressure,
/area/ruin/unpowered)
"eu" = (
/obj/effect/decal/cleanable/dirt/dust,
/obj/structure/light_construct/directional/east,
/turf/open/floor/iron/grimy/lowpressure,
/area/ruin/unpowered)
"eB" = (
/obj/machinery/door/airlock/grunge,
/obj/structure/barricade/wooden/crude,
/obj/effect/turf_decal/sand/plating,
/turf/open/floor/plating/rust/lowpressure,
/area/ruin/unpowered)
"eD" = (
/obj/structure/railing/corner{
	dir = 8
	},
/obj/structure/railing/corner,
/obj/effect/decal/cleanable/dirt/dust,
/turf/open/floor/iron/sepia/lowpressure,
/area/ruin/unpowered)
"eU" = (
/obj/structure/table_frame,
/obj/effect/decal/cleanable/dirt/dust,
/turf/open/floor/iron/sepia/lowpressure,
/area/ruin/unpowered)
"fr" = (
/obj/effect/turf_decal/sand,
/turf/open/floor/plating/rust/lowpressure,
/area/ruin/unpowered)
"fL" = (
/obj/structure/rack/shelf,
/obj/item/keycard/blue,
/turf/open/floor/iron/sepia/lowpressure,
/area/ruin/unpowered)
"fQ" = (
/obj/effect/decal/cleanable/dirt/dust,
/turf/open/floor/engine/lowpressure,
/area/ruin/unpowered)
"fT" = (
/obj/effect/turf_decal/trimline/yellow/line{
	dir = 1
	},
/obj/effect/turf_decal/sand/plating,
/turf/open/floor/iron/dark/smooth_large/lowpressure,
/area/ruin/unpowered)
"gO" = (
/obj/structure/sign/warning/engine_safety{
	pixel_x = 32
	},
/obj/effect/decal/cleanable/robot_debris/up,
/turf/open/floor/iron/sepia/lowpressure,
/area/ruin/unpowered)
"hw" = (
/obj/effect/turf_decal/sand/plating,
/turf/open/floor/iron/dark/smooth_large/lowpressure,
/area/ruin/unpowered)
"hO" = (
/obj/effect/turf_decal/sand/plating,
/turf/open/floor/iron/sepia/lowpressure,
/area/ruin/unpowered)
"hQ" = (
/obj/structure/frame/computer{
	dir = 8
	},
/obj/effect/decal/cleanable/dirt/dust,
/turf/open/floor/iron/smooth_large/lowpressure,
/area/ruin/unpowered)
"ic" = (
/obj/structure/plasticflaps/opaque,
/obj/effect/decal/cleanable/dirt/dust,
/turf/open/floor/iron/smooth_large/lowpressure,
/area/ruin/unpowered)
"iD" = (
/turf/open/floor/plating/rust/lowpressure,
/area/ruin/unpowered)
"iI" = (
/mob/living/simple_animal/hostile/hivebot/mechanic,
/turf/open/floor/iron/smooth_large/lowpressure,
/area/ruin/unpowered)
"iJ" = (
/obj/structure/railing/corner,
/obj/structure/railing/corner{
	dir = 1
	},
/obj/structure/railing/corner{
	dir = 8
	},
/obj/structure/railing/corner{
	dir = 4
	},
/obj/effect/decal/cleanable/dirt/dust,
/turf/open/floor/iron/sepia/lowpressure,
/area/ruin/unpowered)
"jK" = (
/obj/structure/railing/corner{
	dir = 1
	},
/obj/effect/turf_decal/sand/plating,
/turf/open/floor/iron/sepia/lowpressure,
/area/ruin/unpowered)
"jW" = (
/obj/effect/decal/cleanable/robot_debris/old,
/obj/effect/decal/cleanable/dirt/dust,
/turf/open/floor/iron/smooth_large/lowpressure,
/area/ruin/unpowered)
"kn" = (
/turf/open/floor/iron/sepia/lowpressure,
/area/ruin/unpowered)
"kW" = (
/obj/structure/door_assembly/door_assembly_grunge{
	anchored = 1;
	can_be_unanchored = 1
	},
/turf/open/floor/iron/sepia/lowpressure,
/area/ruin/unpowered)
"kY" = (
/turf/open/floor/iron/smooth_large/lowpressure,
/area/ruin/unpowered)
"lN" = (
/obj/effect/turf_decal/sand/plating,
/turf/open/floor/iron/large/lowpressure,
/area/ruin/unpowered)
"lW" = (
/obj/structure/sign/warning/no_smoking/circle{
	pixel_x = -32
	},
/obj/structure/light_construct/directional/west,
/turf/open/floor/iron/smooth_large/lowpressure,
/area/ruin/unpowered)
"lY" = (
/obj/effect/turf_decal/trimline/yellow/warning,
/obj/effect/turf_decal/sand/plating,
/turf/open/floor/iron/dark/smooth_large/lowpressure,
/area/ruin/unpowered)
"nj" = (
/obj/effect/decal/cleanable/dirt/dust,
/turf/open/floor/iron/sepia/lowpressure,
/area/ruin/unpowered)
"nI" = (
/obj/structure/railing{
	dir = 8
	},
/turf/open/floor/iron/sepia/lowpressure,
/area/ruin/unpowered)
"nS" = (
/obj/structure/railing{
	dir = 4
	},
/obj/structure/railing{
	dir = 8
	},
/obj/structure/light_construct/directional/south,
/turf/open/floor/iron/sepia/lowpressure,
/area/ruin/unpowered)
"ou" = (
/mob/living/simple_animal/hostile/hivebot/rapid,
/turf/open/floor/iron/smooth_large/lowpressure,
/area/ruin/unpowered)
"ow" = (
/obj/machinery/conveyor{
	dir = 10
	},
/turf/open/floor/iron/smooth_large/lowpressure,
/area/ruin/unpowered)
"oR" = (
/obj/machinery/conveyor,
/obj/effect/decal/cleanable/dirt/dust,
/turf/open/floor/iron/smooth_large/lowpressure,
/area/ruin/unpowered)
"pR" = (
/obj/effect/decal/cleanable/dirt/dust,
/obj/structure/light_construct/directional/west,
/turf/open/floor/iron/sepia/lowpressure,
/area/ruin/unpowered)
"qf" = (
/obj/effect/mine/stun,
/obj/effect/turf_decal/sand/plating,
/turf/open/floor/iron/large/lowpressure,
/area/ruin/unpowered)
"qy" = (
/obj/effect/turf_decal/trimline/yellow/line,
/obj/effect/turf_decal/sand/plating,
/turf/open/floor/iron/dark/smooth_large/lowpressure,
/area/ruin/unpowered)
"qG" = (
/obj/effect/turf_decal/sand/plating,
/obj/effect/turf_decal/sand/plating,
/turf/open/floor/iron/sepia/lowpressure,
/area/ruin/unpowered)
"qJ" = (
/obj/structure/railing{
	dir = 4
	},
/turf/open/floor/iron/stairs/lowpressure,
/area/ruin/unpowered)
"sj" = (
/obj/machinery/light/built/directional/south,
/turf/open/floor/iron/smooth_large/lowpressure,
/area/ruin/unpowered)
"sN" = (
/obj/structure/railing/corner,
/obj/structure/railing/corner{
	dir = 8
	},
/turf/open/floor/iron/sepia/lowpressure,
/area/ruin/unpowered)
"tA" = (
/obj/structure/chair{
	dir = 4
	},
/mob/living/simple_animal/hostile/hivebot/strong,
/obj/effect/decal/cleanable/dirt/dust,
/turf/open/floor/iron/grimy/lowpressure,
/area/ruin/unpowered)
"tR" = (
/obj/effect/decal/cleanable/dirt/dust,
/turf/open/floor/iron/grimy/lowpressure,
/area/ruin/unpowered)
"vq" = (
/obj/effect/decal/cleanable/oil/streak,
/turf/open/floor/iron/smooth_large/lowpressure,
/area/ruin/unpowered)
"vw" = (
/obj/structure/railing,
/obj/effect/mine/stun,
/obj/effect/decal/cleanable/dirt/dust,
/turf/open/floor/iron/sepia/lowpressure,
/area/ruin/unpowered)
"wo" = (
/obj/structure/railing,
/obj/effect/decal/cleanable/dirt/dust,
/turf/open/floor/iron/sepia/lowpressure,
/area/ruin/unpowered)
"wp" = (
/obj/effect/turf_decal/sand/plating,
/turf/open/floor/plating/lowpressure,
/area/ruin/unpowered)
"wK" = (
/obj/structure/girder/reinforced,
/obj/effect/turf_decal/sand/plating,
/turf/open/floor/plating/rust/lowpressure,
/area/ruin/unpowered)
"wW" = (
/obj/effect/decal/cleanable/oil,
/turf/open/floor/iron/smooth_large/lowpressure,
/area/ruin/unpowered)
"xp" = (
/obj/structure/railing{
	dir = 8
	},
/obj/machinery/light/broken/directional/east,
/turf/open/floor/iron/sepia/lowpressure,
/area/ruin/unpowered)
"xu" = (
/turf/open/misc/asteroid/lowpressure,
/area/ruin/unpowered)
"xW" = (
/obj/structure/table_frame,
/obj/effect/spawner/random/entertainment/money_large,
/turf/open/floor/iron/grimy/lowpressure,
/area/ruin/unpowered)
"yl" = (
/mob/living/simple_animal/hostile/hivebot/strong,
/obj/effect/decal/cleanable/dirt/dust,
/turf/open/floor/iron/sepia/lowpressure,
/area/ruin/unpowered)
"yu" = (
/obj/effect/decal/cleanable/wrapping,
/obj/effect/decal/cleanable/dirt/dust,
/turf/open/floor/iron/sepia/lowpressure,
/area/ruin/unpowered)
"za" = (
/obj/structure/railing{
	dir = 4
	},
/obj/structure/railing{
	dir = 8
	},
/turf/open/floor/iron/sepia/lowpressure,
/area/ruin/unpowered)
"zl" = (
/turf/open/floor/engine/lowpressure,
/area/ruin/unpowered)
"zp" = (
/obj/structure/filingcabinet,
/turf/open/floor/iron/grimy/lowpressure,
/area/ruin/unpowered)
"zu" = (
/obj/structure/chair{
	dir = 4
	},
/obj/effect/decal/cleanable/dirt/dust,
/turf/open/floor/iron/smooth_large/lowpressure,
/area/ruin/unpowered)
"Aa" = (
/obj/effect/turf_decal/trimline/yellow/warning,
/obj/effect/turf_decal/sand/plating,
/turf/open/floor/plating/lowpressure,
/area/ruin/unpowered)
"AI" = (
/obj/structure/railing{
	dir = 8
	},
/obj/effect/decal/cleanable/dirt/dust,
/turf/open/floor/iron/sepia/lowpressure,
/area/ruin/unpowered)
"AT" = (
/obj/effect/turf_decal/trimline/yellow/line{
	dir = 1
	},
/obj/effect/turf_decal/sand/plating,
/turf/open/floor/plating/lowpressure,
/area/ruin/unpowered)
"Bh" = (
/obj/machinery/conveyor{
	dir = 4
	},
/obj/structure/fluff{
	desc = "Some sort of broken machine, beyond repair.";
	icon = 'icons/obj/machines/mining_machines.dmi';
	icon_state = "unloader";
	name = "broken machine"
	},
/obj/effect/decal/cleanable/dirt/dust,
/turf/open/floor/iron/smooth_large/lowpressure,
/area/ruin/unpowered)
"Bn" = (
/obj/effect/decal/cleanable/dirt/dust,
/obj/structure/chair{
	dir = 8
	},
/turf/open/floor/iron/grimy/lowpressure,
/area/ruin/unpowered)
"BZ" = (
/obj/effect/decal/cleanable/dirt/dust,
/turf/open/floor/iron/smooth_large/lowpressure,
/area/ruin/unpowered)
"Cn" = (
/obj/structure/girder/reinforced,
/turf/open/floor/plating/rust/lowpressure,
/area/ruin/unpowered)
"Co" = (
/obj/effect/decal/cleanable/dirt/dust,
/obj/structure/rack/shelf,
/obj/item/fuel_pellet/advanced,
/obj/item/fuel_pellet/advanced,
/turf/open/floor/iron/sepia/lowpressure,
/area/ruin/unpowered)
"Cz" = (
/obj/machinery/door/airlock/grunge,
/turf/open/floor/iron/sepia/lowpressure,
/area/ruin/unpowered)
"Dy" = (
/obj/machinery/light/built/directional/west,
/obj/effect/decal/cleanable/dirt/dust,
/turf/open/floor/iron/sepia/lowpressure,
/area/ruin/unpowered)
"DE" = (
/obj/machinery/conveyor{
	dir = 8
	},
/turf/open/floor/iron/smooth_large/lowpressure,
/area/ruin/unpowered)
"Fg" = (
/obj/structure/flora/ausbushes/stalkybush,
/turf/open/misc/asteroid/lowpressure,
/area/ruin/unpowered)
"FW" = (
/obj/structure/fluff{
	desc = "Some sort of broken machine, beyond repair.";
	icon = 'icons/obj/machines/telecomms.dmi';
	icon_state = "AAS_Off";
	name = "broken machine";
	pixel_x = -1
	},
/turf/open/floor/iron/sepia/lowpressure,
/area/ruin/unpowered)
"FX" = (
/obj/structure/rack/shelf,
/obj/effect/spawner/random/engineering/material_rare,
/turf/open/floor/iron/sepia/lowpressure,
/area/ruin/unpowered)
"Gb" = (
/obj/effect/turf_decal/trimline/yellow/line,
/obj/effect/turf_decal/sand/plating,
/turf/open/floor/plating/lowpressure,
/area/ruin/unpowered)
"GJ" = (
/obj/structure/flora/ausbushes/palebush,
/turf/open/misc/asteroid/lowpressure,
/area/ruin/unpowered)
"GL" = (
/obj/effect/turf_decal/sand/plating,
/turf/open/floor/plating/rust/lowpressure,
/area/ruin/unpowered)
"GN" = (
/obj/structure/fluff{
	desc = "Some sort of broken machine, beyond repair.";
	icon = 'icons/obj/machines/teleporter.dmi';
	icon_state = "controller-p";
	name = "broken machine"
	},
/turf/open/floor/iron/smooth_large/lowpressure,
/area/ruin/unpowered)
"Hc" = (
/turf/template_noop,
/area/template_noop)
"Hm" = (
/obj/structure/table_frame,
/obj/effect/turf_decal/sand/plating,
/turf/open/floor/iron/sepia/lowpressure,
/area/ruin/unpowered)
"Hr" = (
/obj/structure/railing/corner,
/obj/effect/decal/cleanable/dirt/dust,
/turf/open/floor/iron/sepia/lowpressure,
/area/ruin/unpowered)
"HK" = (
/obj/machinery/door/puzzle/keycard/blue_required,
/turf/open/floor/iron/grimy/lowpressure,
/area/ruin/unpowered)
"HQ" = (
/obj/structure/chair{
	dir = 4
	},
/turf/open/floor/iron/smooth_large/lowpressure,
/area/ruin/unpowered)
"Iy" = (
/obj/effect/mine/stun,
/turf/open/floor/iron/smooth_large/lowpressure,
/area/ruin/unpowered)
"Jh" = (
/obj/structure/chair/comfy/black{
	dir = 4
	},
/turf/open/floor/iron/grimy/lowpressure,
/area/ruin/unpowered)
"JE" = (
/obj/structure/rack/shelf,
/obj/item/disk/design_disk/modkit_disc/rapid_repeater,
/obj/effect/decal/cleanable/cobweb,
/turf/open/floor/iron/sepia/lowpressure,
/area/ruin/unpowered)
"Ks" = (
/obj/structure/railing{
	dir = 8
	},
/obj/structure/railing{
	dir = 4
	},
/turf/open/floor/iron/sepia/lowpressure,
/area/ruin/unpowered)
"Kv" = (
/obj/structure/railing/corner{
	dir = 8
	},
/turf/open/floor/iron/sepia/lowpressure,
/area/ruin/unpowered)
"KS" = (
/obj/structure/mopbucket,
/obj/item/mop,
/obj/effect/decal/cleanable/cobweb,
/obj/effect/decal/cleanable/dirt/dust,
/turf/open/floor/iron/sepia/lowpressure,
/area/ruin/unpowered)
"LN" = (
/obj/structure/sign/warning/secure_area{
	pixel_y = 32
	},
/obj/effect/turf_decal/sand/plating,
/turf/open/floor/plating/rust/lowpressure,
/area/ruin/unpowered)
"MH" = (
/obj/structure/fluff{
	desc = "Some sort of broken machine, beyond repair.";
	icon = 'icons/obj/machines/sheetifier.dmi';
	icon_state = "base_machine";
	name = "broken machine"
	},
/turf/open/floor/iron/smooth_large/lowpressure,
/area/ruin/unpowered)
"MJ" = (
/obj/structure/fluff{
	desc = "Some sort of broken machine, beyond repair.";
	icon = 'icons/obj/machines/mining_machines.dmi';
	icon_state = "unloader-corner";
	name = "broken machine"
	},
/turf/open/floor/iron/smooth_large/lowpressure,
/area/ruin/unpowered)
"MP" = (
/obj/structure/railing,
/obj/machinery/light/built/directional/west,
/turf/open/floor/iron/sepia/lowpressure,
/area/ruin/unpowered)
"Ng" = (
/mob/living/simple_animal/hostile/hivebot/rapid,
/turf/open/floor/iron/sepia/lowpressure,
/area/ruin/unpowered)
"Ni" = (
/obj/structure/railing{
	dir = 8
	},
/obj/effect/decal/cleanable/dirt/dust,
/obj/structure/light_construct/directional/east,
/turf/open/floor/iron/sepia/lowpressure,
/area/ruin/unpowered)
"NJ" = (
/mob/living/simple_animal/hostile/hivebot,
/obj/effect/turf_decal/sand/plating,
/turf/open/floor/iron/sepia/lowpressure,
/area/ruin/unpowered)
"NP" = (
/obj/structure/fluff{
	desc = "Some sort of broken machine, beyond repair.";
	icon = 'icons/obj/machines/research.dmi';
	icon_state = "server-nopower";
	name = "broken machine";
	pixel_x = -1
	},
/turf/open/floor/iron/smooth_large/lowpressure,
/area/ruin/unpowered)
"PJ" = (
/obj/machinery/door/poddoor/shutters,
/turf/open/floor/plating/rust/lowpressure,
/area/ruin/unpowered)
"PQ" = (
/obj/structure/railing{
	dir = 8
	},
/turf/open/floor/iron/stairs/lowpressure,
/area/ruin/unpowered)
"Qk" = (
/obj/effect/decal/cleanable/cobweb,
/turf/open/floor/iron/grimy/lowpressure,
/area/ruin/unpowered)
"QA" = (
/obj/machinery/conveyor{
	dir = 8
	},
/obj/structure/fluff{
	desc = "Some sort of broken machine, beyond repair.";
	icon = 'icons/obj/machines/prison.dmi';
	icon_state = "offline";
	name = "broken machine"
	},
/turf/open/floor/iron/smooth_large/lowpressure,
/area/ruin/unpowered)
"QV" = (
/turf/closed/wall/r_wall/rust,
/area/ruin/unpowered)
"RG" = (
/obj/machinery/conveyor{
	dir = 6
	},
/obj/effect/decal/cleanable/dirt/dust,
/turf/open/floor/iron/smooth_large/lowpressure,
/area/ruin/unpowered)
"RY" = (
/obj/machinery/conveyor,
/obj/structure/fluff{
	desc = "Some sort of broken machine, beyond repair.";
	icon = 'icons/obj/chemical.dmi';
	icon_state = "smoke0";
	name = "broken machine"
	},
/obj/effect/decal/cleanable/dirt/dust,
/turf/open/floor/iron/smooth_large/lowpressure,
/area/ruin/unpowered)
"Uw" = (
/obj/effect/spawner/random/entertainment/money_large,
/obj/structure/flippedtable,
/turf/open/floor/iron/grimy/lowpressure,
/area/ruin/unpowered)
"UF" = (
/obj/structure/mineral_door/wood,
/turf/open/floor/iron/sepia/lowpressure,
/area/ruin/unpowered)
"UN" = (
/obj/structure/decorative/shelf/crates1,
/turf/open/floor/iron/sepia/lowpressure,
/area/ruin/unpowered)
"Vd" = (
/obj/structure/railing/corner{
	dir = 4
	},
/turf/open/floor/iron/sepia/lowpressure,
/area/ruin/unpowered)
"Vk" = (
/obj/structure/decorative/shelf/crates,
/turf/open/floor/iron/sepia/lowpressure,
/area/ruin/unpowered)
"WD" = (
/obj/structure/fluff{
	desc = "Some sort of broken machine, beyond repair.";
	icon = 'icons/obj/machines/telecomms.dmi';
	icon_state = "bus_off";
	name = "broken machine";
	pixel_x = -1
	},
/turf/open/floor/iron/smooth_large/lowpressure,
/area/ruin/unpowered)
"Xb" = (
/turf/open/floor/iron/grimy/lowpressure,
/area/ruin/unpowered)
"Xy" = (
/obj/effect/turf_decal/trimline/yellow/warning{
	dir = 1
	},
/obj/effect/turf_decal/sand/plating,
/turf/open/floor/plating/lowpressure,
/area/ruin/unpowered)
"XR" = (
/obj/structure/railing/corner{
	dir = 8
	},
/obj/effect/decal/cleanable/cobweb/cobweb2,
/turf/open/floor/iron/sepia/lowpressure,
/area/ruin/unpowered)
"XX" = (
/obj/structure/fluff{
	desc = "Some sort of broken machine, beyond repair.";
	icon = 'icons/obj/machines/telecomms.dmi';
	icon_state = "hub_off";
	name = "broken machine";
	pixel_x = -3
	},
/turf/open/floor/iron/smooth_large/lowpressure,
/area/ruin/unpowered)
"Yp" = (
/obj/structure/table_frame,
/obj/effect/decal/cleanable/dirt/dust,
/turf/open/floor/iron/grimy/lowpressure,
/area/ruin/unpowered)
"Ys" = (
/obj/item/clipboard,
/obj/item/disk/tech_disk/spaceloot,
/obj/structure/flippedtable{
	dir = 4
	},
/turf/open/floor/iron/grimy/lowpressure,
/area/ruin/unpowered)
"Zr" = (
/obj/structure/railing{
	dir = 4
	},
/obj/structure/railing{
	dir = 8
	},
/obj/effect/decal/cleanable/dirt/dust,
/turf/open/floor/iron/sepia/lowpressure,
/area/ruin/unpowered)

(1,1,1) = {"
Hc
Hc
Hc
Hc
Hc
Hc
Hc
Hc
Hc
Hc
Hc
Hc
Hc
Hc
Hc
Hc
Hc
Hc
Hc
Hc
Hc
Hc
Hc
Hc
Hc
fT
GL
Hc
"}
(2,1,1) = {"
Hc
QV
QV
QV
QV
QV
QV
QV
Hc
QV
QV
QV
QV
QV
Hc
Hc
Hc
Hc
Hc
Hc
Hc
Hc
Hc
Hc
qy
AT
lN
Hc
"}
(3,1,1) = {"
Hc
QV
Qk
Jh
tA
tR
zp
QV
xu
QV
JE
pR
UN
QV
QV
QV
QV
QV
QV
QV
QV
QV
Hc
lN
Gb
AT
Hc
Hc
"}
(4,1,1) = {"
Hc
QV
bJ
Ys
Yp
tR
xW
QV
QV
QV
fL
nj
aM
QV
FX
MP
iD
iD
fQ
zl
aN
PJ
hw
Hc
Aa
dp
Hc
Hc
"}
(5,1,1) = {"
Hc
QV
Xb
Bn
eu
tR
Uw
QV
KS
QV
dj
yu
Vk
QV
Co
sN
zl
zl
zl
iD
fr
bu
wp
hw
Aa
GJ
Hc
Hc
"}
(6,1,1) = {"
Hc
QV
QV
HK
QV
QV
QV
QV
UF
Cn
Cn
kW
QV
Cn
yl
sN
Ks
iJ
Zr
za
nS
QV
xu
lN
qy
xu
Hc
Hc
"}
(7,1,1) = {"
Hc
QV
FW
ab
XX
GN
WD
lW
iI
kY
kY
kY
wW
ic
nj
eD
zl
iD
iD
aN
aN
bu
wp
wp
lY
Xy
GL
Hc
"}
(8,1,1) = {"
Hc
QV
kn
Kv
PQ
BZ
BZ
kY
jW
BZ
HQ
MJ
kY
Cz
nj
dn
zl
iD
iD
iD
aN
bu
hw
hw
Aa
Xy
GL
Hc
"}
(9,1,1) = {"
Hc
QV
Ng
Hr
qJ
kY
iI
kY
BZ
BZ
MH
cZ
Iy
QV
QV
QV
QV
QV
QV
QV
QV
QV
Hc
qf
Gb
AT
Hc
Hc
"}
(10,1,1) = {"
Hc
QV
kn
wo
kY
BZ
BZ
BZ
BZ
BZ
BZ
BZ
kY
kn
kn
nj
Dy
kn
kn
kn
hO
QV
lN
GL
Fg
AT
Hc
Hc
"}
(11,1,1) = {"
Hc
QV
QV
wo
kY
ad
zu
BZ
QA
ed
kY
kY
kY
gO
kn
kn
kn
kn
NJ
hO
qG
eB
lN
GL
Hc
fT
Hc
Hc
"}
(12,1,1) = {"
Hc
Hc
QV
vw
vq
Bh
hQ
BZ
DE
vq
kY
kY
sj
QV
eU
eU
nj
kn
qG
hO
hO
QV
LN
GL
Hc
fT
xu
Hc
"}
(13,1,1) = {"
Hc
Hc
QV
ab
BZ
RG
oR
RY
ow
kY
NP
cZ
ou
Cn
kn
eU
kn
hO
QV
wK
QV
QV
Hc
lN
qy
AT
lN
Hc
"}
(14,1,1) = {"
Hc
Hc
QV
ab
BZ
BZ
BZ
BZ
kY
kY
kY
kY
kY
QV
Vd
Hm
hO
cm
QV
xu
Hc
Hc
Hc
GL
Gb
Hc
Hc
Hc
"}
(15,1,1) = {"
Hc
Hc
QV
XR
xp
nI
nI
nI
AI
AI
Ni
AI
nI
PQ
jK
hO
hO
hO
QV
Fg
Hc
Hc
Hc
GL
Gb
Hc
Hc
Hc
"}
(16,1,1) = {"
Hc
Hc
QV
QV
QV
QV
QV
QV
QV
QV
QV
QV
QV
QV
QV
QV
wK
wK
QV
Hc
Hc
Hc
Hc
lN
Hc
Hc
Hc
Hc
"}
(17,1,1) = {"
Hc
Hc
Hc
Hc
Hc
Hc
Hc
Hc
Hc
Hc
Hc
Hc
Hc
Hc
Hc
Hc
Hc
Hc
Hc
Hc
Hc
Hc
Hc
lN
Hc
Hc
Hc
Hc
"}
