//MAP CONVERTED BY dmm2tgm.py THIS HEADER COMMENT PREVENTS RECONVERSION, DO NOT REMOVE
"a" = (
/turf/template_noop,
/area/template_noop)
"b" = (
/obj/structure/alien/weeds,
/obj/structure/bed/nest,
/obj/effect/gibspawner/human/bodypartless,
/obj/item/mod/control/pre_equipped/prototype,
/obj/item/gun/energy/plasmacutter,
/obj/effect/mob_spawn/corpse/human/charredskeleton,
/turf/open/misc/asteroid/lowpressure,
/area/ruin/unpowered/xenonest)
"c" = (
/obj/structure/alien/resin/wall,
/obj/structure/alien/weeds,
/obj/structure/alien/weeds,
/turf/open/misc/asteroid/lowpressure,
/area/ruin/unpowered/xenonest)
"d" = (
/obj/structure/alien/weeds,
/mob/living/simple_animal/hostile/alien/queen/large{
	desc = "A gigantic alien who is in charge of the hive and all of its loyal servants.";
	name = "alien queen";
	pixel_x = -16;
	plants_off = 1
	},
/turf/open/misc/asteroid/lowpressure,
/area/ruin/unpowered/xenonest)
"e" = (
/obj/structure/alien/weeds,
/obj/structure/bed/nest,
/obj/item/clothing/under/rank/security/officer/blueshirt,
/obj/item/clothing/glasses/thermal/monocle,
/obj/item/clothing/head/collectable/tophat,
/obj/item/clothing/suit/british_officer,
/obj/effect/mob_spawn/corpse/human/charredskeleton,
/obj/effect/gibspawner/human/bodypartless,
/turf/open/misc/asteroid/lowpressure,
/area/ruin/unpowered/xenonest)
"f" = (
/obj/structure/alien/weeds/node,
/obj/effect/gibspawner/human/bodypartless,
/turf/open/misc/asteroid/lowpressure,
/area/ruin/unpowered/xenonest)
"g" = (
/obj/structure/alien/weeds,
/obj/effect/decal/cleanable/blood/tracks{
	dir = 4
	},
/turf/open/misc/asteroid/lowpressure,
/area/ruin/unpowered/xenonest)
"i" = (
/obj/structure/alien/weeds,
/obj/effect/decal/cleanable/blood/gibs,
/turf/open/misc/asteroid/lowpressure,
/area/ruin/unpowered/xenonest)
"m" = (
/obj/structure/alien/weeds,
/obj/effect/decal/cleanable/blood/tracks{
	dir = 1
	},
/turf/open/misc/asteroid/lowpressure,
/area/ruin/unpowered/xenonest)
"o" = (
/obj/structure/alien/weeds,
/obj/structure/bed/nest,
/obj/effect/mob_spawn/corpse/human/nanotrasensoldier,
/obj/effect/gibspawner/human/bodypartless,
/turf/open/misc/asteroid/lowpressure,
/area/ruin/unpowered/xenonest)
"p" = (
/obj/structure/alien/weeds,
/obj/effect/decal/cleanable/blood/tracks{
	dir = 5
	},
/turf/open/misc/asteroid/lowpressure,
/area/ruin/unpowered/xenonest)
"q" = (
/obj/structure/alien/weeds,
/obj/effect/decal/cleanable/blood/tracks,
/turf/open/misc/asteroid/lowpressure,
/area/ruin/unpowered/xenonest)
"r" = (
/turf/closed/mineral/random/asteroid/rockplanet,
/area/ruin/unpowered/xenonest)
"s" = (
/turf/closed/mineral/random/asteroid/rockplanet,
/area/rockplanet/underground)
"v" = (
/obj/structure/alien/weeds/node,
/turf/open/misc/asteroid/lowpressure,
/area/ruin/unpowered/xenonest)
"w" = (
/obj/structure/alien/weeds,
/obj/effect/decal/cleanable/blood/tracks{
	dir = 10
	},
/turf/open/misc/asteroid/lowpressure,
/area/ruin/unpowered/xenonest)
"G" = (
/obj/structure/alien/weeds,
/obj/effect/decal/cleanable/blood/tracks{
	dir = 6
	},
/turf/open/misc/asteroid/lowpressure,
/area/ruin/unpowered/xenonest)
"H" = (
/obj/structure/alien/weeds,
/mob/living/simple_animal/hostile/alien,
/turf/open/misc/asteroid/lowpressure,
/area/ruin/unpowered/xenonest)
"L" = (
/obj/structure/alien/weeds,
/obj/structure/bed/nest,
/obj/effect/mob_spawn/corpse/human/cargo_tech,
/obj/effect/gibspawner/human/bodypartless,
/turf/open/misc/asteroid/lowpressure,
/area/ruin/unpowered/xenonest)
"N" = (
/obj/structure/alien/weeds,
/obj/structure/bed/nest,
/turf/open/misc/asteroid/lowpressure,
/area/ruin/unpowered/xenonest)
"O" = (
/obj/structure/alien/weeds,
/obj/structure/bed/nest,
/obj/effect/mob_spawn/corpse/human/assistant,
/obj/effect/gibspawner/human/bodypartless,
/obj/item/katana,
/turf/open/misc/asteroid/lowpressure,
/area/ruin/unpowered/xenonest)
"P" = (
/obj/structure/alien/weeds,
/obj/effect/decal/cleanable/blood/gibs/up,
/turf/open/misc/asteroid/lowpressure,
/area/ruin/unpowered/xenonest)
"R" = (
/obj/structure/alien/weeds,
/mob/living/simple_animal/hostile/alien/drone{
	plants_off = 1
	},
/turf/open/misc/asteroid/lowpressure,
/area/ruin/unpowered/xenonest)
"S" = (
/obj/structure/alien/weeds,
/mob/living/simple_animal/hostile/alien/sentinel,
/turf/open/misc/asteroid/lowpressure,
/area/ruin/unpowered/xenonest)
"T" = (
/obj/structure/alien/weeds,
/obj/effect/gibspawner/human/bodypartless,
/turf/open/misc/asteroid/lowpressure,
/area/ruin/unpowered/xenonest)
"U" = (
/obj/structure/alien/weeds,
/obj/effect/decal/cleanable/blood/tracks{
	dir = 9
	},
/turf/open/misc/asteroid/lowpressure,
/area/ruin/unpowered/xenonest)
"V" = (
/obj/structure/alien/weeds,
/obj/effect/decal/cleanable/blood,
/turf/open/misc/asteroid/lowpressure,
/area/ruin/unpowered/xenonest)
"W" = (
/obj/structure/alien/weeds,
/turf/open/misc/asteroid/lowpressure,
/area/ruin/unpowered/xenonest)
"Y" = (
/obj/structure/alien/weeds,
/obj/structure/alien/egg/burst,
/turf/open/misc/asteroid/lowpressure,
/area/ruin/unpowered/xenonest)
"Z" = (
/obj/structure/alien/resin/wall,
/obj/structure/alien/weeds,
/turf/open/misc/asteroid/lowpressure,
/area/ruin/unpowered/xenonest)

(1,1,1) = {"
a
a
a
s
s
s
s
s
s
s
s
s
s
a
a
a
a
s
s
s
s
s
s
s
s
s
s
s
s
s
s
a
a
a
a
a
a
"}
(2,1,1) = {"
a
a
s
s
s
s
s
s
Z
Z
Z
s
s
s
s
s
s
s
s
s
s
s
s
s
s
Z
Z
Z
Z
s
s
s
s
s
s
s
a
"}
(3,1,1) = {"
a
a
s
s
s
Z
Z
Z
Z
N
Z
Z
s
s
s
s
s
s
s
Z
Z
Z
Z
Z
Z
Z
v
v
Z
s
s
s
s
s
s
s
s
"}
(4,1,1) = {"
a
a
s
s
Z
Z
W
W
W
W
S
Z
s
s
Z
Z
Z
Z
Z
Z
W
W
W
W
W
W
W
R
Z
s
s
s
Z
Z
Z
s
s
"}
(5,1,1) = {"
a
a
s
s
Z
W
v
W
W
v
W
Z
s
s
Z
W
W
W
W
W
H
q
q
w
W
W
W
W
Z
s
Z
Z
Z
W
Z
s
s
"}
(6,1,1) = {"
a
a
s
s
Z
W
W
W
v
W
O
Z
s
Z
Z
W
H
q
W
W
r
W
W
W
r
r
W
W
Z
s
Z
W
W
H
Z
s
s
"}
(7,1,1) = {"
a
a
s
s
Z
W
W
H
W
W
Z
Z
Z
Z
W
W
W
W
W
Z
r
r
v
Y
W
r
W
N
Z
s
Z
Y
v
W
Z
Z
s
"}
(8,1,1) = {"
a
a
s
s
Z
W
V
W
W
W
W
W
W
W
W
W
Z
Z
Z
r
r
r
W
W
W
W
W
Z
Z
s
Z
Z
W
W
W
Z
s
"}
(9,1,1) = {"
a
a
s
s
Z
Z
W
W
W
v
W
Z
W
W
W
Z
Z
W
W
W
Z
r
Z
Z
Z
W
g
Z
s
s
s
Z
Z
W
W
Z
s
"}
(10,1,1) = {"
a
a
s
s
s
Z
W
W
W
W
W
r
Z
Z
W
Z
Z
b
f
W
W
W
W
W
W
W
W
Z
s
s
s
s
Z
W
v
Z
s
"}
(11,1,1) = {"
a
a
s
s
s
Z
W
W
W
W
r
r
r
Z
W
W
Z
Z
Z
W
W
W
W
W
W
H
W
Z
s
s
s
s
Z
W
W
Z
s
"}
(12,1,1) = {"
a
a
s
s
s
Z
W
W
W
Z
r
r
r
Z
W
W
W
r
r
Z
W
W
W
r
Z
Z
c
Z
Z
Z
s
Z
Z
W
Z
Z
s
"}
(13,1,1) = {"
a
a
a
s
s
Z
Y
W
W
Z
r
r
r
Z
W
W
W
W
W
Z
Z
W
Y
r
r
r
Z
W
W
Z
Z
Z
W
W
Z
s
s
"}
(14,1,1) = {"
a
a
a
s
s
Z
Z
W
R
Z
r
r
r
Y
W
W
v
W
W
S
Z
Z
Z
Z
r
W
W
W
Y
W
W
W
S
W
Z
s
s
"}
(15,1,1) = {"
a
a
a
s
s
s
Z
W
W
Z
Z
r
r
r
W
W
W
W
W
W
W
W
W
W
W
W
W
W
W
W
W
W
Z
Z
Z
s
s
"}
(16,1,1) = {"
a
s
s
s
s
s
Z
W
W
W
Z
Z
r
r
g
Z
Z
Z
W
W
W
W
Z
Z
Z
Z
Z
Z
Z
Z
W
W
v
Z
s
s
s
"}
(17,1,1) = {"
s
s
s
s
s
s
Z
Y
W
v
W
Z
r
r
p
W
Z
Z
Z
Z
W
W
Z
r
r
r
r
r
r
Z
R
W
o
Z
s
s
a
"}
(18,1,1) = {"
s
s
s
s
s
s
Z
Z
W
W
W
Z
r
r
W
g
W
Z
Z
N
W
W
Z
r
r
r
r
Z
Z
W
W
Z
Z
Z
s
s
a
"}
(19,1,1) = {"
s
Z
Z
Z
Z
s
s
Z
Z
W
H
Z
r
r
Z
R
W
Z
Z
Z
W
W
W
r
r
Z
W
W
W
G
Z
Z
s
s
s
s
a
"}
(20,1,1) = {"
s
Z
W
W
Z
Z
Z
Z
W
W
W
Z
r
r
Z
W
W
Z
r
Z
Y
W
W
W
W
Z
Z
g
H
Z
Z
s
s
s
s
a
a
"}
(21,1,1) = {"
s
Z
S
W
U
m
W
q
W
T
W
Z
r
r
Z
W
W
Z
r
Z
Z
Z
W
W
W
W
Z
W
Z
Z
Z
Z
s
s
s
a
a
"}
(22,1,1) = {"
s
Z
W
v
W
Z
Z
Z
Z
Z
r
r
r
r
Z
W
W
Z
Z
Z
W
W
Z
Z
Z
Z
Z
W
W
W
N
Z
s
s
s
a
a
"}
(23,1,1) = {"
s
Z
W
W
W
W
W
W
W
Z
r
r
r
r
Z
W
W
W
W
W
W
v
W
W
W
q
q
V
W
v
L
Z
s
s
a
a
a
"}
(24,1,1) = {"
s
Z
Z
W
W
W
W
d
W
Y
Z
Z
Z
Z
Z
Z
W
W
Z
Y
W
H
W
Z
Z
W
W
W
v
W
Z
Z
s
s
a
a
a
"}
(25,1,1) = {"
s
s
Z
H
W
W
v
W
W
W
W
W
R
N
Z
Z
Z
Z
Z
Z
W
W
W
Z
Z
Z
Z
W
W
Y
Z
s
s
s
a
a
a
"}
(26,1,1) = {"
s
s
Z
W
W
W
Z
Z
Z
W
W
W
W
N
Z
s
s
s
s
Z
W
W
W
Z
s
s
Z
Z
W
W
Z
s
s
s
a
a
a
"}
(27,1,1) = {"
s
s
Z
W
W
W
r
r
r
r
W
v
W
Z
Z
s
s
s
s
Z
V
W
Z
Z
s
s
s
Z
Z
Z
Z
s
s
s
a
a
a
"}
(28,1,1) = {"
s
s
Z
W
W
W
W
W
r
W
W
W
Y
Z
s
s
s
s
Z
Z
W
W
Z
s
s
s
s
s
s
s
s
s
s
s
a
a
a
"}
(29,1,1) = {"
s
s
Z
Z
N
W
W
W
W
H
W
e
Z
Z
s
s
s
s
Z
v
W
P
Z
s
s
s
s
s
s
s
s
s
s
a
a
a
a
"}
(30,1,1) = {"
s
s
s
Z
Z
Z
W
Y
W
Z
Z
Z
Z
s
s
s
a
a
a
W
W
i
a
a
a
a
a
s
s
s
a
a
a
a
a
a
a
"}
(31,1,1) = {"
a
s
s
s
s
Z
Z
Z
Z
Z
s
s
s
s
s
a
a
a
a
a
a
a
a
a
a
a
a
a
a
a
a
a
a
a
a
a
a
"}
(32,1,1) = {"
a
a
s
s
s
s
s
s
s
s
s
s
s
s
a
a
a
a
a
a
a
a
a
a
a
a
a
a
a
a
a
a
a
a
a
a
a
"}
