//MAP CONVERTED BY dmm2tgm.py THIS HEADER COMMENT PREVENTS RECONVERSION, DO NOT REMOVE
"a" = (
/obj/machinery/atmospherics/pipe/smart/manifold4w/supply/hidden/layer4,
/turf/open/floor/iron,
/area/station/common/cryopods)
"b" = (
/obj/machinery/cryopod{
	dir = 4
	},
/obj/effect/turf_decal/siding/white{
	dir = 4
	},
/turf/open/floor/iron/dark,
/area/station/common/cryopods)
"f" = (
/obj/structure/cable,
/obj/machinery/atmospherics/pipe/smart/manifold4w/supply/hidden/layer4,
/obj/machinery/atmospherics/pipe/smart/manifold4w/scrubbers/hidden/layer2,
/obj/machinery/door/airlock/public/glass{
	name = "Cryopods"
	},
/obj/effect/landmark/navigate_destination,
/turf/open/floor/iron,
/area/station/common/cryopods)
"h" = (
/obj/machinery/door/firedoor,
/obj/machinery/door/airlock/public/glass{
	name = "Dormitory"
	},
/obj/effect/turf_decal/tile/neutral{
	dir = 1
	},
/obj/effect/turf_decal/tile/neutral{
	dir = 8
	},
/obj/effect/landmark/navigate_destination,
/obj/structure/cable,
/turf/open/floor/iron,
/area/station/commons/dorms)
"i" = (
/obj/machinery/atmospherics/components/unary/vent_pump/on/layer4,
/turf/open/floor/iron,
/area/station/hallway/primary/central)
"j" = (
/obj/machinery/cryopod{
	dir = 8
	},
/obj/effect/turf_decal/siding/white{
	dir = 9
	},
/obj/machinery/light/directional/east,
/turf/open/floor/iron/dark,
/area/station/common/cryopods)
"k" = (
/obj/machinery/computer/cryopod{
	pixel_y = 32
	},
/obj/structure/cable,
/obj/machinery/atmospherics/pipe/smart/manifold4w/supply/hidden/layer4,
/obj/machinery/atmospherics/pipe/smart/manifold4w/scrubbers/hidden/layer2,
/turf/open/floor/iron,
/area/station/common/cryopods)
"m" = (
/obj/effect/turf_decal/tile/neutral{
	dir = 1
	},
/obj/effect/turf_decal/tile/neutral{
	dir = 8
	},
/obj/structure/cable,
/obj/machinery/camera/directional/west{
	c_tag = "Dormitory South"
	},
/turf/open/floor/iron,
/area/station/commons/dorms)
"o" = (
/obj/effect/turf_decal/tile/blue{
	dir = 1
	},
/obj/effect/turf_decal/tile/blue,
/obj/effect/turf_decal/tile/blue{
	dir = 4
	},
/turf/open/floor/iron,
/area/station/hallway/primary/central)
"q" = (
/obj/effect/turf_decal/plaque{
	icon_state = "L13"
	},
/turf/open/floor/iron,
/area/station/hallway/primary/central)
"s" = (
/turf/open/floor/iron,
/area/station/hallway/primary/central)
"v" = (
/obj/effect/spawner/structure/window,
/turf/open/floor/plating,
/area/station/common/cryopods)
"y" = (
/obj/effect/turf_decal/tile/neutral{
	dir = 4
	},
/turf/open/floor/iron,
/area/station/hallway/primary/central)
"z" = (
/obj/machinery/cryopod{
	dir = 8
	},
/obj/effect/turf_decal/siding/white{
	dir = 8
	},
/obj/machinery/atmospherics/components/unary/vent_pump/on/layer4{
	dir = 8
	},
/turf/open/floor/iron/dark,
/area/station/common/cryopods)
"C" = (
/turf/closed/wall,
/area/station/common/cryopods)
"E" = (
/obj/machinery/cryopod{
	dir = 4
	},
/obj/effect/turf_decal/siding/white{
	dir = 4
	},
/obj/machinery/power/apc/auto_name/directional/north,
/obj/structure/cable,
/obj/machinery/atmospherics/components/unary/vent_scrubber/on/layer2{
	dir = 4
	},
/obj/machinery/camera/directional/west,
/turf/open/floor/iron/dark,
/area/station/common/cryopods)
"H" = (
/obj/effect/turf_decal/tile/neutral{
	dir = 1
	},
/obj/effect/turf_decal/tile/neutral{
	dir = 8
	},
/obj/structure/cable,
/turf/open/floor/iron,
/area/station/hallway/primary/central)
"I" = (
/turf/open/floor/plating,
/area/station/maintenance/fore/lesser)
"J" = (
/obj/machinery/cryopod{
	dir = 4
	},
/obj/effect/turf_decal/siding/white{
	dir = 4
	},
/obj/machinery/airalarm/directional/west,
/turf/open/floor/iron/dark,
/area/station/common/cryopods)
"K" = (
/obj/structure/cable,
/obj/machinery/atmospherics/pipe/smart/manifold4w/supply/hidden/layer4,
/obj/machinery/atmospherics/pipe/smart/manifold4w/scrubbers/hidden/layer2,
/obj/machinery/light/directional/north,
/turf/open/floor/iron,
/area/station/common/cryopods)
"M" = (
/obj/effect/turf_decal/tile/neutral{
	dir = 1
	},
/obj/effect/turf_decal/tile/neutral{
	dir = 8
	},
/obj/structure/cable,
/obj/machinery/atmospherics/pipe/smart/manifold4w/supply/hidden/layer4,
/obj/machinery/atmospherics/pipe/smart/manifold4w/scrubbers/hidden/layer2,
/turf/open/floor/iron,
/area/station/commons/dorms)
"O" = (
/obj/machinery/door/firedoor,
/turf/open/floor/iron,
/area/station/hallway/primary/central)
"Q" = (
/obj/effect/turf_decal/tile/neutral{
	dir = 1
	},
/obj/structure/cable,
/turf/open/floor/iron,
/area/station/hallway/primary/central)
"U" = (
/obj/machinery/door/airlock/maintenance,
/obj/effect/mapping_helpers/airlock/access/any/security/maintenance,
/obj/effect/mapping_helpers/airlock/unres{
	dir = 1
	},
/turf/open/floor/plating,
/area/station/maintenance/fore/lesser)
"Z" = (
/obj/effect/turf_decal/tile/blue,
/obj/effect/turf_decal/tile/blue{
	dir = 4
	},
/turf/open/floor/iron,
/area/station/hallway/primary/central)

(1,1,1) = {"
I
I
U
o
Z
q
"}
(2,1,1) = {"
C
C
C
v
v
s
"}
(3,1,1) = {"
C
E
J
b
v
s
"}
(4,1,1) = {"
C
k
a
a
v
O
"}
(5,1,1) = {"
C
K
j
z
v
i
"}
(6,1,1) = {"
C
f
C
v
v
y
"}
(7,1,1) = {"
m
M
h
H
H
Q
"}
