//MAP CONVERTED BY dmm2tgm.py THIS HEADER COMMENT PREVENTS RECONVERSION, DO NOT REMOVE
"a" = (
/turf/open/floor/iron/dark,
/area/station/hallway/primary/central)
"b" = (
/obj/structure/cable,
/obj/machinery/atmospherics/pipe/smart/manifold4w/scrubbers/hidden/layer2,
/obj/machinery/atmospherics/pipe/smart/manifold4w/supply/hidden/layer4,
/turf/open/floor/iron,
/area/station/hallway/primary/central)
"c" = (
/obj/effect/turf_decal/tile/purple{
	dir = 1
	},
/obj/effect/turf_decal/tile/purple,
/turf/open/floor/iron,
/area/station/service/barber)
"d" = (
/obj/effect/turf_decal/tile/purple{
	dir = 1
	},
/obj/effect/turf_decal/tile/purple,
/obj/effect/landmark/start/barber,
/turf/open/floor/iron,
/area/station/service/barber)
"e" = (
/obj/structure/cable,
/obj/machinery/atmospherics/pipe/smart/manifold4w/supply/hidden/layer4,
/turf/open/floor/iron,
/area/station/hallway/primary/central)
"f" = (
/turf/closed/wall,
/area/station/maintenance/port/greater)
"g" = (
/obj/structure/mirror/directional/west,
/obj/structure/table/glass,
/obj/item/razor{
	pixel_x = -6
	},
/obj/item/reagent_containers/spray/barbers_aid{
	pixel_x = 6
	},
/turf/open/floor/iron,
/area/station/service/barber)
"h" = (
/obj/effect/turf_decal/tile/purple,
/obj/effect/turf_decal/tile/purple{
	dir = 1
	},
/obj/machinery/door/airlock/public/glass{
	name = "Barbershop"
	},
/obj/machinery/door/firedoor,
/obj/machinery/atmospherics/pipe/smart/manifold4w/supply/hidden/layer4,
/obj/machinery/atmospherics/pipe/smart/manifold4w/scrubbers/hidden/layer2,
/obj/structure/cable,
/turf/open/floor/iron,
/area/station/service/barber)
"i" = (
/obj/structure/cable,
/obj/effect/landmark/start/hangover,
/obj/structure/railing/corner{
	dir = 8
	},
/turf/open/floor/iron,
/area/station/hallway/primary/central)
"j" = (
/obj/effect/turf_decal/tile/purple{
	dir = 1
	},
/obj/effect/turf_decal/tile/purple,
/obj/structure/chair/office/light{
	dir = 4
	},
/obj/structure/window,
/obj/structure/window{
	dir = 8
	},
/turf/open/floor/iron,
/area/station/service/barber)
"k" = (
/obj/machinery/power/apc/auto_name/directional/south,
/obj/structure/cable,
/obj/machinery/atmospherics/pipe/smart/manifold4w/supply/hidden/layer4,
/obj/machinery/atmospherics/pipe/smart/manifold4w/scrubbers/hidden/layer2,
/obj/structure/disposalpipe/segment{
	dir = 4
	},
/obj/effect/turf_decal/tile/purple,
/obj/effect/turf_decal/tile/purple{
	dir = 1
	},
/obj/structure/chair{
	dir = 1
	},
/turf/open/floor/iron,
/area/station/service/barber)
"l" = (
/obj/effect/turf_decal/tile/purple{
	dir = 1
	},
/obj/effect/turf_decal/tile/purple,
/obj/structure/chair/comfy/barber_chair{
	dir = 8
	},
/turf/open/floor/iron,
/area/station/service/barber)
"m" = (
/obj/structure/cable,
/obj/machinery/atmospherics/pipe/smart/manifold4w/supply/hidden/layer4,
/obj/structure/railing/corner{
	dir = 1
	},
/turf/open/floor/iron,
/area/station/hallway/primary/central)
"n" = (
/obj/structure/disposalpipe/segment{
	dir = 4
	},
/obj/effect/turf_decal/tile/purple,
/obj/effect/turf_decal/tile/purple{
	dir = 1
	},
/obj/machinery/button/curtain{
	id = "barbershopcurtains";
	pixel_x = 25;
	pixel_y = -24
	},
/obj/structure/chair{
	dir = 1
	},
/turf/open/floor/iron,
/area/station/service/barber)
"o" = (
/obj/machinery/atmospherics/pipe/smart/manifold4w/scrubbers/hidden/layer2,
/obj/machinery/atmospherics/pipe/smart/manifold4w/supply/hidden/layer4,
/obj/structure/disposalpipe/segment{
	dir = 10
	},
/obj/effect/turf_decal/tile/purple,
/obj/effect/turf_decal/tile/purple{
	dir = 1
	},
/turf/open/floor/iron,
/area/station/service/barber)
"p" = (
/obj/structure/disposalpipe/segment,
/turf/closed/wall,
/area/station/service/barber)
"q" = (
/obj/machinery/airalarm/directional/north,
/obj/effect/turf_decal/tile/purple{
	dir = 1
	},
/obj/effect/turf_decal/tile/purple,
/obj/machinery/light/warm/directional/north,
/obj/item/kirbyplants/random,
/turf/open/floor/iron,
/area/station/service/barber)
"r" = (
/obj/effect/turf_decal/tile/purple{
	dir = 1
	},
/obj/effect/turf_decal/tile/purple,
/obj/machinery/holopad,
/turf/open/floor/iron,
/area/station/service/barber)
"s" = (
/obj/effect/spawner/structure/window,
/obj/structure/curtain/cloth/fancy/mechanical{
	id = "barbershopcurtains1"
	},
/turf/open/floor/plating,
/area/station/service/barber)
"t" = (
/turf/open/openspace,
/area/station/hallway/primary/central)
"u" = (
/obj/item/radio/intercom/directional/west,
/obj/structure/table/glass,
/obj/item/reagent_containers/spray/quantum_hair_dye{
	pixel_x = 6
	},
/obj/item/lipstick/random,
/turf/open/floor/iron,
/area/station/service/barber)
"v" = (
/obj/machinery/atmospherics/pipe/smart/manifold4w/supply/hidden/layer4,
/obj/machinery/atmospherics/pipe/smart/manifold4w/scrubbers/hidden/layer2,
/obj/effect/turf_decal/tile/purple,
/obj/effect/turf_decal/tile/purple{
	dir = 1
	},
/obj/structure/cable,
/turf/open/floor/iron,
/area/station/service/barber)
"w" = (
/obj/structure/mirror/directional/west,
/obj/structure/table/glass,
/obj/item/hairbrush/comb{
	pixel_y = 10
	},
/obj/item/reagent_containers/dropper,
/obj/machinery/dryer{
	pixel_y = 14
	},
/turf/open/floor/iron,
/area/station/service/barber)
"x" = (
/obj/effect/turf_decal/tile/purple,
/obj/effect/turf_decal/tile/purple{
	dir = 1
	},
/obj/machinery/atmospherics/pipe/smart/manifold4w/supply/hidden/layer4,
/obj/machinery/atmospherics/pipe/smart/manifold4w/scrubbers/hidden/layer2,
/obj/structure/cable,
/turf/open/floor/iron,
/area/station/service/barber)
"y" = (
/obj/machinery/newscaster/directional/north,
/obj/effect/turf_decal/tile/purple{
	dir = 1
	},
/obj/effect/turf_decal/tile/purple,
/obj/structure/chair/office/light{
	dir = 4
	},
/obj/structure/window{
	dir = 8
	},
/obj/machinery/camera/directional/north{
	c_tag = "Salon"
	},
/turf/open/floor/iron,
/area/station/service/barber)
"z" = (
/obj/effect/turf_decal/tile/neutral,
/obj/machinery/atmospherics/pipe/smart/manifold4w/supply/hidden/layer4,
/obj/effect/turf_decal/tile/purple{
	dir = 1
	},
/obj/effect/turf_decal/tile/purple,
/turf/open/floor/iron,
/area/station/service/barber)
"A" = (
/obj/structure/disposalpipe/segment{
	dir = 10
	},
/obj/effect/spawner/structure/window,
/obj/structure/curtain/cloth/fancy/mechanical{
	id = "barbershopcurtains"
	},
/turf/open/floor/plating,
/area/station/service/barber)
"B" = (
/obj/structure/disposalpipe/segment{
	dir = 4
	},
/obj/effect/turf_decal/tile/purple,
/obj/effect/turf_decal/tile/purple{
	dir = 1
	},
/turf/open/floor/iron,
/area/station/service/barber)
"C" = (
/obj/effect/turf_decal/tile/purple{
	dir = 1
	},
/obj/effect/turf_decal/tile/purple,
/obj/structure/table/glass,
/obj/structure/window,
/obj/item/hairbrush,
/obj/item/lipstick/random,
/turf/open/floor/iron,
/area/station/service/barber)
"D" = (
/obj/machinery/atmospherics/pipe/smart/manifold4w/supply/hidden/layer4,
/obj/effect/turf_decal/tile/purple{
	dir = 1
	},
/obj/effect/turf_decal/tile/purple,
/turf/open/floor/iron,
/area/station/service/barber)
"E" = (
/obj/structure/disposalpipe/segment{
	dir = 5
	},
/obj/effect/turf_decal/tile/purple,
/obj/effect/turf_decal/tile/purple{
	dir = 1
	},
/obj/machinery/vending/barbervend,
/turf/open/floor/iron,
/area/station/service/barber)
"F" = (
/obj/structure/disposalpipe/segment{
	dir = 4
	},
/obj/machinery/door/airlock/maintenance{
	req_access = list("maint_tunnels")
	},
/turf/open/floor/plating,
/area/station/service/barber)
"G" = (
/obj/effect/turf_decal/tile/purple,
/obj/effect/turf_decal/tile/purple{
	dir = 1
	},
/turf/open/floor/iron,
/area/station/service/barber)
"H" = (
/obj/machinery/light/directional/south,
/obj/structure/disposalpipe/segment{
	dir = 4
	},
/obj/effect/turf_decal/tile/purple,
/obj/effect/turf_decal/tile/purple{
	dir = 1
	},
/obj/structure/closet/secure_closet/barber,
/turf/open/floor/iron,
/area/station/service/barber)
"I" = (
/obj/effect/turf_decal/tile/purple{
	dir = 1
	},
/obj/effect/turf_decal/tile/purple,
/obj/structure/chair/comfy/barber_chair{
	dir = 8
	},
/obj/effect/landmark/start/hangover,
/turf/open/floor/iron,
/area/station/service/barber)
"J" = (
/obj/structure/cable,
/obj/structure/railing{
	dir = 8
	},
/obj/machinery/door/firedoor/border_only{
	dir = 8
	},
/turf/open/floor/iron,
/area/station/hallway/primary/central)
"K" = (
/obj/effect/turf_decal/tile/purple{
	dir = 1
	},
/obj/effect/turf_decal/tile/purple,
/obj/machinery/atmospherics/components/unary/vent_scrubber/on/layer2,
/turf/open/floor/iron,
/area/station/service/barber)
"L" = (
/obj/structure/sign/barber{
	pixel_x = -13
	},
/obj/machinery/door/firedoor/border_only{
	dir = 1
	},
/turf/open/floor/iron/dark,
/area/station/hallway/primary/central)
"M" = (
/obj/structure/closet/firecloset,
/turf/open/floor/plating,
/area/station/maintenance/port/greater)
"N" = (
/obj/machinery/atmospherics/pipe/smart/manifold4w/scrubbers/hidden/layer2,
/obj/machinery/atmospherics/pipe/smart/manifold4w/supply/hidden/layer4,
/obj/effect/turf_decal/tile/purple,
/obj/effect/turf_decal/tile/purple{
	dir = 1
	},
/turf/open/floor/iron,
/area/station/service/barber)
"O" = (
/obj/effect/spawner/random/maintenance,
/obj/structure/disposalpipe/segment{
	dir = 4
	},
/turf/open/floor/plating,
/area/station/maintenance/port/greater)
"P" = (
/obj/effect/turf_decal/tile/purple{
	dir = 1
	},
/obj/effect/turf_decal/tile/purple,
/obj/structure/sink/directional/east,
/turf/open/floor/iron,
/area/station/service/barber)
"Q" = (
/obj/effect/turf_decal/tile/purple{
	dir = 1
	},
/obj/effect/turf_decal/tile/purple,
/obj/structure/table/glass,
/obj/item/hairbrush,
/turf/open/floor/iron,
/area/station/service/barber)
"R" = (
/turf/closed/wall,
/area/station/service/barber)
"S" = (
/obj/machinery/disposal/bin,
/obj/structure/disposalpipe/trunk,
/obj/effect/turf_decal/tile/purple,
/obj/effect/turf_decal/tile/purple{
	dir = 1
	},
/obj/machinery/light_switch/directional/west,
/obj/machinery/dryer{
	dir = 4;
	pixel_x = -6;
	pixel_y = -6
	},
/turf/open/floor/iron,
/area/station/service/barber)
"T" = (
/obj/effect/spawner/structure/window,
/obj/structure/curtain/cloth/fancy/mechanical{
	id = "barbershopcurtains"
	},
/turf/open/floor/plating,
/area/station/service/barber)
"U" = (
/obj/machinery/atmospherics/pipe/smart/manifold4w/supply/hidden/layer4,
/obj/machinery/atmospherics/pipe/smart/manifold4w/scrubbers/hidden/layer2,
/obj/structure/cable,
/turf/open/floor/iron/dark,
/area/station/hallway/primary/central)
"V" = (
/obj/machinery/atmospherics/components/unary/vent_pump/on/layer4,
/obj/effect/turf_decal/tile/purple{
	dir = 1
	},
/obj/effect/turf_decal/tile/purple,
/turf/open/floor/iron,
/area/station/service/barber)
"W" = (
/obj/machinery/firealarm/directional/north,
/obj/effect/turf_decal/tile/purple{
	dir = 1
	},
/obj/effect/turf_decal/tile/purple,
/obj/structure/bed/pod,
/obj/effect/landmark/start/hangover,
/turf/open/floor/iron,
/area/station/service/barber)
"X" = (
/obj/effect/turf_decal/tile/purple{
	dir = 1
	},
/obj/effect/turf_decal/tile/purple,
/obj/structure/bed/pod,
/obj/structure/window,
/turf/open/floor/iron,
/area/station/service/barber)
"Y" = (
/obj/effect/landmark/event_spawn,
/obj/structure/cable,
/obj/machinery/atmospherics/pipe/smart/manifold4w/scrubbers/hidden/layer2,
/obj/machinery/atmospherics/pipe/smart/manifold4w/supply/hidden/layer4,
/turf/open/floor/iron,
/area/station/hallway/primary/central)
"Z" = (
/obj/effect/turf_decal/tile/purple{
	dir = 1
	},
/obj/effect/turf_decal/tile/purple,
/obj/effect/landmark/start/barber,
/obj/machinery/button/curtain{
	id = "barbershopcurtains1";
	pixel_x = 25;
	pixel_y = 24
	},
/turf/open/floor/iron,
/area/station/service/barber)

(1,1,1) = {"
f
f
f
f
f
O
M
f
"}
(2,1,1) = {"
R
w
u
g
R
F
R
R
"}
(3,1,1) = {"
R
l
d
I
P
B
S
p
"}
(4,1,1) = {"
R
q
V
D
z
o
E
R
"}
(5,1,1) = {"
R
y
c
j
G
N
H
R
"}
(6,1,1) = {"
R
W
r
X
G
v
k
R
"}
(7,1,1) = {"
R
Q
Z
C
K
x
n
R
"}
(8,1,1) = {"
R
R
s
R
T
h
A
p
"}
(9,1,1) = {"
R
t
t
L
a
U
U
R
"}
(10,1,1) = {"
i
J
J
m
e
e
Y
b
"}
