//MAP CONVERTED BY dmm2tgm.py THIS HEADER COMMENT PREVENTS RECONVERSION, DO NOT REMOVE
"a" = (
/obj/machinery/atmospherics/pipe/smart/manifold4w/scrubbers/hidden/layer2,
/obj/machinery/atmospherics/pipe/smart/manifold4w/supply/hidden/layer4,
/obj/structure/cable,
/turf/open/floor/iron/dark/textured,
/area/station/ai_monitored/security/armory)
"d" = (
/obj/structure/window/reinforced{
	dir = 1;
	layer = 2.9
	},
/obj/effect/turf_decal/tile/red/half{
	dir = 8
	},
/obj/structure/closet/ammunitionlocker/useful,
/obj/item/storage/box/lethalshot,
/obj/item/storage/box/lethalshot,
/obj/item/storage/box/lethalshot,
/obj/item/storage/box/lethalshot,
/turf/open/floor/iron/dark/textured,
/area/station/ai_monitored/security/armory)
"e" = (
/obj/machinery/light/directional/north,
/obj/structure/rack/gunrack,
/obj/effect/spawner/armory_spawn/cmg,
/obj/effect/turf_decal/tile/red/half,
/turf/open/floor/iron/dark/textured,
/area/station/ai_monitored/security/armory)
"f" = (
/obj/machinery/atmospherics/pipe/smart/manifold4w/supply/hidden/layer4,
/turf/open/floor/iron/dark/textured,
/area/station/ai_monitored/security/armory)
"g" = (
/obj/structure/rack,
/obj/item/gun/energy/ionrifle,
/obj/item/gun/energy/temperature/security,
/obj/item/clothing/suit/hooded/ablative,
/obj/effect/turf_decal/tile/red/half{
	dir = 8
	},
/obj/item/gun/grenadelauncher,
/turf/open/floor/iron/dark/textured,
/area/station/ai_monitored/security/armory)
"i" = (
/obj/structure/rack,
/obj/item/clothing/head/helmet/sec{
	pixel_x = -3;
	pixel_y = 3
	},
/obj/item/clothing/head/helmet/sec,
/obj/item/clothing/head/helmet/sec{
	pixel_x = 3;
	pixel_y = -3
	},
/obj/item/clothing/suit/armor/vest/alt/sec{
	pixel_x = 3;
	pixel_y = -3
	},
/obj/item/clothing/suit/armor/vest/alt/sec,
/obj/item/clothing/suit/armor/vest/alt/sec{
	pixel_x = -3;
	pixel_y = 3
	},
/obj/effect/turf_decal/tile/red/half{
	dir = 8
	},
/turf/open/floor/iron/dark/textured,
/area/station/ai_monitored/security/armory)
"m" = (
/obj/structure/stairs/east,
/turf/open/floor/iron/dark/textured,
/area/station/ai_monitored/security/armory)
"q" = (
/obj/structure/window/reinforced{
	dir = 1;
	layer = 2.9
	},
/obj/effect/turf_decal/tile/red/anticorner/contrasted{
	dir = 4
	},
/obj/structure/rack/gunrack,
/obj/effect/spawner/armory_spawn/shotguns,
/turf/open/floor/iron/dark/textured,
/area/station/ai_monitored/security/armory)
"t" = (
/obj/structure/rack,
/obj/item/clothing/suit/armor/bulletproof{
	pixel_x = -3;
	pixel_y = 3
	},
/obj/item/clothing/suit/armor/bulletproof,
/obj/item/clothing/suit/armor/bulletproof{
	pixel_x = 3;
	pixel_y = -3
	},
/obj/item/clothing/head/helmet/alt{
	layer = 3.00001;
	pixel_x = -3;
	pixel_y = 3
	},
/obj/item/clothing/head/helmet/alt{
	layer = 3.00001
	},
/obj/item/clothing/head/helmet/alt{
	layer = 3.00001;
	pixel_x = 3;
	pixel_y = -3
	},
/obj/effect/turf_decal/tile/red/half,
/turf/open/floor/iron/dark/textured,
/area/station/ai_monitored/security/armory)
"v" = (
/turf/closed/wall/r_wall,
/area/station/ai_monitored/security/armory)
"w" = (
/obj/machinery/recharger,
/obj/structure/table,
/obj/effect/turf_decal/tile/red/half,
/obj/machinery/light/directional/north,
/turf/open/floor/iron/dark/textured,
/area/station/ai_monitored/security/armory)
"x" = (
/obj/effect/turf_decal/tile/red/half{
	dir = 4
	},
/obj/structure/rack/gunrack,
/obj/effect/spawner/armory_spawn/microfusion,
/turf/open/floor/iron/dark/textured,
/area/station/ai_monitored/security/armory)
"y" = (
/obj/machinery/light/directional/south,
/turf/open/floor/iron/dark/textured,
/area/station/ai_monitored/security/armory)
"B" = (
/obj/machinery/camera/directional/north{
	c_tag = "Armory - Internal - Lower"
	},
/obj/effect/turf_decal/tile/red/half,
/obj/structure/closet/secure_closet/smartgun,
/turf/open/floor/iron/dark/textured,
/area/station/ai_monitored/security/armory)
"L" = (
/turf/closed/wall,
/area/station/ai_monitored/security/armory)
"M" = (
/obj/structure/rack,
/obj/item/storage/box/teargas{
	pixel_x = -3;
	pixel_y = 3
	},
/obj/item/storage/box/handcuffs,
/obj/item/storage/box/flashbangs{
	pixel_x = 3;
	pixel_y = -3
	},
/obj/effect/turf_decal/tile/red/half{
	dir = 8
	},
/obj/item/storage/toolbox/drone,
/turf/open/floor/iron/dark/textured,
/area/station/ai_monitored/security/armory)
"N" = (
/obj/machinery/atmospherics/components/unary/vent_pump/on/layer4{
	dir = 8
	},
/turf/open/floor/iron/dark/textured,
/area/station/ai_monitored/security/armory)
"Q" = (
/obj/machinery/atmospherics/components/unary/vent_scrubber/on/layer2,
/obj/machinery/power/apc/auto_name/directional/west,
/obj/structure/cable,
/turf/open/floor/iron/dark/textured,
/area/station/ai_monitored/security/armory)
"S" = (
/mob/living/simple_animal/bot/secbot/beepsky/armsky,
/turf/open/floor/iron/dark/textured,
/area/station/ai_monitored/security/armory)
"W" = (
/obj/machinery/atmospherics/pipe/smart/manifold4w/scrubbers/hidden/layer2,
/obj/machinery/atmospherics/pipe/smart/manifold4w/supply/hidden/layer4,
/obj/structure/cable,
/obj/effect/spawner/structure/window/reinforced,
/turf/open/floor/plating,
/area/station/ai_monitored/security/armory)
"X" = (
/obj/structure/rack,
/obj/item/clothing/suit/armor/riot{
	pixel_x = -3;
	pixel_y = 3
	},
/obj/item/clothing/suit/armor/riot,
/obj/item/clothing/suit/armor/riot{
	pixel_x = 3;
	pixel_y = -3
	},
/obj/item/clothing/head/helmet/riot{
	pixel_x = -3;
	pixel_y = 3
	},
/obj/item/clothing/head/helmet/riot,
/obj/item/clothing/head/helmet/riot{
	pixel_x = 3;
	pixel_y = -3
	},
/obj/item/shield/riot{
	pixel_x = -3;
	pixel_y = 3
	},
/obj/item/shield/riot,
/obj/item/shield/riot{
	pixel_x = 3;
	pixel_y = -3
	},
/obj/effect/turf_decal/tile/red/half,
/obj/machinery/airalarm/directional/north,
/turf/open/floor/iron/dark/textured,
/area/station/ai_monitored/security/armory)
"Y" = (
/turf/open/floor/iron/dark/textured,
/area/station/ai_monitored/security/armory)

(1,1,1) = {"
v
v
v
v
v
v
v
"}
(2,1,1) = {"
v
t
Q
a
a
a
W
"}
(3,1,1) = {"
v
X
Y
f
L
m
v
"}
(4,1,1) = {"
v
w
Y
f
L
L
v
"}
(5,1,1) = {"
v
e
Y
f
q
x
v
"}
(6,1,1) = {"
v
B
S
N
Y
y
v
"}
(7,1,1) = {"
v
v
M
i
d
g
v
"}
(8,1,1) = {"
v
v
v
v
v
v
v
"}
