//MAP CONVERTED BY dmm2tgm.py THIS HEADER COMMENT PREVENTS RECONVERSION, DO NOT REMOVE
"a" = (
/turf/closed/wall,
/area/station/security/checkpoint/medical)
"b" = (
/obj/machinery/atmospherics/components/unary/vent_pump/on/layer4{
	dir = 4
	},
/obj/structure/chair/office{
	dir = 1
	},
/obj/effect/turf_decal/trimline/blue/filled/line{
	dir = 8
	},
/obj/effect/landmark/start/orderly,
/turf/open/floor/iron/white,
/area/station/security/checkpoint/medical)
"c" = (
/obj/machinery/atmospherics/components/unary/vent_scrubber/on/layer2{
	dir = 4
	},
/obj/structure/chair/office,
/obj/effect/turf_decal/trimline/blue/filled/line{
	dir = 8
	},
/obj/effect/landmark/start/orderly,
/turf/open/floor/iron/white,
/area/station/security/checkpoint/medical)
"d" = (
/obj/machinery/computer/med_data,
/obj/structure/cable,
/obj/effect/turf_decal/trimline/blue/filled/line{
	dir = 9
	},
/turf/open/floor/iron/white,
/area/station/security/checkpoint/medical)
"e" = (
/obj/structure/cable,
/obj/machinery/computer/crew{
	dir = 1
	},
/obj/effect/turf_decal/trimline/blue/filled/line{
	dir = 10
	},
/turf/open/floor/iron/white,
/area/station/security/checkpoint/medical)
"f" = (
/obj/machinery/atmospherics/pipe/smart/manifold4w/scrubbers/hidden/layer2,
/obj/machinery/atmospherics/pipe/smart/manifold4w/supply/hidden/layer4,
/obj/structure/cable,
/obj/machinery/holopad,
/obj/machinery/button/door/directional/west{
	id = "MedbayFoyer";
	name = "Medbay Doors Control";
	normaldoorcontrol = 1;
	pixel_x = -35;
	pixel_y = -56
	},
/obj/effect/landmark/start/orderly,
/turf/open/floor/iron/white,
/area/station/security/checkpoint/medical)
"p" = (
/obj/machinery/atmospherics/pipe/smart/manifold4w/supply/hidden/layer4,
/obj/structure/cable,
/obj/machinery/button/door/directional/east{
	id = "medsecprivacy";
	name = "Privacy Shutters Control";
	pixel_x = -32;
	pixel_y = 56
	},
/obj/effect/landmark/start/orderly,
/turf/open/floor/iron/white,
/area/station/security/checkpoint/medical)
"w" = (
/obj/structure/closet/secure_closet/security/med,
/obj/machinery/firealarm/directional/south,
/obj/structure/cable,
/obj/machinery/power/apc/auto_name/directional/east,
/obj/effect/turf_decal/trimline/blue/filled/line{
	dir = 6
	},
/turf/open/floor/iron/white,
/area/station/security/checkpoint/medical)
"F" = (
/obj/structure/table/reinforced,
/obj/machinery/recharger{
	pixel_y = 4
	},
/obj/machinery/light/directional/east,
/obj/machinery/requests_console/directional/east{
	anon_tips_receiver = 1;
	assistance_requestable = 1;
	department = "Security";
	departmentType = 5;
	name = "Security Requests Console"
	},
/obj/effect/turf_decal/trimline/blue/filled/line{
	dir = 4
	},
/turf/open/floor/iron/white,
/area/station/security/checkpoint/medical)
"I" = (
/obj/machinery/door/firedoor,
/obj/structure/cable,
/obj/machinery/atmospherics/pipe/smart/manifold4w/scrubbers/hidden/layer2,
/obj/machinery/atmospherics/pipe/smart/manifold4w/supply/hidden/layer4,
/obj/effect/turf_decal/trimline/blue/filled/line{
	dir = 1
	},
/obj/effect/turf_decal/trimline/blue/filled/line,
/obj/machinery/door/airlock/medical/glass{
	name = "Orderly Office"
	},
/obj/effect/mapping_helpers/airlock/access/all/medical/orderly,
/turf/open/floor/iron/white,
/area/station/security/checkpoint/medical)
"L" = (
/obj/structure/table/reinforced,
/obj/machinery/camera{
	c_tag = "Security Post - Medbay";
	dir = 9;
	network = list("ss13","medbay")
	},
/obj/machinery/newscaster/directional/north,
/obj/structure/cable,
/obj/machinery/computer/security/telescreen{
	desc = "Used for monitoring medbay to ensure patient safety.";
	dir = 8;
	name = "Medbay Monitor";
	network = list("medbay");
	pixel_y = 4
	},
/obj/effect/turf_decal/trimline/blue/filled/line{
	dir = 1
	},
/turf/open/floor/iron/white,
/area/station/security/checkpoint/medical)
"P" = (
/obj/structure/cable,
/obj/machinery/atmospherics/pipe/smart/manifold4w/scrubbers/hidden/layer2,
/obj/machinery/atmospherics/pipe/smart/manifold4w/supply/hidden/layer4,
/obj/machinery/light_switch/directional/south{
	pixel_x = -21;
	pixel_y = -25
	},
/obj/effect/turf_decal/trimline/blue/filled/line,
/obj/effect/landmark/start/orderly,
/turf/open/floor/iron/white,
/area/station/security/checkpoint/medical)
"S" = (
/obj/structure/table/reinforced,
/obj/item/screwdriver{
	pixel_y = 10
	},
/obj/item/radio/off,
/obj/machinery/light/directional/north,
/obj/item/radio/intercom/directional/north,
/obj/machinery/airalarm/directional/east,
/obj/effect/turf_decal/trimline/blue/filled/line{
	dir = 5
	},
/turf/open/floor/iron/white,
/area/station/security/checkpoint/medical)
"T" = (
/obj/structure/closet/secure_closet/security/med,
/obj/effect/turf_decal/trimline/blue/filled/line{
	dir = 4
	},
/turf/open/floor/iron/white,
/area/station/security/checkpoint/medical)

(1,1,1) = {"
d
b
c
e
a
"}
(2,1,1) = {"
L
p
f
P
I
"}
(3,1,1) = {"
S
F
T
w
a
"}
