//MAP CONVERTED BY dmm2tgm.py THIS HEADER COMMENT PREVENTS RECONVERSION, DO NOT REMOVE
"a" = (
/turf/closed/wall/r_wall,
/area/station/ai_monitored/security/armory/upper)
"b" = (
/obj/effect/turf_decal/tile/red/anticorner/contrasted{
	dir = 4
	},
/obj/structure/cable,
/obj/machinery/atmospherics/components/unary/vent_scrubber/on/layer2,
/turf/open/floor/iron/dark/textured,
/area/station/ai_monitored/security/armory/upper)
"c" = (
/obj/machinery/light/directional/west,
/obj/machinery/camera/motion/directional/south{
	c_tag = "Armory - Internal - Upper"
	},
/turf/open/openspace,
/area/station/ai_monitored/security/armory/upper)
"f" = (
/obj/machinery/atmospherics/pipe/smart/manifold4w/supply/hidden/layer4,
/turf/closed/wall/r_wall,
/area/station/ai_monitored/security/armory/upper)
"i" = (
/obj/structure/railing,
/obj/structure/rack,
/obj/item/gun/energy/e_gun/dragnet{
	pixel_y = 4
	},
/obj/item/gun/energy/e_gun/dragnet,
/obj/effect/turf_decal/tile/red/half{
	dir = 1
	},
/obj/structure/cable,
/obj/machinery/door/firedoor/border_only,
/turf/open/floor/iron/dark/textured,
/area/station/ai_monitored/security/armory/upper)
"j" = (
/turf/open/openspace,
/area/station/ai_monitored/security/armory/upper)
"k" = (
/obj/structure/table,
/obj/item/storage/box/chemimp{
	pixel_x = 6
	},
/obj/item/storage/box/trackimp{
	pixel_x = -3
	},
/obj/item/storage/lockbox/loyalty,
/obj/effect/turf_decal/tile/red/half{
	dir = 1
	},
/obj/machinery/light_switch/directional/east,
/obj/machinery/atmospherics/pipe/smart/manifold4w/supply/hidden/layer4,
/turf/open/floor/iron/dark/textured,
/area/station/ai_monitored/security/armory/upper)
"l" = (
/obj/structure/table/reinforced,
/obj/machinery/door/firedoor,
/obj/machinery/door/window/brigdoor{
	name = "Armory Desk";
	req_access = list("armory")
	},
/obj/machinery/door/window/left/directional/north{
	name = "Armory Desk"
	},
/turf/open/floor/iron,
/area/station/ai_monitored/security/armory/upper)
"m" = (
/obj/structure/table,
/obj/item/storage/box/firingpins,
/obj/item/storage/box/firingpins,
/obj/item/key/security,
/obj/machinery/light/directional/east,
/obj/item/radio/intercom/prison/directional/east,
/turf/open/floor/iron/dark/textured,
/area/station/ai_monitored/security/armory/upper)
"n" = (
/obj/item/grenade/barrier{
	pixel_x = 4
	},
/obj/item/grenade/barrier,
/obj/item/grenade/barrier{
	pixel_x = -4
	},
/obj/structure/table,
/obj/effect/turf_decal/tile/red/half{
	dir = 8
	},
/turf/open/floor/iron/dark/textured,
/area/station/ai_monitored/security/armory/upper)
"o" = (
/obj/structure/railing,
/obj/machinery/flasher/portable,
/obj/effect/turf_decal/tile/red/half{
	dir = 1
	},
/obj/structure/cable,
/obj/machinery/door/firedoor/border_only,
/turf/open/floor/iron/dark/textured,
/area/station/ai_monitored/security/armory/upper)
"p" = (
/obj/machinery/door/airlock/security/glass{
	name = "Armory"
	},
/obj/effect/mapping_helpers/airlock/access/all/security/armory,
/obj/structure/cable,
/obj/machinery/door/firedoor,
/turf/open/floor/iron,
/area/station/ai_monitored/security/armory/upper)
"q" = (
/obj/structure/cable,
/turf/open/floor/iron/dark/textured,
/area/station/ai_monitored/security/armory/upper)
"r" = (
/turf/open/floor/glass/reinforced,
/area/station/ai_monitored/security/armory/upper)
"t" = (
/obj/effect/turf_decal/tile/red/anticorner/contrasted,
/turf/open/floor/iron/dark/textured,
/area/station/ai_monitored/security/armory/upper)
"w" = (
/obj/machinery/power/apc/auto_name/directional/east,
/obj/structure/closet/secure_closet/contraband/armory,
/obj/machinery/firealarm/directional/north,
/obj/effect/spawner/random/maintenance/three,
/obj/effect/spawner/random/contraband/armory,
/obj/effect/turf_decal/tile/red/half{
	dir = 8
	},
/obj/structure/cable,
/turf/open/floor/iron/dark/textured,
/area/station/ai_monitored/security/armory/upper)
"x" = (
/turf/open/floor/iron/dark/textured,
/area/station/ai_monitored/security/armory/upper)
"y" = (
/obj/effect/spawner/structure/window/reinforced,
/obj/structure/cable,
/turf/open/floor/plating,
/area/station/ai_monitored/security/armory/upper)
"z" = (
/obj/machinery/door/poddoor/shutters{
	id = "armory";
	name = "Armory Shutter"
	},
/turf/open/floor/iron,
/area/station/ai_monitored/security/armory/upper)
"E" = (
/obj/machinery/airalarm/directional/north,
/turf/open/floor/glass/reinforced,
/area/station/ai_monitored/security/armory/upper)
"J" = (
/obj/vehicle/ridden/secway,
/obj/effect/turf_decal/tile/red/half,
/obj/structure/cable,
/turf/open/floor/iron/dark/textured,
/area/station/ai_monitored/security/armory/upper)
"K" = (
/obj/effect/turf_decal/tile/red/half,
/turf/open/floor/iron/dark/textured,
/area/station/ai_monitored/security/armory/upper)
"N" = (
/obj/effect/turf_decal/tile/red/anticorner/contrasted{
	dir = 1
	},
/obj/machinery/atmospherics/components/unary/vent_pump/on/layer4{
	dir = 4
	},
/turf/open/floor/iron/dark/textured,
/area/station/ai_monitored/security/armory/upper)
"O" = (
/obj/item/gun/energy/laser/practice{
	pixel_y = 5
	},
/obj/item/gun/energy/laser/practice,
/obj/item/gun/energy/laser/practice{
	pixel_y = -5
	},
/obj/structure/rack,
/turf/open/floor/iron/dark/textured,
/area/station/security/office)
"P" = (
/obj/machinery/flasher/portable,
/obj/effect/turf_decal/tile/red/half,
/turf/open/floor/iron/dark/textured,
/area/station/ai_monitored/security/armory/upper)
"Q" = (
/obj/machinery/button/door/directional/east{
	id = "armory";
	name = "Armory Shutters";
	pixel_x = -9;
	pixel_y = 30;
	req_access = list("armory")
	},
/obj/structure/rack,
/obj/item/gun/energy/e_gun{
	pixel_x = -3;
	pixel_y = 3
	},
/obj/item/gun/energy/e_gun,
/obj/item/gun/energy/e_gun{
	pixel_x = 3;
	pixel_y = -3
	},
/obj/effect/turf_decal/tile/red/half{
	dir = 4
	},
/obj/machinery/light/directional/north,
/turf/open/floor/iron/dark/textured,
/area/station/ai_monitored/security/armory/upper)
"T" = (
/obj/machinery/door/airlock/security/glass{
	name = "Armory"
	},
/obj/effect/mapping_helpers/airlock/access/all/security/armory,
/obj/structure/cable,
/obj/machinery/atmospherics/pipe/smart/manifold4w/scrubbers/hidden/layer2,
/obj/machinery/door/firedoor,
/turf/open/floor/iron/dark/textured,
/area/station/ai_monitored/security/armory/upper)
"U" = (
/obj/machinery/door/airlock/security/glass{
	name = "Armory"
	},
/obj/effect/mapping_helpers/airlock/access/all/security/armory,
/obj/machinery/door/firedoor,
/turf/open/floor/iron/dark/textured,
/area/station/ai_monitored/security/armory/upper)
"W" = (
/obj/effect/turf_decal/tile/red/half{
	dir = 4
	},
/obj/structure/cable,
/obj/machinery/atmospherics/pipe/smart/manifold4w/scrubbers/hidden/layer2,
/obj/machinery/door/firedoor/border_only{
	dir = 8
	},
/turf/open/floor/iron/dark/textured,
/area/station/ai_monitored/security/armory/upper)
"Z" = (
/obj/effect/turf_decal/tile/red/anticorner/contrasted{
	dir = 8
	},
/obj/structure/cable,
/turf/open/floor/iron/dark/textured,
/area/station/ai_monitored/security/armory/upper)

(1,1,1) = {"
a
a
y
y
y
a
a
"}
(2,1,1) = {"
l
x
P
r
o
c
a
"}
(3,1,1) = {"
z
x
K
r
i
j
a
"}
(4,1,1) = {"
a
Q
t
r
b
W
T
"}
(5,1,1) = {"
a
E
r
r
r
r
U
"}
(6,1,1) = {"
a
w
Z
r
N
n
a
"}
(7,1,1) = {"
a
a
J
q
k
m
a
"}
(8,1,1) = {"
O
a
a
p
f
a
a
"}
