//MAP CONVERTED BY dmm2tgm.py THIS HEADER COMMENT PREVENTS RECONVERSION, DO NOT REMOVE
"a" = (
/obj/effect/spawner/structure/window/reinforced,
/turf/open/floor/plating,
/area/station/security/checkpoint/supply)
"b" = (
/obj/item/paper_bin{
	pixel_x = 1;
	pixel_y = 9
	},
/obj/item/pen,
/obj/structure/table,
/turf/open/floor/iron,
/area/station/security/checkpoint/supply)
"n" = (
/obj/machinery/recharger{
	pixel_y = 4
	},
/obj/structure/table,
/turf/open/floor/iron,
/area/station/security/checkpoint/supply)
"r" = (
/obj/item/radio/intercom/directional/east,
/obj/machinery/computer/secure_data{
	dir = 8
	},
/turf/open/floor/iron,
/area/station/security/checkpoint/supply)
"v" = (
/obj/machinery/atmospherics/pipe/smart/manifold4w/scrubbers/hidden/layer2,
/obj/machinery/atmospherics/components/unary/vent_pump/on/layer4{
	dir = 8
	},
/obj/structure/cable,
/obj/effect/landmark/start/customs_agent,
/turf/open/floor/iron,
/area/station/security/checkpoint/supply)
"w" = (
/obj/machinery/light_switch/directional/south,
/obj/structure/closet/secure_closet/security/cargo,
/turf/open/floor/iron,
/area/station/security/checkpoint/supply)
"z" = (
/obj/structure/chair/office{
	dir = 1
	},
/obj/machinery/atmospherics/pipe/smart/manifold4w/scrubbers/hidden/layer2,
/obj/effect/landmark/start/customs_agent,
/turf/open/floor/iron,
/area/station/security/checkpoint/supply)
"J" = (
/obj/machinery/requests_console/directional/south{
	anon_tips_receiver = 1;
	assistance_requestable = 1;
	department = "Security";
	departmentType = 5;
	name = "Security Requests Console"
	},
/obj/machinery/light/directional/south,
/obj/machinery/atmospherics/components/unary/vent_scrubber/on/layer2{
	dir = 1
	},
/obj/effect/landmark/start/customs_agent,
/turf/open/floor/iron,
/area/station/security/checkpoint/supply)
"Q" = (
/obj/structure/reagent_dispensers/wall/peppertank/directional/east,
/obj/machinery/newscaster/directional/south,
/obj/machinery/camera/directional/south{
	c_tag = "Security Post - Cargo"
	},
/obj/machinery/computer/security/mining{
	dir = 8
	},
/turf/open/floor/iron,
/area/station/security/checkpoint/supply)
"R" = (
/obj/machinery/airalarm/directional/east,
/obj/structure/table,
/turf/open/floor/iron,
/area/station/security/checkpoint/supply)
"S" = (
/obj/structure/table,
/obj/item/screwdriver{
	pixel_y = 10
	},
/obj/item/radio/off,
/turf/open/floor/iron,
/area/station/security/checkpoint/supply)
"W" = (
/obj/machinery/power/apc/auto_name/directional/south,
/obj/structure/cable,
/obj/structure/closet/secure_closet/security/cargo,
/turf/open/floor/iron,
/area/station/security/checkpoint/supply)
"X" = (
/obj/machinery/atmospherics/pipe/smart/manifold4w/scrubbers/hidden/layer2,
/obj/structure/cable,
/obj/effect/landmark/start/customs_agent,
/turf/open/floor/iron,
/area/station/security/checkpoint/supply)
"Y" = (
/obj/machinery/atmospherics/pipe/smart/manifold4w/scrubbers/hidden/layer2,
/obj/machinery/atmospherics/pipe/smart/manifold4w/supply/hidden/layer4,
/obj/structure/cable,
/obj/machinery/door/airlock/mining/glass{
	name = "Customs Agent Office"
	},
/obj/effect/mapping_helpers/airlock/access/any/supply/mining,
/turf/open/floor/iron,
/area/station/security/checkpoint/supply)

(1,1,1) = {"
a
Y
a
"}
(2,1,1) = {"
S
v
w
"}
(3,1,1) = {"
b
X
W
"}
(4,1,1) = {"
n
z
J
"}
(5,1,1) = {"
R
r
Q
"}
