//MAP CONVERTED BY dmm2tgm.py THIS HEADER COMMENT PREVENTS RECONVERSION, DO NOT REMOVE
"a" = (
/obj/structure/reagent_dispensers/wall/peppertank/directional/south,
/obj/structure/table,
/obj/machinery/recharger{
	pixel_y = 4
	},
/obj/item/screwdriver{
	pixel_y = 10
	},
/obj/machinery/power/apc/auto_name/directional/west,
/obj/structure/cable,
/turf/open/floor/iron,
/area/station/security/checkpoint/engineering)
"d" = (
/obj/structure/cable,
/obj/effect/landmark/start/engineering_guard,
/turf/open/floor/iron,
/area/station/security/checkpoint/engineering)
"f" = (
/obj/machinery/meter,
/obj/machinery/atmospherics/pipe/smart/manifold4w/scrubbers/visible,
/turf/closed/wall/r_wall,
/area/station/security/checkpoint/engineering)
"g" = (
/obj/structure/table,
/obj/item/paper_bin{
	pixel_x = 1;
	pixel_y = 9
	},
/obj/item/pen,
/obj/item/radio/off,
/turf/open/floor/iron,
/area/station/security/checkpoint/engineering)
"k" = (
/obj/structure/cable,
/obj/machinery/atmospherics/pipe/smart/manifold4w/supply/hidden/layer4,
/obj/machinery/atmospherics/pipe/smart/manifold4w/scrubbers/hidden/layer2,
/turf/open/floor/iron,
/area/station/security/checkpoint/engineering)
"o" = (
/obj/structure/cable,
/obj/machinery/atmospherics/pipe/smart/manifold4w/scrubbers/hidden/layer2,
/obj/machinery/holopad,
/obj/effect/turf_decal/bot,
/turf/open/floor/iron,
/area/station/security/checkpoint/engineering)
"u" = (
/obj/effect/spawner/structure/window/reinforced,
/obj/structure/cable,
/turf/open/floor/plating,
/area/station/security/checkpoint/engineering)
"B" = (
/obj/machinery/computer/security/telescreen/engine{
	dir = 8;
	pixel_x = 24
	},
/obj/machinery/camera/directional/east{
	c_tag = "Security Post - Engineering"
	},
/obj/structure/cable,
/obj/machinery/light/directional/east,
/turf/open/floor/iron,
/area/station/security/checkpoint/engineering)
"F" = (
/obj/machinery/atmospherics/pipe/smart/manifold4w/scrubbers/visible,
/turf/closed/wall/r_wall,
/area/station/security/checkpoint/engineering)
"G" = (
/obj/machinery/atmospherics/pipe/smart/manifold4w/supply/hidden/layer4,
/obj/machinery/atmospherics/pipe/smart/manifold4w/scrubbers/hidden/layer2,
/obj/machinery/door/firedoor,
/obj/structure/cable,
/obj/machinery/door/airlock/engineering/glass{
	name = "Engineering Guard Outpost"
	},
/obj/effect/mapping_helpers/airlock/access/all/engineering/engie_guard,
/turf/open/floor/iron,
/area/station/security/checkpoint/engineering)
"N" = (
/obj/structure/chair/office,
/obj/machinery/atmospherics/components/unary/vent_scrubber/on/layer2{
	dir = 1
	},
/obj/effect/landmark/start/engineering_guard,
/turf/open/floor/iron,
/area/station/security/checkpoint/engineering)
"O" = (
/obj/structure/closet/secure_closet/security/engine,
/obj/machinery/requests_console/directional/north{
	anon_tips_receiver = 1;
	assistance_requestable = 1;
	department = "Security";
	departmentType = 5;
	name = "Security Requests Console"
	},
/obj/machinery/newscaster/directional/west,
/turf/open/floor/iron,
/area/station/security/checkpoint/engineering)
"P" = (
/obj/machinery/atmospherics/pipe/smart/manifold4w/scrubbers/hidden/layer2,
/obj/machinery/atmospherics/components/unary/vent_pump/on/layer4{
	dir = 4
	},
/obj/effect/landmark/start/engineering_guard,
/turf/open/floor/iron,
/area/station/security/checkpoint/engineering)
"R" = (
/turf/closed/wall/r_wall,
/area/station/engineering/lobby)
"S" = (
/obj/structure/filingcabinet,
/obj/machinery/airalarm/directional/north,
/obj/structure/cable,
/turf/open/floor/iron,
/area/station/security/checkpoint/engineering)
"T" = (
/obj/structure/cable,
/obj/item/radio/intercom/directional/east,
/obj/machinery/computer/station_alert{
	dir = 1
	},
/turf/open/floor/iron,
/area/station/security/checkpoint/engineering)
"U" = (
/turf/closed/wall/r_wall,
/area/station/security/checkpoint/engineering)
"Z" = (
/obj/structure/cable,
/obj/structure/closet/secure_closet/security/engine,
/turf/open/floor/iron,
/area/station/security/checkpoint/engineering)

(1,1,1) = {"
f
F
U
S
d
a
"}
(2,1,1) = {"
U
O
P
o
N
g
"}
(3,1,1) = {"
U
Z
k
B
d
T
"}
(4,1,1) = {"
U
u
G
U
u
R
"}
