//MAP CONVERTED BY dmm2tgm.py THIS HEADER COMMENT PREVENTS RECONVERSION, DO NOT REMOVE
"a" = (
/obj/structure/cable,
/obj/machinery/atmospherics/pipe/smart/manifold4w/supply/hidden/layer4,
/obj/machinery/atmospherics/pipe/smart/manifold4w/scrubbers/hidden/layer2,
/turf/open/floor/iron,
/area/station/hallway/primary/central)
"k" = (
/obj/structure/ladder,
/turf/open/floor/plating,
/area/station/maintenance/central/greater)
"o" = (
/obj/effect/turf_decal/tile/blue,
/obj/machinery/firealarm/directional/east,
/turf/open/floor/iron,
/area/station/hallway/primary/central)
"r" = (
/obj/machinery/door/airlock/maintenance,
/obj/structure/cable,
/obj/effect/mapping_helpers/airlock/unres{
	dir = 4
	},
/obj/effect/mapping_helpers/airlock/access/all/engineering/maintenance,
/obj/machinery/atmospherics/pipe/smart/manifold4w/supply/hidden/layer4,
/obj/machinery/atmospherics/pipe/smart/manifold4w/scrubbers/hidden/layer2,
/turf/open/floor/plating,
/area/station/maintenance/central/greater)
"s" = (
/obj/structure/cable/multilayer/multiz,
/turf/open/floor/plating,
/area/station/maintenance/central/greater)
"E" = (
/turf/closed/wall/r_wall,
/area/station/maintenance/central/greater)
"I" = (
/obj/effect/landmark/blobstart,
/obj/structure/cable,
/obj/machinery/atmospherics/pipe/smart/manifold4w/supply/hidden/layer4,
/obj/machinery/atmospherics/pipe/smart/manifold4w/scrubbers/hidden/layer2,
/turf/open/floor/plating,
/area/station/maintenance/central/greater)
"M" = (
/obj/structure/cable,
/obj/effect/spawner/random/maintenance,
/obj/machinery/atmospherics/pipe/smart/manifold4w/supply/hidden/layer4,
/obj/machinery/atmospherics/pipe/smart/manifold4w/scrubbers/hidden/layer2,
/turf/open/floor/plating,
/area/station/maintenance/central/greater)
"R" = (
/obj/machinery/atmospherics/pipe/smart/manifold4w/scrubbers/hidden/layer2,
/turf/open/floor/plating,
/area/station/maintenance/central/greater)
"W" = (
/obj/machinery/power/apc/auto_name/directional/north,
/obj/structure/cable,
/turf/open/floor/plating,
/area/station/maintenance/central/greater)
"X" = (
/obj/structure/cable,
/obj/machinery/atmospherics/pipe/smart/manifold4w/supply/hidden/layer4,
/obj/machinery/atmospherics/pipe/smart/manifold4w/scrubbers/hidden/layer2,
/turf/open/floor/plating,
/area/station/maintenance/central/greater)
"Z" = (
/obj/machinery/atmospherics/pipe/multiz/scrubbers/visible/layer2{
	color = "#ff0000";
	dir = 8;
	name = "Scrubbers multi deck pipe adapter"
	},
/obj/machinery/atmospherics/pipe/multiz/supply/visible/layer4{
	color = "#0000ff";
	dir = 8;
	name = "Supply multi deck pipe adapter"
	},
/turf/open/floor/plating,
/area/station/maintenance/central/greater)

(1,1,1) = {"
o
a
"}
(2,1,1) = {"
E
r
"}
(3,1,1) = {"
R
X
"}
(4,1,1) = {"
k
M
"}
(5,1,1) = {"
W
I
"}
(6,1,1) = {"
s
Z
"}
