//MAP CONVERTED BY dmm2tgm.py THIS HEADER COMMENT PREVENTS RECONVERSION, DO NOT REMOVE
"a" = (
/turf/closed/wall,
/area/station/service/salon)
"b" = (
/obj/effect/turf_decal/tile/purple,
/obj/effect/turf_decal/tile/purple{
	dir = 1
	},
/turf/open/floor/iron,
/area/station/service/salon)
"c" = (
/obj/effect/turf_decal/tile/purple{
	dir = 1
	},
/obj/effect/turf_decal/tile/purple,
/obj/effect/landmark/start/barber,
/obj/machinery/button/curtain{
	id = "barbershopcurtains1";
	pixel_x = 25;
	pixel_y = 24
	},
/turf/open/floor/iron,
/area/station/service/salon)
"d" = (
/obj/structure/mirror/directional/west,
/obj/structure/table/reinforced/rglass,
/obj/item/hairbrush/comb{
	pixel_y = 10
	},
/obj/item/reagent_containers/dropper,
/obj/machinery/dryer{
	pixel_y = 14
	},
/turf/open/floor/iron,
/area/station/service/salon)
"e" = (
/obj/effect/turf_decal/tile/purple{
	dir = 1
	},
/obj/effect/turf_decal/tile/purple,
/obj/structure/table/reinforced/rglass,
/obj/item/hairbrush,
/turf/open/floor/iron,
/area/station/service/salon)
"f" = (
/obj/effect/turf_decal/tile/purple{
	dir = 1
	},
/obj/effect/turf_decal/tile/purple,
/obj/structure/bed/pod,
/obj/structure/window,
/turf/open/floor/iron,
/area/station/service/salon)
"g" = (
/turf/open/floor/iron/dark,
/area/station/hallway/primary/central)
"h" = (
/obj/machinery/atmospherics/pipe/smart/manifold4w/supply/hidden/layer4,
/obj/machinery/atmospherics/pipe/smart/manifold4w/scrubbers/hidden/layer2,
/obj/effect/turf_decal/tile/purple,
/obj/effect/turf_decal/tile/purple{
	dir = 1
	},
/obj/structure/cable,
/turf/open/floor/iron,
/area/station/service/salon)
"i" = (
/obj/effect/turf_decal/tile/neutral,
/obj/machinery/atmospherics/pipe/smart/manifold4w/supply/hidden/layer4,
/obj/effect/turf_decal/tile/purple{
	dir = 1
	},
/obj/effect/turf_decal/tile/purple,
/turf/open/floor/iron,
/area/station/service/salon)
"j" = (
/obj/machinery/atmospherics/pipe/smart/manifold4w/scrubbers/hidden/layer2,
/obj/machinery/atmospherics/pipe/smart/manifold4w/supply/hidden/layer4,
/obj/structure/disposalpipe/segment{
	dir = 10
	},
/obj/effect/turf_decal/tile/purple,
/obj/effect/turf_decal/tile/purple{
	dir = 1
	},
/turf/open/floor/iron,
/area/station/service/salon)
"k" = (
/obj/structure/disposalpipe/segment,
/turf/closed/wall,
/area/station/service/salon)
"l" = (
/obj/machinery/atmospherics/pipe/smart/manifold4w/supply/hidden/layer4,
/obj/machinery/atmospherics/pipe/smart/manifold4w/scrubbers/hidden/layer2,
/obj/structure/cable,
/turf/open/floor/iron/dark,
/area/station/hallway/primary/central)
"m" = (
/obj/structure/disposalpipe/segment{
	dir = 10
	},
/obj/effect/spawner/structure/window,
/obj/structure/curtain/cloth/fancy/mechanical{
	id = "barbershopcurtains"
	},
/turf/open/floor/plating,
/area/station/service/salon)
"n" = (
/obj/machinery/newscaster/directional/north,
/obj/effect/turf_decal/tile/purple{
	dir = 1
	},
/obj/effect/turf_decal/tile/purple,
/obj/structure/chair/office/light{
	dir = 4
	},
/obj/structure/window{
	dir = 8
	},
/obj/machinery/camera/directional/north{
	c_tag = "Salon"
	},
/turf/open/floor/iron,
/area/station/service/salon)
"o" = (
/obj/structure/disposalpipe/segment{
	dir = 4
	},
/obj/effect/turf_decal/tile/purple,
/obj/effect/turf_decal/tile/purple{
	dir = 1
	},
/obj/machinery/button/curtain{
	id = "barbershopcurtains";
	pixel_x = 25;
	pixel_y = -24
	},
/obj/structure/chair{
	dir = 1
	},
/turf/open/floor/iron,
/area/station/service/salon)
"p" = (
/turf/closed/wall,
/area/station/maintenance/port/greater)
"q" = (
/obj/effect/turf_decal/tile/purple{
	dir = 1
	},
/obj/effect/turf_decal/tile/purple,
/obj/machinery/holopad,
/turf/open/floor/iron,
/area/station/service/salon)
"r" = (
/obj/structure/closet/firecloset,
/turf/open/floor/plating,
/area/station/maintenance/port/greater)
"s" = (
/obj/effect/spawner/structure/window,
/obj/structure/curtain/cloth/fancy/mechanical{
	id = "barbershopcurtains"
	},
/turf/open/floor/plating,
/area/station/service/salon)
"t" = (
/obj/machinery/atmospherics/pipe/smart/manifold4w/supply/hidden/layer4,
/obj/effect/turf_decal/tile/purple{
	dir = 1
	},
/obj/effect/turf_decal/tile/purple,
/turf/open/floor/iron,
/area/station/service/salon)
"u" = (
/obj/effect/turf_decal/tile/purple{
	dir = 1
	},
/obj/effect/turf_decal/tile/purple,
/obj/structure/chair/comfy/barber_chair{
	dir = 8
	},
/turf/open/floor/iron,
/area/station/service/salon)
"w" = (
/obj/structure/disposalpipe/segment{
	dir = 5
	},
/obj/effect/turf_decal/tile/purple,
/obj/effect/turf_decal/tile/purple{
	dir = 1
	},
/obj/machinery/vending/barbervend,
/turf/open/floor/iron,
/area/station/service/salon)
"x" = (
/obj/effect/turf_decal/tile/purple{
	dir = 1
	},
/obj/effect/turf_decal/tile/purple,
/obj/effect/landmark/start/barber,
/turf/open/floor/iron,
/area/station/service/salon)
"y" = (
/obj/effect/turf_decal/tile/purple{
	dir = 1
	},
/obj/effect/turf_decal/tile/purple,
/obj/structure/chair/office/light{
	dir = 4
	},
/obj/structure/window,
/obj/structure/window{
	dir = 8
	},
/turf/open/floor/iron,
/area/station/service/salon)
"z" = (
/obj/machinery/atmospherics/components/unary/vent_pump/on/layer4,
/obj/effect/turf_decal/tile/purple{
	dir = 1
	},
/obj/effect/turf_decal/tile/purple,
/turf/open/floor/iron,
/area/station/service/salon)
"A" = (
/obj/structure/disposalpipe/segment{
	dir = 4
	},
/obj/machinery/door/airlock/maintenance{
	req_access = list("maint_tunnels")
	},
/turf/open/floor/plating,
/area/station/service/salon)
"C" = (
/obj/effect/turf_decal/tile/purple,
/obj/effect/turf_decal/tile/purple{
	dir = 1
	},
/obj/machinery/atmospherics/pipe/smart/manifold4w/supply/hidden/layer4,
/obj/machinery/atmospherics/pipe/smart/manifold4w/scrubbers/hidden/layer2,
/obj/structure/cable,
/turf/open/floor/iron,
/area/station/service/salon)
"D" = (
/turf/open/openspace,
/area/station/hallway/primary/central)
"E" = (
/obj/effect/turf_decal/tile/purple{
	dir = 1
	},
/obj/effect/turf_decal/tile/purple,
/obj/structure/sink{
	dir = 4;
	pixel_x = -12
	},
/turf/open/floor/iron,
/area/station/service/salon)
"F" = (
/obj/effect/turf_decal/tile/purple{
	dir = 1
	},
/obj/effect/turf_decal/tile/purple,
/obj/structure/table/reinforced/rglass,
/obj/structure/window,
/obj/item/hairbrush,
/obj/item/lipstick/random,
/turf/open/floor/iron,
/area/station/service/salon)
"H" = (
/obj/effect/turf_decal/tile/purple{
	dir = 1
	},
/obj/effect/turf_decal/tile/purple,
/turf/open/floor/iron,
/area/station/service/salon)
"I" = (
/obj/machinery/disposal/bin,
/obj/structure/disposalpipe/trunk,
/obj/effect/turf_decal/tile/purple,
/obj/effect/turf_decal/tile/purple{
	dir = 1
	},
/obj/machinery/light_switch/directional/west,
/obj/machinery/dryer{
	dir = 4;
	pixel_x = -6;
	pixel_y = -6
	},
/turf/open/floor/iron,
/area/station/service/salon)
"K" = (
/obj/structure/disposalpipe/segment{
	dir = 4
	},
/obj/effect/turf_decal/tile/purple,
/obj/effect/turf_decal/tile/purple{
	dir = 1
	},
/turf/open/floor/iron,
/area/station/service/salon)
"M" = (
/obj/machinery/atmospherics/pipe/smart/manifold4w/scrubbers/hidden/layer2,
/obj/machinery/atmospherics/pipe/smart/manifold4w/supply/hidden/layer4,
/obj/effect/turf_decal/tile/purple,
/obj/effect/turf_decal/tile/purple{
	dir = 1
	},
/turf/open/floor/iron,
/area/station/service/salon)
"O" = (
/obj/machinery/power/apc/auto_name/directional/south,
/obj/structure/cable,
/obj/machinery/atmospherics/pipe/smart/manifold4w/supply/hidden/layer4,
/obj/machinery/atmospherics/pipe/smart/manifold4w/scrubbers/hidden/layer2,
/obj/structure/disposalpipe/segment{
	dir = 4
	},
/obj/effect/turf_decal/tile/purple,
/obj/effect/turf_decal/tile/purple{
	dir = 1
	},
/obj/structure/chair{
	dir = 1
	},
/turf/open/floor/iron,
/area/station/service/salon)
"P" = (
/obj/structure/mirror/directional/west,
/obj/structure/table/reinforced/rglass,
/obj/item/razor{
	pixel_x = -6
	},
/obj/item/reagent_containers/spray/barbers_aid{
	pixel_x = 6
	},
/turf/open/floor/iron,
/area/station/service/salon)
"Q" = (
/obj/item/storage/secure/safe/directional/south,
/obj/machinery/light/directional/south,
/obj/structure/disposalpipe/segment{
	dir = 4
	},
/obj/effect/turf_decal/tile/purple,
/obj/effect/turf_decal/tile/purple{
	dir = 1
	},
/obj/structure/closet/secure_closet/barber,
/turf/open/floor/iron,
/area/station/service/salon)
"R" = (
/obj/effect/turf_decal/tile/purple,
/obj/effect/turf_decal/tile/purple{
	dir = 1
	},
/obj/machinery/door/airlock/public/glass{
	name = "Barbershop"
	},
/obj/machinery/door/firedoor,
/obj/machinery/atmospherics/pipe/smart/manifold4w/supply/hidden/layer4,
/obj/machinery/atmospherics/pipe/smart/manifold4w/scrubbers/hidden/layer2,
/obj/structure/cable,
/turf/open/floor/iron,
/area/station/service/salon)
"S" = (
/obj/effect/spawner/random/maintenance,
/obj/structure/disposalpipe/segment{
	dir = 4
	},
/turf/open/floor/plating,
/area/station/maintenance/port/greater)
"T" = (
/obj/machinery/firealarm/directional/north,
/obj/effect/turf_decal/tile/purple{
	dir = 1
	},
/obj/effect/turf_decal/tile/purple,
/obj/structure/bed/pod,
/obj/effect/landmark/start/hangover,
/turf/open/floor/iron,
/area/station/service/salon)
"U" = (
/obj/structure/sign/barber{
	pixel_x = -13
	},
/obj/machinery/door/firedoor/border_only{
	dir = 1
	},
/turf/open/floor/iron/dark,
/area/station/hallway/primary/central)
"V" = (
/obj/effect/turf_decal/tile/purple{
	dir = 1
	},
/obj/effect/turf_decal/tile/purple,
/obj/machinery/atmospherics/components/unary/vent_scrubber/on/layer2,
/turf/open/floor/iron,
/area/station/service/salon)
"W" = (
/obj/machinery/airalarm/directional/north,
/obj/effect/turf_decal/tile/purple{
	dir = 1
	},
/obj/effect/turf_decal/tile/purple,
/obj/machinery/light/warm/directional/north,
/obj/item/kirbyplants/random,
/turf/open/floor/iron,
/area/station/service/salon)
"X" = (
/obj/effect/spawner/structure/window,
/obj/structure/curtain/cloth/fancy/mechanical{
	id = "barbershopcurtains1"
	},
/turf/open/floor/plating,
/area/station/service/salon)
"Y" = (
/obj/item/radio/intercom/directional/west,
/obj/structure/table/reinforced/rglass,
/obj/item/reagent_containers/spray/quantum_hair_dye{
	pixel_x = 6
	},
/obj/item/lipstick/random,
/turf/open/floor/iron,
/area/station/service/salon)
"Z" = (
/obj/effect/turf_decal/tile/purple{
	dir = 1
	},
/obj/effect/turf_decal/tile/purple,
/obj/structure/chair/comfy/barber_chair{
	dir = 8
	},
/obj/effect/landmark/start/hangover,
/turf/open/floor/iron,
/area/station/service/salon)

(1,1,1) = {"
p
p
p
p
p
S
r
p
"}
(2,1,1) = {"
a
d
Y
P
a
A
a
a
"}
(3,1,1) = {"
a
u
x
Z
E
K
I
k
"}
(4,1,1) = {"
a
W
z
t
i
j
w
a
"}
(5,1,1) = {"
a
n
H
y
b
M
Q
a
"}
(6,1,1) = {"
a
T
q
f
b
h
O
a
"}
(7,1,1) = {"
a
e
c
F
V
C
o
a
"}
(8,1,1) = {"
a
a
X
a
s
R
m
k
"}
(9,1,1) = {"
a
D
D
U
g
l
l
a
"}
