//MAP CONVERTED BY dmm2tgm.py THIS HEADER COMMENT PREVENTS RECONVERSION, DO NOT REMOVE
"a" = (
/obj/structure/filingcabinet,
/obj/structure/sign/poster/official/space_cops{
	pixel_x = -32
	},
/turf/open/floor/iron/white,
/area/station/security/checkpoint/science)
"c" = (
/obj/structure/table,
/obj/item/book/manual/wiki/security_space_law,
/obj/item/radio/off,
/turf/open/floor/iron/white,
/area/station/security/checkpoint/science)
"d" = (
/obj/machinery/camera/directional/west{
	c_tag = "Security Post - Science";
	network = list("ss13","rd")
	},
/obj/machinery/newscaster/directional/west,
/obj/machinery/light/directional/west,
/obj/structure/closet/secure_closet/security/science,
/turf/open/floor/iron/white,
/area/station/security/checkpoint/science)
"e" = (
/obj/structure/chair/office{
	dir = 4
	},
/obj/effect/landmark/start/science_guard,
/turf/open/floor/iron/white,
/area/station/security/checkpoint/science)
"f" = (
/obj/structure/cable,
/obj/machinery/atmospherics/pipe/smart/manifold4w/scrubbers/hidden/layer2,
/obj/machinery/atmospherics/pipe/smart/manifold4w/supply/hidden/layer4,
/obj/effect/mapping_helpers/airlock/access/all/science/sci_guard,
/obj/machinery/door/airlock/research/glass{
	name = "Science Guard Post"
	},
/turf/open/floor/iron/white,
/area/station/security/checkpoint/science)
"h" = (
/obj/structure/cable,
/obj/machinery/atmospherics/pipe/smart/manifold4w/scrubbers/hidden/layer2,
/turf/open/floor/iron/white,
/area/station/security/checkpoint/science)
"i" = (
/turf/closed/wall,
/area/station/security/checkpoint/science)
"o" = (
/obj/structure/cable,
/obj/effect/landmark/start/science_guard,
/turf/open/floor/iron/white,
/area/station/security/checkpoint/science)
"p" = (
/obj/structure/table,
/obj/item/paper_bin{
	pixel_x = 1;
	pixel_y = 9
	},
/obj/item/pen,
/obj/item/radio/intercom/directional/south,
/turf/open/floor/iron/white,
/area/station/security/checkpoint/science)
"z" = (
/obj/structure/reagent_dispensers/wall/peppertank/directional/west,
/obj/machinery/airalarm/directional/north,
/obj/structure/closet/secure_closet/security/science,
/turf/open/floor/iron/white,
/area/station/security/checkpoint/science)
"A" = (
/obj/structure/table,
/obj/machinery/computer/security/telescreen/research,
/turf/open/floor/iron/white,
/area/station/security/checkpoint/science)
"C" = (
/obj/structure/cable,
/obj/machinery/atmospherics/components/unary/vent_scrubber/on/layer2{
	dir = 4
	},
/obj/machinery/power/apc/auto_name/directional/south,
/turf/open/floor/iron/white,
/area/station/security/checkpoint/science)
"D" = (
/obj/structure/cable,
/obj/machinery/atmospherics/pipe/smart/manifold4w/scrubbers/hidden/layer2,
/obj/machinery/atmospherics/pipe/smart/manifold4w/supply/hidden/layer4,
/turf/open/floor/iron/white,
/area/station/security/checkpoint/science)
"I" = (
/obj/structure/table,
/obj/machinery/recharger{
	pixel_y = 4
	},
/obj/item/screwdriver{
	pixel_y = 10
	},
/turf/open/floor/iron/white,
/area/station/security/checkpoint/science)
"J" = (
/obj/effect/spawner/structure/window/reinforced,
/turf/open/floor/plating,
/area/station/security/checkpoint/science)
"L" = (
/obj/machinery/light_switch/directional/north{
	pixel_x = 4
	},
/obj/machinery/atmospherics/components/unary/vent_pump/on/layer4{
	dir = 4
	},
/obj/machinery/button/door/directional/north{
	id = "Biohazard";
	name = "Biohazard Shutter Control";
	pixel_x = -6;
	req_access = list("research")
	},
/obj/effect/landmark/start/science_guard,
/turf/open/floor/iron/white,
/area/station/security/checkpoint/science)
"N" = (
/obj/machinery/requests_console/directional/south{
	anon_tips_receiver = 1;
	assistance_requestable = 1;
	department = "Security";
	departmentType = 5;
	name = "Security Requests Console"
	},
/obj/machinery/computer/mecha{
	dir = 1
	},
/turf/open/floor/iron/white,
/area/station/security/checkpoint/science)
"O" = (
/obj/machinery/atmospherics/pipe/smart/manifold4w/scrubbers/hidden/layer2,
/turf/open/floor/iron/white,
/area/station/security/checkpoint/science)

(1,1,1) = {"
i
z
d
a
"}
(2,1,1) = {"
i
L
o
C
"}
(3,1,1) = {"
f
D
h
O
"}
(4,1,1) = {"
J
A
e
N
"}
(5,1,1) = {"
J
I
c
p
"}
