//MAP CONVERTED BY dmm2tgm.py THIS HEADER COMMENT PREVENTS RECONVERSION, DO NOT REMOVE
"ac" = (
/obj/effect/turf_decal/tile/purple{
	dir = 1
	},
/obj/effect/turf_decal/tile/purple,
/turf/open/floor/iron,
/area/station/service/barber)
"ad" = (
/obj/effect/turf_decal/tile/purple{
	dir = 1
	},
/obj/effect/turf_decal/tile/purple,
/obj/effect/landmark/start/barber,
/turf/open/floor/iron,
/area/station/service/barber)
"af" = (
/turf/closed/wall,
/area/station/maintenance/port/greater)
"ag" = (
/obj/structure/mirror/directional/west,
/obj/structure/table/glass,
/obj/item/razor{
	pixel_x = -6
	},
/obj/item/reagent_containers/spray/barbers_aid{
	pixel_x = 6
	},
/turf/open/floor/iron,
/area/station/service/barber)
"ah" = (
/obj/effect/turf_decal/tile/purple,
/obj/effect/turf_decal/tile/purple{
	dir = 1
	},
/obj/machinery/door/airlock/public/glass{
	name = "Barbershop"
	},
/obj/machinery/door/firedoor,
/obj/machinery/atmospherics/pipe/smart/manifold4w/supply/hidden/layer4,
/obj/machinery/atmospherics/pipe/smart/manifold4w/scrubbers/hidden/layer2,
/obj/structure/cable,
/turf/open/floor/iron,
/area/station/service/barber)
"ai" = (
/obj/structure/railing/corner{
	dir = 8
	},
/turf/open/floor/iron,
/area/station/hallway/primary/central)
"aj" = (
/obj/effect/turf_decal/tile/purple{
	dir = 1
	},
/obj/effect/turf_decal/tile/purple,
/obj/structure/chair/office/light{
	dir = 4
	},
/obj/structure/window/spawner/directional/south,
/obj/structure/window/spawner/directional/west,
/turf/open/floor/iron,
/area/station/service/barber)
"ak" = (
/obj/machinery/power/apc/auto_name/directional/south,
/obj/structure/cable,
/obj/machinery/atmospherics/pipe/smart/manifold4w/supply/hidden/layer4,
/obj/machinery/atmospherics/pipe/smart/manifold4w/scrubbers/hidden/layer2,
/obj/structure/disposalpipe/segment{
	dir = 4
	},
/obj/effect/turf_decal/tile/purple,
/obj/effect/turf_decal/tile/purple{
	dir = 1
	},
/obj/structure/chair{
	dir = 1
	},
/turf/open/floor/iron,
/area/station/service/barber)
"al" = (
/obj/effect/turf_decal/tile/purple{
	dir = 1
	},
/obj/effect/turf_decal/tile/purple,
/obj/structure/chair/comfy/barber_chair{
	dir = 8
	},
/turf/open/floor/iron,
/area/station/service/barber)
"am" = (
/obj/structure/railing/corner{
	dir = 1
	},
/obj/machinery/atmospherics/components/unary/vent_pump/on/layer4{
	dir = 4
	},
/turf/open/floor/iron,
/area/station/hallway/primary/central)
"an" = (
/obj/structure/disposalpipe/segment{
	dir = 4
	},
/obj/effect/turf_decal/tile/purple,
/obj/effect/turf_decal/tile/purple{
	dir = 1
	},
/obj/machinery/button/curtain{
	id = "barbershopcurtains";
	pixel_x = 25;
	pixel_y = -24
	},
/obj/structure/chair{
	dir = 1
	},
/turf/open/floor/iron,
/area/station/service/barber)
"ao" = (
/obj/machinery/atmospherics/pipe/smart/manifold4w/scrubbers/hidden/layer2,
/obj/machinery/atmospherics/pipe/smart/manifold4w/supply/hidden/layer4,
/obj/structure/disposalpipe/segment{
	dir = 10
	},
/obj/effect/turf_decal/tile/purple,
/obj/effect/turf_decal/tile/purple{
	dir = 1
	},
/turf/open/floor/iron,
/area/station/service/barber)
"ap" = (
/obj/structure/disposalpipe/segment,
/turf/closed/wall,
/area/station/service/barber)
"aq" = (
/obj/machinery/airalarm/directional/north,
/obj/effect/turf_decal/tile/purple{
	dir = 1
	},
/obj/effect/turf_decal/tile/purple,
/obj/machinery/light/warm/directional/north,
/obj/item/kirbyplants/random,
/turf/open/floor/iron,
/area/station/service/barber)
"ar" = (
/obj/effect/turf_decal/tile/purple{
	dir = 1
	},
/obj/effect/turf_decal/tile/purple,
/obj/machinery/holopad,
/turf/open/floor/iron,
/area/station/service/barber)
"as" = (
/obj/effect/spawner/structure/window,
/obj/structure/curtain/cloth/fancy/mechanical{
	id = "barbershopcurtains1"
	},
/turf/open/floor/plating,
/area/station/service/barber)
"at" = (
/turf/open/openspace,
/area/station/hallway/primary/central)
"au" = (
/obj/item/radio/intercom/directional/west,
/obj/structure/table/glass,
/obj/item/reagent_containers/spray/quantum_hair_dye{
	pixel_x = 6
	},
/obj/item/lipstick/random,
/turf/open/floor/iron,
/area/station/service/barber)
"av" = (
/obj/machinery/atmospherics/pipe/smart/manifold4w/supply/hidden/layer4,
/obj/machinery/atmospherics/pipe/smart/manifold4w/scrubbers/hidden/layer2,
/obj/effect/turf_decal/tile/purple,
/obj/effect/turf_decal/tile/purple{
	dir = 1
	},
/obj/structure/cable,
/turf/open/floor/iron,
/area/station/service/barber)
"aw" = (
/obj/structure/mirror/directional/west,
/obj/structure/table/glass,
/obj/item/hairbrush/comb{
	pixel_y = 10
	},
/obj/item/reagent_containers/dropper,
/obj/machinery/dryer{
	pixel_y = 14
	},
/turf/open/floor/iron,
/area/station/service/barber)
"ax" = (
/obj/effect/turf_decal/tile/purple,
/obj/effect/turf_decal/tile/purple{
	dir = 1
	},
/obj/machinery/atmospherics/pipe/smart/manifold4w/supply/hidden/layer4,
/obj/machinery/atmospherics/pipe/smart/manifold4w/scrubbers/hidden/layer2,
/obj/structure/cable,
/turf/open/floor/iron,
/area/station/service/barber)
"ay" = (
/obj/machinery/newscaster/directional/north,
/obj/effect/turf_decal/tile/purple{
	dir = 1
	},
/obj/effect/turf_decal/tile/purple,
/obj/structure/chair/office/light{
	dir = 4
	},
/obj/structure/window/spawner/directional/west,
/obj/machinery/camera/directional/north{
	c_tag = "Salon"
	},
/turf/open/floor/iron,
/area/station/service/barber)
"az" = (
/obj/effect/turf_decal/tile/neutral,
/obj/machinery/atmospherics/pipe/smart/manifold4w/supply/hidden/layer4,
/obj/effect/turf_decal/tile/purple{
	dir = 1
	},
/obj/effect/turf_decal/tile/purple,
/turf/open/floor/iron,
/area/station/service/barber)
"aA" = (
/obj/structure/disposalpipe/segment{
	dir = 10
	},
/obj/effect/spawner/structure/window,
/obj/structure/curtain/cloth/fancy/mechanical{
	id = "barbershopcurtains"
	},
/turf/open/floor/plating,
/area/station/service/barber)
"aB" = (
/obj/structure/disposalpipe/segment{
	dir = 4
	},
/obj/effect/turf_decal/tile/purple,
/obj/effect/turf_decal/tile/purple{
	dir = 1
	},
/turf/open/floor/iron,
/area/station/service/barber)
"aC" = (
/obj/effect/turf_decal/tile/purple{
	dir = 1
	},
/obj/effect/turf_decal/tile/purple,
/obj/structure/table/glass,
/obj/structure/window/spawner/directional/south,
/obj/item/hairbrush,
/obj/item/lipstick/random,
/turf/open/floor/iron,
/area/station/service/barber)
"aD" = (
/obj/machinery/atmospherics/pipe/smart/manifold4w/supply/hidden/layer4,
/obj/effect/turf_decal/tile/purple{
	dir = 1
	},
/obj/effect/turf_decal/tile/purple,
/turf/open/floor/iron,
/area/station/service/barber)
"aE" = (
/obj/structure/disposalpipe/segment{
	dir = 5
	},
/obj/effect/turf_decal/tile/purple,
/obj/effect/turf_decal/tile/purple{
	dir = 1
	},
/obj/machinery/vending/barbervend,
/turf/open/floor/iron,
/area/station/service/barber)
"aF" = (
/obj/structure/disposalpipe/segment{
	dir = 4
	},
/obj/machinery/door/airlock/maintenance{
	req_access = list("maint_tunnels")
	},
/turf/open/floor/plating,
/area/station/service/barber)
"aG" = (
/obj/effect/turf_decal/tile/purple,
/obj/effect/turf_decal/tile/purple{
	dir = 1
	},
/turf/open/floor/iron,
/area/station/service/barber)
"aH" = (
/obj/machinery/light/directional/south,
/obj/structure/disposalpipe/segment{
	dir = 4
	},
/obj/effect/turf_decal/tile/purple,
/obj/effect/turf_decal/tile/purple{
	dir = 1
	},
/obj/structure/closet/secure_closet/barber,
/turf/open/floor/iron,
/area/station/service/barber)
"aI" = (
/obj/effect/turf_decal/tile/purple{
	dir = 1
	},
/obj/effect/turf_decal/tile/purple,
/obj/structure/chair/comfy/barber_chair{
	dir = 8
	},
/obj/effect/landmark/start/hangover,
/turf/open/floor/iron,
/area/station/service/barber)
"aJ" = (
/obj/structure/railing{
	dir = 8
	},
/obj/machinery/door/firedoor/border_only{
	dir = 8
	},
/turf/open/floor/iron,
/area/station/hallway/primary/central)
"aK" = (
/obj/effect/turf_decal/tile/purple{
	dir = 1
	},
/obj/effect/turf_decal/tile/purple,
/obj/machinery/atmospherics/components/unary/vent_scrubber/on/layer2,
/turf/open/floor/iron,
/area/station/service/barber)
"aL" = (
/obj/structure/sign/barber{
	pixel_x = -13
	},
/obj/machinery/door/firedoor/border_only{
	dir = 1
	},
/turf/open/floor/iron/dark,
/area/station/hallway/primary/central)
"aN" = (
/obj/machinery/atmospherics/pipe/smart/manifold4w/scrubbers/hidden/layer2,
/obj/machinery/atmospherics/pipe/smart/manifold4w/supply/hidden/layer4,
/obj/effect/turf_decal/tile/purple,
/obj/effect/turf_decal/tile/purple{
	dir = 1
	},
/turf/open/floor/iron,
/area/station/service/barber)
"aP" = (
/obj/effect/turf_decal/tile/purple{
	dir = 1
	},
/obj/effect/turf_decal/tile/purple,
/obj/structure/sink/directional/east,
/turf/open/floor/iron,
/area/station/service/barber)
"aQ" = (
/obj/effect/turf_decal/tile/purple{
	dir = 1
	},
/obj/effect/turf_decal/tile/purple,
/obj/structure/table/glass,
/obj/item/hairbrush,
/turf/open/floor/iron,
/area/station/service/barber)
"aR" = (
/turf/closed/wall,
/area/station/service/barber)
"aS" = (
/obj/machinery/disposal/bin,
/obj/structure/disposalpipe/trunk,
/obj/effect/turf_decal/tile/purple,
/obj/effect/turf_decal/tile/purple{
	dir = 1
	},
/obj/machinery/light_switch/directional/west,
/obj/machinery/dryer{
	dir = 4;
	pixel_x = -6;
	pixel_y = -6
	},
/turf/open/floor/iron,
/area/station/service/barber)
"aT" = (
/obj/effect/spawner/structure/window,
/obj/structure/curtain/cloth/fancy/mechanical{
	id = "barbershopcurtains"
	},
/turf/open/floor/plating,
/area/station/service/barber)
"aV" = (
/obj/machinery/atmospherics/components/unary/vent_pump/on/layer4,
/obj/effect/turf_decal/tile/purple{
	dir = 1
	},
/obj/effect/turf_decal/tile/purple,
/turf/open/floor/iron,
/area/station/service/barber)
"aW" = (
/obj/machinery/firealarm/directional/north,
/obj/effect/turf_decal/tile/purple{
	dir = 1
	},
/obj/effect/turf_decal/tile/purple,
/obj/structure/bed/pod,
/obj/effect/landmark/start/hangover,
/turf/open/floor/iron,
/area/station/service/barber)
"aX" = (
/obj/effect/turf_decal/tile/purple{
	dir = 1
	},
/obj/effect/turf_decal/tile/purple,
/obj/structure/bed/pod,
/obj/structure/window/spawner/directional/south,
/turf/open/floor/iron,
/area/station/service/barber)
"aZ" = (
/obj/effect/turf_decal/tile/purple{
	dir = 1
	},
/obj/effect/turf_decal/tile/purple,
/obj/effect/landmark/start/barber,
/obj/machinery/button/curtain{
	id = "barbershopcurtains1";
	pixel_x = 25;
	pixel_y = 24
	},
/turf/open/floor/iron,
/area/station/service/barber)
"lL" = (
/obj/machinery/atmospherics/pipe/smart/manifold4w/supply/hidden/layer4,
/obj/machinery/atmospherics/pipe/smart/manifold4w/scrubbers/hidden/layer2,
/obj/structure/cable,
/turf/open/floor/iron,
/area/station/hallway/primary/central)
"vq" = (
/turf/template_noop,
/area/template_noop)

(1,1,1) = {"
af
af
af
af
af
vq
vq
vq
"}
(2,1,1) = {"
aR
aw
au
ag
aR
aF
aR
aR
"}
(3,1,1) = {"
aR
al
ad
aI
aP
aB
aS
ap
"}
(4,1,1) = {"
aR
aq
aV
aD
az
ao
aE
aR
"}
(5,1,1) = {"
aR
ay
ac
aj
aG
aN
aH
aR
"}
(6,1,1) = {"
aR
aW
ar
aX
aG
av
ak
aR
"}
(7,1,1) = {"
aR
aQ
aZ
aC
aK
ax
an
aR
"}
(8,1,1) = {"
aR
aR
as
aR
aT
ah
aA
ap
"}
(9,1,1) = {"
aR
at
at
aL
vq
lL
vq
aR
"}
(10,1,1) = {"
ai
aJ
aJ
am
vq
vq
vq
vq
"}
