//MAP CONVERTED BY dmm2tgm.py THIS HEADER COMMENT PREVENTS RECONVERSION, DO NOT REMOVE
"ad" = (
/obj/structure/chair/sofa/bench{
	dir = 4;
	pixel_x = -5
	},
/obj/effect/landmark/start/assistant,
/turf/open/floor/iron/dark/side{
	dir = 8
	},
/area/station/hallway/secondary/entry)
"aF" = (
/turf/closed/wall/r_wall/rust,
/area/station/hallway/secondary/entry)
"bW" = (
/obj/effect/turf_decal/bot,
/obj/structure/closet/crate/internals,
/turf/open/floor/iron/dark,
/area/station/command/cc_dock)
"cd" = (
/obj/machinery/atmospherics/components/unary/vent_pump/on/layer4{
	dir = 4
	},
/turf/open/floor/iron,
/area/station/hallway/secondary/entry)
"dS" = (
/obj/structure/railing{
	dir = 1
	},
/obj/effect/turf_decal/stripes/corner{
	dir = 4
	},
/obj/machinery/atmospherics/pipe/smart/simple/supply/hidden/layer4{
	dir = 4
	},
/obj/machinery/atmospherics/pipe/smart/simple/scrubbers/hidden/layer2{
	dir = 4
	},
/turf/open/floor/iron/dark/side{
	dir = 1
	},
/area/station/hallway/secondary/entry)
"ek" = (
/obj/machinery/status_display/ai,
/turf/closed/wall,
/area/station/hallway/secondary/entry)
"ep" = (
/obj/machinery/light/small/directional/north,
/turf/open/floor/plating,
/area/station/hallway/secondary/entry)
"eq" = (
/obj/effect/turf_decal/bot,
/obj/structure/decorative/shelf/soda_multipacks,
/turf/open/floor/iron/dark,
/area/station/command/cc_dock)
"er" = (
/obj/machinery/status_display/evac,
/turf/closed/wall,
/area/station/hallway/secondary/entry)
"ev" = (
/obj/machinery/light/floor,
/obj/effect/turf_decal/bot,
/turf/open/floor/plating,
/area/station/hallway/secondary/entry)
"eT" = (
/obj/machinery/light/directional/south,
/obj/structure/cable,
/obj/structure/noticeboard/directional/south,
/turf/open/floor/iron/dark/side,
/area/station/hallway/secondary/entry)
"ff" = (
/obj/structure/chair/sofa/bench/right{
	dir = 4;
	pixel_x = -5
	},
/obj/effect/landmark/start/assistant,
/turf/open/floor/iron/dark/side{
	dir = 8
	},
/area/station/hallway/secondary/entry)
"fo" = (
/obj/structure/chair/sofa/bench/left{
	dir = 1
	},
/obj/structure/cable,
/obj/effect/landmark/start/assistant,
/turf/open/floor/iron/dark/side,
/area/station/hallway/secondary/entry)
"gf" = (
/obj/structure/window/reinforced{
	dir = 8
	},
/obj/structure/chair/sofa/bench/right{
	dir = 4
	},
/obj/effect/landmark/start/assistant,
/turf/open/floor/iron/dark/side{
	dir = 8
	},
/area/station/hallway/secondary/entry)
"gl" = (
/obj/structure/railing{
	dir = 4
	},
/turf/open/floor/iron/dark/side{
	dir = 4
	},
/area/station/hallway/secondary/entry)
"gs" = (
/obj/machinery/light/directional/south,
/obj/structure/cable,
/turf/open/floor/iron/dark/side,
/area/station/hallway/secondary/entry)
"gu" = (
/obj/machinery/atmospherics/components/unary/vent_pump/on/layer4{
	dir = 8
	},
/turf/open/floor/iron,
/area/station/hallway/secondary/entry)
"gD" = (
/obj/structure/chair/sofa/bench{
	dir = 8;
	pixel_x = 5
	},
/obj/effect/landmark/start/assistant,
/turf/open/floor/iron/dark/side{
	dir = 4
	},
/area/station/hallway/secondary/entry)
"hl" = (
/obj/structure/railing/corner{
	dir = 1
	},
/obj/machinery/atmospherics/pipe/smart/simple/supply/hidden/layer4{
	dir = 4
	},
/obj/machinery/atmospherics/pipe/smart/simple/scrubbers/hidden/layer2{
	dir = 4
	},
/obj/effect/turf_decal/delivery/red,
/obj/effect/turf_decal/stripes{
	dir = 8
	},
/turf/open/floor/iron,
/area/station/hallway/secondary/entry)
"ho" = (
/obj/structure/cable,
/obj/effect/turf_decal/arrows{
	dir = 8
	},
/turf/open/floor/iron/dark/side,
/area/station/hallway/secondary/entry)
"ht" = (
/obj/machinery/atmospherics/pipe/smart/simple/supply/hidden/layer4{
	dir = 4
	},
/obj/machinery/atmospherics/pipe/smart/manifold/scrubbers/hidden/layer2,
/turf/open/floor/iron,
/area/station/hallway/secondary/entry)
"hE" = (
/obj/structure/railing/corner{
	dir = 4
	},
/obj/structure/railing/corner{
	dir = 1
	},
/obj/effect/turf_decal/stripes{
	dir = 1
	},
/obj/machinery/atmospherics/pipe/smart/simple/supply/hidden/layer4{
	dir = 4
	},
/obj/machinery/atmospherics/pipe/smart/simple/scrubbers/hidden/layer2{
	dir = 4
	},
/turf/open/floor/iron/dark/side{
	dir = 1
	},
/area/station/hallway/secondary/entry)
"hL" = (
/obj/structure/chair/sofa/bench/left{
	dir = 8;
	pixel_x = 5
	},
/turf/open/floor/iron/dark/side{
	dir = 4
	},
/area/station/hallway/secondary/entry)
"hU" = (
/obj/machinery/light/directional/west,
/obj/machinery/airalarm/directional/west,
/turf/open/floor/iron,
/area/station/hallway/secondary/entry)
"ih" = (
/obj/effect/turf_decal/stripes{
	dir = 1
	},
/turf/open/floor/plating,
/area/station/hallway/secondary/entry)
"ix" = (
/obj/effect/turf_decal/stripes{
	dir = 9
	},
/turf/open/floor/plating,
/area/station/hallway/secondary/entry)
"iy" = (
/obj/effect/turf_decal/bot,
/obj/structure/decorative/shelf/crates,
/turf/open/floor/iron/dark,
/area/station/command/cc_dock)
"iF" = (
/obj/machinery/door/firedoor,
/obj/effect/turf_decal/delivery/white,
/obj/machinery/door/poddoor/shutters/window/preopen{
	id = "ArrivalsEntry";
	name = "Free Acces Shutters"
	},
/turf/open/floor/iron/dark,
/area/station/hallway/secondary/entry)
"iP" = (
/obj/item/kirbyplants/random,
/obj/machinery/camera/directional/west{
	c_tag = "Arrivals - Lounge 2";
	name = "arrivals camera"
	},
/turf/open/floor/iron/dark/side{
	dir = 8
	},
/area/station/hallway/secondary/entry)
"iU" = (
/obj/structure/fans/tiny/forcefield{
	dir = 8
	},
/obj/effect/turf_decal/stripes{
	dir = 4
	},
/obj/effect/turf_decal/stripes{
	dir = 8
	},
/turf/open/floor/plating,
/area/station/hallway/secondary/entry)
"js" = (
/obj/machinery/computer/shuttle/arrivals/recall,
/obj/effect/turf_decal/bot,
/turf/open/floor/iron,
/area/station/hallway/secondary/entry)
"jF" = (
/obj/effect/turf_decal/stripes{
	dir = 8
	},
/turf/open/floor/plating,
/area/station/hallway/secondary/entry)
"kG" = (
/obj/item/kirbyplants/random,
/obj/machinery/light/directional/east,
/turf/open/floor/iron/dark/side{
	dir = 6
	},
/area/station/hallway/secondary/entry)
"kV" = (
/obj/effect/turf_decal/bot,
/obj/structure/closet/crate{
	icon_state = "crateopen"
	},
/obj/effect/spawner/random/clothing/gloves,
/turf/open/floor/iron/dark,
/area/station/command/cc_dock)
"kY" = (
/obj/machinery/atmospherics/components/unary/vent_scrubber/on/layer2{
	dir = 8
	},
/turf/open/floor/iron,
/area/station/hallway/secondary/entry)
"le" = (
/obj/structure/window/reinforced{
	dir = 8
	},
/obj/structure/chair/sofa/bench/left{
	dir = 4
	},
/turf/open/floor/iron/dark/side{
	dir = 8
	},
/area/station/hallway/secondary/entry)
"lk" = (
/obj/structure/chair/sofa/bench/left{
	dir = 4;
	pixel_x = -5
	},
/obj/effect/landmark/start/assistant,
/turf/open/floor/iron/dark/side{
	dir = 8
	},
/area/station/hallway/secondary/entry)
"lI" = (
/obj/structure/chair/sofa/bench/right{
	dir = 8;
	pixel_x = 5
	},
/turf/open/floor/iron/dark/side{
	dir = 4
	},
/area/station/hallway/secondary/entry)
"lV" = (
/obj/structure/cable,
/turf/open/floor/iron,
/area/station/hallway/secondary/entry)
"mf" = (
/obj/machinery/atmospherics/components/unary/vent_scrubber/on/layer2{
	dir = 4
	},
/obj/item/radio/intercom/directional/west,
/turf/open/floor/iron,
/area/station/hallway/secondary/entry)
"mA" = (
/obj/effect/turf_decal/stripes/corner{
	dir = 8
	},
/turf/open/floor/plating,
/area/station/hallway/secondary/entry)
"mF" = (
/obj/machinery/door/firedoor,
/obj/effect/turf_decal/delivery/white,
/obj/machinery/door/poddoor/shutters/window/preopen{
	id = "ArrivalsEntry";
	name = "Free Acces Shutters"
	},
/obj/machinery/atmospherics/pipe/smart/simple/supply/hidden/layer4,
/obj/machinery/atmospherics/pipe/smart/simple/scrubbers/hidden/layer2,
/turf/open/floor/iron/dark,
/area/station/hallway/secondary/entry)
"nq" = (
/obj/structure/cable,
/obj/machinery/atmospherics/pipe/smart/simple/supply/hidden/layer4{
	dir = 4
	},
/obj/machinery/atmospherics/pipe/smart/simple/scrubbers/hidden/layer2{
	dir = 4
	},
/turf/open/floor/iron,
/area/station/hallway/secondary/entry)
"ns" = (
/obj/structure/railing{
	dir = 1
	},
/obj/effect/turf_decal/stripes/corner{
	dir = 1
	},
/obj/machinery/atmospherics/pipe/smart/manifold/supply/hidden/layer4{
	dir = 1
	},
/obj/machinery/atmospherics/pipe/smart/manifold/scrubbers/hidden/layer2{
	dir = 1
	},
/turf/open/floor/iron/dark/side{
	dir = 1
	},
/area/station/hallway/secondary/entry)
"oq" = (
/obj/machinery/atmospherics/pipe/smart/simple/supply/hidden/layer4{
	dir = 6
	},
/obj/machinery/atmospherics/pipe/smart/simple/scrubbers/hidden/layer2,
/turf/open/floor/iron,
/area/station/hallway/secondary/entry)
"ou" = (
/obj/structure/fans/tiny/forcefield{
	dir = 8
	},
/obj/effect/turf_decal/stripes{
	dir = 4
	},
/obj/effect/turf_decal/stripes{
	dir = 8
	},
/turf/open/floor/iron/smooth_half,
/area/station/hallway/secondary/entry)
"ph" = (
/turf/closed/wall/r_wall,
/area/station/command/cc_dock)
"pO" = (
/obj/machinery/atmospherics/pipe/smart/simple/scrubbers/hidden/layer2{
	dir = 10
	},
/turf/open/floor/iron,
/area/station/hallway/secondary/entry)
"qe" = (
/obj/machinery/atmospherics/pipe/smart/simple/scrubbers/hidden/layer2,
/turf/open/floor/iron,
/area/station/hallway/secondary/entry)
"qj" = (
/obj/machinery/atmospherics/pipe/smart/simple/supply/hidden/layer4{
	dir = 4
	},
/obj/machinery/atmospherics/pipe/smart/simple/scrubbers/hidden/layer2{
	dir = 4
	},
/turf/open/floor/iron,
/area/station/hallway/secondary/entry)
"qt" = (
/obj/effect/turf_decal/stripes{
	dir = 1
	},
/obj/machinery/camera/directional/north{
	c_tag = "Arrivals - Shuttle Dock";
	name = "arrivals camera"
	},
/turf/open/floor/plating,
/area/station/hallway/secondary/entry)
"qz" = (
/obj/effect/turf_decal/bot,
/obj/effect/turf_decal/loading_area{
	dir = 4
	},
/turf/open/floor/iron/smooth_half,
/area/station/hallway/secondary/entry)
"rL" = (
/obj/machinery/vending/cigarette,
/obj/effect/turf_decal/bot,
/obj/machinery/firealarm/directional/north,
/turf/open/floor/iron/dark/corner{
	dir = 4
	},
/area/station/hallway/secondary/entry)
"sq" = (
/obj/effect/spawner/structure/window/reinforced,
/turf/open/floor/plating,
/area/station/command/cc_dock)
"sJ" = (
/obj/structure/chair/sofa/bench/right{
	dir = 8;
	pixel_x = 5
	},
/obj/machinery/light/directional/east,
/obj/effect/landmark/start/assistant,
/turf/open/floor/iron/dark/side{
	dir = 4
	},
/area/station/hallway/secondary/entry)
"sU" = (
/obj/structure/extinguisher_cabinet,
/turf/closed/wall,
/area/station/hallway/secondary/entry)
"tE" = (
/turf/open/floor/iron,
/area/station/hallway/secondary/entry)
"uk" = (
/obj/machinery/atmospherics/pipe/smart/simple/scrubbers/hidden/layer2{
	dir = 6
	},
/turf/open/floor/iron,
/area/station/hallway/secondary/entry)
"uR" = (
/obj/structure/flora/bush/grassy,
/obj/structure/flora/bush/flowers_br,
/obj/structure/window/reinforced/fulltile,
/turf/open/floor/grass,
/area/station/hallway/secondary/entry)
"vK" = (
/obj/structure/chair/sofa/bench/left{
	dir = 8;
	pixel_x = 5
	},
/obj/machinery/light/directional/east,
/turf/open/floor/iron/dark/side{
	dir = 4
	},
/area/station/hallway/secondary/entry)
"vR" = (
/obj/structure/railing/corner{
	dir = 1
	},
/obj/structure/railing/corner{
	dir = 4
	},
/obj/effect/turf_decal/stripes{
	dir = 1
	},
/obj/machinery/atmospherics/pipe/smart/simple/supply/hidden/layer4{
	dir = 4
	},
/obj/machinery/atmospherics/pipe/smart/simple/scrubbers/hidden/layer2{
	dir = 4
	},
/obj/effect/landmark/navigate_destination{
	location = "Arrival Shuttle"
	},
/turf/open/floor/iron/dark/side{
	dir = 1
	},
/area/station/hallway/secondary/entry)
"we" = (
/obj/effect/turf_decal/bot,
/obj/structure/decorative/shelf/crates1,
/turf/open/floor/iron/dark,
/area/station/command/cc_dock)
"ww" = (
/obj/effect/turf_decal/bot_white,
/obj/effect/turf_decal/loading_area/white{
	dir = 8
	},
/obj/structure/cable,
/obj/machinery/door/poddoor/shutters/window/preopen{
	id = "ArrivalsEntry4";
	name = "Line Acces Shutter"
	},
/obj/machinery/atmospherics/pipe/smart/simple/supply/hidden/layer4{
	dir = 4
	},
/obj/machinery/atmospherics/pipe/smart/simple/scrubbers/hidden/layer2{
	dir = 4
	},
/turf/open/floor/iron/dark,
/area/station/hallway/secondary/entry)
"xM" = (
/obj/machinery/newscaster/directional/south,
/turf/open/floor/iron/dark/side,
/area/station/hallway/secondary/entry)
"zh" = (
/obj/structure/chair/sofa/bench/left{
	dir = 4;
	pixel_x = -5
	},
/obj/machinery/light/directional/west,
/obj/effect/landmark/start/assistant,
/turf/open/floor/iron/dark/side{
	dir = 8
	},
/area/station/hallway/secondary/entry)
"zi" = (
/obj/effect/turf_decal/stripes{
	dir = 5
	},
/turf/open/floor/plating,
/area/station/hallway/secondary/entry)
"zA" = (
/obj/effect/turf_decal/stripes{
	dir = 4
	},
/turf/open/floor/plating,
/area/station/hallway/secondary/entry)
"zR" = (
/obj/machinery/light/directional/south,
/obj/effect/turf_decal/arrows{
	dir = 8
	},
/turf/open/floor/iron/dark/side,
/area/station/hallway/secondary/entry)
"Ak" = (
/obj/effect/turf_decal/stripes/corner,
/turf/open/floor/plating,
/area/station/hallway/secondary/entry)
"Ax" = (
/obj/effect/turf_decal/stripes{
	dir = 4
	},
/turf/open/floor/iron/smooth_half,
/area/station/hallway/secondary/entry)
"Bi" = (
/obj/structure/falsewall,
/turf/open/floor/plating,
/area/station/command/cc_dock)
"Bn" = (
/obj/effect/turf_decal/bot,
/obj/structure/decorative/shelf,
/turf/open/floor/iron/dark,
/area/station/command/cc_dock)
"DY" = (
/obj/structure/cable,
/obj/machinery/atmospherics/pipe/smart/simple/supply/hidden/layer4,
/obj/machinery/atmospherics/pipe/smart/simple/scrubbers/hidden/layer2,
/turf/open/floor/iron/dark/side,
/area/station/hallway/secondary/entry)
"Eh" = (
/obj/structure/flora/grass/jungle,
/obj/structure/flora/bush/grassy,
/obj/structure/flora/bush/flowers_br,
/obj/structure/window/reinforced/fulltile,
/turf/open/floor/grass,
/area/station/hallway/secondary/entry)
"Ei" = (
/obj/machinery/atmospherics/pipe/smart/simple/scrubbers/hidden/layer2,
/turf/open/floor/iron/smooth_half,
/area/station/hallway/secondary/entry)
"FL" = (
/turf/closed/wall,
/area/station/command/cc_dock)
"FO" = (
/obj/effect/turf_decal/bot,
/obj/machinery/portable_atmospherics/canister/air,
/turf/open/floor/iron/dark,
/area/station/command/cc_dock)
"FQ" = (
/obj/structure/reagent_dispensers/fueltank{
	pixel_y = 1
	},
/obj/effect/turf_decal/bot,
/turf/open/floor/iron,
/area/station/hallway/secondary/entry)
"Gp" = (
/turf/open/floor/iron/dark/small,
/area/station/hallway/secondary/entry)
"GJ" = (
/turf/closed/wall/r_wall,
/area/station/hallway/secondary/entry)
"Hj" = (
/obj/structure/table,
/obj/machinery/light/directional/south,
/obj/structure/cable,
/obj/machinery/newscaster/directional/west,
/turf/open/floor/iron/dark/side,
/area/station/hallway/secondary/entry)
"Hy" = (
/obj/effect/turf_decal/stripes,
/turf/open/floor/plating,
/area/station/hallway/secondary/entry)
"HP" = (
/obj/machinery/door/poddoor/shutters/window/preopen{
	id = "ArrivalsEntry";
	name = "Free Acces Shutters"
	},
/obj/machinery/door/firedoor,
/obj/effect/turf_decal/delivery/white,
/turf/open/floor/iron/dark,
/area/station/hallway/secondary/entry)
"IX" = (
/obj/structure/chair/sofa/bench/right{
	dir = 1
	},
/obj/structure/cable,
/turf/open/floor/iron/dark/side,
/area/station/hallway/secondary/entry)
"KZ" = (
/obj/item/kirbyplants/random,
/obj/machinery/camera/directional/east{
	c_tag = "Arrivals - Lounge 1";
	name = "arrivals camera"
	},
/turf/open/floor/iron/dark/side{
	dir = 4
	},
/area/station/hallway/secondary/entry)
"Lc" = (
/obj/structure/chair/sofa/bench/right{
	dir = 4;
	pixel_x = -5
	},
/obj/machinery/light/directional/west,
/obj/effect/landmark/start/assistant,
/turf/open/floor/iron/dark/side{
	dir = 8
	},
/area/station/hallway/secondary/entry)
"Lm" = (
/obj/effect/turf_decal/stripes{
	dir = 10
	},
/turf/open/floor/plating,
/area/station/hallway/secondary/entry)
"Mg" = (
/turf/open/floor/iron/smooth_half,
/area/station/hallway/secondary/entry)
"MF" = (
/obj/effect/turf_decal/arrows{
	dir = 8
	},
/turf/open/floor/iron/dark/side,
/area/station/hallway/secondary/entry)
"ND" = (
/obj/structure/reagent_dispensers/watertank,
/obj/effect/turf_decal/bot,
/turf/open/floor/iron,
/area/station/hallway/secondary/entry)
"NE" = (
/obj/machinery/camera/directional/south{
	c_tag = "Arrivals - Shuttle Dock";
	name = "arrivals camera"
	},
/obj/machinery/status_display/evac/directional/south,
/turf/open/floor/iron/dark/side,
/area/station/hallway/secondary/entry)
"Oc" = (
/obj/structure/railing{
	dir = 1
	},
/obj/effect/turf_decal/stripes/corner{
	dir = 1
	},
/obj/machinery/atmospherics/pipe/smart/simple/supply/hidden/layer4{
	dir = 4
	},
/obj/machinery/atmospherics/pipe/smart/simple/scrubbers/hidden/layer2{
	dir = 4
	},
/obj/effect/turf_decal/loading_area{
	dir = 8
	},
/obj/effect/turf_decal/stripes{
	dir = 4
	},
/turf/open/floor/iron/dark/side{
	dir = 5
	},
/area/station/hallway/secondary/entry)
"Oe" = (
/obj/structure/flora/grass/jungle,
/obj/structure/flora/bush/flowers_pp,
/obj/structure/window/reinforced/fulltile,
/turf/open/floor/grass,
/area/station/hallway/secondary/entry)
"Ok" = (
/obj/machinery/atmospherics/pipe/smart/simple/supply/hidden/layer4{
	dir = 9
	},
/turf/open/floor/iron,
/area/station/hallway/secondary/entry)
"OM" = (
/obj/structure/window/reinforced{
	dir = 8
	},
/obj/structure/chair/sofa/bench{
	dir = 4
	},
/obj/effect/landmark/start/assistant,
/turf/open/floor/iron/dark/side{
	dir = 8
	},
/area/station/hallway/secondary/entry)
"Pk" = (
/obj/machinery/atmospherics/pipe/smart/simple/supply/hidden/layer4{
	dir = 9
	},
/obj/machinery/atmospherics/pipe/smart/simple/scrubbers/hidden/layer2{
	dir = 9
	},
/turf/open/floor/iron,
/area/station/hallway/secondary/entry)
"PY" = (
/obj/structure/railing/corner{
	dir = 4
	},
/obj/machinery/atmospherics/pipe/smart/simple/supply/hidden/layer4{
	dir = 4
	},
/obj/machinery/atmospherics/pipe/smart/simple/scrubbers/hidden/layer2{
	dir = 4
	},
/turf/open/floor/iron/dark/corner{
	dir = 4
	},
/area/station/hallway/secondary/entry)
"Qk" = (
/obj/structure/window/reinforced{
	dir = 8
	},
/obj/structure/chair/sofa/bench{
	dir = 4
	},
/turf/open/floor/iron/dark/side{
	dir = 8
	},
/area/station/hallway/secondary/entry)
"QZ" = (
/obj/structure/flora/grass/jungle,
/obj/structure/flora/bush/grassy,
/obj/structure/flora/bush/flowers_yw,
/obj/structure/window/reinforced/fulltile,
/turf/open/floor/grass,
/area/station/hallway/secondary/entry)
"RB" = (
/obj/structure/window/reinforced{
	dir = 8
	},
/obj/structure/chair/sofa/bench/left{
	dir = 4
	},
/obj/effect/landmark/start/assistant,
/turf/open/floor/iron/dark/side{
	dir = 8
	},
/area/station/hallway/secondary/entry)
"SN" = (
/obj/machinery/atmospherics/pipe/smart/manifold/supply/hidden/layer4{
	dir = 4
	},
/obj/machinery/atmospherics/pipe/smart/simple/scrubbers/hidden/layer2{
	dir = 9
	},
/turf/open/floor/iron,
/area/station/hallway/secondary/entry)
"Td" = (
/obj/machinery/vending/clothing,
/obj/effect/turf_decal/bot,
/obj/structure/railing/corner,
/turf/open/floor/iron/dark/side{
	dir = 5
	},
/area/station/hallway/secondary/entry)
"TU" = (
/obj/structure/chair/sofa/bench{
	dir = 4;
	pixel_x = -5
	},
/turf/open/floor/iron/dark/side{
	dir = 8
	},
/area/station/hallway/secondary/entry)
"UU" = (
/obj/effect/turf_decal/stripes{
	dir = 6
	},
/turf/open/floor/plating,
/area/station/hallway/secondary/entry)
"Vc" = (
/turf/open/floor/plating,
/area/station/hallway/secondary/entry)
"Vd" = (
/turf/open/floor/iron/dark/side,
/area/station/hallway/secondary/entry)
"Wb" = (
/obj/effect/spawner/structure/window/reinforced,
/turf/open/floor/plating,
/area/station/hallway/secondary/entry)
"We" = (
/obj/effect/turf_decal/bot_white,
/obj/effect/turf_decal/loading_area/white{
	dir = 4
	},
/obj/machinery/door/poddoor/shutters/window/preopen{
	id = "ArrivalsEntry3";
	name = "Line Reroute Shutter"
	},
/obj/machinery/atmospherics/pipe/smart/simple/supply/hidden/layer4{
	dir = 4
	},
/obj/machinery/atmospherics/pipe/smart/simple/scrubbers/hidden/layer2{
	dir = 4
	},
/turf/open/floor/iron/dark,
/area/station/hallway/secondary/entry)
"Wf" = (
/obj/structure/railing{
	dir = 1
	},
/obj/machinery/atmospherics/pipe/smart/simple/supply/hidden/layer4{
	dir = 4
	},
/obj/machinery/atmospherics/pipe/smart/simple/scrubbers/hidden/layer2{
	dir = 4
	},
/turf/open/floor/iron/dark/side{
	dir = 1
	},
/area/station/hallway/secondary/entry)
"WP" = (
/obj/docking_port/stationary{
	dir = 8;
	dwidth = 1;
	height = 13;
	shuttle_id = "arrivals_stationary";
	name = "arrivals";
	width = 7
	},
/turf/open/floor/iron/smooth_half,
/area/station/hallway/secondary/entry)
"Xz" = (
/obj/structure/railing{
	dir = 1
	},
/obj/machinery/atmospherics/pipe/smart/simple/supply/hidden/layer4{
	dir = 4
	},
/obj/machinery/atmospherics/pipe/smart/simple/scrubbers/hidden/layer2{
	dir = 4
	},
/turf/open/floor/iron/stairs{
	dir = 4
	},
/area/station/hallway/secondary/entry)
"XW" = (
/obj/effect/turf_decal/delivery,
/obj/structure/closet/crate/internals,
/obj/machinery/light/directional/east,
/turf/open/floor/iron/dark,
/area/station/hallway/secondary/entry)
"Yn" = (
/obj/structure/chair/sofa/bench{
	dir = 1
	},
/obj/structure/cable,
/obj/effect/landmark/start/assistant,
/obj/structure/extinguisher_cabinet/directional/south,
/turf/open/floor/iron/dark/side,
/area/station/hallway/secondary/entry)
"YB" = (
/obj/item/beacon,
/turf/open/floor/iron,
/area/station/hallway/secondary/entry)
"ZB" = (
/obj/effect/turf_decal/delivery,
/obj/structure/rack,
/obj/item/weldingtool,
/obj/item/clothing/head/welding,
/obj/machinery/light/directional/east,
/turf/open/floor/iron/dark,
/area/station/hallway/secondary/entry)
"ZH" = (
/obj/structure/fans/tiny/forcefield{
	dir = 8
	},
/obj/effect/turf_decal/stripes{
	dir = 4
	},
/obj/effect/turf_decal/stripes{
	dir = 8
	},
/obj/machinery/light/floor,
/turf/open/floor/plating,
/area/station/hallway/secondary/entry)
"ZI" = (
/obj/structure/window/reinforced{
	dir = 8
	},
/obj/structure/chair/sofa/bench/right{
	dir = 4
	},
/turf/open/floor/iron/dark/side{
	dir = 8
	},
/area/station/hallway/secondary/entry)
"ZN" = (
/obj/effect/turf_decal/bot,
/obj/effect/turf_decal/loading_area{
	dir = 4
	},
/turf/open/floor/iron/dark,
/area/station/hallway/secondary/entry)
"ZO" = (
/turf/closed/wall,
/area/station/hallway/secondary/entry)

(1,1,1) = {"
ZO
We
ZO
le
OM
gf
ZO
RB
Qk
ZI
ZO
ww
ZO
"}
(2,1,1) = {"
HP
qj
cd
tE
tE
tE
hU
tE
tE
tE
mf
nq
Hj
"}
(3,1,1) = {"
mF
SN
Ok
sJ
gD
hL
KZ
lI
gD
vK
pO
ht
fo
"}
(4,1,1) = {"
iF
tE
tE
ek
QZ
Oe
sU
uR
Eh
er
js
qj
Yn
"}
(5,1,1) = {"
FL
rL
tE
zh
ad
ff
iP
lk
TU
Lc
tE
qj
IX
"}
(6,1,1) = {"
FL
Td
gl
gl
gl
gl
gl
gl
gl
gl
gl
PY
eT
"}
(7,1,1) = {"
FL
FL
ix
jF
ev
jF
jF
jF
ev
jF
Lm
Wf
lV
"}
(8,1,1) = {"
iy
sq
ih
Mg
Vc
Mg
Vc
Mg
Vc
Mg
Hy
Wf
lV
"}
(9,1,1) = {"
Bn
sq
Vc
Mg
Vc
Mg
Vc
Mg
Vc
Mg
Vc
Wf
lV
"}
(10,1,1) = {"
we
sq
ih
Gp
Vc
Gp
Vc
Gp
Vc
Gp
Ak
dS
gs
"}
(11,1,1) = {"
FL
FL
ih
Mg
Vc
Mg
Vc
Mg
Vc
Mg
Hy
vR
ho
"}
(12,1,1) = {"
Bi
ep
Vc
Mg
Vc
Mg
Vc
Mg
Vc
Mg
mA
ns
DY
"}
(13,1,1) = {"
FL
FL
ih
Mg
Vc
Mg
Vc
Mg
Vc
Mg
Vc
Wf
xM
"}
(14,1,1) = {"
we
sq
ih
Mg
Vc
Mg
Vc
Mg
Vc
Mg
Hy
Wf
NE
"}
(15,1,1) = {"
kV
sq
qt
Gp
ev
Gp
Vc
Gp
ev
Gp
Hy
Wf
zR
"}
(16,1,1) = {"
iy
sq
ih
Mg
Vc
Mg
Vc
Mg
Vc
Mg
Hy
Wf
Vd
"}
(17,1,1) = {"
FL
FL
ih
Mg
Vc
Mg
Vc
Mg
Vc
Mg
Vc
Wf
Vd
"}
(18,1,1) = {"
FL
ep
Vc
Mg
Vc
Mg
Vc
Mg
Vc
Mg
Ak
dS
Vd
"}
(19,1,1) = {"
FL
FL
ih
Mg
Vc
Mg
Vc
Mg
Vc
Mg
Hy
hE
MF
"}
(20,1,1) = {"
FO
sq
ih
Gp
Vc
Gp
Vc
Gp
Vc
Gp
mA
Oc
kG
"}
(21,1,1) = {"
eq
sq
Vc
Mg
Vc
Mg
Vc
Mg
Vc
WP
Vc
Xz
GJ
"}
(22,1,1) = {"
bW
sq
ih
Mg
Vc
Mg
Vc
Mg
Vc
Mg
Hy
hl
GJ
"}
(23,1,1) = {"
ph
FL
zi
Ax
ev
Ax
zA
Ax
ev
Ax
UU
qj
Wb
"}
(24,1,1) = {"
ph
ND
uk
Ei
qe
Ei
qe
Ei
qe
Ei
oq
Pk
Wb
"}
(25,1,1) = {"
ph
FQ
kY
Mg
tE
Mg
YB
Mg
tE
Mg
gu
tE
Wb
"}
(26,1,1) = {"
ph
ZB
ZN
qz
ZN
qz
ZN
qz
ZN
qz
ZN
XW
aF
"}
(27,1,1) = {"
aF
aF
iU
ou
ZH
ou
iU
ou
ZH
ou
iU
GJ
aF
"}
