//MAP CONVERTED BY dmm2tgm.py THIS HEADER COMMENT PREVENTS RECONVERSION, DO NOT REMOVE
"a" = (
/turf/template_noop,
/area/template_noop)
"f" = (
/obj/machinery/airalarm/directional/north,
/obj/structure/fans/tiny,
/turf/open/floor/plating/ocean/rock/heavy,
/area/ruin/ocean/saddam_hole)
"l" = (
/obj/machinery/atmospherics/components/tank/air,
/turf/open/floor/plating/ocean/rock/heavy,
/area/ruin/ocean/saddam_hole)
"n" = (
/turf/open/floor/plating/ocean/rock/heavy,
/area/ruin/ocean/saddam_hole)
"D" = (
/obj/structure/ladder,
/turf/open/floor/plating/ocean/rock/heavy,
/area/ruin/ocean/saddam_hole)
"F" = (
/obj/machinery/atmospherics/components/unary/vent_pump{
	dir = 1
	},
/turf/open/floor/plating/ocean/rock/heavy,
/area/ruin/ocean/saddam_hole)
"G" = (
/obj/structure/cable,
/obj/machinery/power/port_gen/pacman{
	anchored = 1
	},
/turf/open/floor/plating/ocean/rock/heavy,
/area/ruin/ocean/saddam_hole)
"R" = (
/obj/machinery/power/apc/auto_name/directional/east{
	start_charge = 0
	},
/obj/structure/cable,
/turf/open/floor/plating/ocean/rock/heavy,
/area/ruin/ocean/saddam_hole)
"T" = (
/turf/closed/wall/mineral/iron,
/area/ruin/ocean/saddam_hole)
"U" = (
/turf/closed/mineral/random/ocean,
/area/ruin/ocean/saddam_hole)

(1,1,1) = {"
a
a
a
a
a
a
a
a
a
a
"}
(2,1,1) = {"
a
a
a
a
U
U
U
U
a
a
"}
(3,1,1) = {"
a
a
U
U
U
U
U
U
a
a
"}
(4,1,1) = {"
a
U
U
U
U
n
U
U
U
a
"}
(5,1,1) = {"
U
U
U
n
n
n
U
U
U
a
"}
(6,1,1) = {"
U
U
l
F
D
n
n
U
U
a
"}
(7,1,1) = {"
U
U
T
f
n
n
n
U
U
a
"}
(8,1,1) = {"
U
U
U
U
R
G
U
U
U
a
"}
(9,1,1) = {"
a
U
U
U
T
U
U
U
a
a
"}
(10,1,1) = {"
a
a
U
U
U
U
U
a
a
a
"}
