//MAP CONVERTED BY dmm2tgm.py THIS HEADER COMMENT PREVENTS RECONVERSION, DO NOT REMOVE
"a" = (
/turf/template_noop,
/area/template_noop)
"b" = (
/obj/machinery/door/airlock/maintenance,
/turf/open/floor/plating,
/area/ruin/ocean/bioweapon_research)
"d" = (
/turf/open/floor/plating/ocean/rock/heavy,
/area/template_noop)
"e" = (
/obj/machinery/door/airlock,
/turf/open/floor/plating,
/area/ruin/ocean/bioweapon_research)
"f" = (
/obj/machinery/door/airlock/external,
/turf/open/floor/plating,
/area/ruin/ocean/bioweapon_research)
"g" = (
/turf/closed/mineral/random/stationside/ocean,
/area/template_noop)
"i" = (
/turf/open/floor/engine,
/area/ruin/ocean/bioweapon_research)
"k" = (
/obj/machinery/door/airlock/medical,
/turf/open/floor/iron/white,
/area/ruin/ocean/bioweapon_research)
"l" = (
/turf/open/floor/wood,
/area/ruin/ocean/bioweapon_research)
"m" = (
/obj/machinery/door/airlock,
/turf/open/floor/wood,
/area/ruin/ocean/bioweapon_research)
"n" = (
/turf/open/floor/plating,
/area/ruin/ocean/bioweapon_research)
"o" = (
/turf/open/floor/iron/dark,
/area/ruin/ocean/bioweapon_research)
"q" = (
/obj/effect/spawner/structure/window/reinforced/plasma/plastitanium,
/turf/open/floor/plating,
/area/ruin/ocean/bioweapon_research)
"r" = (
/obj/machinery/door/airlock/virology,
/turf/open/floor/iron/white,
/area/ruin/ocean/bioweapon_research)
"x" = (
/obj/effect/turf_decal/tile/bar{
	dir = 1
	},
/obj/effect/turf_decal/tile/bar,
/obj/structure/table,
/turf/open/floor/iron,
/area/ruin/ocean/bioweapon_research)
"y" = (
/turf/open/floor/iron/white,
/area/ruin/ocean/bioweapon_research)
"z" = (
/obj/machinery/door/airlock/public,
/turf/open/floor/iron,
/area/ruin/ocean/bioweapon_research)
"B" = (
/obj/structure/barricade/sandbags,
/turf/open/floor/plating,
/area/ruin/ocean/bioweapon_research)
"C" = (
/obj/effect/turf_decal/tile/bar{
	dir = 1
	},
/obj/effect/turf_decal/tile/bar,
/obj/structure/chair/stool/bar,
/turf/open/floor/iron,
/area/ruin/ocean/bioweapon_research)
"D" = (
/obj/machinery/door/airlock,
/turf/open/floor/iron/dark,
/area/ruin/ocean/bioweapon_research)
"F" = (
/obj/machinery/door/airlock/engineering,
/turf/open/floor/iron,
/area/ruin/ocean/bioweapon_research)
"I" = (
/obj/structure/table,
/turf/open/floor/wood,
/area/ruin/ocean/bioweapon_research)
"J" = (
/obj/structure/table/wood,
/turf/open/floor/wood,
/area/ruin/ocean/bioweapon_research)
"K" = (
/obj/effect/turf_decal/tile/bar{
	dir = 1
	},
/obj/effect/turf_decal/tile/bar,
/obj/structure/chair{
	dir = 4
	},
/turf/open/floor/iron,
/area/ruin/ocean/bioweapon_research)
"M" = (
/turf/open/floor/iron,
/area/ruin/ocean/bioweapon_research)
"N" = (
/obj/structure/barricade/sandbags,
/turf/open/floor/iron,
/area/ruin/ocean/bioweapon_research)
"O" = (
/obj/effect/mapping_helpers/broken_floor,
/turf/open/floor/plating,
/area/ruin/ocean/bioweapon_research)
"P" = (
/obj/effect/turf_decal/tile/bar{
	dir = 1
	},
/obj/effect/turf_decal/tile/bar,
/obj/structure/chair{
	dir = 8
	},
/turf/open/floor/iron,
/area/ruin/ocean/bioweapon_research)
"Q" = (
/obj/effect/spawner/liquids_spawner,
/turf/open/floor/iron,
/area/ruin/ocean/bioweapon_research)
"R" = (
/obj/structure/drain/big,
/turf/open/floor/engine,
/area/ruin/ocean/bioweapon_research)
"S" = (
/obj/effect/turf_decal/tile/bar{
	dir = 1
	},
/obj/effect/turf_decal/tile/bar,
/turf/open/floor/iron,
/area/ruin/ocean/bioweapon_research)
"T" = (
/obj/machinery/door/airlock/mining,
/turf/open/floor/iron/dark,
/area/ruin/ocean/bioweapon_research)
"U" = (
/turf/closed/wall/mineral/plastitanium/nodiagonal,
/area/ruin/ocean/bioweapon_research)
"X" = (
/obj/machinery/door/airlock/medical,
/turf/open/floor/engine,
/area/ruin/ocean/bioweapon_research)
"Y" = (
/obj/effect/turf_decal/tile/bar{
	dir = 1
	},
/obj/effect/turf_decal/tile/bar,
/obj/structure/chair{
	dir = 1
	},
/turf/open/floor/iron,
/area/ruin/ocean/bioweapon_research)
"Z" = (
/obj/machinery/door/poddoor,
/turf/open/floor/plating,
/area/ruin/ocean/bioweapon_research)

(1,1,1) = {"
a
a
a
a
a
a
a
a
a
a
a
a
a
a
a
a
a
a
a
a
a
a
a
a
a
a
a
a
a
a
a
a
a
a
a
a
a
a
a
a
"}
(2,1,1) = {"
a
a
a
a
a
a
a
a
a
a
a
a
a
a
g
g
g
g
g
g
g
g
g
g
g
a
a
a
a
a
a
a
a
a
a
a
a
a
a
a
"}
(3,1,1) = {"
a
a
a
a
a
a
a
a
a
a
g
g
g
g
g
g
g
g
g
g
g
g
g
g
g
g
g
g
g
g
g
g
g
a
a
a
a
a
a
a
"}
(4,1,1) = {"
a
a
a
a
a
a
a
a
a
g
g
g
g
g
g
g
g
g
g
g
g
g
g
g
g
g
g
g
g
g
g
g
g
g
g
g
a
a
a
a
"}
(5,1,1) = {"
a
a
a
a
a
a
g
g
g
g
g
g
g
g
g
g
g
g
g
g
g
g
g
g
g
g
g
g
g
g
g
g
g
g
g
g
g
a
a
a
"}
(6,1,1) = {"
a
a
a
a
a
g
g
g
g
g
g
g
g
g
U
U
U
U
U
U
U
U
U
U
U
U
U
U
U
U
U
U
U
U
U
g
g
a
a
a
"}
(7,1,1) = {"
a
a
a
a
g
g
g
g
g
g
g
g
g
U
U
y
y
q
y
y
q
y
y
U
l
l
l
U
M
M
U
l
l
l
U
g
g
g
a
a
"}
(8,1,1) = {"
a
a
a
g
g
g
g
g
g
g
g
g
g
U
y
y
y
q
y
y
q
y
y
U
l
l
l
m
M
M
m
l
l
l
U
g
g
g
a
a
"}
(9,1,1) = {"
a
a
a
g
g
g
g
g
g
g
g
g
g
U
y
y
y
q
r
q
q
r
q
U
l
l
l
U
M
M
U
l
l
l
U
g
g
g
a
a
"}
(10,1,1) = {"
a
a
g
g
g
g
g
g
g
U
U
U
U
U
y
y
y
y
y
y
y
y
y
U
U
U
U
U
M
M
U
U
U
U
U
g
g
g
a
a
"}
(11,1,1) = {"
a
g
g
g
g
g
g
g
g
U
y
y
y
U
y
y
y
q
q
q
r
q
q
U
l
l
l
U
M
M
U
l
l
l
U
g
g
g
g
a
"}
(12,1,1) = {"
a
g
g
g
U
U
U
U
U
U
y
y
y
r
y
y
y
q
y
y
y
y
y
U
l
l
l
m
M
M
m
l
l
l
U
g
g
g
g
a
"}
(13,1,1) = {"
a
g
g
g
U
y
y
y
y
U
y
y
y
U
y
y
y
q
y
y
y
y
y
U
l
l
l
U
M
M
U
l
l
l
U
g
g
g
g
a
"}
(14,1,1) = {"
a
g
g
g
U
y
y
y
y
U
U
r
U
U
U
U
U
U
U
U
U
U
U
U
U
U
U
U
M
M
U
U
U
U
U
U
U
g
g
a
"}
(15,1,1) = {"
a
g
g
g
U
y
y
y
y
y
y
y
y
y
k
M
M
M
M
M
M
M
M
M
M
M
M
M
M
M
M
M
M
M
M
M
U
g
g
a
"}
(16,1,1) = {"
g
g
g
g
U
y
y
y
y
y
y
y
y
y
k
M
M
M
M
M
M
M
M
M
M
M
M
M
M
M
M
M
M
M
M
M
U
g
g
a
"}
(17,1,1) = {"
g
g
U
U
U
U
U
U
U
U
U
k
U
U
U
M
M
q
q
q
z
z
U
U
U
U
e
U
U
b
U
U
U
U
F
U
U
g
g
a
"}
(18,1,1) = {"
g
d
Z
i
i
i
i
q
y
y
y
y
y
y
U
M
M
q
x
Y
S
S
S
S
U
n
n
n
U
n
n
U
M
M
M
M
U
g
g
a
"}
(19,1,1) = {"
d
d
Z
i
R
R
i
q
y
y
y
y
y
y
U
N
N
q
P
S
S
S
S
S
U
n
n
n
U
n
n
U
M
M
M
M
U
g
g
a
"}
(20,1,1) = {"
d
d
Z
i
i
i
i
q
y
y
y
y
y
y
U
M
M
q
S
S
S
S
S
S
U
U
U
U
U
n
n
U
M
M
M
M
U
g
g
a
"}
(21,1,1) = {"
d
d
Z
i
R
R
i
q
y
y
y
y
y
y
U
Q
M
q
K
S
S
C
C
S
U
n
n
n
n
n
n
U
M
M
M
M
U
g
g
a
"}
(22,1,1) = {"
g
d
Z
i
i
i
i
X
y
y
y
y
y
y
U
M
N
q
x
S
C
J
J
l
U
U
b
U
U
n
n
U
M
M
M
M
U
g
g
a
"}
(23,1,1) = {"
g
g
U
U
U
U
U
U
U
U
U
U
U
U
U
M
M
q
P
S
C
J
l
l
U
o
o
o
U
n
n
b
M
M
M
M
U
g
g
a
"}
(24,1,1) = {"
a
g
g
g
g
g
U
o
o
o
o
o
o
o
U
N
N
q
S
S
C
J
l
l
U
o
o
o
U
B
B
U
M
M
M
M
U
g
g
a
"}
(25,1,1) = {"
a
d
d
d
g
g
U
o
o
o
o
o
o
o
T
M
M
q
K
S
C
J
l
l
U
o
o
o
U
n
n
U
U
U
U
U
U
g
g
a
"}
(26,1,1) = {"
a
d
d
d
d
g
U
o
o
o
o
o
o
o
U
M
n
q
x
S
C
J
l
l
D
o
o
o
U
n
n
U
g
g
g
g
g
g
g
a
"}
(27,1,1) = {"
d
d
d
d
d
d
U
o
o
O
U
U
T
U
U
n
M
q
P
S
C
J
I
I
U
U
U
U
U
U
n
U
g
g
g
g
g
g
g
a
"}
(28,1,1) = {"
d
d
d
d
d
d
U
n
o
o
U
o
n
o
U
z
z
U
U
U
U
U
U
U
U
n
n
n
n
U
n
U
g
g
g
g
g
g
a
a
"}
(29,1,1) = {"
d
d
d
d
U
U
U
o
o
n
U
o
o
o
U
M
M
U
n
n
n
n
n
n
n
n
U
n
n
U
n
U
g
g
g
g
g
a
a
a
"}
(30,1,1) = {"
d
d
d
d
f
n
f
o
o
o
T
o
o
o
n
n
M
b
n
n
n
n
n
n
n
n
U
n
n
n
n
U
g
g
g
g
g
a
a
a
"}
(31,1,1) = {"
d
d
d
d
U
U
U
o
O
o
n
o
n
n
O
M
O
U
U
U
U
U
U
U
U
U
U
U
U
U
U
U
g
g
g
g
g
a
a
a
"}
(32,1,1) = {"
d
d
d
d
d
d
U
n
O
n
n
o
o
o
n
M
M
U
M
O
M
n
M
q
d
d
g
g
g
g
g
g
g
g
g
g
a
a
a
a
"}
(33,1,1) = {"
d
d
d
d
d
d
U
n
n
O
n
O
n
n
n
n
O
M
M
M
M
n
n
q
d
d
d
d
g
g
g
g
g
g
g
g
a
a
a
a
"}
(34,1,1) = {"
d
d
d
d
d
d
d
d
d
d
d
d
d
d
O
M
M
n
M
n
n
n
O
q
d
d
d
d
d
d
g
a
g
g
g
g
g
a
a
a
"}
(35,1,1) = {"
d
d
d
d
d
d
d
d
d
d
d
d
d
d
n
q
q
O
q
q
O
q
q
q
d
d
d
d
g
d
d
a
a
a
g
g
a
a
a
a
"}
(36,1,1) = {"
a
d
d
d
d
d
d
d
d
d
d
d
d
d
d
d
d
d
d
q
n
q
d
d
d
d
d
d
d
d
a
a
a
a
a
a
a
a
a
a
"}
(37,1,1) = {"
a
a
d
d
d
d
d
d
d
d
d
d
d
d
d
d
d
d
d
q
n
q
d
d
d
d
d
d
d
d
a
a
a
a
a
a
a
a
a
a
"}
(38,1,1) = {"
a
a
a
d
d
d
d
d
d
d
d
d
d
d
d
d
d
d
d
d
d
d
d
d
d
d
d
a
a
a
a
a
a
a
a
a
a
a
a
a
"}
(39,1,1) = {"
a
a
a
a
d
d
d
d
d
d
d
d
d
d
d
d
d
d
d
d
d
d
d
d
d
d
a
a
a
a
a
a
a
a
a
a
a
a
a
a
"}
(40,1,1) = {"
a
a
a
a
a
a
d
a
a
a
d
d
d
d
d
d
d
d
d
d
d
d
d
d
d
a
a
a
a
a
a
a
a
a
a
a
a
a
a
a
"}
