//MAP CONVERTED BY dmm2tgm.py THIS HEADER COMMENT PREVENTS RECONVERSION, DO NOT REMOVE
"aj" = (
/turf/template_noop,
/area/template_noop)
"au" = (
/turf/open/floor/iron/large,
/area/ruin/ocean/bioweapon_research)
"cy" = (
/obj/structure/fluff/broken_flooring,
/turf/open/floor/plating/ocean_plating,
/area/ruin/ocean/bioweapon_research)
"cA" = (
/turf/open/floor/iron,
/area/ruin/ocean/bioweapon_research)
"cF" = (
/turf/open/floor/iron/white,
/area/ruin/ocean/bioweapon_research)
"cL" = (
/obj/effect/turf_decal/siding/thinplating/end{
	dir = 4
	},
/turf/open/floor/plating,
/area/ruin/ocean/bioweapon_research)
"ec" = (
/turf/open/floor/iron/ocean,
/area/ruin/ocean/bioweapon_research)
"ed" = (
/obj/machinery/door/poddoor,
/turf/open/floor/plating,
/area/ruin/ocean/bioweapon_research)
"ev" = (
/turf/open/floor/iron/dark,
/area/ruin/ocean/bioweapon_research)
"fn" = (
/obj/structure/table,
/turf/open/floor/iron/kitchen,
/area/ruin/ocean/bioweapon_research)
"fp" = (
/obj/structure/drain/big,
/turf/open/floor/engine,
/area/ruin/ocean/bioweapon_research)
"fG" = (
/obj/structure/chair/stool/bar{
	dir = 4
	},
/turf/open/floor/iron/large,
/area/ruin/ocean/bioweapon_research)
"fV" = (
/obj/item/storage/box/syndie_kit/chameleon/broken,
/obj/structure/closet/crate/secure/gear,
/turf/open/floor/plating/ocean_plating,
/area/ruin/ocean/bioweapon_research)
"gh" = (
/obj/effect/turf_decal/trimline/white/filled/corner{
	color = "#791500";
	dir = 1
	},
/turf/open/floor/iron/large,
/area/ruin/ocean/bioweapon_research)
"hS" = (
/obj/structure/table,
/obj/machinery/chem_dispenser/drinks/beer{
	dir = 8
	},
/turf/open/floor/wood,
/area/ruin/ocean/bioweapon_research)
"jc" = (
/obj/effect/turf_decal/siding/wood{
	dir = 8
	},
/turf/open/floor/wood,
/area/ruin/ocean/bioweapon_research)
"jt" = (
/obj/machinery/door/airlock/research,
/turf/open/floor/engine,
/area/ruin/ocean/bioweapon_research)
"ku" = (
/obj/machinery/door/airlock/external,
/turf/open/floor/plating,
/area/ruin/ocean/bioweapon_research)
"le" = (
/turf/open/floor/iron/ocean/dark,
/area/ruin/ocean/bioweapon_research)
"ly" = (
/obj/structure/table/wood,
/obj/effect/turf_decal/siding/wood{
	dir = 1
	},
/obj/item/reagent_containers/food/drinks/drinkingglass,
/turf/open/floor/wood,
/area/ruin/ocean/bioweapon_research)
"mG" = (
/obj/structure/chair/sofa/bench/left{
	dir = 4
	},
/obj/structure/window/reinforced/survival_pod{
	dir = 8
	},
/turf/open/floor/iron/kitchen,
/area/ruin/ocean/bioweapon_research)
"nF" = (
/obj/machinery/door/airlock/multi_tile/glass,
/turf/open/floor/iron,
/area/ruin/ocean/bioweapon_research)
"oA" = (
/obj/structure/fluff/broken_flooring{
	icon_state = "side"
	},
/turf/open/floor/plating,
/area/ruin/ocean/bioweapon_research)
"pk" = (
/obj/effect/decal/cleanable/glass,
/obj/item/broken_bottle,
/turf/open/floor/iron/large,
/area/ruin/ocean/bioweapon_research)
"qt" = (
/obj/structure/table,
/obj/effect/turf_decal/siding/thinplating,
/turf/open/floor/iron/kitchen,
/area/ruin/ocean/bioweapon_research)
"sY" = (
/obj/machinery/power/apc/auto_name/north{
	start_charge = 0
	},
/obj/structure/cable,
/turf/open/floor/plating,
/area/ruin/ocean/bioweapon_research)
"tU" = (
/obj/structure/chair/stool/bar,
/turf/open/floor/iron/large,
/area/ruin/ocean/bioweapon_research)
"uc" = (
/obj/machinery/door/airlock/virology,
/turf/open/floor/iron/white,
/area/ruin/ocean/bioweapon_research)
"uv" = (
/turf/open/floor/wood,
/area/ruin/ocean/bioweapon_research)
"uz" = (
/turf/open/floor/plating/ocean/rock/heavy,
/area/template_noop)
"uM" = (
/obj/structure/table/wood,
/obj/effect/turf_decal/siding/wood{
	dir = 1
	},
/obj/item/reagent_containers/food/drinks/drinkingglass/shotglass{
	pixel_x = 5;
	pixel_y = 9
	},
/turf/open/floor/wood,
/area/ruin/ocean/bioweapon_research)
"uQ" = (
/obj/machinery/door/airlock/public,
/turf/open/floor/iron,
/area/ruin/ocean/bioweapon_research)
"uS" = (
/obj/structure/chair/stool/bar,
/obj/effect/turf_decal/trimline/white/filled/line{
	color = "#791500";
	dir = 4
	},
/obj/machinery/light/broken/directional/east,
/turf/open/floor/iron/large,
/area/ruin/ocean/bioweapon_research)
"vF" = (
/obj/structure/fluff/broken_flooring{
	icon_state = "singular"
	},
/turf/open/floor/plating,
/area/ruin/ocean/bioweapon_research)
"xA" = (
/turf/open/floor/iron/white/corner{
	dir = 4
	},
/area/ruin/ocean/bioweapon_research)
"yw" = (
/obj/effect/turf_decal/siding/wood{
	dir = 8
	},
/obj/structure/table/wood,
/turf/open/floor/wood,
/area/ruin/ocean/bioweapon_research)
"zh" = (
/turf/open/floor/plating,
/area/ruin/ocean/bioweapon_research)
"Ag" = (
/obj/effect/turf_decal/siding/thinplating{
	dir = 9
	},
/turf/open/floor/plating,
/area/ruin/ocean/bioweapon_research)
"AX" = (
/obj/effect/turf_decal/trimline/white/filled/line{
	color = "#791500";
	dir = 4
	},
/turf/open/floor/iron/large,
/area/ruin/ocean/bioweapon_research)
"CE" = (
/obj/effect/turf_decal/trimline/white/filled/line{
	color = "#791500";
	dir = 10
	},
/turf/open/floor/iron/large,
/area/ruin/ocean/bioweapon_research)
"Dr" = (
/obj/machinery/door/airlock/research,
/turf/open/floor/iron/white,
/area/ruin/ocean/bioweapon_research)
"DX" = (
/obj/effect/turf_decal/trimline/white/filled/line{
	color = "#791500";
	dir = 9
	},
/obj/item/kirbyplants/random,
/turf/open/floor/iron/large,
/area/ruin/ocean/bioweapon_research)
"Ed" = (
/obj/structure/frame/computer,
/turf/open/floor/iron/white/corner{
	dir = 4
	},
/area/ruin/ocean/bioweapon_research)
"Et" = (
/obj/machinery/door/airlock/mining,
/turf/open/floor/iron/dark,
/area/ruin/ocean/bioweapon_research)
"Fc" = (
/turf/open/floor/iron/white/side{
	dir = 4
	},
/area/ruin/ocean/bioweapon_research)
"GL" = (
/obj/machinery/door/airlock/multi_tile/glass{
	dir = 4
	},
/turf/open/floor/iron/half{
	dir = 1
	},
/area/ruin/ocean/bioweapon_research)
"GN" = (
/obj/effect/turf_decal/siding/thinplating{
	dir = 10
	},
/turf/open/floor/plating,
/area/ruin/ocean/bioweapon_research)
"GY" = (
/turf/open/floor/iron/white/side{
	dir = 8
	},
/area/ruin/ocean/bioweapon_research)
"HC" = (
/turf/open/floor/plating/ocean_plating,
/area/ruin/ocean/bioweapon_research)
"HY" = (
/obj/structure/chair/sofa/bench/right{
	dir = 4
	},
/obj/effect/turf_decal/siding/thinplating,
/obj/structure/window/reinforced/survival_pod{
	dir = 8
	},
/turf/open/floor/iron/kitchen,
/area/ruin/ocean/bioweapon_research)
"If" = (
/obj/structure/table,
/obj/machinery/chem_dispenser/drinks{
	dir = 8
	},
/turf/open/floor/wood,
/area/ruin/ocean/bioweapon_research)
"Ig" = (
/obj/structure/barricade/sandbags,
/turf/open/floor/iron,
/area/ruin/ocean/bioweapon_research)
"ID" = (
/turf/closed/wall/mineral/plastitanium/nodiagonal,
/area/ruin/ocean/bioweapon_research)
"JX" = (
/obj/structure/barricade/sandbags,
/turf/open/floor/plating,
/area/ruin/ocean/bioweapon_research)
"KO" = (
/obj/structure/chair/sofa/bench/right{
	dir = 8
	},
/obj/structure/window/reinforced/survival_pod{
	dir = 4
	},
/turf/open/floor/iron/kitchen,
/area/ruin/ocean/bioweapon_research)
"Ly" = (
/obj/machinery/door/airlock,
/turf/open/floor/iron/dark,
/area/ruin/ocean/bioweapon_research)
"LD" = (
/obj/structure/cable,
/turf/open/floor/plating,
/area/ruin/ocean/bioweapon_research)
"Mc" = (
/obj/effect/turf_decal/trimline/white/filled/line{
	color = "#791500";
	dir = 8
	},
/turf/open/floor/iron/large,
/area/ruin/ocean/bioweapon_research)
"MG" = (
/obj/structure/table/optable,
/turf/open/floor/iron/white/corner{
	dir = 1
	},
/area/ruin/ocean/bioweapon_research)
"NK" = (
/turf/open/floor/iron/half{
	dir = 1
	},
/area/ruin/ocean/bioweapon_research)
"Oj" = (
/turf/closed/wall/mineral/plastitanium,
/area/ruin/ocean/bioweapon_research)
"Ps" = (
/turf/open/floor/plating/ocean_plating{
	icon_state = "platingdmg1"
	},
/area/ruin/ocean/bioweapon_research)
"PG" = (
/turf/open/floor/iron/white/corner{
	dir = 1
	},
/area/ruin/ocean/bioweapon_research)
"PH" = (
/turf/open/floor/plating/ocean_plating{
	icon_state = "platingdmg2"
	},
/area/ruin/ocean/bioweapon_research)
"PM" = (
/obj/effect/spawner/liquids_spawner,
/turf/open/floor/iron,
/area/ruin/ocean/bioweapon_research)
"Qf" = (
/obj/structure/fluff/broken_flooring{
	icon_state = "pile"
	},
/turf/open/floor/iron,
/area/ruin/ocean/bioweapon_research)
"Qi" = (
/obj/effect/turf_decal/trimline/white/filled/corner{
	color = "#791500";
	dir = 8
	},
/turf/open/floor/iron/large,
/area/ruin/ocean/bioweapon_research)
"Qq" = (
/obj/structure/fluff/empty_sleeper/syndicate{
	dir = 4
	},
/turf/open/floor/iron/white,
/area/ruin/ocean/bioweapon_research)
"QH" = (
/obj/machinery/door/airlock/engineering,
/turf/open/floor/iron,
/area/ruin/ocean/bioweapon_research)
"QI" = (
/turf/closed/mineral/random/stationside/ocean,
/area/template_noop)
"QW" = (
/obj/structure/chair/sofa/bench/left{
	dir = 8
	},
/obj/effect/turf_decal/siding/thinplating,
/obj/structure/window/reinforced/survival_pod{
	dir = 4
	},
/turf/open/floor/iron/kitchen,
/area/ruin/ocean/bioweapon_research)
"RF" = (
/turf/open/floor/engine,
/area/ruin/ocean/bioweapon_research)
"RK" = (
/obj/structure/table/wood,
/obj/effect/turf_decal/siding/wood{
	dir = 9
	},
/obj/item/clothing/glasses/material/mining,
/turf/open/floor/wood,
/area/ruin/ocean/bioweapon_research)
"So" = (
/obj/structure/table/wood,
/obj/effect/turf_decal/siding/wood{
	dir = 1
	},
/turf/open/floor/wood,
/area/ruin/ocean/bioweapon_research)
"Sp" = (
/obj/effect/spawner/structure/window/plasma/reinforced/plastitanium,
/turf/open/floor/plating,
/area/ruin/ocean/bioweapon_research)
"Su" = (
/obj/effect/turf_decal/trimline/white/filled/line{
	color = "#791500"
	},
/turf/open/floor/iron/large,
/area/ruin/ocean/bioweapon_research)
"UG" = (
/obj/machinery/door/airlock/maintenance,
/turf/open/floor/plating,
/area/ruin/ocean/bioweapon_research)
"Va" = (
/obj/machinery/door/airlock,
/turf/open/floor/plating,
/area/ruin/ocean/bioweapon_research)
"WO" = (
/obj/effect/turf_decal/siding/thinplating{
	dir = 6
	},
/turf/open/floor/plating,
/area/ruin/ocean/bioweapon_research)
"XK" = (
/obj/machinery/door/airlock,
/turf/open/floor/wood,
/area/ruin/ocean/bioweapon_research)
"YE" = (
/obj/effect/turf_decal/siding/thinplating/corner,
/obj/effect/turf_decal/siding/thinplating{
	dir = 1
	},
/turf/open/floor/plating,
/area/ruin/ocean/bioweapon_research)

(1,1,1) = {"
aj
aj
aj
aj
aj
aj
aj
aj
aj
aj
aj
aj
aj
aj
aj
aj
aj
aj
aj
aj
aj
aj
aj
aj
aj
aj
aj
aj
aj
aj
aj
aj
aj
aj
aj
aj
aj
aj
aj
aj
"}
(2,1,1) = {"
aj
aj
aj
aj
aj
aj
aj
aj
aj
aj
aj
aj
aj
aj
QI
QI
QI
QI
QI
QI
QI
QI
QI
QI
QI
aj
aj
aj
aj
aj
aj
aj
aj
aj
aj
aj
aj
aj
aj
aj
"}
(3,1,1) = {"
aj
aj
aj
aj
aj
aj
aj
aj
aj
aj
QI
QI
QI
QI
QI
QI
QI
QI
QI
QI
QI
QI
QI
QI
QI
QI
QI
QI
QI
QI
QI
QI
QI
aj
aj
aj
aj
aj
aj
aj
"}
(4,1,1) = {"
aj
aj
aj
aj
aj
aj
aj
aj
aj
QI
QI
QI
QI
QI
QI
QI
QI
QI
QI
QI
QI
QI
QI
QI
QI
QI
QI
QI
QI
QI
QI
QI
QI
QI
QI
QI
aj
aj
aj
aj
"}
(5,1,1) = {"
aj
aj
aj
aj
aj
aj
QI
QI
QI
QI
QI
QI
QI
QI
QI
QI
QI
QI
QI
QI
QI
QI
QI
QI
QI
QI
QI
QI
QI
QI
QI
QI
QI
QI
QI
QI
QI
aj
aj
aj
"}
(6,1,1) = {"
aj
aj
aj
aj
aj
QI
QI
QI
QI
QI
QI
QI
QI
QI
ID
ID
ID
ID
ID
ID
ID
ID
ID
ID
ID
ID
ID
ID
ID
ID
ID
ID
ID
ID
ID
QI
QI
aj
aj
aj
"}
(7,1,1) = {"
aj
aj
aj
aj
QI
QI
QI
QI
QI
QI
QI
QI
QI
ID
ID
cF
cF
Sp
cF
cF
Sp
cF
cF
ID
uv
uv
uv
ID
cA
cA
ID
uv
uv
uv
ID
QI
QI
QI
aj
aj
"}
(8,1,1) = {"
aj
aj
aj
QI
QI
QI
QI
QI
QI
QI
QI
QI
QI
ID
cF
cF
cF
Sp
cF
cF
Sp
cF
cF
ID
uv
uv
uv
XK
cA
cA
XK
uv
uv
uv
ID
QI
QI
QI
aj
aj
"}
(9,1,1) = {"
aj
aj
aj
QI
QI
QI
QI
QI
QI
QI
QI
QI
QI
ID
cF
cF
cF
Sp
uc
Sp
Sp
uc
Sp
ID
uv
uv
uv
ID
cA
cA
ID
uv
uv
uv
ID
QI
QI
QI
aj
aj
"}
(10,1,1) = {"
aj
aj
QI
QI
QI
QI
QI
QI
QI
ID
ID
ID
ID
ID
cF
cF
cF
cF
cF
cF
cF
cF
cF
ID
ID
ID
ID
ID
cA
cA
ID
ID
ID
ID
ID
QI
QI
QI
aj
aj
"}
(11,1,1) = {"
aj
QI
QI
QI
QI
QI
QI
QI
QI
ID
cF
cF
cF
ID
cF
cF
cF
Sp
Sp
Sp
uc
Sp
Sp
ID
uv
uv
uv
ID
cA
cA
ID
uv
uv
uv
ID
QI
QI
QI
QI
aj
"}
(12,1,1) = {"
aj
QI
QI
QI
QI
ID
ID
ID
ID
ID
cF
cF
cF
uc
cF
cF
cF
Sp
cF
cF
cF
cF
cF
ID
uv
uv
uv
XK
cA
cA
XK
uv
uv
uv
ID
QI
QI
QI
QI
aj
"}
(13,1,1) = {"
aj
QI
QI
QI
ID
ID
Oj
Qq
Qq
ID
cF
cF
cF
ID
cF
cF
cF
Sp
cF
cF
cF
cF
cF
ID
uv
uv
uv
ID
cA
cA
ID
uv
uv
uv
ID
QI
QI
QI
QI
aj
"}
(14,1,1) = {"
aj
QI
QI
QI
ID
Oj
cF
cF
cF
ID
ID
uc
ID
ID
ID
ID
ID
ID
ID
ID
ID
ID
ID
ID
ID
ID
ID
ID
cA
cA
ID
ID
ID
ID
ID
ID
ID
QI
QI
aj
"}
(15,1,1) = {"
aj
QI
QI
QI
ID
MG
GY
PG
GY
PG
GY
PG
GY
PG
nF
cA
cA
cA
cA
cA
cA
cA
cA
cA
cA
cA
cA
cA
cA
cA
cA
cA
cA
cA
cA
cA
ID
QI
QI
aj
"}
(16,1,1) = {"
QI
QI
QI
QI
ID
Ed
Fc
xA
Fc
xA
Fc
xA
Fc
xA
cA
cA
cA
cA
cA
cA
cA
cA
cA
cA
cA
cA
cA
cA
cA
cA
cA
cA
cA
cA
cA
cA
ID
QI
QI
aj
"}
(17,1,1) = {"
QI
QI
ID
ID
ID
ID
ID
ID
ID
ID
ID
Dr
ID
ID
ID
cA
cA
ID
ID
Sp
NK
GL
Sp
ID
ID
ID
Va
ID
ID
UG
ID
ID
ID
ID
QH
ID
ID
QI
QI
aj
"}
(18,1,1) = {"
QI
uz
ed
RF
RF
RF
RF
Sp
cF
cF
cF
cF
cF
cF
ID
cA
cA
ID
DX
gh
au
au
Qi
Mc
CE
ID
zh
zh
ID
zh
zh
ID
cA
cA
cA
cA
ID
QI
QI
aj
"}
(19,1,1) = {"
uz
uz
ed
RF
fp
fp
RF
Sp
cF
cF
cF
cF
cF
cF
ID
Ig
Ig
Sp
mG
HY
Ag
GN
au
au
Su
ID
zh
zh
ID
zh
zh
ID
cA
cA
cA
cA
ID
QI
QI
aj
"}
(20,1,1) = {"
uz
uz
ed
RF
RF
RF
RF
Sp
cF
cF
cF
cF
cF
cF
ID
cA
cA
Sp
fn
qt
YE
WO
au
pk
Su
ID
ID
ID
ID
sY
LD
ID
cA
cA
cA
cA
ID
QI
QI
aj
"}
(21,1,1) = {"
uz
uz
ed
RF
fp
fp
RF
Sp
cF
cF
cF
cF
cF
cF
ID
PM
cA
Sp
KO
QW
cL
au
fG
fG
Su
ID
zh
zh
zh
zh
zh
ID
cA
cA
cA
cA
ID
QI
QI
aj
"}
(22,1,1) = {"
QI
uz
ed
RF
RF
RF
RF
jt
cF
cF
cF
cF
cF
cF
ID
cA
Ig
Sp
mG
HY
au
tU
RK
yw
jc
ID
UG
ID
ID
zh
zh
ID
cA
cA
cA
cA
ID
QI
QI
aj
"}
(23,1,1) = {"
QI
QI
ID
ID
ID
ID
ID
ID
ID
ID
ID
ID
ID
ID
ID
cA
cA
Sp
fn
qt
au
tU
So
uv
uv
ID
ev
ev
ID
zh
zh
UG
cA
cA
cA
cA
ID
QI
QI
aj
"}
(24,1,1) = {"
aj
QI
QI
QI
QI
QI
ID
le
le
le
le
le
le
le
ID
Ig
Ig
Sp
KO
QW
au
tU
ly
uv
uv
ID
ev
ev
ID
JX
JX
ID
cA
cA
cA
cA
ID
QI
QI
aj
"}
(25,1,1) = {"
aj
uz
uz
uz
QI
QI
ID
le
le
le
le
le
le
le
Et
Qf
cA
Sp
mG
HY
au
tU
So
uv
uv
ID
ev
ev
ID
zh
zh
ID
ID
ID
ID
ID
ID
QI
QI
aj
"}
(26,1,1) = {"
aj
uz
uz
uz
uz
QI
ID
le
le
le
le
le
le
le
ID
cA
vF
Sp
fn
qt
au
tU
uM
uv
uv
Ly
ev
ev
ID
zh
zh
ID
QI
QI
QI
QI
QI
QI
QI
aj
"}
(27,1,1) = {"
uz
uz
uz
uz
uz
uz
ID
le
le
PH
ID
ID
Et
ID
ID
oA
cA
Sp
KO
QW
AX
uS
So
If
hS
ID
ID
ID
ID
ID
zh
ID
QI
QI
QI
QI
QI
QI
QI
aj
"}
(28,1,1) = {"
uz
uz
uz
uz
uz
uz
ID
HC
le
le
ID
le
HC
le
ID
uQ
uQ
ID
ID
ID
ID
ID
ID
ID
ID
ID
zh
zh
zh
ID
zh
ID
QI
QI
QI
QI
QI
QI
aj
aj
"}
(29,1,1) = {"
uz
uz
uz
uz
ID
ID
ID
le
le
HC
ID
le
le
le
ID
ec
ec
ID
zh
zh
zh
zh
zh
zh
zh
zh
zh
zh
zh
ID
zh
ID
QI
QI
QI
QI
QI
aj
aj
aj
"}
(30,1,1) = {"
uz
uz
uz
uz
ku
zh
ku
le
le
le
Et
le
le
le
HC
cy
ec
UG
zh
zh
zh
zh
zh
zh
zh
zh
zh
zh
zh
zh
zh
ID
QI
QI
QI
QI
QI
aj
aj
aj
"}
(31,1,1) = {"
uz
uz
uz
uz
ID
ID
ID
le
Ps
le
HC
le
HC
HC
Ps
ec
Ps
ID
ID
ID
ID
ID
ID
ID
ID
ID
ID
ID
ID
ID
ID
ID
QI
QI
QI
QI
QI
aj
aj
aj
"}
(32,1,1) = {"
uz
uz
uz
uz
uz
uz
ID
fV
PH
HC
HC
le
le
le
HC
ec
ec
ID
ec
Ps
ec
HC
ec
Sp
uz
uz
QI
QI
QI
QI
QI
QI
QI
QI
QI
QI
aj
aj
aj
aj
"}
(33,1,1) = {"
uz
uz
uz
uz
uz
uz
ID
HC
HC
PH
HC
PH
HC
HC
HC
HC
Ps
ec
ec
ec
ec
HC
HC
Sp
uz
uz
uz
uz
QI
QI
QI
QI
QI
QI
QI
QI
aj
aj
aj
aj
"}
(34,1,1) = {"
uz
uz
uz
uz
uz
uz
uz
uz
uz
uz
uz
uz
uz
uz
PH
ec
ec
HC
ec
HC
HC
HC
Ps
Sp
uz
uz
uz
uz
uz
uz
QI
aj
QI
QI
QI
QI
QI
aj
aj
aj
"}
(35,1,1) = {"
uz
uz
uz
uz
uz
uz
uz
uz
uz
uz
uz
uz
uz
uz
HC
Sp
Sp
PH
Sp
Sp
PH
Sp
Sp
Sp
uz
uz
uz
uz
QI
uz
uz
aj
aj
aj
QI
QI
aj
aj
aj
aj
"}
(36,1,1) = {"
aj
uz
uz
uz
uz
uz
uz
uz
uz
uz
uz
uz
uz
uz
uz
uz
uz
uz
uz
Sp
HC
Sp
uz
uz
uz
uz
uz
uz
uz
uz
aj
aj
aj
aj
aj
aj
aj
aj
aj
aj
"}
(37,1,1) = {"
aj
aj
uz
uz
uz
uz
uz
uz
uz
uz
uz
uz
uz
uz
uz
uz
uz
uz
uz
Sp
HC
Sp
uz
uz
uz
uz
uz
uz
uz
uz
aj
aj
aj
aj
aj
aj
aj
aj
aj
aj
"}
(38,1,1) = {"
aj
aj
aj
uz
uz
uz
uz
uz
uz
uz
uz
uz
uz
uz
uz
uz
uz
uz
uz
uz
uz
uz
uz
uz
uz
uz
uz
aj
aj
aj
aj
aj
aj
aj
aj
aj
aj
aj
aj
aj
"}
(39,1,1) = {"
aj
aj
aj
aj
uz
uz
uz
uz
uz
uz
uz
uz
uz
uz
uz
uz
uz
uz
uz
uz
uz
uz
uz
uz
uz
uz
aj
aj
aj
aj
aj
aj
aj
aj
aj
aj
aj
aj
aj
aj
"}
(40,1,1) = {"
aj
aj
aj
aj
aj
aj
uz
aj
aj
aj
uz
uz
uz
uz
uz
uz
uz
uz
uz
uz
uz
uz
uz
uz
uz
aj
aj
aj
aj
aj
aj
aj
aj
aj
aj
aj
aj
aj
aj
aj
"}
