//MAP CONVERTED BY dmm2tgm.py THIS HEADER COMMENT PREVENTS RECONVERSION, DO NOT REMOVE
"aa" = (
/obj/machinery/atmospherics/pipe/smart/manifold4w/scrubbers/hidden{
	dir = 4;
	piping_layer = 4;
	pixel_x = 5;
	pixel_y = 5
	},
/obj/machinery/atmospherics/pipe/smart/manifold4w/supply/hidden{
	dir = 4
	},
/obj/effect/decal/cleanable/dirt,
/turf/open/floor/wood,
/area/ruin/ocean/listening_outpost)
"ai" = (
/obj/machinery/door/firedoor,
/obj/effect/decal/cleanable/dirt,
/turf/open/floor/iron,
/area/ruin/ocean/listening_outpost)
"aU" = (
/obj/machinery/atmospherics/pipe/smart/manifold4w/supply/hidden{
	dir = 4
	},
/obj/effect/decal/cleanable/dirt,
/turf/open/floor/plating,
/area/ruin/ocean/listening_outpost)
"bp" = (
/obj/structure/table,
/obj/machinery/firealarm{
	dir = 1;
	pixel_y = -26
	},
/obj/machinery/light/small,
/obj/item/storage/box/donkpockets{
	pixel_y = 3
	},
/obj/item/storage/box/donkpockets{
	pixel_x = -2
	},
/obj/item/storage/box/donkpockets{
	pixel_x = 1;
	pixel_y = -3
	},
/obj/item/food/chips,
/turf/open/floor/iron/showroomfloor,
/area/ruin/ocean/listening_outpost)
"cb" = (
/obj/machinery/atmospherics/components/unary/vent_pump/on{
	dir = 4
	},
/obj/structure/table/wood,
/obj/item/flashlight/lamp,
/turf/open/floor/carpet,
/area/ruin/ocean/listening_outpost)
"cg" = (
/obj/machinery/atmospherics/components/unary/vent_pump/on{
	dir = 4
	},
/obj/effect/decal/cleanable/dirt,
/turf/open/floor/iron/dark,
/area/ruin/ocean/listening_outpost)
"cp" = (
/obj/machinery/atmospherics/components/unary/vent_pump/on{
	dir = 8
	},
/obj/machinery/atmospherics/pipe/smart/manifold4w/scrubbers/hidden{
	dir = 4;
	piping_layer = 4;
	pixel_x = 5;
	pixel_y = 5
	},
/obj/effect/decal/cleanable/dirt,
/turf/open/floor/iron/dark,
/area/ruin/ocean/listening_outpost)
"cz" = (
/obj/machinery/suit_storage_unit/standard_unit{
	desc = "An industrial suit storage device carrying retro space suits. Neat!";
	helmet_type = /obj/item/clothing/head/helmet/space;
	suit_type = /obj/item/clothing/suit/space
	},
/obj/machinery/light/small{
	dir = 1
	},
/turf/open/floor/iron/dark,
/area/ruin/ocean/listening_outpost)
"dc" = (
/obj/machinery/atmospherics/components/unary/vent_pump/on{
	dir = 4
	},
/turf/open/floor/iron,
/area/ruin/ocean/listening_outpost)
"dj" = (
/obj/machinery/iv_drip,
/obj/structure/sink{
	dir = 4;
	pixel_x = -12;
	pixel_y = 2
	},
/obj/effect/decal/cleanable/dirt,
/turf/open/floor/iron/white,
/area/ruin/ocean/listening_outpost)
"eD" = (
/obj/structure/extinguisher_cabinet{
	pixel_x = -26
	},
/obj/structure/rack{
	dir = 8
	},
/obj/machinery/newscaster{
	pixel_y = -28
	},
/obj/effect/decal/cleanable/dirt,
/turf/open/floor/iron/dark,
/area/ruin/ocean/listening_outpost)
"fa" = (
/obj/machinery/atmospherics/pipe/smart/manifold4w/supply/hidden{
	dir = 4
	},
/obj/machinery/atmospherics/pipe/smart/manifold4w/scrubbers/hidden{
	dir = 4;
	piping_layer = 4;
	pixel_x = 5;
	pixel_y = 5
	},
/turf/open/floor/wood,
/area/ruin/ocean/listening_outpost)
"fe" = (
/obj/machinery/airalarm/unlocked{
	dir = 4;
	pixel_x = 26
	},
/obj/machinery/atmospherics/pipe/smart/manifold4w/scrubbers/hidden{
	dir = 9;
	piping_layer = 4;
	pixel_x = 5;
	pixel_y = 5
	},
/obj/machinery/atmospherics/pipe/smart/manifold4w/supply/hidden{
	dir = 4
	},
/obj/machinery/light/small{
	dir = 4
	},
/obj/effect/decal/cleanable/dirt,
/turf/open/floor/wood,
/area/ruin/ocean/listening_outpost)
"fn" = (
/obj/machinery/atmospherics/pipe/smart/manifold4w/supply/hidden{
	dir = 4
	},
/obj/machinery/atmospherics/pipe/smart/manifold4w/scrubbers/hidden{
	dir = 4;
	piping_layer = 4;
	pixel_x = 5;
	pixel_y = 5
	},
/obj/effect/decal/cleanable/dirt,
/turf/open/floor/iron/dark,
/area/ruin/ocean/listening_outpost)
"gb" = (
/obj/structure/table,
/obj/item/paper_bin,
/obj/item/pen,
/obj/effect/decal/cleanable/dirt,
/turf/open/floor/iron/dark,
/area/ruin/ocean/listening_outpost)
"ge" = (
/obj/structure/toilet{
	dir = 8
	},
/obj/structure/sink{
	dir = 4;
	pixel_x = -12;
	pixel_y = 2
	},
/obj/structure/mirror{
	pixel_x = -28
	},
/obj/effect/decal/cleanable/dirt,
/turf/open/floor/iron/showroomfloor,
/area/ruin/ocean/listening_outpost)
"hp" = (
/obj/machinery/atmospherics/pipe/smart/manifold4w/supply/hidden{
	dir = 4
	},
/obj/machinery/atmospherics/pipe/smart/manifold4w/scrubbers/hidden{
	dir = 5;
	piping_layer = 4;
	pixel_x = 5;
	pixel_y = 5
	},
/obj/structure/chair/office,
/turf/open/floor/iron/dark,
/area/ruin/ocean/listening_outpost)
"hu" = (
/obj/structure/table/wood,
/obj/machinery/atmospherics/pipe/smart/manifold4w/supply/hidden{
	dir = 4
	},
/obj/machinery/atmospherics/pipe/smart/manifold4w/scrubbers/hidden{
	dir = 4;
	piping_layer = 4;
	pixel_x = 5;
	pixel_y = 5
	},
/obj/effect/decal/cleanable/dirt,
/obj/item/reagent_containers/food/drinks/bottle/rum{
	pixel_x = -11;
	pixel_y = 3
	},
/obj/item/food/chips{
	pixel_x = 12;
	pixel_y = 9
	},
/obj/item/reagent_containers/food/drinks/soda_cans/cola,
/turf/open/floor/carpet,
/area/ruin/ocean/listening_outpost)
"im" = (
/obj/machinery/atmospherics/components/unary/vent_scrubber/on{
	dir = 1;
	piping_layer = 4;
	pixel_x = 5;
	pixel_y = 5
	},
/obj/effect/decal/cleanable/dirt,
/turf/open/floor/wood,
/area/ruin/ocean/listening_outpost)
"iB" = (
/obj/machinery/atmospherics/components/unary/vent_scrubber/on{
	dir = 8;
	piping_layer = 4;
	pixel_x = 5;
	pixel_y = 5
	},
/obj/effect/decal/cleanable/dirt,
/turf/open/floor/iron/dark,
/area/ruin/ocean/listening_outpost)
"jq" = (
/turf/open/floor/plating/ocean,
/area/template_noop)
"js" = (
/obj/machinery/atmospherics/pipe/smart/manifold4w/supply/hidden{
	dir = 8
	},
/obj/machinery/atmospherics/pipe/smart/manifold4w/scrubbers/hidden{
	dir = 8;
	piping_layer = 4;
	pixel_x = 5;
	pixel_y = 5
	},
/obj/effect/decal/cleanable/dirt,
/turf/open/floor/iron,
/area/ruin/ocean/listening_outpost)
"kf" = (
/obj/machinery/atmospherics/pipe/smart/manifold4w/supply/hidden{
	dir = 4
	},
/obj/machinery/atmospherics/pipe/smart/manifold4w/scrubbers/hidden{
	dir = 1;
	piping_layer = 4;
	pixel_x = 5;
	pixel_y = 5
	},
/obj/effect/decal/cleanable/dirt,
/turf/open/floor/iron/dark,
/area/ruin/ocean/listening_outpost)
"kB" = (
/obj/structure/fireplace,
/turf/open/floor/wood,
/area/ruin/ocean/listening_outpost)
"kW" = (
/obj/machinery/atmospherics/pipe/smart/manifold4w/supply/hidden{
	dir = 4
	},
/obj/machinery/atmospherics/pipe/smart/manifold4w/scrubbers/hidden{
	dir = 4;
	piping_layer = 4;
	pixel_x = 5;
	pixel_y = 5
	},
/obj/effect/decal/cleanable/dirt,
/turf/open/floor/wood,
/area/ruin/ocean/listening_outpost)
"lB" = (
/obj/structure/bed/roller,
/obj/machinery/atmospherics/components/unary/vent_pump/on{
	dir = 4
	},
/turf/open/floor/iron/white,
/area/ruin/ocean/listening_outpost)
"mn" = (
/obj/machinery/airalarm/unlocked{
	dir = 4;
	pixel_x = 26
	},
/obj/machinery/atmospherics/pipe/smart/manifold4w/supply/hidden,
/obj/machinery/atmospherics/pipe/smart/manifold4w/scrubbers/hidden{
	dir = 4;
	piping_layer = 4;
	pixel_x = 5;
	pixel_y = 5
	},
/turf/open/floor/iron,
/area/ruin/ocean/listening_outpost)
"mt" = (
/obj/structure/extinguisher_cabinet{
	pixel_x = 25
	},
/obj/machinery/atmospherics/components/unary/vent_pump/on{
	dir = 1
	},
/obj/effect/decal/cleanable/dirt,
/turf/open/floor/wood,
/area/ruin/ocean/listening_outpost)
"mM" = (
/obj/structure/table,
/obj/item/multitool,
/obj/machinery/light/small{
	dir = 1
	},
/obj/effect/decal/cleanable/dirt,
/turf/open/floor/iron/dark,
/area/ruin/ocean/listening_outpost)
"mT" = (
/obj/machinery/atmospherics/pipe/smart/manifold4w/supply/hidden{
	dir = 4
	},
/obj/machinery/atmospherics/pipe/smart/manifold4w/scrubbers/hidden{
	piping_layer = 4;
	pixel_x = 5;
	pixel_y = 5
	},
/obj/effect/decal/cleanable/dirt,
/turf/open/floor/iron,
/area/ruin/ocean/listening_outpost)
"mZ" = (
/turf/closed/wall/rust,
/area/ruin/ocean/listening_outpost)
"nb" = (
/obj/structure/table/wood,
/obj/item/reagent_containers/food/drinks/bottle/kahlua{
	pixel_x = -10;
	pixel_y = 9
	},
/obj/item/reagent_containers/food/drinks/bottle/whiskey{
	pixel_y = 14
	},
/obj/item/lighter{
	pixel_x = 7;
	pixel_y = -3
	},
/obj/item/storage/fancy/cigarettes/cigpack_uplift,
/turf/open/floor/wood,
/area/ruin/ocean/listening_outpost)
"nE" = (
/obj/structure/table,
/obj/machinery/microwave,
/obj/structure/sign/poster/contraband/random{
	pixel_x = -32
	},
/turf/open/floor/iron/showroomfloor,
/area/ruin/ocean/listening_outpost)
"ov" = (
/obj/machinery/atmospherics/components/unary/vent_scrubber/on{
	piping_layer = 4;
	pixel_x = 5;
	pixel_y = 5
	},
/turf/open/floor/iron/dark,
/area/ruin/ocean/listening_outpost)
"ox" = (
/obj/machinery/door/airlock{
	name = "Toilet"
	},
/turf/open/floor/iron/showroomfloor,
/area/ruin/ocean/listening_outpost)
"oA" = (
/obj/machinery/door/airlock{
	name = "Personal Quarters"
	},
/obj/machinery/door/firedoor,
/obj/machinery/atmospherics/pipe/smart/manifold4w/scrubbers/hidden{
	dir = 4;
	piping_layer = 4;
	pixel_x = 5;
	pixel_y = 5
	},
/turf/open/floor/iron/dark,
/area/ruin/ocean/listening_outpost)
"oE" = (
/obj/machinery/atmospherics/pipe/smart/manifold4w/supply/hidden{
	dir = 4
	},
/obj/effect/decal/cleanable/dirt,
/obj/effect/decal/cleanable/dirt,
/turf/open/floor/iron,
/area/ruin/ocean/listening_outpost)
"oR" = (
/obj/effect/spawner/random/vending/snackvend,
/obj/effect/decal/cleanable/dirt,
/turf/open/floor/iron,
/area/ruin/ocean/listening_outpost)
"pi" = (
/obj/structure/chair/sofa/left{
	color = "#c45c57"
	},
/obj/machinery/firealarm{
	pixel_y = 24
	},
/turf/open/floor/carpet,
/area/ruin/ocean/listening_outpost)
"px" = (
/obj/machinery/atmospherics/pipe/smart/manifold4w/scrubbers/hidden{
	dir = 4;
	piping_layer = 4;
	pixel_x = 5;
	pixel_y = 5
	},
/obj/effect/decal/cleanable/dirt,
/turf/open/floor/iron/dark,
/area/ruin/ocean/listening_outpost)
"qj" = (
/obj/structure/window{
	dir = 1
	},
/obj/effect/decal/cleanable/dirt,
/turf/open/floor/iron/showroomfloor,
/area/ruin/ocean/listening_outpost)
"qv" = (
/obj/machinery/atmospherics/components/tank/air{
	dir = 4
	},
/obj/effect/decal/cleanable/dirt,
/turf/open/floor/plating,
/area/ruin/ocean/listening_outpost)
"rh" = (
/obj/structure/cable,
/obj/structure/reagent_dispensers/fueltank,
/obj/item/clothing/head/welding,
/obj/item/weldingtool/largetank,
/obj/effect/decal/cleanable/dirt,
/turf/open/floor/plating,
/area/ruin/ocean/listening_outpost)
"rs" = (
/obj/machinery/airalarm/unlocked{
	dir = 4;
	pixel_x = 26
	},
/obj/effect/decal/cleanable/dirt,
/turf/open/floor/iron/dark,
/area/ruin/ocean/listening_outpost)
"rx" = (
/obj/structure/extinguisher_cabinet{
	pixel_x = 25
	},
/obj/machinery/atmospherics/pipe/smart/manifold4w/supply/hidden{
	dir = 4
	},
/obj/machinery/atmospherics/pipe/smart/manifold4w/scrubbers/hidden{
	piping_layer = 4;
	pixel_x = 5;
	pixel_y = 5
	},
/obj/machinery/light/small{
	dir = 4
	},
/obj/effect/decal/cleanable/dirt,
/turf/open/floor/iron,
/area/ruin/ocean/listening_outpost)
"rR" = (
/obj/structure/extinguisher_cabinet{
	pixel_x = 25
	},
/obj/machinery/suit_storage_unit/standard_unit{
	desc = "An industrial suit storage device carrying retro space suits. Neat!";
	helmet_type = /obj/item/clothing/head/helmet/space;
	suit_type = /obj/item/clothing/suit/space
	},
/turf/open/floor/iron/dark,
/area/ruin/ocean/listening_outpost)
"rS" = (
/obj/structure/table/wood,
/obj/machinery/atmospherics/pipe/smart/manifold4w/supply/hidden{
	dir = 4
	},
/obj/machinery/atmospherics/pipe/smart/manifold4w/scrubbers/hidden{
	dir = 4;
	piping_layer = 4;
	pixel_x = 5;
	pixel_y = 5
	},
/obj/effect/decal/cleanable/dirt,
/obj/item/reagent_containers/food/drinks/drinkingglass{
	pixel_x = 9;
	pixel_y = 7
	},
/obj/item/reagent_containers/food/drinks/drinkingglass,
/turf/open/floor/carpet,
/area/ruin/ocean/listening_outpost)
"rX" = (
/obj/structure/table,
/obj/item/storage/medkit/regular,
/obj/item/clothing/neck/stethoscope,
/obj/effect/decal/cleanable/dirt,
/turf/open/floor/iron/white,
/area/ruin/ocean/listening_outpost)
"sD" = (
/obj/structure/flora/ocean/longseaweed,
/turf/open/floor/plating/ocean,
/area/template_noop)
"sJ" = (
/obj/structure/chair/office{
	dir = 1
	},
/obj/effect/decal/cleanable/dirt,
/turf/open/floor/iron/dark,
/area/ruin/ocean/listening_outpost)
"te" = (
/obj/effect/spawner/structure/window/reinforced,
/obj/machinery/atmospherics/pipe/smart/manifold4w/scrubbers/hidden{
	piping_layer = 4;
	pixel_x = 5;
	pixel_y = 5
	},
/turf/open/floor/plating/airless,
/area/ruin/ocean/listening_outpost)
"ti" = (
/obj/machinery/washing_machine{
	pixel_x = -7
	},
/obj/structure/window{
	dir = 4
	},
/obj/structure/sink{
	dir = 8;
	pixel_x = 6;
	pixel_y = 5
	},
/turf/open/floor/iron/showroomfloor,
/area/ruin/ocean/listening_outpost)
"tu" = (
/obj/machinery/atmospherics/pipe/smart/manifold4w/supply/hidden{
	dir = 4
	},
/obj/machinery/atmospherics/pipe/smart/manifold4w/scrubbers/hidden{
	dir = 4;
	piping_layer = 4;
	pixel_x = 5;
	pixel_y = 5
	},
/turf/open/floor/iron/dark,
/area/ruin/ocean/listening_outpost)
"tw" = (
/obj/effect/decal/cleanable/dirt,
/turf/open/floor/wood,
/area/ruin/ocean/listening_outpost)
"tE" = (
/obj/structure/dresser,
/turf/open/floor/carpet,
/area/ruin/ocean/listening_outpost)
"un" = (
/obj/machinery/atmospherics/components/unary/vent_scrubber/on{
	dir = 4;
	piping_layer = 4;
	pixel_x = 5;
	pixel_y = 5
	},
/obj/effect/decal/cleanable/dirt,
/obj/machinery/light/small{
	brightness = 3;
	dir = 8
	},
/turf/open/floor/iron,
/area/ruin/ocean/listening_outpost)
"vz" = (
/obj/item/kirbyplants,
/turf/open/floor/carpet,
/area/ruin/ocean/listening_outpost)
"vK" = (
/turf/closed/mineral/random/stationside/ocean,
/area/template_noop)
"wu" = (
/obj/machinery/shower{
	pixel_y = 14
	},
/obj/structure/curtain,
/obj/item/soap,
/obj/effect/decal/cleanable/dirt,
/turf/open/floor/iron/showroomfloor,
/area/ruin/ocean/listening_outpost)
"wy" = (
/obj/structure/closet/crate/bin,
/turf/open/floor/wood,
/area/ruin/ocean/listening_outpost)
"wL" = (
/obj/machinery/atmospherics/pipe/smart/manifold4w/supply/hidden,
/obj/machinery/atmospherics/pipe/smart/manifold4w/scrubbers/hidden{
	piping_layer = 4;
	pixel_x = 5;
	pixel_y = 5
	},
/obj/effect/decal/cleanable/dirt,
/turf/open/floor/wood,
/area/ruin/ocean/listening_outpost)
"xg" = (
/obj/machinery/computer/security,
/obj/effect/decal/cleanable/dirt,
/turf/open/floor/iron/dark,
/area/ruin/ocean/listening_outpost)
"xy" = (
/obj/structure/cable,
/obj/machinery/power/apc/unlocked{
	pixel_y = -25
	},
/obj/machinery/atmospherics/pipe/smart/manifold4w/supply/hidden{
	dir = 4
	},
/obj/effect/decal/cleanable/dirt,
/turf/open/floor/plating,
/area/ruin/ocean/listening_outpost)
"xH" = (
/obj/machinery/atmospherics/pipe/smart/manifold4w/supply/hidden{
	dir = 4
	},
/obj/machinery/light/small,
/obj/effect/decal/cleanable/dirt,
/turf/open/floor/plating,
/area/ruin/ocean/listening_outpost)
"yn" = (
/obj/machinery/atmospherics/pipe/smart/manifold4w/scrubbers/hidden{
	dir = 4;
	piping_layer = 4;
	pixel_x = 5;
	pixel_y = 5
	},
/obj/machinery/atmospherics/pipe/smart/manifold4w/supply/hidden{
	dir = 4
	},
/obj/effect/decal/cleanable/dirt,
/turf/open/floor/iron/white,
/area/ruin/ocean/listening_outpost)
"yA" = (
/obj/machinery/atmospherics/pipe/smart/manifold4w/scrubbers/hidden{
	dir = 4;
	piping_layer = 4;
	pixel_x = 5;
	pixel_y = 5
	},
/obj/machinery/atmospherics/pipe/smart/manifold4w/supply/hidden{
	dir = 4
	},
/turf/open/floor/iron,
/area/ruin/ocean/listening_outpost)
"yS" = (
/obj/structure/cable,
/obj/effect/decal/cleanable/dirt,
/obj/machinery/power/smes,
/turf/open/floor/plating,
/area/ruin/ocean/listening_outpost)
"zi" = (
/obj/structure/closet/secure_closet/medical1,
/obj/effect/decal/cleanable/dirt,
/turf/open/floor/iron/white,
/area/ruin/ocean/listening_outpost)
"AA" = (
/obj/machinery/atmospherics/pipe/smart/manifold4w/scrubbers/hidden{
	dir = 1;
	piping_layer = 4;
	pixel_x = 5;
	pixel_y = 5
	},
/obj/machinery/atmospherics/pipe/smart/manifold4w/supply/hidden{
	dir = 4
	},
/obj/effect/decal/cleanable/dirt,
/turf/open/floor/wood,
/area/ruin/ocean/listening_outpost)
"AT" = (
/obj/structure/rack,
/obj/item/pickaxe,
/obj/item/mining_scanner,
/turf/open/floor/iron/dark,
/area/ruin/ocean/listening_outpost)
"Bh" = (
/obj/structure/closet/crate/freezer,
/obj/item/reagent_containers/blood/o_minus,
/obj/item/reagent_containers/blood/o_minus{
	pixel_x = -3;
	pixel_y = 3
	},
/obj/effect/decal/cleanable/dirt,
/turf/open/floor/iron/white,
/area/ruin/ocean/listening_outpost)
"BB" = (
/obj/structure/cable,
/obj/machinery/power/port_gen/pacman{
	anchored = 1
	},
/obj/item/wrench,
/obj/effect/decal/cleanable/dirt,
/turf/open/floor/plating,
/area/ruin/ocean/listening_outpost)
"BC" = (
/obj/effect/decal/cleanable/dirt,
/obj/structure/sign/poster/contraband/random{
	pixel_y = 32
	},
/turf/open/floor/carpet,
/area/ruin/ocean/listening_outpost)
"BE" = (
/obj/structure/lattice,
/turf/open/floor/plating/ocean,
/area/template_noop)
"BG" = (
/obj/machinery/atmospherics/components/unary/vent_scrubber/on{
	dir = 1;
	piping_layer = 4;
	pixel_x = 5;
	pixel_y = 5
	},
/obj/effect/decal/cleanable/dirt,
/turf/open/floor/iron/white,
/area/ruin/ocean/listening_outpost)
"Dd" = (
/obj/structure/table,
/obj/item/storage/toolbox/syndicate,
/obj/item/flashlight,
/obj/machinery/light/small{
	dir = 1
	},
/turf/open/floor/iron/dark,
/area/ruin/ocean/listening_outpost)
"Dp" = (
/obj/structure/drain/big,
/turf/open/floor/plating,
/area/ruin/ocean/listening_outpost)
"Dz" = (
/obj/structure/flora/ocean/seaweed,
/turf/open/floor/plating/ocean,
/area/template_noop)
"EB" = (
/obj/structure/filingcabinet,
/obj/effect/decal/cleanable/dirt,
/turf/open/floor/iron/dark,
/area/ruin/ocean/listening_outpost)
"EH" = (
/obj/machinery/atmospherics/pipe/smart/manifold4w/supply/hidden,
/obj/machinery/atmospherics/pipe/smart/manifold4w/scrubbers/hidden{
	piping_layer = 4;
	pixel_x = 5;
	pixel_y = 5
	},
/obj/effect/decal/cleanable/dirt,
/turf/open/floor/carpet,
/area/ruin/ocean/listening_outpost)
"Fg" = (
/obj/structure/bed,
/obj/item/bedsheet/dorms,
/turf/open/floor/carpet,
/area/ruin/ocean/listening_outpost)
"FT" = (
/turf/closed/wall,
/area/ruin/ocean/listening_outpost)
"Go" = (
/obj/structure/table,
/obj/machinery/light/small,
/obj/effect/decal/cleanable/dirt,
/turf/open/floor/iron/dark,
/area/ruin/ocean/listening_outpost)
"GE" = (
/obj/machinery/computer/crew{
	dir = 4
	},
/obj/effect/decal/cleanable/dirt,
/obj/item/radio/intercom{
	freerange = 1;
	name = "free-range intercom";
	pixel_x = -30
	},
/turf/open/floor/iron/dark,
/area/ruin/ocean/listening_outpost)
"GS" = (
/obj/structure/chair/sofa/right{
	color = "#c45c57"
	},
/obj/structure/sign/poster/contraband/random{
	pixel_y = 32
	},
/turf/open/floor/carpet,
/area/ruin/ocean/listening_outpost)
"Hl" = (
/obj/machinery/door/airlock/hatch{
	name = "Telecommunications"
	},
/obj/machinery/door/firedoor,
/obj/machinery/atmospherics/pipe/smart/manifold4w/supply/hidden{
	dir = 4
	},
/obj/machinery/atmospherics/pipe/smart/manifold4w/scrubbers/hidden{
	dir = 4;
	piping_layer = 4;
	pixel_x = 5;
	pixel_y = 5
	},
/turf/open/floor/iron/dark,
/area/ruin/ocean/listening_outpost)
"IN" = (
/obj/machinery/firealarm{
	dir = 8;
	pixel_x = 24
	},
/obj/machinery/telecomms/relay/preset/ruskie{
	use_power = 0
	},
/obj/effect/decal/cleanable/dirt,
/turf/open/floor/iron/dark,
/area/ruin/ocean/listening_outpost)
"IQ" = (
/obj/machinery/firealarm{
	dir = 8;
	pixel_x = 24
	},
/obj/machinery/atmospherics/pipe/smart/manifold4w/supply/hidden{
	dir = 10
	},
/obj/machinery/atmospherics/pipe/smart/manifold4w/scrubbers/hidden{
	dir = 10;
	piping_layer = 4;
	pixel_x = 5;
	pixel_y = 5
	},
/obj/machinery/light/small{
	dir = 4
	},
/obj/effect/decal/cleanable/dirt,
/turf/open/floor/iron,
/area/ruin/ocean/listening_outpost)
"Jl" = (
/obj/structure/lattice/catwalk,
/obj/structure/marker_beacon/burgundy{
	name = "landing marker"
	},
/turf/open/floor/plating/ocean,
/area/template_noop)
"Jt" = (
/obj/machinery/door/airlock{
	name = "Personal Dorm"
	},
/obj/machinery/atmospherics/pipe/smart/manifold4w/supply/hidden,
/obj/machinery/atmospherics/pipe/smart/manifold4w/scrubbers/hidden{
	piping_layer = 4;
	pixel_x = 5;
	pixel_y = 5
	},
/obj/effect/decal/cleanable/dirt,
/turf/open/floor/wood,
/area/ruin/ocean/listening_outpost)
"KK" = (
/obj/structure/closet/secure_closet/personal/cabinet,
/turf/open/floor/carpet,
/area/ruin/ocean/listening_outpost)
"Lg" = (
/obj/structure/table/wood,
/obj/item/reagent_containers/food/drinks/bottle/beer{
	pixel_x = -4;
	pixel_y = 14
	},
/obj/item/reagent_containers/food/drinks/bottle/beer{
	pixel_x = 3;
	pixel_y = 11
	},
/obj/item/reagent_containers/food/drinks/bottle/beer,
/turf/open/floor/wood,
/area/ruin/ocean/listening_outpost)
"LE" = (
/obj/machinery/airalarm/unlocked{
	dir = 4;
	pixel_x = 26
	},
/obj/machinery/atmospherics/components/unary/vent_scrubber/on{
	dir = 8;
	piping_layer = 4;
	pixel_x = 5;
	pixel_y = 5
	},
/obj/machinery/light/small{
	dir = 4
	},
/obj/effect/decal/cleanable/dirt,
/turf/open/floor/carpet,
/area/ruin/ocean/listening_outpost)
"Mg" = (
/obj/structure/lattice/catwalk,
/turf/open/floor/plating/ocean,
/area/template_noop)
"Mp" = (
/obj/effect/decal/cleanable/dirt,
/obj/structure/sign/poster/contraband/random{
	pixel_x = -32
	},
/turf/open/floor/iron,
/area/ruin/ocean/listening_outpost)
"Mu" = (
/obj/structure/cable,
/obj/structure/closet/crate,
/obj/item/stack/sheet/mineral/plasma{
	amount = 30
	},
/obj/item/storage/box/lights/bulbs,
/obj/item/stack/sheet/iron/twenty,
/obj/item/stack/sheet/glass{
	amount = 10
	},
/obj/item/stack/rods/ten,
/obj/effect/decal/cleanable/dirt,
/turf/open/floor/plating,
/area/ruin/ocean/listening_outpost)
"MX" = (
/obj/structure/flora/ocean/glowweed,
/turf/open/floor/plating/ocean,
/area/template_noop)
"Ne" = (
/obj/machinery/atmospherics/components/unary/outlet_injector/on{
	dir = 1;
	piping_layer = 4;
	pixel_x = 5;
	pixel_y = 5
	},
/turf/open/floor/plating,
/area/ruin/ocean/listening_outpost)
"NS" = (
/turf/template_noop,
/area/template_noop)
"NV" = (
/obj/machinery/power/terminal{
	dir = 4
	},
/obj/structure/cable,
/obj/structure/liquid_pump,
/obj/effect/decal/cleanable/dirt,
/turf/open/floor/plating,
/area/ruin/ocean/listening_outpost)
"Oa" = (
/obj/machinery/vending/coffee,
/obj/effect/decal/cleanable/dirt,
/turf/open/floor/iron,
/area/ruin/ocean/listening_outpost)
"Oi" = (
/obj/structure/drain,
/obj/machinery/light/small{
	dir = 4
	},
/obj/effect/decal/cleanable/dirt,
/turf/open/floor/iron/showroomfloor,
/area/ruin/ocean/listening_outpost)
"OC" = (
/turf/closed/wall/rust,
/area/template_noop)
"Qq" = (
/obj/effect/spawner/random/vending/colavend,
/obj/effect/decal/cleanable/dirt,
/turf/open/floor/iron,
/area/ruin/ocean/listening_outpost)
"QH" = (
/obj/machinery/door/airlock/external,
/turf/open/floor/plating,
/area/ruin/ocean/listening_outpost)
"RY" = (
/obj/structure/flora/rock/pile,
/turf/open/floor/plating/ocean,
/area/template_noop)
"Sa" = (
/obj/effect/spawner/structure/window/reinforced,
/turf/open/floor/plating/airless,
/area/ruin/ocean/listening_outpost)
"St" = (
/obj/machinery/door/airlock/hatch{
	name = "E.V.A. Equipment"
	},
/obj/machinery/door/firedoor,
/obj/machinery/atmospherics/pipe/smart/manifold4w/supply/hidden{
	dir = 4
	},
/obj/machinery/atmospherics/pipe/smart/manifold4w/scrubbers/hidden{
	dir = 4;
	piping_layer = 4;
	pixel_x = 5;
	pixel_y = 5
	},
/turf/open/floor/iron/dark,
/area/ruin/ocean/listening_outpost)
"SX" = (
/obj/structure/window{
	dir = 1
	},
/obj/structure/closet/secure_closet/freezer/meat,
/turf/open/floor/iron/showroomfloor,
/area/ruin/ocean/listening_outpost)
"Ti" = (
/turf/open/floor/iron/dark,
/area/ruin/ocean/listening_outpost)
"TD" = (
/obj/machinery/atmospherics/pipe/smart/manifold4w/scrubbers/hidden{
	piping_layer = 4;
	pixel_x = 5;
	pixel_y = 5
	},
/obj/machinery/atmospherics/pipe/smart/manifold4w/supply/hidden,
/obj/effect/decal/cleanable/dirt,
/turf/open/floor/iron,
/area/ruin/ocean/listening_outpost)
"TE" = (
/obj/structure/rack,
/obj/item/clothing/mask/gas{
	pixel_x = -3;
	pixel_y = 3
	},
/obj/item/clothing/mask/gas{
	pixel_x = 4;
	pixel_y = 4
	},
/obj/item/clothing/mask/gas,
/turf/open/floor/iron/dark,
/area/ruin/ocean/listening_outpost)
"Um" = (
/obj/machinery/vending/cigarette,
/obj/effect/decal/cleanable/dirt,
/turf/open/floor/iron,
/area/ruin/ocean/listening_outpost)
"Up" = (
/obj/machinery/door/firedoor,
/obj/machinery/atmospherics/pipe/smart/manifold4w/supply/hidden,
/obj/machinery/atmospherics/pipe/smart/manifold4w/scrubbers/hidden{
	piping_layer = 4;
	pixel_x = 5;
	pixel_y = 5
	},
/turf/open/floor/iron,
/area/ruin/ocean/listening_outpost)
"Va" = (
/obj/structure/table/wood,
/turf/open/floor/wood,
/area/ruin/ocean/listening_outpost)
"Vp" = (
/obj/machinery/atmospherics/pipe/smart/manifold4w/supply/hidden{
	dir = 4
	},
/obj/machinery/atmospherics/pipe/smart/manifold4w/scrubbers/hidden{
	dir = 4;
	piping_layer = 4;
	pixel_x = 5;
	pixel_y = 5
	},
/turf/open/floor/iron,
/area/ruin/ocean/listening_outpost)
"VJ" = (
/obj/effect/spawner/random/entertainment/arcade,
/obj/machinery/light/small{
	dir = 1
	},
/turf/open/floor/wood,
/area/ruin/ocean/listening_outpost)
"Wa" = (
/obj/machinery/door/airlock/maintenance,
/obj/machinery/door/firedoor,
/obj/machinery/atmospherics/pipe/smart/manifold4w/supply/hidden{
	dir = 4
	},
/obj/effect/decal/cleanable/dirt,
/turf/open/floor/plating,
/area/ruin/ocean/listening_outpost)
"WL" = (
/obj/machinery/atmospherics/pipe/smart/manifold4w/supply/hidden{
	dir = 10
	},
/obj/machinery/atmospherics/pipe/smart/manifold4w/scrubbers/hidden{
	dir = 6;
	piping_layer = 4;
	pixel_x = 5;
	pixel_y = 5
	},
/obj/effect/decal/cleanable/dirt,
/turf/open/floor/carpet,
/area/ruin/ocean/listening_outpost)
"WP" = (
/obj/machinery/airalarm/unlocked{
	pixel_y = 23;
	dir = 1
	},
/obj/machinery/atmospherics/pipe/smart/manifold4w/scrubbers/hidden{
	dir = 6;
	piping_layer = 4;
	pixel_x = 5;
	pixel_y = 5
	},
/obj/machinery/atmospherics/pipe/smart/manifold4w/supply/hidden{
	dir = 4
	},
/obj/machinery/light/small{
	dir = 1
	},
/obj/effect/decal/cleanable/dirt,
/turf/open/floor/iron/white,
/area/ruin/ocean/listening_outpost)
"XJ" = (
/obj/machinery/airalarm/unlocked{
	pixel_y = 23;
	dir = 1
	},
/obj/structure/tank_dispenser/oxygen{
	oxygentanks = 4
	},
/turf/open/floor/iron/dark,
/area/ruin/ocean/listening_outpost)
"Yu" = (
/obj/machinery/newscaster{
	pixel_y = -28
	},
/obj/effect/decal/cleanable/dirt,
/turf/open/floor/wood,
/area/ruin/ocean/listening_outpost)
"Yv" = (
/obj/machinery/computer/security{
	dir = 4
	},
/obj/effect/decal/cleanable/dirt,
/turf/open/floor/iron/dark,
/area/ruin/ocean/listening_outpost)
"ZJ" = (
/obj/machinery/door/airlock/medical/glass{
	name = "Medbay"
	},
/obj/machinery/door/firedoor,
/obj/machinery/atmospherics/pipe/smart/manifold4w/scrubbers/hidden{
	dir = 4;
	piping_layer = 4;
	pixel_x = 5;
	pixel_y = 5
	},
/obj/machinery/atmospherics/pipe/smart/manifold4w/supply/hidden{
	dir = 4
	},
/obj/effect/decal/cleanable/dirt,
/turf/open/floor/iron/white,
/area/ruin/ocean/listening_outpost)

(1,1,1) = {"
NS
NS
NS
NS
NS
NS
NS
NS
NS
NS
NS
NS
NS
NS
NS
NS
NS
NS
NS
NS
NS
NS
NS
NS
NS
"}
(2,1,1) = {"
NS
NS
NS
NS
NS
NS
NS
vK
vK
vK
vK
vK
vK
NS
NS
NS
NS
NS
jq
NS
NS
jq
NS
NS
NS
"}
(3,1,1) = {"
NS
NS
vK
vK
vK
vK
vK
vK
vK
FT
FT
FT
vK
vK
vK
vK
jq
jq
jq
jq
jq
jq
jq
NS
NS
"}
(4,1,1) = {"
NS
NS
vK
vK
vK
vK
vK
vK
FT
FT
qv
FT
vK
vK
vK
vK
jq
Dz
jq
jq
jq
jq
jq
jq
NS
"}
(5,1,1) = {"
NS
vK
vK
FT
FT
FT
FT
FT
FT
BB
aU
FT
vK
vK
vK
vK
jq
jq
jq
jq
jq
jq
Dz
jq
jq
"}
(6,1,1) = {"
NS
vK
FT
FT
Yv
GE
eD
FT
FT
Mu
aU
FT
FT
FT
FT
mZ
jq
jq
jq
jq
jq
jq
jq
jq
jq
"}
(7,1,1) = {"
NS
vK
FT
xg
sJ
Ti
cg
gb
FT
rh
xH
FT
lB
dj
zi
mZ
Mg
BE
BE
BE
BE
BE
BE
Jl
jq
"}
(8,1,1) = {"
NS
vK
FT
mM
Ti
ov
hp
Go
FT
NV
aU
FT
WP
BG
Bh
mZ
jq
jq
jq
jq
jq
jq
jq
BE
NS
"}
(9,1,1) = {"
NS
vK
FT
FT
IN
rs
tu
EB
FT
yS
xy
FT
yn
rX
mZ
mZ
jq
jq
jq
jq
jq
jq
jq
BE
jq
"}
(10,1,1) = {"
NS
vK
vK
FT
FT
FT
Hl
FT
FT
FT
Wa
FT
ZJ
FT
mZ
jq
jq
jq
jq
jq
jq
jq
jq
BE
jq
"}
(11,1,1) = {"
NS
vK
vK
vK
FT
Oa
Vp
Mp
un
ai
oE
dc
yA
Qq
mZ
Dz
jq
jq
jq
Dz
jq
jq
jq
BE
jq
"}
(12,1,1) = {"
NS
vK
vK
vK
FT
Um
IQ
js
mn
Up
rx
mT
TD
oR
mZ
RY
jq
jq
jq
jq
jq
jq
jq
Mg
jq
"}
(13,1,1) = {"
vK
vK
vK
vK
FT
FT
FT
oA
FT
FT
FT
FT
St
mZ
mZ
sD
jq
jq
jq
jq
jq
jq
jq
BE
jq
"}
(14,1,1) = {"
vK
vK
vK
vK
FT
FT
nb
fa
SX
nE
FT
AT
kf
te
Ne
jq
jq
jq
jq
jq
jq
jq
jq
BE
NS
"}
(15,1,1) = {"
vK
vK
vK
vK
vK
FT
Lg
aa
qj
bp
FT
Dd
fn
Sa
Sa
Sa
jq
jq
jq
jq
jq
jq
jq
BE
Dz
"}
(16,1,1) = {"
NS
vK
vK
vK
vK
FT
VJ
kW
qj
ti
FT
XJ
cp
QH
Dp
QH
jq
jq
jq
jq
jq
jq
jq
BE
jq
"}
(17,1,1) = {"
vK
vK
vK
vK
vK
FT
kB
AA
im
wy
FT
cz
px
Sa
Sa
Sa
jq
jq
jq
jq
jq
jq
jq
BE
jq
"}
(18,1,1) = {"
vK
FT
FT
FT
FT
FT
GS
rS
tw
Va
FT
rR
iB
Sa
MX
Dz
jq
jq
jq
jq
jq
jq
jq
Mg
jq
"}
(19,1,1) = {"
vK
FT
KK
cb
tE
FT
pi
hu
tw
Va
FT
FT
TE
Sa
RY
jq
jq
jq
Dz
jq
jq
jq
jq
BE
NS
"}
(20,1,1) = {"
vK
FT
BC
WL
EH
Jt
wL
fe
mt
Yu
FT
FT
mZ
mZ
jq
sD
jq
jq
jq
jq
jq
jq
jq
BE
NS
"}
(21,1,1) = {"
vK
FT
Fg
LE
vz
FT
FT
FT
FT
ox
FT
FT
vK
vK
vK
jq
jq
jq
jq
jq
jq
jq
jq
BE
NS
"}
(22,1,1) = {"
vK
FT
FT
FT
FT
FT
vK
FT
wu
Oi
ge
FT
vK
vK
vK
vK
jq
jq
jq
jq
jq
jq
jq
BE
jq
"}
(23,1,1) = {"
vK
vK
vK
vK
vK
vK
vK
FT
FT
FT
FT
FT
vK
vK
vK
OC
Mg
BE
BE
BE
BE
BE
BE
Jl
jq
"}
(24,1,1) = {"
NS
vK
vK
vK
vK
vK
vK
vK
vK
vK
vK
vK
vK
vK
vK
vK
jq
jq
jq
Dz
jq
jq
jq
jq
NS
"}
(25,1,1) = {"
NS
NS
NS
NS
NS
NS
vK
vK
vK
vK
vK
vK
vK
NS
NS
jq
jq
jq
jq
jq
jq
jq
jq
NS
NS
"}
