//MAP CONVERTED BY dmm2tgm.py THIS HEADER COMMENT PREVENTS RECONVERSION, DO NOT REMOVE
"a" = (
/turf/template_noop,
/area/template_noop)
"d" = (
/turf/open/floor/iron/smooth_large,
/area/ruin/powered/shuttle)
"e" = (
/obj/machinery/portable_atmospherics/canister/oxygen,
/turf/open/floor/plating/ocean/rock/heavy,
/area/ocean/trench)
"f" = (
/obj/structure/bonfire/prelit,
/turf/open/floor/iron,
/area/ruin/powered/shuttle)
"g" = (
/obj/item/clothing/suit/space/fragile,
/obj/item/clothing/head/helmet/space/fragile,
/turf/open/floor/iron/smooth_large,
/area/ruin/powered/shuttle)
"h" = (
/obj/effect/spawner/structure/window/shuttle,
/turf/open/floor/plating,
/area/ruin/powered/shuttle)
"i" = (
/obj/item/flashlight/lamp{
	pixel_y = 2
	},
/obj/structure/table/wood,
/obj/item/tank/internals/emergency_oxygen/engi{
	pixel_x = 5;
	pixel_y = -4
	},
/turf/open/floor/iron,
/area/ruin/powered/shuttle)
"n" = (
/obj/structure/inflatable/door,
/turf/open/floor/plating,
/area/ocean/trench)
"o" = (
/obj/structure/flora/rock,
/turf/open/floor/plating/ocean/rock/heavy,
/area/ocean/trench)
"p" = (
/obj/effect/turf_decal/siding/thinplating{
	dir = 4
	},
/turf/open/floor/iron/smooth_large,
/area/ruin/powered/shuttle)
"q" = (
/obj/machinery/door/airlock/titanium/glass,
/turf/open/floor/iron/smooth_half,
/area/ruin/powered/shuttle)
"s" = (
/turf/open/floor/plating,
/area/ocean/trench)
"t" = (
/obj/item/reagent_containers/glass/bucket/wooden,
/obj/effect/turf_decal/siding/thinplating{
	dir = 4
	},
/turf/open/floor/iron/smooth_large,
/area/ruin/powered/shuttle)
"w" = (
/turf/closed/wall/mineral/titanium/nodiagonal,
/area/ruin/powered/shuttle)
"x" = (
/obj/effect/turf_decal/siding/thinplating{
	dir = 8
	},
/turf/open/floor/iron/smooth_large,
/area/ruin/powered/shuttle)
"y" = (
/obj/machinery/hydroponics/constructable,
/turf/open/floor/iron,
/area/ruin/powered/shuttle)
"z" = (
/turf/closed/wall/mineral/titanium,
/area/ruin/powered/shuttle)
"B" = (
/obj/structure/drain/big,
/turf/open/floor/iron/smooth_large,
/area/ruin/powered/shuttle)
"C" = (
/obj/machinery/seed_extractor,
/obj/structure/window/reinforced/spawner/west,
/turf/open/floor/iron/smooth_large,
/area/ruin/powered/shuttle)
"E" = (
/obj/item/pickaxe/improvised,
/turf/open/floor/iron/smooth_large,
/area/ruin/powered/shuttle)
"F" = (
/obj/item/shovel,
/obj/effect/turf_decal/siding/thinplating{
	dir = 8
	},
/turf/open/floor/iron/smooth_large,
/area/ruin/powered/shuttle)
"G" = (
/obj/structure/chair/comfy/beige{
	dir = 8
	},
/turf/open/floor/iron/smooth_large,
/area/ruin/powered/shuttle)
"H" = (
/obj/structure/inflatable,
/turf/open/floor/plating,
/area/ocean/trench)
"J" = (
/obj/effect/mob_spawn/human/hermit/ocean,
/turf/open/floor/iron,
/area/ruin/powered/shuttle)
"O" = (
/turf/open/floor/plating/ocean/rock/heavy,
/area/ocean/trench)
"Q" = (
/obj/item/storage/firstaid/medical,
/obj/structure/table/wood,
/obj/item/storage/bag/ore,
/obj/structure/window/reinforced/spawner/west,
/turf/open/floor/iron/smooth_large,
/area/ruin/powered/shuttle)
"R" = (
/obj/item/seeds/plump,
/obj/item/seeds/plump,
/obj/item/seeds/tower,
/obj/item/seeds/reishi,
/obj/structure/table/wood,
/obj/item/food/grown/mushroom/glowshroom,
/obj/item/paper/guides/jobs/hydroponics,
/obj/effect/turf_decal/siding/thinplating{
	dir = 4
	},
/turf/open/floor/iron/smooth_large,
/area/ruin/powered/shuttle)
"S" = (
/obj/item/storage/toolbox/emergency,
/obj/effect/turf_decal/siding/thinplating{
	dir = 8
	},
/turf/open/floor/iron/smooth_large,
/area/ruin/powered/shuttle)
"T" = (
/obj/item/storage/inflatable,
/turf/open/floor/iron/smooth_large,
/area/ruin/powered/shuttle)
"U" = (
/obj/item/kitchen/knife/combat,
/turf/open/floor/plating/ocean/rock/heavy,
/area/ocean/trench)
"V" = (
/obj/structure/flora/rock/pile,
/turf/open/floor/plating/ocean/rock/heavy,
/area/ocean/trench)
"Y" = (
/obj/structure/shuttle/engine/propulsion{
	dir = 4
	},
/obj/structure/window/reinforced/spawner/west,
/turf/open/floor/plating/ocean_plating,
/area/ruin/powered/shuttle)

(1,1,1) = {"
a
a
a
a
O
O
O
a
a
a
a
"}
(2,1,1) = {"
a
a
a
O
O
O
O
O
a
a
a
"}
(3,1,1) = {"
a
a
O
O
O
O
O
O
O
a
a
"}
(4,1,1) = {"
a
a
o
O
O
O
O
O
O
O
a
"}
(5,1,1) = {"
a
O
O
O
z
w
h
w
z
O
O
"}
(6,1,1) = {"
a
O
O
O
w
J
i
f
w
O
V
"}
(7,1,1) = {"
O
O
U
e
h
F
S
x
h
O
O
"}
(8,1,1) = {"
O
O
H
H
w
T
g
E
w
O
O
"}
(9,1,1) = {"
O
O
n
s
q
d
B
G
w
O
O
"}
(10,1,1) = {"
O
O
H
H
w
C
d
Q
w
O
O
"}
(11,1,1) = {"
a
O
O
O
h
t
p
R
h
O
O
"}
(12,1,1) = {"
a
O
O
O
w
y
y
y
w
O
O
"}
(13,1,1) = {"
a
a
O
O
z
w
Y
w
z
O
a
"}
(14,1,1) = {"
a
a
a
O
O
O
O
O
O
O
a
"}
(15,1,1) = {"
a
a
a
a
O
O
V
O
O
a
a
"}
(16,1,1) = {"
a
a
a
a
a
O
O
O
a
a
a
"}
