//MAP CONVERTED BY dmm2tgm.py THIS HEADER COMMENT PREVENTS RECONVERSION, DO NOT REMOVE
"a" = (
/turf/template_noop,
/area/template_noop)
"c" = (
/turf/open/floor/plating/ocean/rock/warm,
/area/ocean)
"e" = (
/turf/open/floor/plating/ocean/rock,
/area/template_noop)
"f" = (
/turf/open/floor/plating/ocean/rock/warm/fissure,
/area/ocean)

(1,1,1) = {"
a
c
c
a
a
a
a
a
a
a
a
a
a
a
"}
(2,1,1) = {"
c
f
f
c
a
e
a
a
a
e
a
a
a
a
"}
(3,1,1) = {"
a
c
f
f
c
e
a
a
e
a
a
a
a
a
"}
(4,1,1) = {"
a
a
c
f
f
c
a
e
a
a
a
a
a
a
"}
(5,1,1) = {"
a
a
c
f
f
f
c
e
a
e
a
e
a
a
"}
(6,1,1) = {"
a
e
e
c
f
f
f
c
e
a
e
a
a
a
"}
(7,1,1) = {"
e
a
a
a
c
f
f
f
c
e
e
a
a
a
"}
(8,1,1) = {"
a
a
a
a
e
c
f
f
f
c
e
a
a
a
"}
(9,1,1) = {"
a
a
a
e
e
e
c
f
f
f
c
c
a
a
"}
(10,1,1) = {"
a
a
e
e
a
e
e
c
f
f
f
f
c
a
"}
(11,1,1) = {"
a
a
a
a
a
e
a
e
c
c
f
f
f
c
"}
(12,1,1) = {"
a
a
a
a
a
a
a
e
a
a
c
c
f
f
"}
(13,1,1) = {"
a
a
a
a
e
a
a
a
a
a
e
a
c
a
"}
(14,1,1) = {"
a
a
a
a
a
a
a
a
a
a
a
a
a
a
"}
