"a" = (/turf/template_noop,/area/template_noop)
"b" = (/obj/machinery/button/door/directional/north{id = "shuttleload"; name = "Loading Bay Blast Doors"; pixel_x = -25; pixel_y = 0},/turf/open/floor/iron/dark,/area/shuttle/cargodise)
"f" = (/turf/open/floor/iron/dark/brown/side{dir = 8},/area/shuttle/cargodise)
"i" = (/obj/structure/window/shuttle/spaceship,/turf/open/floor/plating,/area/shuttle/cargodise)
"j" = (/turf/open/floor/iron/dark/brown/side{dir = 1},/area/shuttle/cargodise)
"l" = (/obj/machinery/computer/crew{dir = 8},/turf/open/floor/iron/dark/brown/side{dir = 6},/area/shuttle/cargodise)
"n" = (/obj/machinery/door/airlock/external{name = "External Docking Port"},/obj/structure/fans/tiny,/obj/docking_port/mobile{callTime = 50; dir = 2; dwidth = 12; height = 5; id = "cargodise"; ignitionTime = 25; movement_force = list("KNOCKDOWN" = 0, "THROW" = 0); name = "Salvage Vessel"; width = 12},/turf/open/floor/plating,/area/shuttle/cargodise)
"o" = (/turf/open/floor/iron/dark/brown,/area/shuttle/cargodise)
"p" = (/obj/structure/chair/comfy/shuttle{dir = 4},/turf/open/floor/iron/dark/brown/side,/area/shuttle/cargodise)
"r" = (/obj/machinery/computer/camera_advanced/shuttle_docker/cargodise{dir = 8},/turf/open/floor/iron/dark/brown/side{dir = 5},/area/shuttle/cargodise)
"v" = (/obj/structure/chair/comfy/shuttle{dir = 4},/turf/open/floor/iron/dark/brown/side{dir = 1},/area/shuttle/cargodise)
"w" = (/turf/open/floor/iron/dark/brown/side,/area/shuttle/cargodise)
"x" = (/obj/structure/shuttle/engine/propulsion{dir = 8},/turf/open/floor/plating,/area/shuttle/cargodise)
"B" = (/turf/closed/wall/mineral/titanium/spaceship,/area/shuttle/cargodise)
"D" = (/obj/structure/fans{pixel_y = 26},/turf/open/floor/iron/dark/brown/side{dir = 9},/area/shuttle/cargodise)
"E" = (/obj/effect/turf_decal/bot,/obj/structure/closet/crate/secure/gear,/turf/open/floor/iron/dark,/area/shuttle/cargodise)
"F" = (/obj/item/gps/computer/space,/turf/open/floor/iron/dark/brown/side{dir = 1},/area/shuttle/cargodise)
"G" = (/obj/effect/turf_decal/bot,/obj/structure/closet/crate/radiation,/turf/open/floor/iron/dark,/area/shuttle/cargodise)
"L" = (/turf/open/floor/iron/dark/brown/side{dir = 10},/area/shuttle/cargodise)
"M" = (/turf/open/floor/iron/dark,/area/shuttle/cargodise)
"Q" = (/obj/effect/turf_decal/bot,/obj/structure/closet/crate,/turf/open/floor/iron/dark,/area/shuttle/cargodise)
"S" = (/obj/machinery/computer/shuttle/cargodise{dir = 8},/turf/open/floor/iron/dark/brown/side{dir = 4},/area/shuttle/cargodise)
"U" = (/obj/structure/chair/comfy/shuttle{dir = 4},/turf/open/floor/iron/dark/brown,/area/shuttle/cargodise)
"V" = (/obj/structure/fans/tiny/forcefield,/obj/machinery/door/poddoor{id = "shuttleload"},/turf/open/floor/plating,/area/shuttle/cargodise)

(1,1,1) = {"
axBVVVBBBBBB
xBBbMMDFjvri
xBMMMMfooUSi
xBBQEGLwwpli
axBBBBnBBBBB
"}
