//MAP CONVERTED BY dmm2tgm.py THIS HEADER COMMENT PREVENTS RECONVERSION, DO NOT REMOVE
"a" = (
/obj/structure/window/reinforced/survival_pod,
/obj/structure/chair/comfy/shuttle{
	dir = 4
	},
/turf/open/floor/pod,
/area/shuttle/interdyne_cargo)
"d" = (
/turf/open/floor/iron/dark,
/area/shuttle/interdyne_cargo)
"e" = (
/obj/structure/table/reinforced,
/obj/item/paper_bin,
/obj/item/pen,
/turf/open/floor/pod,
/area/shuttle/interdyne_cargo)
"g" = (
/obj/machinery/door/poddoor{
	id = "interdynecargoshuttletop"
	},
/turf/open/floor/plating,
/area/shuttle/interdyne_cargo)
"h" = (
/obj/machinery/light/directional/east,
/obj/machinery/button/door{
	id = "interdynecargoshuttletop";
	pixel_x = 32;
	pixel_y = 8
	},
/obj/machinery/button/door{
	id = "interdynecargoshuttlebottom";
	pixel_x = 32;
	pixel_y = -8
	},
/turf/open/floor/iron/dark,
/area/shuttle/interdyne_cargo)
"i" = (
/obj/docking_port/mobile{
	dir = 8;
	dwidth = 5;
	height = 7;
	id = "interdyne_cargo";
	movement_force = list("KNOCKDOWN" = 0, "THROW" = 0);
	name = "Interdyne Cargo Shuttle";
	port_direction = 4;
	width = 12
	},
/obj/machinery/door/poddoor{
	id = "interdynecargoshuttlebottom"
	},
/turf/open/floor/plating,
/area/shuttle/interdyne_cargo)
"j" = (
/obj/machinery/door/airlock/survival_pod/glass{
	req_access_txt = "150"
	},
/turf/open/floor/plating,
/area/shuttle/interdyne_cargo)
"k" = (
/obj/effect/turf_decal/siding/thinplating/dark/end,
/turf/open/floor/mineral/plastitanium,
/area/shuttle/interdyne_cargo)
"l" = (
/turf/closed/wall/mineral/titanium/survival,
/area/shuttle/interdyne_cargo)
"p" = (
/obj/effect/turf_decal/siding/thinplating/dark{
	dir = 4
	},
/obj/effect/turf_decal/siding/thinplating/dark{
	dir = 8
	},
/turf/open/floor/mineral/plastitanium,
/area/shuttle/interdyne_cargo)
"q" = (
/obj/structure/shuttle/engine/heater,
/obj/structure/window/reinforced/survival_pod{
	dir = 1
	},
/turf/open/floor/plating/airless,
/area/shuttle/interdyne_cargo)
"s" = (
/turf/template_noop,
/area/template_noop)
"t" = (
/obj/structure/shuttle/engine/propulsion/burst/left,
/turf/open/floor/plating/airless,
/area/shuttle/interdyne_cargo)
"u" = (
/obj/structure/shuttle/engine/propulsion,
/turf/open/floor/plating/airless,
/area/shuttle/interdyne_cargo)
"v" = (
/obj/structure/shuttle/engine/propulsion/burst/right,
/turf/open/floor/plating/airless,
/area/shuttle/interdyne_cargo)
"w" = (
/obj/machinery/light/directional/north,
/obj/structure/reagent_dispensers/water_cooler,
/turf/open/floor/pod,
/area/shuttle/interdyne_cargo)
"x" = (
/obj/machinery/light/directional/west,
/turf/open/floor/iron/dark,
/area/shuttle/interdyne_cargo)
"z" = (
/obj/machinery/door/window/survival_pod{
	req_access_txt = "150"
	},
/turf/open/floor/pod,
/area/shuttle/interdyne_cargo)
"C" = (
/obj/structure/window/reinforced/survival_pod,
/obj/structure/sign/poster/contraband/syndicate_recruitment{
	pixel_x = 37;
	pixel_y = 1
	},
/obj/machinery/computer/shuttle/caravan/interdyne_cargo{
	dir = 8
	},
/turf/open/floor/pod,
/area/shuttle/interdyne_cargo)
"G" = (
/obj/structure/window/reinforced/survival_pod,
/obj/structure/chair/comfy/shuttle{
	dir = 8
	},
/turf/open/floor/pod,
/area/shuttle/interdyne_cargo)
"I" = (
/obj/structure/table/reinforced,
/obj/item/modular_computer/laptop/preset/syndicate,
/turf/open/floor/pod,
/area/shuttle/interdyne_cargo)
"M" = (
/obj/structure/window/shuttle/survival_pod,
/obj/structure/grille,
/turf/open/floor/plating,
/area/shuttle/interdyne_cargo)
"O" = (
/obj/structure/table/reinforced,
/obj/item/toy/plush/cat/tux,
/turf/open/floor/pod,
/area/shuttle/interdyne_cargo)
"R" = (
/obj/structure/window/reinforced/survival_pod,
/obj/machinery/computer/crew/syndie{
	dir = 4
	},
/turf/open/floor/pod,
/area/shuttle/interdyne_cargo)
"V" = (
/obj/effect/turf_decal/siding/thinplating/dark/end{
	dir = 1
	},
/turf/open/floor/mineral/plastitanium,
/area/shuttle/interdyne_cargo)
"X" = (
/obj/structure/table/reinforced,
/turf/open/floor/pod,
/area/shuttle/interdyne_cargo)

(1,1,1) = {"
l
l
l
l
l
l
l
l
l
l
l
s
"}
(2,1,1) = {"
M
e
R
d
d
x
d
d
d
l
l
t
"}
(3,1,1) = {"
M
O
G
d
V
p
p
k
d
d
q
u
"}
(4,1,1) = {"
l
w
z
d
d
d
d
d
d
d
q
u
"}
(5,1,1) = {"
M
I
a
d
V
p
p
k
d
d
q
u
"}
(6,1,1) = {"
M
X
C
d
d
h
d
d
d
l
l
v
"}
(7,1,1) = {"
l
l
l
j
g
l
i
j
l
l
l
s
"}
