//MAP CONVERTED BY dmm2tgm.py THIS HEADER COMMENT PREVENTS RECONVERSION, DO NOT REMOVE
"bY" = (
/obj/effect/spawner/lootdrop/gross_decal_spawner,
/turf/open/floor/mineral/titanium,
/area/shuttle/blackmarket_chevvy)
"eu" = (
/obj/structure/table,
/turf/open/floor/iron,
/area/shuttle/blackmarket_chevvy)
"fh" = (
/turf/open/floor/mineral/titanium,
/area/shuttle/blackmarket_chevvy)
"fp" = (
/turf/closed/wall/mineral/titanium,
/area/shuttle/blackmarket_chevvy)
"iG" = (
/obj/structure/chair/comfy/shuttle{
	dir = 1
	},
/turf/open/floor/plating,
/area/shuttle/blackmarket_chevvy)
"kT" = (
/obj/effect/turf_decal/siding/brown{
	dir = 1
	},
/obj/effect/decal/cleanable/dirt/dust,
/turf/open/floor/mineral/titanium,
/area/shuttle/blackmarket_chevvy)
"qx" = (
/obj/effect/decal/cleanable/dirt/dust,
/turf/open/floor/plating,
/area/shuttle/blackmarket_chevvy)
"rw" = (
/obj/machinery/door/window{
	req_access_txt = "208"
	},
/obj/effect/decal/cleanable/dirt/dust,
/turf/open/floor/plating,
/area/shuttle/blackmarket_chevvy)
"sU" = (
/obj/effect/decal/cleanable/dirt/dust,
/obj/structure/table,
/obj/item/storage/toolbox/mechanical/old,
/turf/open/floor/mineral/titanium,
/area/shuttle/blackmarket_chevvy)
"ts" = (
/obj/effect/decal/cleanable/dirt/dust,
/obj/structure/shuttle/engine/heater,
/obj/machinery/atmospherics/pipe/smart/manifold4w/orange/visible,
/obj/structure/window/reinforced{
	dir = 1
	},
/obj/structure/window/reinforced{
	dir = 8
	},
/obj/structure/window/reinforced{
	dir = 4
	},
/turf/open/floor/mineral/titanium,
/area/shuttle/blackmarket_chevvy)
"uW" = (
/obj/effect/turf_decal/siding/brown{
	dir = 1
	},
/turf/open/floor/mineral/titanium,
/area/shuttle/blackmarket_chevvy)
"vK" = (
/obj/structure/chair/comfy/shuttle{
	dir = 1
	},
/turf/open/floor/mineral/titanium,
/area/shuttle/blackmarket_chevvy)
"wV" = (
/obj/docking_port/mobile{
	callTime = 50;
	dir = 4;
	dwidth = 4;
	height = 5;
	id = "blackmarket_chevvy";
	ignitionTime = 25;
	name = "Chevvy";
	port_direction = 2;
	width = 9
	},
/obj/machinery/door/airlock/external,
/turf/open/floor/plating,
/area/shuttle/blackmarket_chevvy)
"Dx" = (
/turf/open/floor/plating,
/area/shuttle/blackmarket_chevvy)
"FD" = (
/obj/machinery/atmospherics/components/unary/engine,
/turf/open/floor/plating,
/area/shuttle/blackmarket_chevvy)
"GO" = (
/obj/structure/window/reinforced/spawner,
/turf/open/floor/plating,
/area/shuttle/blackmarket_chevvy)
"Jr" = (
/obj/effect/decal/cleanable/dirt/dust,
/obj/structure/chair/comfy/shuttle{
	dir = 1
	},
/turf/open/floor/mineral/titanium,
/area/shuttle/blackmarket_chevvy)
"Ov" = (
/obj/structure/window/reinforced/spawner,
/obj/effect/decal/cleanable/dirt/dust,
/obj/structure/chair/comfy/shuttle{
	dir = 1
	},
/turf/open/floor/iron,
/area/shuttle/blackmarket_chevvy)
"OR" = (
/obj/effect/decal/cleanable/dirt/dust,
/obj/machinery/atmospherics/components/unary/portables_connector/visible{
	dir = 8
	},
/turf/open/floor/mineral/titanium,
/area/shuttle/blackmarket_chevvy)
"RS" = (
/obj/machinery/computer/shuttle/caravan/blackmarket_chevvy,
/turf/open/floor/iron,
/area/shuttle/blackmarket_chevvy)
"Vy" = (
/obj/machinery/light{
	dir = 4
	},
/obj/effect/decal/cleanable/dirt/dust,
/turf/open/floor/mineral/titanium,
/area/shuttle/blackmarket_chevvy)
"YP" = (
/obj/structure/table,
/obj/effect/decal/cleanable/dirt/dust,
/turf/open/floor/iron,
/area/shuttle/blackmarket_chevvy)
"YX" = (
/obj/effect/spawner/structure/window/shuttle,
/turf/open/floor/plating,
/area/shuttle/blackmarket_chevvy)

(1,1,1) = {"
fp
fp
fp
YX
wV
YX
fp
fp
fp
"}
(2,1,1) = {"
fp
YP
rw
uW
fh
iG
vK
sU
fp
"}
(3,1,1) = {"
YX
RS
Ov
kT
qx
bY
Dx
ts
FD
"}
(4,1,1) = {"
fp
eu
GO
uW
Vy
Jr
vK
OR
fp
"}
(5,1,1) = {"
fp
YX
YX
YX
fp
YX
YX
YX
fp
"}
