"a" = (/obj/structure/table/reinforced,/turf/open/floor/mineral/titanium,/area/shuttle/tarkon_driver)
"b" = (/obj/machinery/computer/camera_advanced/shuttle_docker/tarkon_driver,/turf/open/floor/mineral/titanium,/area/shuttle/tarkon_driver)
"e" = (/obj/machinery/computer/shuttle/tarkon_driver,/turf/open/floor/mineral/titanium,/area/shuttle/tarkon_driver)
"g" = (/obj/structure/bed/pod{dir = 1},/obj/item/bedsheet{dir = 1},/turf/open/floor/mineral/titanium,/area/shuttle/tarkon_driver)
"l" = (/obj/machinery/light/dim/directional/west,/obj/structure/table/reinforced,/turf/open/floor/mineral/titanium,/area/shuttle/tarkon_driver)
"p" = (/obj/effect/spawner/structure/window/reinforced/shuttle,/turf/open/floor/mineral/titanium,/area/shuttle/tarkon_driver)
"q" = (/obj/machinery/door/airlock/titanium,/obj/docking_port/mobile{height = 12; id = "tarkon_driver"; name = "Tarkon Driver"; port_direction = 2; preferred_direction = 8; width = 12},/turf/open/floor/mineral/titanium,/area/shuttle/tarkon_driver)
"r" = (/turf/closed/wall/mineral/titanium,/area/shuttle/tarkon_driver)
"s" = (/obj/structure/shuttle/engine/propulsion/burst{dir = 1},/turf/open/floor/mineral/titanium,/area/shuttle/tarkon_driver)
"t" = (/obj/structure/chair/office{dir = 1},/turf/open/floor/mineral/titanium,/area/shuttle/tarkon_driver)
"u" = (/obj/machinery/light/dim/directional/east,/obj/structure/table/reinforced,/turf/open/floor/mineral/titanium,/area/shuttle/tarkon_driver)
"v" = (/obj/structure/window/reinforced/tinted,/obj/structure/table/reinforced,/turf/open/floor/mineral/titanium,/area/shuttle/tarkon_driver)
"x" = (/obj/machinery/door/window/southright,/turf/open/floor/mineral/titanium,/area/shuttle/tarkon_driver)
"A" = (/obj/machinery/door/window/southleft,/turf/open/floor/mineral/titanium,/area/shuttle/tarkon_driver)
"B" = (/obj/structure/bed/pod,/obj/item/bedsheet,/turf/open/floor/mineral/titanium,/area/shuttle/tarkon_driver)
"F" = (/turf/open/floor/mineral/titanium,/area/shuttle/tarkon_driver)
"G" = (/obj/machinery/door/window/eastright{opacity = 1},/turf/open/floor/mineral/titanium,/area/shuttle/tarkon_driver)
"H" = (/obj/structure/window/reinforced/tinted{dir = 4},/obj/structure/closet,/turf/open/floor/mineral/titanium,/area/shuttle/tarkon_driver)
"I" = (/turf/template_noop,/area/template_noop)
"M" = (/obj/structure/window/reinforced/tinted{dir = 8},/obj/structure/closet,/turf/open/floor/mineral/titanium,/area/shuttle/tarkon_driver)
"Q" = (/turf/closed/wall/mineral/titanium/nodiagonal,/area/shuttle/tarkon_driver)
"R" = (/obj/machinery/door/window/westleft{opacity = 1},/turf/open/floor/mineral/titanium,/area/shuttle/tarkon_driver)
"S" = (/obj/machinery/door/airlock/titanium,/turf/open/floor/mineral/titanium,/area/shuttle/tarkon_driver)
"U" = (/obj/structure/shuttle/engine/propulsion/burst,/turf/open/floor/mineral/titanium,/area/shuttle/tarkon_driver)
"W" = (/obj/structure/table/reinforced,/obj/item/storage/toolbox/emergency,/turf/open/floor/mineral/titanium,/area/shuttle/tarkon_driver)

(1,1,1) = {"
sIIrpppprIIs
rsIppbeppIsr
rrrQlttuQrrr
rgFHvxAvMFBr
raFGFFFFRFar
rgFHFFFFMFBr
rrrQWFFaQrrr
rUUrrSqrrUUr
"}
