//MAP CONVERTED BY dmm2tgm.py THIS HEADER COMMENT PREVENTS RECONVERSION, DO NOT REMOVE
"bY" = (
/obj/effect/spawner/random/trash/mess,
/turf/open/floor/mineral/titanium,
/area/shuttle/blackmarket_chevvy)
"eu" = (
/obj/structure/table,
/turf/open/floor/iron,
/area/shuttle/blackmarket_chevvy)
"fh" = (
/turf/open/floor/mineral/titanium,
/area/shuttle/blackmarket_chevvy)
"fp" = (
/turf/closed/wall/mineral/titanium,
/area/shuttle/blackmarket_chevvy)
"kT" = (
/obj/effect/turf_decal/siding/brown{
	dir = 1
	},
/obj/effect/decal/cleanable/dirt/dust,
/turf/open/floor/mineral/titanium,
/area/shuttle/blackmarket_chevvy)
"lB" = (
/obj/structure/window/reinforced/spawner,
/obj/effect/decal/cleanable/dirt/dust,
/obj/structure/chair/comfy/shuttle{
	dir = 1
	},
/turf/open/floor/iron,
/area/shuttle/blackmarket_chevvy)
"pJ" = (
/obj/machinery/atmospherics/components/unary/engine,
/obj{
	name = "---Merge conflict marker---"
	},
/obj/effect/spawner/structure/window/reinforced/shuttle,
/turf/open/floor/plating,
/area/shuttle/blackmarket_chevvy)
"qx" = (
/obj/effect/decal/cleanable/dirt/dust,
/turf/open/floor/plating,
/area/shuttle/blackmarket_chevvy)
"rw" = (
/obj/machinery/door/window{
	req_access_txt = "208"
	},
/obj/effect/decal/cleanable/dirt/dust,
/turf/open/floor/plating,
/area/shuttle/blackmarket_chevvy)
"rB" = (
/obj/machinery/computer/shuttle/caravan/blackmarket_chevvy,
/turf/open/floor/iron,
/area/shuttle/blackmarket_chevvy)
"uW" = (
/obj/effect/turf_decal/siding/brown{
	dir = 1
	},
/turf/open/floor/mineral/titanium,
/area/shuttle/blackmarket_chevvy)
"zl" = (
/obj/effect/decal/cleanable/dirt/dust,
/obj/structure/table,
/obj/item/storage/toolbox/mechanical/old,
/turf/open/floor/mineral/titanium,
/area/shuttle/blackmarket_chevvy)
"Dx" = (
/turf/open/floor/plating,
/area/shuttle/blackmarket_chevvy)
"Dy" = (
/obj/structure/window/reinforced/spawner,
/turf/open/floor/plating,
/area/shuttle/blackmarket_chevvy)
"Gn" = (
/obj/effect/decal/cleanable/dirt/dust,
/obj/structure/chair/comfy/shuttle{
	dir = 1
	},
/turf/open/floor/mineral/titanium,
/area/shuttle/blackmarket_chevvy)
"Hj" = (
/obj/structure/chair/comfy/shuttle{
	dir = 1
	},
/turf/open/floor/mineral/titanium,
/area/shuttle/blackmarket_chevvy)
"Pb" = (
/obj/effect/spawner/structure/window/reinforced/shuttle,
/turf/open/floor/plating,
/area/shuttle/blackmarket_chevvy)
"Ut" = (
/obj/structure/chair/comfy/shuttle{
	dir = 1
	},
/turf/open/floor/plating,
/area/shuttle/blackmarket_chevvy)
"Vy" = (
/obj/machinery/light{
	dir = 4
	},
/obj/effect/decal/cleanable/dirt/dust,
/turf/open/floor/mineral/titanium,
/area/shuttle/blackmarket_chevvy)
"XU" = (
/obj/docking_port/mobile{
	callTime = 50;
	dir = 4;
	dwidth = 4;
	height = 5;
	id = "blackmarket_chevvy";
	ignitionTime = 25;
	name = "Chevvy";
	port_direction = 2;
	width = 9
	},
/obj/machinery/door/airlock/external,
/turf/open/floor/plating,
/area/shuttle/blackmarket_chevvy)
"Yw" = (
/obj/effect/decal/cleanable/dirt/dust,
/obj/structure/shuttle/engine/heater,
/obj/machinery/atmospherics/pipe/smart/manifold4w/orange/visible,
/obj/structure/window/reinforced{
	dir = 1
	},
/obj/structure/window/reinforced{
	dir = 8
	},
/obj/structure/window/reinforced{
	dir = 4
	},
/turf/open/floor/mineral/titanium,
/area/shuttle/blackmarket_chevvy)
"YP" = (
/obj/structure/table,
/obj/effect/decal/cleanable/dirt/dust,
/turf/open/floor/iron,
/area/shuttle/blackmarket_chevvy)
"ZI" = (
/obj/effect/decal/cleanable/dirt/dust,
/obj/machinery/atmospherics/components/unary/portables_connector/visible{
	dir = 8
	},
/turf/open/floor/mineral/titanium,
/area/shuttle/blackmarket_chevvy)

(1,1,1) = {"
fp
fp
fp
Pb
XU
Pb
fp
fp
fp
"}
(2,1,1) = {"
fp
YP
rw
uW
fh
Ut
Hj
zl
fp
"}
(3,1,1) = {"
Pb
rB
lB
kT
qx
bY
Dx
Yw
pJ
"}
(4,1,1) = {"
fp
eu
Dy
uW
Vy
Gn
Hj
ZI
fp
"}
(5,1,1) = {"
fp
Pb
Pb
Pb
fp
Pb
Pb
Pb
fp
"}
