//MAP CONVERTED BY dmm2tgm.py THIS HEADER COMMENT PREVENTS RECONVERSION, DO NOT REMOVE
"ak" = (
/obj/effect/turf_decal/stripes/red/line,
/turf/open/floor/iron/dark,
/area/shuttle/syndicate/frigate)
"bc" = (
/obj/machinery/suit_storage_unit/syndicate,
/obj/effect/turf_decal/stripes/box,
/turf/open/floor/iron/dark,
/area/shuttle/syndicate/frigate)
"br" = (
/obj/machinery/door/poddoor/shutters{
	id = "frigateleftshutters"
	},
/obj/effect/turf_decal/delivery/red,
/obj/structure/fans/tiny,
/turf/open/floor/plating,
/area/shuttle/syndicate/frigate)
"ep" = (
/obj/machinery/light/cold/no_nightlight{
	dir = 8;
	icon_state = "tube"
	},
/turf/open/floor/iron/dark,
/area/shuttle/syndicate/frigate)
"eG" = (
/obj/effect/turf_decal/stripes/line,
/turf/open/floor/engine,
/area/shuttle/syndicate/frigate)
"fo" = (
/obj/effect/turf_decal/stripes/line{
	dir = 10
	},
/turf/open/floor/engine,
/area/shuttle/syndicate/frigate)
"fJ" = (
/obj/effect/turf_decal/stripes/line{
	dir = 1
	},
/turf/open/floor/engine,
/area/shuttle/syndicate/frigate)
"id" = (
/obj/effect/turf_decal/stripes/red/line{
	dir = 8
	},
/obj/effect/turf_decal/stripes/red/line{
	dir = 4
	},
/obj/effect/turf_decal/caution/stand_clear/red{
	dir = 8
	},
/turf/open/floor/iron/dark,
/area/shuttle/syndicate/frigate)
"jh" = (
/obj/effect/turf_decal/stripes/red/line{
	dir = 4
	},
/obj/effect/turf_decal/stripes/red/line{
	dir = 8
	},
/obj/effect/turf_decal/caution/stand_clear/red{
	dir = 8
	},
/turf/open/floor/iron/dark,
/area/shuttle/syndicate/frigate)
"kS" = (
/obj/structure/table/reinforced,
/turf/open/floor/iron/dark,
/area/shuttle/syndicate/frigate)
"lr" = (
/obj/structure/chair/comfy/shuttle{
	dir = 8;
	name = "tactical chair"
	},
/turf/open/floor/iron/dark,
/area/shuttle/syndicate/frigate)
"mt" = (
/obj/structure/chair/comfy/shuttle{
	dir = 1
	},
/obj/machinery/light/cold/no_nightlight{
	dir = 8;
	icon_state = "tube"
	},
/turf/open/floor/iron/dark,
/area/shuttle/syndicate/frigate)
"mv" = (
/obj/effect/turf_decal/stripes/red/line{
	dir = 8
	},
/obj/effect/turf_decal/stripes/red/line{
	dir = 4
	},
/turf/open/floor/iron/dark,
/area/shuttle/syndicate/frigate)
"nt" = (
/turf/closed/wall/r_wall/syndicate/cruiser,
/area/shuttle/syndicate/frigate)
"nJ" = (
/obj/effect/turf_decal/stripes/line{
	dir = 5
	},
/turf/open/floor/engine,
/area/shuttle/syndicate/frigate)
"nL" = (
/obj/structure/rack,
/obj/item/pickaxe{
	pixel_x = 5
	},
/obj/item/pickaxe{
	pixel_x = 5
	},
/obj/item/pickaxe{
	pixel_x = 5
	},
/obj/item/shovel{
	pixel_x = -5
	},
/obj/item/shovel{
	pixel_x = -5
	},
/obj/item/shovel{
	pixel_x = -5
	},
/turf/open/floor/iron/dark,
/area/shuttle/syndicate/frigate)
"pW" = (
/obj/structure/chair/comfy/shuttle{
	dir = 1
	},
/obj/machinery/light/cold/no_nightlight{
	dir = 4;
	icon_state = "tube"
	},
/turf/open/floor/iron/dark,
/area/shuttle/syndicate/frigate)
"qp" = (
/obj/machinery/button/door{
	id = "frigaterightshutters"
	},
/turf/closed/wall/r_wall/syndicate/nodiagonal,
/area/shuttle/syndicate/frigate)
"sZ" = (
/obj/machinery/suit_storage_unit/syndicate,
/obj/effect/turf_decal/stripes/box,
/obj/machinery/light/cold/no_nightlight{
	dir = 8;
	icon_state = "tube"
	},
/turf/open/floor/iron/dark,
/area/shuttle/syndicate/frigate)
"tg" = (
/obj/structure/table/reinforced,
/obj/machinery/recharger,
/turf/open/floor/iron/dark,
/area/shuttle/syndicate/frigate)
"to" = (
/obj/structure/table/reinforced,
/obj/machinery/recharger,
/obj/machinery/light/cold/no_nightlight{
	dir = 4;
	icon_state = "tube"
	},
/turf/open/floor/iron/dark,
/area/shuttle/syndicate/frigate)
"tt" = (
/obj/machinery/mineral/equipment_vendor/golem{
	name = "Syndie-Mine"
	},
/turf/open/floor/iron/dark,
/area/shuttle/syndicate/frigate)
"tz" = (
/obj/structure/chair/comfy/shuttle{
	dir = 1;
	name = "captains chair"
	},
/turf/open/floor/iron/dark,
/area/shuttle/syndicate/frigate)
"wJ" = (
/obj/structure/closet/secure_closet/miner{
	req_access = null;
	req_access_txt = "150"
	},
/obj/effect/turf_decal/stripes/box,
/turf/open/floor/iron/dark,
/area/shuttle/syndicate/frigate)
"xp" = (
/obj/machinery/button/door{
	id = "frigateleftshutters"
	},
/turf/closed/wall/r_wall/syndicate/nodiagonal,
/area/shuttle/syndicate/frigate)
"xw" = (
/obj/structure/tank_dispenser/oxygen,
/obj/effect/turf_decal/stripes/red/box,
/turf/open/floor/iron/dark,
/area/shuttle/syndicate/frigate)
"BX" = (
/obj/effect/turf_decal/stripes/full,
/turf/open/floor/engine,
/area/shuttle/syndicate/frigate)
"De" = (
/obj/structure/chair/comfy/shuttle{
	dir = 4;
	name = "tactical chair"
	},
/turf/open/floor/iron/dark,
/area/shuttle/syndicate/frigate)
"Dy" = (
/obj/effect/turf_decal/stripes/line{
	dir = 1
	},
/obj/structure/ore_box,
/turf/open/floor/engine,
/area/shuttle/syndicate/frigate)
"DB" = (
/obj/effect/turf_decal/stripes/red/corner{
	dir = 4
	},
/obj/effect/turf_decal/stripes/red/corner{
	dir = 1
	},
/turf/open/floor/iron/dark,
/area/shuttle/syndicate/frigate)
"EF" = (
/obj/machinery/door/poddoor/shutters{
	id = "frigateleftshutters"
	},
/obj/effect/turf_decal/delivery/red,
/obj/structure/fans/tiny,
/obj/machinery/button/door{
	id = "frigateleftshutters";
	pixel_y = -32;
	req_access_txt = "150"
	},
/turf/open/floor/plating,
/area/shuttle/syndicate/frigate)
"Gp" = (
/obj/machinery/suit_storage_unit/syndicate,
/obj/effect/turf_decal/stripes/box,
/obj/machinery/light/cold/no_nightlight{
	dir = 4;
	icon_state = "tube"
	},
/turf/open/floor/iron/dark,
/area/shuttle/syndicate/frigate)
"HD" = (
/obj/structure/table/reinforced,
/obj/machinery/light/cold/no_nightlight{
	dir = 8;
	icon_state = "tube"
	},
/turf/open/floor/iron/dark,
/area/shuttle/syndicate/frigate)
"HX" = (
/obj/machinery/porta_turret/assaultops/shuttle{
	name = "Defense System Turret";
	system_id = "frigate_turrets_outer"
	},
/turf/closed/wall/r_wall/syndicate/cruiser,
/area/shuttle/syndicate/frigate)
"Iw" = (
/obj/structure/window/plasma/reinforced/plastitanium,
/obj/structure/grille,
/turf/open/floor/plating,
/area/shuttle/syndicate/frigate)
"KC" = (
/obj/structure/chair/comfy/shuttle{
	dir = 1
	},
/turf/open/floor/iron/dark,
/area/shuttle/syndicate/frigate)
"KN" = (
/obj/effect/mapping_helpers/airlock/cutaiwire,
/obj/machinery/door/airlock/mining/glass{
	req_access_txt = "150"
	},
/turf/open/floor/iron/dark,
/area/shuttle/syndicate/frigate)
"NU" = (
/obj/effect/turf_decal/delivery/red,
/obj/structure/fans/tiny,
/obj/machinery/door/poddoor/shutters/preopen{
	id = "frigaterightshutters"
	},
/turf/open/floor/plating,
/area/shuttle/syndicate/frigate)
"OY" = (
/obj/effect/turf_decal/stripes/line{
	dir = 9
	},
/turf/open/floor/engine,
/area/shuttle/syndicate/frigate)
"Pw" = (
/obj/effect/turf_decal/stripes/red/line,
/obj/machinery/light/cold/no_nightlight,
/turf/open/floor/iron/dark,
/area/shuttle/syndicate/frigate)
"PQ" = (
/obj/effect/turf_decal/delivery/red,
/obj/structure/fans/tiny,
/obj/machinery/button/door{
	id = "frigaterightshutters";
	pixel_y = -32;
	req_access_txt = "150"
	},
/obj/machinery/door/poddoor/shutters/preopen{
	id = "frigaterightshutters"
	},
/turf/open/floor/plating,
/area/shuttle/syndicate/frigate)
"PS" = (
/turf/open/floor/iron/dark,
/area/shuttle/syndicate/frigate)
"Qh" = (
/obj/effect/turf_decal/stripes/line{
	dir = 6
	},
/turf/open/floor/engine,
/area/shuttle/syndicate/frigate)
"Qk" = (
/obj/machinery/light/cold/no_nightlight{
	dir = 4;
	icon_state = "tube"
	},
/turf/open/floor/iron/dark,
/area/shuttle/syndicate/frigate)
"SY" = (
/obj/structure/table/reinforced,
/obj/item/storage/firstaid/medical,
/turf/open/floor/iron/dark,
/area/shuttle/syndicate/frigate)
"Tw" = (
/turf/template_noop,
/area/template_noop)
"TC" = (
/turf/closed/wall/r_wall/syndicate/nodiagonal,
/area/shuttle/syndicate/frigate)
"UA" = (
/obj/structure/table/reinforced,
/obj/item/toy/plush/moth{
	pixel_y = 5
	},
/turf/open/floor/iron/dark,
/area/shuttle/syndicate/frigate)
"VV" = (
/obj/effect/turf_decal/delivery/red,
/obj/docking_port/mobile{
	dir = 8;
	dwidth = 8;
	height = 13;
	hidden = 1;
	id = "syndicate_frigate";
	movement_force = list("KNOCKDOWN" = 0, "THROW" = 0);
	name = "syndicate frigate";
	port_direction = 4;
	width = 22
	},
/obj/structure/fans/tiny,
/obj/machinery/door/poddoor/shutters/preopen{
	id = "frigaterightshutters"
	},
/turf/open/floor/plating,
/area/shuttle/syndicate/frigate)
"Wl" = (
/obj/effect/turf_decal/stripes/red/line{
	dir = 1
	},
/turf/open/floor/iron/dark,
/area/shuttle/syndicate/frigate)
"Wp" = (
/obj/machinery/computer/shuttle/syndicate_frigate,
/turf/open/floor/iron/dark,
/area/shuttle/syndicate/frigate)
"WO" = (
/obj/effect/turf_decal/stripes/line{
	dir = 8
	},
/turf/open/floor/engine,
/area/shuttle/syndicate/frigate)
"Xo" = (
/obj/effect/turf_decal/stripes/line,
/obj/structure/ore_box,
/turf/open/floor/engine,
/area/shuttle/syndicate/frigate)
"Yi" = (
/turf/open/floor/engine,
/area/shuttle/syndicate/frigate)
"YC" = (
/obj/machinery/turretid{
	name = "DANGER: Outer Turret Control";
	pixel_x = -32;
	req_access = null;
	req_access_txt = "150";
	system_id = "frigate_turrets_outer"
	},
/turf/open/floor/iron/dark,
/area/shuttle/syndicate/frigate)
"Zl" = (
/obj/structure/shuttle/engine/large,
/obj/effect/turf_decal/stripes/full,
/turf/open/floor/engine,
/area/shuttle/syndicate/frigate)
"Zn" = (
/obj/effect/turf_decal/stripes/line{
	dir = 4
	},
/turf/open/floor/engine,
/area/shuttle/syndicate/frigate)

(1,1,1) = {"
Tw
Tw
Tw
Tw
Tw
Tw
Tw
Tw
Tw
Tw
Tw
nt
br
br
br
EF
nt
nt
nt
Tw
Tw
Tw
"}
(2,1,1) = {"
Tw
Tw
Tw
Tw
Tw
Tw
Tw
Tw
Tw
Tw
nt
xp
id
id
id
id
nt
BX
Zl
Tw
Tw
Tw
"}
(3,1,1) = {"
Tw
Tw
Tw
Tw
Tw
Tw
Tw
Tw
Tw
HX
TC
sZ
PS
PS
PS
Pw
nt
BX
BX
Tw
Tw
Tw
"}
(4,1,1) = {"
Tw
nt
nt
nt
nt
nt
nt
nt
nt
TC
bc
PS
PS
PS
PS
ak
TC
nt
nt
nt
nt
Tw
"}
(5,1,1) = {"
nt
nt
HD
SY
nt
KC
mt
KC
Wl
Iw
Wl
PS
OY
WO
fo
ak
Iw
PS
ep
wJ
nt
HX
"}
(6,1,1) = {"
Iw
UA
YC
lr
Iw
KC
KC
KC
Wl
KN
Wl
PS
Dy
Yi
Xo
ak
KN
PS
PS
tt
nt
nt
"}
(7,1,1) = {"
Iw
Wp
tz
PS
KN
mv
mv
mv
DB
Iw
xw
PS
fJ
Yi
eG
ak
Iw
nL
PS
wJ
nt
Tw
"}
(8,1,1) = {"
Iw
kS
PS
De
Iw
KC
KC
KC
Wl
KN
Wl
PS
Dy
Yi
Xo
ak
KN
PS
PS
tt
nt
nt
"}
(9,1,1) = {"
nt
nt
to
tg
nt
KC
pW
KC
Wl
Iw
Wl
PS
nJ
Zn
Qh
ak
Iw
PS
Qk
wJ
nt
HX
"}
(10,1,1) = {"
Tw
nt
nt
nt
nt
nt
nt
nt
nt
TC
bc
PS
PS
PS
PS
ak
TC
nt
nt
nt
nt
Tw
"}
(11,1,1) = {"
Tw
Tw
Tw
Tw
Tw
Tw
Tw
Tw
Tw
HX
TC
Gp
PS
PS
PS
Pw
nt
BX
Zl
Tw
Tw
Tw
"}
(12,1,1) = {"
Tw
Tw
Tw
Tw
Tw
Tw
Tw
Tw
Tw
Tw
nt
qp
jh
jh
jh
jh
nt
BX
BX
Tw
Tw
Tw
"}
(13,1,1) = {"
Tw
Tw
Tw
Tw
Tw
Tw
Tw
Tw
Tw
Tw
Tw
nt
NU
VV
NU
PQ
nt
nt
nt
Tw
Tw
Tw
"}
