//MAP CONVERTED BY dmm2tgm.py THIS HEADER COMMENT PREVENTS RECONVERSION, DO NOT REMOVE
"bJ" = (
/obj/machinery/button/door/directional/east{
	id = "engsm";
	name = "Radiation Shutters Control";
	req_access = list("engineering")
	},
/turf/open/floor/iron/dark,
/area/station/engineering/supermatter/room)
"cu" = (
/obj/effect/spawner/structure/window/reinforced/plasma,
/turf/open/floor/plating,
/area/station/engineering/supermatter/room)
"cP" = (
/obj/effect/turf_decal/stripes/red/line{
	dir = 8
	},
/turf/open/floor/plating,
/area/station/engineering/supermatter/room)
"do" = (
/obj/item/wrench,
/obj/structure/cable,
/turf/open/floor/plating,
/area/station/engineering/supermatter/room)
"ey" = (
/obj/structure/cable/layer1,
/obj/item/radio/intercom/directional/north,
/turf/open/floor/iron/dark,
/area/station/engineering/supermatter/room)
"fm" = (
/obj/machinery/power/energy_accumulator/rad_collector,
/obj/effect/turf_decal/bot_blue,
/obj/structure/cable,
/turf/open/floor/plating,
/area/space/nearstation)
"fQ" = (
/obj/machinery/light/directional/east,
/turf/open/floor/iron/dark,
/area/station/engineering/supermatter/room)
"ha" = (
/obj/machinery/light/directional/west,
/turf/open/floor/iron/dark,
/area/station/engineering/supermatter/room)
"hc" = (
/obj/effect/turf_decal/stripes/line{
	dir = 4
	},
/obj/structure/cable/layer1,
/turf/open/floor/iron/dark,
/area/station/engineering/supermatter/room)
"hI" = (
/obj/effect/spawner/structure/window/reinforced,
/turf/open/floor/plating,
/area/station/engineering/supermatter/room)
"iB" = (
/turf/closed/wall/r_wall,
/area/station/engineering/supermatter/room)
"jm" = (
/obj/structure/cable,
/turf/open/floor/engine,
/area/station/engineering/supermatter/room)
"jv" = (
/obj/machinery/button/door/directional/west{
	id = "engsm";
	name = "Radiation Shutters Control"
	},
/obj/structure/cable,
/turf/open/floor/iron/dark,
/area/station/engineering/supermatter/room)
"jQ" = (
/obj/structure/cable,
/obj/machinery/light/directional/north,
/turf/open/floor/iron/dark,
/area/station/engineering/supermatter/room)
"kQ" = (
/obj/effect/turf_decal/stripes/line{
	dir = 6
	},
/obj/structure/cable,
/turf/open/floor/engine,
/area/station/engineering/supermatter/room)
"md" = (
/obj/machinery/atmospherics/pipe/smart/manifold4w/scrubbers/visible,
/turf/closed/wall/r_wall,
/area/space/nearstation)
"oe" = (
/obj/structure/cable/layer1,
/turf/open/floor/plating,
/area/station/engineering/supermatter/room)
"oK" = (
/obj/effect/turf_decal/stripes/red/full,
/turf/open/floor/plating,
/area/space/nearstation)
"oT" = (
/obj/structure/cable/layer1,
/turf/open/floor/plating,
/area/space/nearstation)
"pi" = (
/obj/machinery/door/airlock/external/glass/emp_proof,
/obj/effect/mapping_helpers/airlock/cyclelink_helper{
	dir = 1
	},
/obj/structure/cable/layer1,
/turf/open/floor/plating,
/area/station/engineering/supermatter/room)
"pM" = (
/obj/effect/turf_decal/stripes/line{
	dir = 5
	},
/obj/structure/particle_accelerator/fuel_chamber{
	dir = 4
	},
/turf/open/floor/engine,
/area/station/engineering/supermatter/room)
"qc" = (
/obj/structure/cable,
/obj/effect/turf_decal/stripes/line{
	dir = 8
	},
/turf/open/floor/iron/dark,
/area/station/engineering/supermatter/room)
"qC" = (
/obj/structure/cable,
/obj/structure/particle_accelerator/particle_emitter/center,
/turf/open/floor/engine,
/area/station/engineering/supermatter/room)
"qG" = (
/obj/machinery/door/airlock/external/glass/emp_proof,
/obj/effect/mapping_helpers/airlock/cyclelink_helper,
/obj/structure/cable/layer1,
/turf/open/floor/plating,
/area/station/engineering/supermatter/room)
"qL" = (
/obj/effect/turf_decal/caution/stand_clear/red,
/turf/open/floor/plating,
/area/station/engineering/supermatter/room)
"sE" = (
/obj/structure/sign/warning/vacuum/external/directional/west,
/obj/structure/tank_dispenser,
/turf/open/floor/iron/dark,
/area/station/engineering/supermatter/room)
"sT" = (
/turf/open/floor/plating,
/area/space/nearstation)
"tq" = (
/obj/effect/turf_decal/caution/red,
/obj/effect/turf_decal/caution/red{
	dir = 1
	},
/turf/open/floor/plating,
/area/space/nearstation)
"um" = (
/obj/machinery/light/directional/west,
/turf/open/floor/plating,
/area/station/engineering/supermatter/room)
"vs" = (
/obj/machinery/door/airlock/engineering/glass{
	name = "Supermatter Engine Room"
	},
/obj/effect/turf_decal/trimline/yellow/filled/line{
	dir = 4
	},
/obj/effect/turf_decal/trimline/yellow/filled/line{
	dir = 8
	},
/obj/machinery/atmospherics/pipe/smart/manifold4w/supply/hidden/layer4,
/obj/machinery/atmospherics/pipe/smart/manifold4w/scrubbers/hidden/layer2,
/obj/machinery/door/firedoor,
/obj/effect/mapping_helpers/airlock/access/all/engineering/general,
/obj/structure/cable/layer1,
/obj/effect/turf_decal/trimline/yellow/arrow_ccw{
	dir = 4
	},
/obj/effect/turf_decal/trimline/yellow/arrow_cw{
	dir = 8
	},
/obj/structure/cable,
/turf/open/floor/iron,
/area/station/engineering/supermatter/room)
"vO" = (
/obj/machinery/singularity_generator,
/obj/item/wrench,
/turf/open/floor/plating,
/area/space/nearstation)
"wc" = (
/obj/machinery/atmospherics/pipe/smart/manifold4w/orange/visible,
/turf/closed/wall/r_wall,
/area/station/engineering/supermatter/room)
"xx" = (
/obj/effect/turf_decal/caution/red{
	dir = 1
	},
/obj/effect/turf_decal/caution/red,
/turf/open/floor/plating,
/area/space/nearstation)
"yz" = (
/obj/machinery/door/poddoor/shutters/radiation/preopen{
	id = "engsm";
	name = "Radiation Chamber Shutters"
	},
/turf/open/floor/plating,
/area/station/engineering/supermatter/room)
"Ae" = (
/obj/effect/turf_decal/stripes/line{
	dir = 4
	},
/turf/open/floor/iron/dark,
/area/station/engineering/supermatter/room)
"Av" = (
/obj/effect/turf_decal/stripes/line{
	dir = 1
	},
/obj/structure/cable,
/turf/open/floor/engine,
/area/station/engineering/supermatter/room)
"Ax" = (
/obj/structure/cable/layer1,
/obj/effect/turf_decal/stripes/line,
/turf/open/floor/iron/dark,
/area/station/engineering/supermatter/room)
"AG" = (
/obj/structure/closet/emcloset/anchored,
/obj/machinery/light/small/directional/east,
/obj/structure/sign/warning/vacuum/external/directional/north,
/turf/open/floor/plating,
/area/station/engineering/supermatter/room)
"Cd" = (
/obj/machinery/door/airlock/external/glass/emp_proof,
/obj/effect/mapping_helpers/airlock/cyclelink_helper,
/turf/open/floor/plating,
/area/station/engineering/supermatter/room)
"CA" = (
/obj/machinery/light/directional/west,
/obj/structure/cable/layer1,
/turf/open/floor/plating,
/area/station/engineering/supermatter/room)
"CF" = (
/obj/machinery/light/directional/east,
/turf/open/floor/plating,
/area/station/engineering/supermatter/room)
"CU" = (
/obj/machinery/door/airlock/external,
/obj/effect/mapping_helpers/airlock/cyclelink_helper{
	dir = 8
	},
/obj/effect/mapping_helpers/airlock/access/all/engineering/general,
/turf/open/floor/plating,
/area/station/engineering/supermatter/room)
"Dj" = (
/obj/effect/turf_decal/stripes/line{
	dir = 8
	},
/obj/structure/particle_accelerator/power_box{
	dir = 4
	},
/turf/open/floor/engine,
/area/station/engineering/supermatter/room)
"DD" = (
/obj/item/screwdriver,
/turf/open/floor/plating,
/area/station/engineering/supermatter/room)
"DU" = (
/obj/effect/turf_decal/stripes/line{
	dir = 10
	},
/obj/structure/cable,
/obj/structure/particle_accelerator/particle_emitter/right,
/turf/open/floor/engine,
/area/station/engineering/supermatter/room)
"Ea" = (
/obj/effect/turf_decal/stripes/line{
	dir = 4
	},
/obj/structure/particle_accelerator/end_cap,
/turf/open/floor/engine,
/area/station/engineering/supermatter/room)
"Ef" = (
/obj/structure/sign/warning/radiation,
/turf/closed/wall/r_wall,
/area/space/nearstation)
"Ek" = (
/obj/machinery/door/poddoor/shutters/radiation/preopen{
	id = "engsm";
	name = "Radiation Chamber Shutters"
	},
/obj/structure/cable,
/turf/open/floor/plating,
/area/station/engineering/supermatter/room)
"En" = (
/obj/machinery/power/emitter{
	dir = 8
	},
/obj/effect/turf_decal/bot_white,
/obj/structure/cable/layer1,
/turf/open/floor/plating,
/area/space/nearstation)
"EI" = (
/obj/machinery/power/apc/auto_name/emp_proof/directional/east,
/obj/structure/cable,
/obj/effect/mapping_helpers/apc/cell_10k,
/turf/open/floor/iron/dark,
/area/station/engineering/supermatter/room)
"Fy" = (
/obj/effect/turf_decal/stripes/line,
/obj/structure/cable,
/turf/open/floor/engine,
/area/station/engineering/supermatter/room)
"Gf" = (
/obj/item/stack/cable_coil,
/turf/open/floor/plating,
/area/station/engineering/supermatter/room)
"GO" = (
/obj/structure/cable/layer1,
/obj/structure/cable,
/obj/machinery/atmospherics/pipe/smart/manifold4w/scrubbers/hidden/layer2,
/obj/machinery/atmospherics/pipe/smart/manifold4w/supply/hidden/layer4,
/obj/effect/turf_decal/stripes/line,
/turf/open/floor/iron/dark,
/area/station/engineering/supermatter/room)
"Ht" = (
/obj/effect/turf_decal/stripes/line{
	dir = 8
	},
/turf/open/floor/engine,
/area/station/engineering/supermatter/room)
"Iv" = (
/obj/structure/cable,
/turf/open/floor/plating,
/area/station/engineering/supermatter/room)
"IO" = (
/obj/machinery/field/generator/singularity,
/obj/effect/turf_decal/bot_red,
/turf/open/floor/plating,
/area/space/nearstation)
"IU" = (
/obj/structure/sign/warning/vacuum/external/directional/east,
/obj/structure/tank_dispenser,
/turf/open/floor/iron/dark,
/area/station/engineering/supermatter/room)
"LR" = (
/obj/effect/turf_decal/stripes/line{
	dir = 9
	},
/obj/structure/particle_accelerator/particle_emitter/left{
	dir = 4
	},
/turf/open/floor/engine,
/area/station/engineering/supermatter/room)
"LU" = (
/obj/structure/lattice/catwalk,
/turf/open/floor/plating,
/area/space/nearstation)
"Mq" = (
/turf/open/floor/plating,
/area/station/engineering/supermatter/room)
"Ms" = (
/obj/machinery/door/poddoor/shutters/radiation/preopen{
	id = "engsm";
	name = "Radiation Chamber Shutters"
	},
/obj/structure/cable/layer1,
/turf/open/floor/plating,
/area/station/engineering/supermatter/room)
"Mu" = (
/obj/effect/turf_decal/stripes/line{
	dir = 4
	},
/obj/structure/cable,
/turf/open/floor/engine,
/area/station/engineering/supermatter/room)
"MK" = (
/turf/closed/wall/r_wall,
/area/space/nearstation)
"ND" = (
/obj/machinery/firealarm/directional/north,
/obj/machinery/light/directional/north,
/turf/open/floor/iron/dark,
/area/station/engineering/supermatter/room)
"OL" = (
/obj/machinery/power/emitter{
	dir = 4
	},
/obj/effect/turf_decal/bot_white,
/obj/structure/cable/layer1,
/turf/open/floor/plating,
/area/space/nearstation)
"Pe" = (
/obj/structure/cable/layer1,
/obj/machinery/atmospherics/components/unary/vent_scrubber/on/layer2{
	dir = 4
	},
/obj/effect/turf_decal/stripes/line,
/turf/open/floor/iron/dark,
/area/station/engineering/supermatter/room)
"Qv" = (
/obj/structure/sign/warning/radiation,
/turf/closed/wall/r_wall,
/area/station/engineering/supermatter/room)
"Sz" = (
/obj/structure/cable,
/obj/effect/turf_decal/stripes/line,
/turf/open/floor/iron/dark,
/area/station/engineering/supermatter/room)
"SK" = (
/turf/open/floor/iron/dark,
/area/station/engineering/supermatter/room)
"UI" = (
/obj/structure/cable,
/turf/open/floor/plating,
/area/space/nearstation)
"Wn" = (
/obj/structure/cable,
/obj/machinery/atmospherics/components/unary/vent_pump/on/layer4{
	dir = 8
	},
/obj/effect/turf_decal/stripes/line,
/turf/open/floor/iron/dark,
/area/station/engineering/supermatter/room)
"Wq" = (
/obj/structure/closet/emcloset/anchored,
/obj/machinery/light/small/directional/west,
/obj/structure/sign/warning/vacuum/external/directional/north,
/turf/open/floor/plating,
/area/station/engineering/supermatter/room)
"WH" = (
/obj/machinery/airalarm/directional/north,
/turf/open/floor/iron/dark,
/area/station/engineering/supermatter/room)
"WT" = (
/turf/open/space/basic,
/area/space)
"XX" = (
/obj/structure/cable,
/turf/open/floor/iron/dark,
/area/station/engineering/supermatter/room)
"Ym" = (
/obj/effect/turf_decal/stripes/red/line{
	dir = 4
	},
/turf/open/floor/plating,
/area/station/engineering/supermatter/room)
"Ys" = (
/obj/structure/cable/layer1,
/turf/closed/wall/r_wall,
/area/station/engineering/supermatter/room)
"YV" = (
/obj/machinery/door/airlock/external/glass/emp_proof,
/obj/effect/mapping_helpers/airlock/cyclelink_helper{
	dir = 1
	},
/obj/structure/cable,
/turf/open/floor/plating,
/area/station/engineering/supermatter/room)
"Zk" = (
/obj/effect/turf_decal/stripes/red/full,
/obj/structure/cable,
/turf/open/floor/plating,
/area/space/nearstation)

(1,1,1) = {"
iB
iB
iB
iB
iB
CU
iB
iB
iB
iB
MK
MK
MK
MK
MK
MK
MK
Ef
MK
MK
"}
(2,1,1) = {"
iB
SK
SK
SK
ha
SK
sE
iB
Wq
iB
oT
OL
oT
oT
oT
oT
oT
OL
oT
MK
"}
(3,1,1) = {"
iB
ND
SK
bJ
Ae
hc
hc
qG
oe
pi
oT
tq
WT
WT
WT
WT
WT
xx
oT
MK
"}
(4,1,1) = {"
iB
SK
Qv
iB
yz
Ms
yz
iB
iB
iB
UI
Zk
fm
UI
fm
UI
fm
oK
oT
Ef
"}
(5,1,1) = {"
iB
ey
Ys
CA
oe
oe
Mq
Mq
um
cu
UI
IO
LU
LU
sT
LU
LU
IO
oT
MK
"}
(6,1,1) = {"
iB
Ax
yz
Mq
Mq
Mq
Gf
Mq
Ym
cu
UI
LU
WT
WT
sT
WT
WT
LU
oT
MK
"}
(7,1,1) = {"
hI
Pe
yz
Mq
LR
Dj
Ht
DU
qL
cu
UI
LU
WT
WT
sT
WT
WT
LU
oT
MK
"}
(8,1,1) = {"
vs
GO
yz
Mq
Av
qC
jm
Fy
qL
cu
UI
sT
sT
sT
vO
sT
sT
sT
oT
MK
"}
(9,1,1) = {"
hI
Wn
yz
Mq
pM
Mu
Ea
kQ
qL
cu
UI
LU
WT
WT
sT
WT
WT
LU
oT
MK
"}
(10,1,1) = {"
iB
Sz
Ek
do
Iv
Iv
Mq
Mq
cP
cu
UI
LU
WT
WT
sT
WT
WT
LU
oT
MK
"}
(11,1,1) = {"
iB
SK
iB
CF
Mq
Iv
Mq
DD
CF
cu
UI
IO
LU
LU
sT
LU
LU
IO
oT
MK
"}
(12,1,1) = {"
iB
WH
Qv
iB
yz
Ek
yz
iB
iB
iB
UI
Zk
fm
UI
fm
UI
fm
oK
oT
Ef
"}
(13,1,1) = {"
iB
jQ
XX
jv
qc
qc
qc
Cd
Iv
YV
UI
xx
WT
WT
WT
WT
WT
xx
oT
MK
"}
(14,1,1) = {"
iB
EI
SK
SK
fQ
SK
IU
iB
AG
iB
sT
En
oT
oT
oT
oT
oT
En
oT
MK
"}
(15,1,1) = {"
iB
iB
iB
wc
iB
iB
iB
iB
iB
iB
MK
MK
MK
md
MK
MK
MK
Ef
MK
MK
"}
