//MAP CONVERTED BY dmm2tgm.py THIS HEADER COMMENT PREVENTS RECONVERSION, DO NOT REMOVE
"a" = (
/obj/effect/decal/cleanable/glitter/blue,
/obj/structure/chair/x_stand,
/obj/structure/window/spawner,
/turf/open/floor/glass/plasma,
/area/station/service/jadedragon)
"b" = (
/obj/machinery/light/blacklight/directional/south,
/obj/effect/decal/cleanable/dirt,
/turf/open/floor/carpet/purple,
/area/station/service/jadedragon)
"e" = (
/obj/effect/decal/cleanable/glitter/blue,
/turf/open/floor/carpet/purple,
/area/station/service/jadedragon)
"g" = (
/obj/effect/decal/cleanable/glitter/blue,
/obj/effect/decal/cleanable/femcum,
/turf/open/floor/glass/plasma,
/area/station/service/jadedragon)
"i" = (
/obj/effect/decal/cleanable/glitter/blue,
/obj/structure/window/spawner/north,
/turf/open/floor/glass/plasma,
/area/station/service/jadedragon)
"j" = (
/obj/item/clothing/neck/human_petcollar/locked/leather,
/obj/effect/spawner/costume/nyangirl,
/obj/item/stack/spacecash/c200{
	pixel_x = -5;
	pixel_y = -5
	},
/obj/structure/window/spawner/east,
/obj/structure/window/spawner/north,
/turf/open/floor/glass/plasma,
/area/station/service/jadedragon)
"n" = (
/obj/effect/landmark/xeno_spawn,
/obj/structure/sign/poster/contraband/lusty_xenomorph{
	pixel_x = 30
	},
/turf/open/floor/carpet/purple,
/area/station/service/jadedragon)
"o" = (
/obj/machinery/light/blacklight/directional/south,
/obj/effect/decal/cleanable/generic,
/obj/structure/sign/poster/contraband/busty_backdoor_xeno_babes_6{
	pixel_x = -32
	},
/obj/item/flashlight/lantern/jade,
/turf/open/floor/carpet/purple,
/area/station/service/jadedragon)
"q" = (
/obj/structure/mineral_door/wood{
	name = "The Jade Dragon"
	},
/turf/open/floor/wood,
/area/station/service/jadedragon)
"r" = (
/obj/structure/bed,
/obj/effect/decal/cleanable/cum,
/obj/effect/decal/cleanable/shreds{
	pixel_x = 15;
	pixel_y = 3
	},
/obj/effect/decal/cleanable/glitter/blue,
/obj/item/clothing/glasses/blindfold{
	pixel_y = -8
	},
/obj/item/key/collar,
/turf/open/floor/glass/plasma,
/area/station/service/jadedragon)
"s" = (
/obj/machinery/shower/directional/south,
/obj/structure/window/reinforced/tinted/frosted{
	dir = 4
	},
/turf/open/floor/catwalk_floor/iron_smooth,
/area/station/service/jadedragon)
"t" = (
/obj/structure/rack/shelf,
/obj/item/clothing/gloves/fingerless,
/obj/item/assembly/signaler{
	pixel_x = 3;
	pixel_y = -4
	},
/obj/item/electropack/shockcollar,
/obj/item/lipstick/jade,
/turf/open/floor/carpet/purple,
/area/station/service/jadedragon)
"u" = (
/turf/open/floor/carpet/purple,
/area/station/service/jadedragon)
"w" = (
/turf/closed/wall/mineral/wood,
/area/station/service/jadedragon)
"A" = (
/obj/item/clothing/head/kitty/genuine,
/obj/structure/table/wood/fancy/cyan,
/obj/item/clothing/mask/muzzle{
	pixel_y = -2
	},
/obj/item/clothing/neck/human_petcollar/locked/choker{
	pixel_y = 10
	},
/obj/structure/window/spawner,
/turf/open/floor/glass/plasma,
/area/station/service/jadedragon)
"B" = (
/obj/structure/closet/mini_fridge,
/obj/item/stack/spacecash/c1000,
/obj/item/reagent_containers/cup/glass/bottle/absinthe/premium,
/obj/effect/decal/cleanable/dirt/dust,
/turf/open/floor/carpet/purple,
/area/station/service/jadedragon)
"C" = (
/obj/item/candle/infinite{
	light_color = "#A700FF";
	pixel_x = -6
	},
/obj/item/candle/infinite{
	light_color = "#A700FF";
	pixel_x = 4;
	pixel_y = 3
	},
/obj/structure/window/spawner/east,
/obj/structure/window/spawner,
/turf/open/floor/glass/plasma,
/area/station/service/jadedragon)
"D" = (
/obj/item/clothing/mask/cigarette,
/obj/effect/decal/cleanable/dirt,
/obj/item/cigbutt{
	pixel_y = 6
	},
/obj/effect/decal/cleanable/ash,
/turf/open/floor/carpet/purple,
/area/station/service/jadedragon)
"E" = (
/obj/structure/ladder,
/obj/machinery/light/small/red/dim/directional/south,
/turf/open/floor/wood,
/area/station/service/jadedragon)
"F" = (
/obj/item/bdsm_candle,
/obj/effect/decal/cleanable/wrapping,
/turf/open/floor/carpet/purple,
/area/station/service/jadedragon)
"G" = (
/obj/effect/decal/cleanable/glitter/blue,
/obj/item/reagent_containers/spray/cyborg_lube{
	desc = "All natural friction defeating lubricant in a spray.";
	name = "Exotic Lubricant"
	},
/obj/effect/decal/cleanable/plastic,
/obj/effect/decal/cleanable/cum{
	pixel_x = 11;
	pixel_y = 8
	},
/obj/effect/landmark/blobstart,
/turf/open/floor/glass/plasma,
/area/station/service/jadedragon)
"J" = (
/obj/effect/decal/cleanable/hair,
/obj/item/reagent_containers/cup/glass/waterbottle/empty{
	pixel_x = -15
	},
/turf/open/floor/carpet/purple,
/area/station/service/jadedragon)
"L" = (
/obj/effect/decal/cleanable/glitter/blue,
/turf/open/floor/glass/plasma,
/area/station/service/jadedragon)
"M" = (
/obj/structure/chair/comfy/brown{
	dir = 4
	},
/obj/item/reagent_containers/syringe/contraband/space_drugs,
/obj/item/cigbutt,
/mob/living/simple_animal/mouse/gray{
	chew_probability = 0;
	dir = 4;
	name = "Checkerz"
	},
/turf/open/floor/carpet/purple,
/area/station/service/jadedragon)
"N" = (
/turf/open/misc/asteroid/snow/icemoon,
/area/icemoon/surface/outdoors/nospawn)
"O" = (
/obj/structure/window/spawner/north,
/obj/item/melee/chainofcommand/tailwhip/kitty,
/turf/open/floor/glass/plasma,
/area/station/service/jadedragon)
"P" = (
/obj/effect/decal/cleanable/oil/streak,
/turf/open/floor/glass/plasma,
/area/station/service/jadedragon)
"R" = (
/obj/effect/decal/cleanable/glitter/blue,
/obj/structure/tank_holder/anesthetic{
	anchored = 1;
	can_be_unanchored = 1
	},
/obj/item/clothing/mask/breath/anesthetic{
	pixel_y = -6
	},
/obj/machinery/light/blacklight/directional/west,
/turf/open/floor/glass/plasma,
/area/station/service/jadedragon)
"T" = (
/obj/structure/window/spawner/north,
/obj/item/feather{
	pixel_x = 4;
	pixel_y = -1
	},
/obj/item/clothing/under/misc/gear_harness{
	pixel_x = -3;
	pixel_y = -11
	},
/turf/open/floor/glass/plasma,
/area/station/service/jadedragon)
"V" = (
/obj/effect/decal/cleanable/glitter/blue,
/obj/structure/window/spawner/east,
/turf/open/floor/glass/plasma,
/area/station/service/jadedragon)
"W" = (
/obj/machinery/vending/dorms{
	extended_inventory = 1;
	market_verb = "Deviant";
	name = "\improper Kinko-Mat 3000"
	},
/turf/open/floor/carpet/purple,
/area/station/service/jadedragon)
"Y" = (
/obj/structure/window/spawner/east,
/turf/open/floor/glass/plasma,
/area/station/service/jadedragon)

(1,1,1) = {"
N
N
N
w
w
w
N
N
N
"}
(2,1,1) = {"
w
w
w
w
W
w
w
N
N
"}
(3,1,1) = {"
w
t
M
B
F
o
w
w
w
"}
(4,1,1) = {"
w
w
D
J
n
u
q
E
w
"}
(5,1,1) = {"
N
w
e
w
w
b
w
w
w
"}
(6,1,1) = {"
N
T
L
R
w
s
w
N
N
"}
(7,1,1) = {"
N
O
G
P
A
N
N
N
N
"}
(8,1,1) = {"
N
i
r
g
a
N
N
N
N
"}
(9,1,1) = {"
N
j
V
Y
C
N
N
N
N
"}
