//MAP CONVERTED BY dmm2tgm.py THIS HEADER COMMENT PREVENTS RECONVERSION, DO NOT REMOVE
"bj" = (
/obj/effect/decal/cleanable/dirt/dust,
/obj/machinery/atmospherics/pipe/smart/manifold4w/scrubbers/hidden/layer2,
/obj/machinery/atmospherics/pipe/smart/manifold4w/supply/hidden/layer4,
/turf/open/floor/catwalk_floor/iron_dark,
/area/station/science/research/abandoned)
"bs" = (
/obj/effect/spawner/structure/window/reinforced/plasma,
/turf/open/floor/plating,
/area/station/science/research/abandoned)
"bx" = (
/obj/machinery/disposal/bin,
/obj/structure/disposalpipe/trunk{
	dir = 4
	},
/obj/effect/decal/cleanable/dirt/dust,
/turf/open/floor/iron/dark/purple/side{
	dir = 6
	},
/area/station/science/research/abandoned)
"by" = (
/obj/machinery/atmospherics/components/unary/vent_scrubber/on/layer2,
/turf/open/floor/engine/airless,
/area/station/science/research/abandoned)
"dq" = (
/obj/structure/table_frame,
/obj/machinery/atmospherics/pipe/smart/manifold4w/scrubbers/hidden/layer2,
/obj/machinery/atmospherics/pipe/smart/manifold4w/supply/hidden/layer4,
/obj/structure/cable,
/obj/machinery/light/cold/directional/west,
/obj/effect/decal/cleanable/dirt/dust,
/turf/open/floor/catwalk_floor/iron_dark,
/area/station/science/research/abandoned)
"eP" = (
/obj/machinery/atmospherics/pipe/smart/manifold4w/scrubbers/hidden/layer2,
/obj/machinery/atmospherics/pipe/smart/manifold4w/supply/hidden/layer4,
/obj/structure/cable,
/obj/effect/decal/cleanable/dirt/dust,
/turf/open/floor/catwalk_floor/iron_dark,
/area/station/science/research/abandoned)
"eZ" = (
/obj/structure/cable,
/obj/effect/decal/cleanable/dirt/dust,
/obj/machinery/atmospherics/pipe/smart/manifold4w/scrubbers/hidden/layer2,
/obj/machinery/atmospherics/pipe/smart/manifold4w/supply/hidden/layer4,
/obj/machinery/disposal/bin,
/obj/structure/disposalpipe/trunk,
/turf/open/floor/catwalk_floor/iron_dark,
/area/station/science/research/abandoned)
"fm" = (
/obj/machinery/power/emitter/welded{
	dir = 1
	},
/obj/structure/cable,
/obj/effect/decal/cleanable/dirt/dust,
/obj/effect/turf_decal/stripes/end,
/turf/open/floor/plating,
/area/station/science/research/abandoned)
"fp" = (
/obj/effect/decal/cleanable/dirt/dust,
/obj/machinery/destructive_scanner,
/obj/effect/turf_decal/stripes/end,
/turf/open/floor/iron/dark/purple/side{
	dir = 1
	},
/area/station/science/research/abandoned)
"fr" = (
/obj/machinery/door/airlock/science{
	name = "Abandoned Warp Stone Lab"
	},
/obj/machinery/door/firedoor,
/obj/effect/mapping_helpers/airlock/locked,
/turf/open/floor/iron/dark/purple,
/area/station/science/research/abandoned)
"ft" = (
/obj/machinery/light/red/directional/north,
/turf/open/floor/engine/airless,
/area/station/science/research/abandoned)
"fG" = (
/obj/machinery/atmospherics/pipe/smart/manifold4w/scrubbers/hidden/layer2,
/obj/machinery/atmospherics/pipe/smart/manifold4w/supply/hidden/layer4,
/obj/effect/decal/cleanable/dirt/dust,
/obj/effect/turf_decal/caution{
	dir = 8
	},
/turf/open/floor/iron/dark/purple/side{
	dir = 4
	},
/area/station/science/research/abandoned)
"fW" = (
/obj/machinery/airalarm/all_access{
	dir = 1;
	pixel_y = 22
	},
/obj/structure/cable,
/obj/effect/decal/cleanable/dirt/dust,
/obj/item/storage/bag/trash/filled,
/turf/open/floor/catwalk_floor/iron_dark,
/area/station/science/research/abandoned)
"gb" = (
/obj/effect/decal/cleanable/dirt/dust,
/turf/open/floor/iron/dark/purple/side,
/area/station/science/research/abandoned)
"gm" = (
/obj/structure/table/reinforced/rglass,
/obj/item/modular_computer/laptop/preset/civilian,
/obj/effect/decal/cleanable/dirt/dust,
/obj/item/trash/can{
	pixel_y = 11
	},
/turf/open/floor/iron/dark/purple/side{
	dir = 6
	},
/area/station/science/research/abandoned)
"gn" = (
/obj/effect/decal/cleanable/dirt/dust,
/obj/machinery/portable_atmospherics/canister/freon,
/obj/effect/turf_decal/box,
/turf/open/floor/iron/dark/purple/side{
	dir = 10
	},
/area/station/science/research/abandoned)
"hk" = (
/obj/machinery/power/supermatter_crystal/shard/hugbox/fakecrystal{
	color = "green";
	name = "Synthetic Warp Stone Crystal"
	},
/turf/open/floor/engine/airless,
/area/station/science/research/abandoned)
"hW" = (
/obj/machinery/atmospherics/pipe/smart/manifold4w/scrubbers/hidden/layer2,
/obj/machinery/atmospherics/pipe/smart/manifold4w/supply/hidden/layer4,
/turf/open/floor/engine/airless,
/area/station/science/research/abandoned)
"iX" = (
/turf/closed/wall/r_wall,
/area/station/science/research/abandoned)
"iY" = (
/obj/effect/mapping_helpers/airlock/cyclelink_helper{
	dir = 8
	},
/obj/machinery/door/airlock/plasma{
	name = "Inner Warpstone Lock"
	},
/obj/structure/fans/tiny/invisible,
/obj/machinery/atmospherics/pipe/smart/manifold4w/scrubbers/hidden/layer2,
/obj/machinery/atmospherics/pipe/smart/manifold4w/supply/hidden/layer4,
/obj/effect/mapping_helpers/airlock/locked,
/turf/open/floor/catwalk_floor/iron_dark,
/area/station/science/research/abandoned)
"jq" = (
/obj/structure/cable,
/obj/effect/decal/cleanable/dirt/dust,
/obj/machinery/atmospherics/pipe/smart/manifold4w/scrubbers/hidden/layer2,
/obj/machinery/atmospherics/pipe/smart/manifold4w/supply/hidden/layer4,
/obj/effect/gibspawner/robot,
/turf/open/floor/catwalk_floor/iron_dark,
/area/station/science/research/abandoned)
"ju" = (
/obj/structure/disposalpipe/segment,
/turf/closed/wall/r_wall,
/area/station/science/research/abandoned)
"lG" = (
/obj/structure/table/reinforced/rglass,
/obj/effect/decal/cleanable/dirt/dust,
/obj/item/storage/box/gorillacubes,
/obj/item/analyzer,
/turf/open/floor/iron/dark/purple/side{
	dir = 5
	},
/area/station/science/research/abandoned)
"nA" = (
/obj/machinery/light/cold/directional/south,
/obj/effect/decal/cleanable/dirt/dust,
/turf/open/floor/iron/dark/purple/side,
/area/station/science/research/abandoned)
"oI" = (
/obj/effect/decal/cleanable/dirt/dust,
/turf/open/floor/iron/dark/purple/corner,
/area/station/science/research/abandoned)
"oN" = (
/obj/effect/decal/cleanable/dirt/dust,
/obj/machinery/atmospherics/components/unary/vent_pump/on/layer4{
	dir = 4
	},
/obj/structure/disposalpipe/segment,
/turf/open/floor/iron/dark,
/area/station/science/research/abandoned)
"tu" = (
/obj/effect/decal/cleanable/dirt/dust,
/obj/machinery/portable_atmospherics/canister/halon,
/obj/effect/turf_decal/box,
/turf/open/floor/iron/dark/purple/side{
	dir = 8
	},
/area/station/science/research/abandoned)
"tV" = (
/obj/effect/mapping_helpers/airlock/cyclelink_helper{
	dir = 4
	},
/obj/machinery/door/airlock/plasma{
	name = "Outer Warpstone Lock"
	},
/obj/machinery/atmospherics/pipe/smart/manifold4w/scrubbers/hidden/layer2,
/obj/machinery/atmospherics/pipe/smart/manifold4w/supply/hidden/layer4,
/obj/effect/mapping_helpers/airlock/locked,
/turf/open/floor/iron/dark/purple,
/area/station/science/research/abandoned)
"uy" = (
/obj/structure/cable,
/obj/effect/decal/cleanable/dirt/dust,
/turf/open/floor/iron/dark/purple/side,
/area/station/science/research/abandoned)
"uS" = (
/obj/structure/disposalpipe/segment{
	dir = 4
	},
/obj/effect/spawner/structure/window/reinforced/plasma,
/turf/open/floor/plating,
/area/station/science/research/abandoned)
"vw" = (
/obj/effect/decal/cleanable/dirt/dust,
/obj/machinery/newscaster/directional/south,
/obj/item/trash/energybar,
/turf/open/floor/iron/dark/purple/side,
/area/station/science/research/abandoned)
"xl" = (
/turf/open/floor/engine/airless,
/area/station/science/research/abandoned)
"xv" = (
/obj/machinery/power/smes,
/obj/structure/cable,
/obj/effect/decal/cleanable/dirt/dust,
/turf/open/floor/iron/dark/purple/side{
	dir = 5
	},
/area/station/science/research/abandoned)
"yj" = (
/obj/structure/cable,
/obj/effect/decal/cleanable/dirt/dust,
/obj/machinery/atmospherics/pipe/smart/manifold4w/scrubbers/hidden/layer2,
/obj/machinery/atmospherics/pipe/smart/manifold4w/supply/hidden/layer4,
/turf/open/floor/catwalk_floor/iron_dark,
/area/station/science/research/abandoned)
"AE" = (
/obj/effect/decal/cleanable/dirt/dust,
/obj/structure/trash_pile,
/turf/open/floor/iron/dark,
/area/station/science/research/abandoned)
"AL" = (
/obj/machinery/atmospherics/components/unary/vent_pump/layer4,
/turf/open/floor/engine/airless,
/area/station/science/research/abandoned)
"AT" = (
/obj/effect/decal/cleanable/dirt/dust,
/mob/living/simple_animal/hostile/rat,
/turf/open/floor/iron/dark,
/area/station/science/research/abandoned)
"El" = (
/obj/machinery/light/cold/directional/south,
/obj/machinery/firealarm/directional/south,
/obj/effect/decal/cleanable/dirt/dust,
/obj/structure/disposalpipe/segment,
/turf/open/floor/iron/dark/purple/side,
/area/station/science/research/abandoned)
"ED" = (
/obj/structure/frame/machine,
/obj/effect/decal/cleanable/dirt/dust,
/turf/open/floor/iron/dark/purple/side{
	dir = 1
	},
/area/station/science/research/abandoned)
"EM" = (
/obj/structure/table_frame,
/obj/structure/cable,
/obj/effect/decal/cleanable/dirt/dust,
/obj/structure/sign/poster/official/random{
	pixel_x = -32
	},
/turf/open/floor/iron/dark/purple/side{
	dir = 8
	},
/area/station/science/research/abandoned)
"Fx" = (
/obj/effect/decal/cleanable/dirt/dust,
/obj/structure/showcase/horrific_experiment,
/turf/open/floor/iron/dark/purple/side{
	dir = 1
	},
/area/station/science/research/abandoned)
"GN" = (
/obj/structure/disposaloutlet{
	dir = 4
	},
/obj/structure/disposalpipe/trunk{
	dir = 8
	},
/turf/open/floor/engine/airless,
/area/station/science/research/abandoned)
"HA" = (
/obj/machinery/light/red/directional/south,
/turf/open/floor/engine/airless,
/area/station/science/research/abandoned)
"HE" = (
/obj/structure/cable,
/obj/effect/decal/cleanable/dirt/dust,
/turf/open/floor/iron/dark,
/area/station/science/research/abandoned)
"HP" = (
/obj/machinery/atmospherics/pipe/smart/manifold4w/scrubbers/hidden/layer2,
/obj/machinery/atmospherics/pipe/smart/manifold4w/supply/hidden/layer4,
/obj/structure/cable,
/obj/effect/decal/cleanable/dirt/dust,
/obj/structure/closet/firecloset/wall{
	pixel_x = -28
	},
/turf/open/floor/catwalk_floor/iron_dark,
/area/station/science/research/abandoned)
"Li" = (
/obj/machinery/atmospherics/pipe/smart/manifold4w/scrubbers/hidden/layer2,
/obj/machinery/atmospherics/pipe/smart/manifold4w/supply/hidden/layer4,
/obj/effect/decal/cleanable/dirt/dust,
/turf/open/floor/catwalk_floor/iron_dark,
/area/station/science/research/abandoned)
"LI" = (
/obj/effect/landmark/blobstart,
/obj/machinery/atmospherics/pipe/smart/manifold4w/supply/hidden/layer4,
/turf/open/floor/engine/airless,
/area/station/science/research/abandoned)
"MR" = (
/obj/structure/cable,
/obj/effect/spawner/structure/window/reinforced,
/turf/open/floor/plating,
/area/station/science/research/abandoned)
"Nh" = (
/obj/machinery/atmospherics/pipe/smart/manifold4w/scrubbers/hidden/layer2,
/obj/item/clothing/glasses/welding,
/obj/effect/mob_spawn/corpse/human/charredskeleton,
/turf/open/floor/engine/airless,
/area/station/science/research/abandoned)
"Oa" = (
/obj/effect/decal/cleanable/dirt/dust,
/obj/machinery/atmospherics/components/unary/vent_scrubber/on/layer2,
/turf/open/floor/iron/dark,
/area/station/science/research/abandoned)
"OL" = (
/obj/machinery/shower/directional/west{
	name = "emergency shower"
	},
/obj/effect/decal/cleanable/dirt/dust,
/obj/machinery/atmospherics/components/unary/vent_pump/on/layer4,
/turf/open/floor/iron/dark/purple/side{
	dir = 4
	},
/area/station/science/research/abandoned)
"OW" = (
/obj/effect/decal/cleanable/dirt/dust,
/turf/open/floor/iron/dark,
/area/station/science/research/abandoned)
"QG" = (
/obj/structure/cable,
/obj/effect/decal/cleanable/dirt/dust,
/obj/structure/extinguisher_cabinet/directional/north,
/turf/open/floor/catwalk_floor/iron_dark,
/area/station/science/research/abandoned)
"QP" = (
/obj/structure/table/reinforced/rglass,
/obj/effect/decal/cleanable/dirt/dust,
/obj/item/paper,
/obj/item/disk{
	name = "Research Data";
	pixel_x = 7
	},
/obj/item/pen/fourcolor,
/turf/open/floor/iron/dark/purple/side{
	dir = 4
	},
/area/station/science/research/abandoned)
"Rq" = (
/obj/machinery/power/energy_accumulator/tesla_coil/anchored,
/turf/open/floor/engine/airless,
/area/station/science/research/abandoned)
"Rt" = (
/obj/structure/table/reinforced/rglass,
/obj/structure/cable,
/obj/item/scalpel/supermatter{
	name = "Warpstone Chisel"
	},
/obj/effect/decal/cleanable/dirt/dust,
/obj/item/multitool,
/obj/machinery/camera/autoname/directional/west,
/turf/open/floor/iron/dark/purple/side{
	dir = 8
	},
/area/station/science/research/abandoned)
"Tw" = (
/obj/effect/decal/cleanable/dirt/dust,
/obj/machinery/atmospherics/components/unary/vent_scrubber/on/layer2{
	dir = 8
	},
/turf/open/floor/iron/dark,
/area/station/science/research/abandoned)
"TT" = (
/obj/machinery/power/apc/auto_name/directional/north,
/obj/structure/cable,
/obj/effect/decal/cleanable/dirt/dust,
/obj/machinery/atmospherics/pipe/smart/manifold4w/scrubbers/hidden/layer2,
/obj/machinery/atmospherics/pipe/smart/manifold4w/supply/hidden/layer4,
/turf/open/floor/catwalk_floor/iron_dark,
/area/station/science/research/abandoned)
"Vh" = (
/obj/machinery/door/airlock/maintenance_hatch,
/obj/machinery/atmospherics/pipe/smart/manifold4w/scrubbers/hidden/layer2,
/obj/machinery/atmospherics/pipe/smart/manifold4w/supply/hidden/layer4,
/obj/structure/cable,
/obj/machinery/door/firedoor,
/obj/effect/mapping_helpers/airlock/abandoned,
/turf/open/floor/catwalk_floor/iron_dark,
/area/station/maintenance/fore/lesser)
"Wm" = (
/obj/structure/cable,
/obj/machinery/power/terminal{
	dir = 4
	},
/obj/effect/decal/cleanable/dirt/dust,
/obj/effect/turf_decal/stripes/line{
	dir = 4
	},
/obj/effect/turf_decal/stripes/line{
	dir = 8
	},
/turf/open/floor/catwalk_floor/iron_dark,
/area/station/science/research/abandoned)
"Wr" = (
/obj/structure/cable,
/obj/effect/decal/cleanable/dirt/dust,
/obj/item/paper/crumpled,
/turf/open/floor/catwalk_floor/iron_dark,
/area/station/science/research/abandoned)
"WG" = (
/obj/machinery/light/cold/directional/south,
/obj/machinery/light_switch/directional/south,
/obj/effect/decal/cleanable/dirt/dust,
/turf/open/floor/iron/dark/purple/side,
/area/station/science/research/abandoned)
"Xq" = (
/obj/structure/chair/office{
	dir = 1
	},
/obj/effect/decal/cleanable/dirt/dust,
/obj/machinery/requests_console{
	department = "Science";
	departmentType = 2;
	name = "Science Requests Console";
	pixel_y = -32
	},
/turf/open/floor/iron/dark/purple/side,
/area/station/science/research/abandoned)
"XF" = (
/obj/effect/decal/cleanable/dirt/dust,
/obj/item/radio/intercom/directional/south,
/turf/open/floor/iron/dark/purple/side,
/area/station/science/research/abandoned)
"XY" = (
/obj/machinery/power/energy_accumulator/grounding_rod/anchored,
/obj/machinery/atmospherics/pipe/smart/manifold4w/scrubbers/hidden/layer2,
/obj/machinery/atmospherics/pipe/smart/manifold4w/supply/hidden/layer4,
/turf/open/floor/engine/airless,
/area/station/science/research/abandoned)
"Yw" = (
/obj/effect/decal/cleanable/dirt/dust,
/obj/structure/closet/radiation,
/turf/open/floor/iron/dark/purple/side{
	dir = 4
	},
/area/station/science/research/abandoned)
"YY" = (
/obj/machinery/atmospherics/pipe/smart/manifold4w/scrubbers/hidden/layer2,
/obj/machinery/atmospherics/pipe/smart/manifold4w/supply/hidden/layer4,
/turf/open/floor/iron/dark/purple,
/area/station/science/research/abandoned)
"Zk" = (
/obj/structure/frame/computer{
	anchored = 1;
	broken = 1;
	can_be_unanchored = 1
	},
/obj/effect/decal/cleanable/dirt/dust,
/turf/open/floor/iron/dark,
/area/station/science/research/abandoned)

(1,1,1) = {"
iX
iX
iX
iX
iX
iX
iX
iX
iX
iX
"}
(2,1,1) = {"
Vh
eP
eP
HP
dq
Rt
EM
tu
gn
iX
"}
(3,1,1) = {"
iX
ED
AE
OW
Li
AT
HE
OW
gb
iX
"}
(4,1,1) = {"
iX
ED
AT
Oa
Li
bj
jq
HE
uy
MR
"}
(5,1,1) = {"
iX
fp
oI
OL
fG
Yw
yj
AT
gb
MR
"}
(6,1,1) = {"
iX
Fx
nA
iX
tV
iX
eZ
oN
El
ju
"}
(7,1,1) = {"
iX
lG
bx
iX
YY
iX
TT
bj
gb
fr
"}
(8,1,1) = {"
iX
bs
uS
iX
iY
iX
fW
Tw
WG
iX
"}
(9,1,1) = {"
iX
Rq
GN
xl
hW
iX
QG
OW
XF
iX
"}
(10,1,1) = {"
iX
ft
AL
LI
XY
bs
Wr
Zk
vw
iX
"}
(11,1,1) = {"
iX
xl
hk
by
Nh
bs
Wm
fm
Xq
iX
"}
(12,1,1) = {"
iX
xl
xl
xl
HA
iX
xv
QP
gm
iX
"}
