//MAP CONVERTED BY dmm2tgm.py THIS HEADER COMMENT PREVENTS RECONVERSION, DO NOT REMOVE
"a" = (
/obj/structure/table/wood/fancy/cyan,
/obj/item/clothing/mask/muzzle{
	pixel_y = -2
	},
/obj/item/clothing/neck/human_petcollar/choker{
	pixel_y = 6
	},
/obj/item/clothing/head/kitty/genuine,
/obj/structure/window,
/turf/open/floor/glass,
/area/station/service/jadedragon)
"b" = (
/obj/structure/bed/bdsm_bed,
/obj/item/clothing/glasses/blindfold{
	pixel_y = 3
	},
/obj/item/clothing/mask/breath/medical{
	pixel_y = 6
	},
/obj/effect/decal/cleanable/blood/splatter{
	pixel_x = 4;
	pixel_y = 14
	},
/obj/effect/landmark/blobstart,
/obj/item/key/collar{
	color = "purple";
	pixel_x = -6
	},
/turf/open/floor/glass,
/area/station/service/jadedragon)
"c" = (
/obj/item/light/tube/broken,
/obj/machinery/light/built/directional/south,
/obj/effect/decal/cleanable/dirt/dust,
/turf/open/floor/carpet/purple,
/area/station/service/jadedragon)
"d" = (
/turf/closed/wall,
/area/station/service/jadedragon)
"e" = (
/obj/effect/decal/cleanable/glitter/blue,
/obj/effect/decal/cleanable/shreds,
/obj/effect/landmark/start/hangover,
/turf/open/floor/glass,
/area/station/service/jadedragon)
"h" = (
/obj/structure/window,
/obj/structure/window{
	dir = 4
	},
/obj/item/feather{
	pixel_y = 12
	},
/obj/item/candle/infinite{
	light_color = "#A700FF";
	pixel_x = -6
	},
/obj/item/candle/infinite{
	light_color = "#A700FF";
	pixel_x = 4;
	pixel_y = 3
	},
/turf/open/floor/glass,
/area/station/service/jadedragon)
"i" = (
/obj/effect/landmark/xeno_spawn,
/turf/open/floor/carpet/purple,
/area/station/service/jadedragon)
"k" = (
/obj/structure/rack/shelf,
/obj/item/clothing/gloves/fingerless,
/obj/item/assembly/signaler,
/obj/item/electropack/shockcollar,
/turf/open/floor/carpet/purple,
/area/station/service/jadedragon)
"l" = (
/obj/item/vending_refill/lustwish,
/obj/effect/decal/cleanable/generic,
/turf/open/floor/carpet/purple,
/area/station/service/jadedragon)
"m" = (
/obj/structure/lattice,
/turf/open/space/basic,
/area/space/nearstation)
"o" = (
/obj/structure/closet/mini_fridge,
/obj/effect/decal/cleanable/cobweb,
/obj/item/reagent_containers/cup/glass/waterbottle,
/obj/item/stack/spacecash/c1000,
/obj/item/reagent_containers/cup/glass/bottle/absinthe/premium,
/turf/open/floor/carpet/purple,
/area/station/service/jadedragon)
"p" = (
/obj/structure/falsewall,
/turf/open/floor/plating,
/area/station/service/jadedragon)
"s" = (
/obj/effect/decal/cleanable/cobweb/cobweb2,
/obj/structure/tank_holder/anesthetic{
	anchored = 1;
	can_be_unanchored = 1
	},
/turf/open/floor/carpet/purple,
/area/station/service/jadedragon)
"t" = (
/obj/machinery/shower/directional/west,
/obj/effect/decal/cleanable/cobweb/cobweb2,
/obj/effect/decal/cleanable/dirt/dust,
/turf/open/floor/carpet/purple,
/area/station/service/jadedragon)
"u" = (
/obj/structure/sign/poster/contraband/busty_backdoor_xeno_babes_6{
	pixel_y = 32
	},
/obj/machinery/power/apc/auto_name/directional/east,
/obj/structure/cable,
/turf/open/floor/carpet/purple,
/area/station/service/jadedragon)
"w" = (
/turf/open/space/basic,
/area/space)
"x" = (
/obj/structure/window,
/obj/effect/decal/cleanable/glitter/blue,
/turf/open/floor/glass,
/area/station/service/jadedragon)
"y" = (
/obj/machinery/light/blacklight/directional/west,
/obj/structure/sign/poster/contraband/lusty_xenomorph{
	pixel_x = -32
	},
/obj/item/reagent_containers/cup/glass/waterbottle/empty,
/turf/open/floor/carpet/purple,
/area/station/service/jadedragon)
"z" = (
/obj/structure/cable,
/obj/machinery/atmospherics/pipe/smart/manifold4w/supply/hidden/layer4,
/obj/machinery/atmospherics/pipe/smart/manifold4w/scrubbers/hidden/layer2,
/obj/structure/disposalpipe/segment,
/turf/open/floor/plating,
/area/station/maintenance/aft)
"A" = (
/obj/machinery/vending/dorms{
	extended_inventory = 1;
	market_verb = "Deviant";
	name = "\improper Kinko-Mat 3000"
	},
/obj/structure/cable,
/turf/open/floor/carpet/purple,
/area/station/service/jadedragon)
"E" = (
/turf/closed/wall/r_wall,
/area/station/service/jadedragon)
"G" = (
/obj/effect/decal/cleanable/dirt/dust,
/turf/open/floor/carpet/purple,
/area/station/service/jadedragon)
"H" = (
/obj/structure/disposalpipe/segment{
	dir = 4
	},
/obj/machinery/atmospherics/pipe/smart/manifold4w/scrubbers/hidden/layer2,
/obj/machinery/atmospherics/pipe/smart/manifold4w/supply/hidden/layer4,
/turf/open/floor/plating,
/area/station/maintenance/aft)
"I" = (
/obj/structure/cable,
/obj/structure/disposalpipe/segment{
	dir = 5
	},
/turf/open/floor/plating,
/area/station/maintenance/aft)
"J" = (
/obj/machinery/light/blacklight/directional/north,
/obj/structure/window{
	dir = 4
	},
/obj/item/bdsm_candle,
/turf/open/floor/glass,
/area/station/service/jadedragon)
"K" = (
/obj/item/clothing/under/misc/gear_harness{
	pixel_x = 6;
	pixel_y = 8
	},
/obj/effect/decal/cleanable/glitter/blue,
/turf/open/floor/glass,
/area/station/service/jadedragon)
"L" = (
/obj/structure/window,
/obj/structure/window{
	dir = 8
	},
/obj/effect/decal/cleanable/glitter/blue,
/turf/open/floor/glass,
/area/station/service/jadedragon)
"M" = (
/obj/machinery/door/airlock/public/glass,
/obj/effect/mapping_helpers/airlock/abandoned,
/obj/structure/barricade/wooden/crude,
/obj/structure/cable,
/turf/open/floor/plating,
/area/station/service/jadedragon)
"N" = (
/obj/machinery/atmospherics/pipe/smart/manifold4w/scrubbers/hidden/layer2,
/obj/machinery/atmospherics/pipe/smart/manifold4w/supply/hidden/layer4,
/obj/structure/disposalpipe/segment{
	dir = 5
	},
/turf/open/floor/plating,
/area/station/maintenance/aft)
"P" = (
/obj/structure/window{
	dir = 8
	},
/obj/effect/spawner/costume/maid,
/obj/item/stack/spacecash/c200{
	pixel_x = 4;
	pixel_y = 5
	},
/turf/open/floor/glass,
/area/station/service/jadedragon)
"Q" = (
/obj/structure/chair/comfy/brown{
	dir = 4
	},
/obj/item/reagent_containers/syringe/contraband/morphine,
/obj/effect/decal/cleanable/ash,
/turf/open/floor/carpet/purple,
/area/station/service/jadedragon)
"R" = (
/obj/effect/decal/cleanable/glitter/blue,
/obj/item/reagent_containers/spray/cyborg_lube{
	desc = "All natural friction defeating lubricant in a spray.";
	name = "Exotic Lubricant"
	},
/obj/effect/decal/cleanable/plastic,
/obj/effect/decal/cleanable/cum{
	pixel_x = 11;
	pixel_y = 8
	},
/turf/open/floor/glass,
/area/station/service/jadedragon)
"S" = (
/obj/structure/window{
	dir = 4
	},
/obj/effect/decal/cleanable/glitter/blue,
/turf/open/floor/glass,
/area/station/service/jadedragon)
"U" = (
/obj/machinery/light/blacklight/directional/north,
/obj/structure/window{
	dir = 8
	},
/obj/effect/decal/cleanable/glitter/blue,
/turf/open/floor/glass,
/area/station/service/jadedragon)
"V" = (
/obj/effect/decal/cleanable/dirt,
/obj/effect/decal/cleanable/glitter/blue,
/turf/open/floor/carpet/purple,
/area/station/service/jadedragon)
"W" = (
/obj/effect/decal/cleanable/glass,
/obj/item/crowbar/makeshift,
/obj/structure/cable,
/turf/open/floor/carpet/purple,
/area/station/service/jadedragon)
"X" = (
/obj/item/clothing/mask/cigarette,
/obj/effect/decal/cleanable/dirt,
/obj/item/cigbutt{
	pixel_y = 6
	},
/obj/effect/decal/cleanable/ash,
/turf/open/floor/carpet/purple,
/area/station/service/jadedragon)
"Y" = (
/turf/open/floor/carpet/purple,
/area/station/service/jadedragon)

(1,1,1) = {"
d
d
d
d
d
w
w
w
"}
(2,1,1) = {"
d
o
y
Q
d
U
P
L
"}
(3,1,1) = {"
M
W
i
X
V
K
R
a
"}
(4,1,1) = {"
d
A
l
G
k
e
b
x
"}
(5,1,1) = {"
d
u
t
c
d
J
S
h
"}
(6,1,1) = {"
E
p
d
Y
d
w
w
w
"}
(7,1,1) = {"
z
N
d
s
d
m
w
w
"}
(8,1,1) = {"
I
H
d
d
d
m
w
w
"}
