//MAP CONVERTED BY dmm2tgm.py THIS HEADER COMMENT PREVENTS RECONVERSION, DO NOT REMOVE
"a" = (
/obj/machinery/vending/coffee,
/turf/open/floor/eighties,
/area/station/common/arcade)
"d" = (
/obj/machinery/vending/cola/red,
/turf/open/floor/eighties,
/area/station/common/arcade)
"e" = (
/obj/structure/chair/stool,
/obj/structure/cable,
/obj/machinery/atmospherics/pipe/smart/manifold4w/supply/hidden/layer4,
/obj/machinery/atmospherics/pipe/smart/manifold4w/scrubbers/hidden/layer2,
/turf/open/floor/eighties,
/area/station/common/arcade)
"h" = (
/obj/structure/closet/lasertag/blue,
/obj/machinery/light{
	bulb_colour = "#A700FF";
	dir = 4
	},
/obj/item/radio/intercom{
	name = "station intercom (General)";
	pixel_x = 28
	},
/turf/open/floor/eighties,
/area/station/common/arcade)
"i" = (
/obj/structure/chair/comfy/black{
	dir = 1
	},
/turf/open/floor/eighties,
/area/station/common/arcade)
"k" = (
/obj/structure/table,
/obj/machinery/light/small/blacklight{
	dir = 1
	},
/obj/machinery/status_display{
	layer = 4;
	pixel_y = 32
	},
/obj/item/food/pizza/arnold,
/obj/item/reagent_containers/cup/soda_cans/space_mountain_wind{
	pixel_x = 7;
	pixel_y = 10
	},
/obj/item/plate,
/obj/item/reagent_containers/cup/soda_cans/starkist{
	pixel_x = -4;
	pixel_y = 10
	},
/turf/open/floor/eighties,
/area/station/common/arcade)
"l" = (
/obj/structure/cable,
/obj/machinery/power/apc/auto_name/directional/east,
/turf/open/floor/eighties,
/area/station/common/arcade)
"m" = (
/obj/structure/chair/stool,
/obj/effect/landmark/start/assistant,
/turf/open/floor/eighties,
/area/station/common/arcade)
"o" = (
/obj/structure/chair/stool,
/obj/structure/cable,
/turf/open/floor/eighties,
/area/station/common/arcade)
"p" = (
/obj/structure/chair/stool,
/turf/open/floor/eighties,
/area/station/common/arcade)
"q" = (
/obj/machinery/holopad,
/obj/structure/cable,
/obj/machinery/atmospherics/pipe/smart/manifold4w/supply/hidden/layer4,
/obj/machinery/atmospherics/pipe/smart/manifold4w/scrubbers/hidden/layer2,
/turf/open/floor/eighties,
/area/station/common/arcade)
"s" = (
/obj/machinery/atmospherics/components/unary/vent_pump/on/layer4{
	dir = 8
	},
/turf/open/floor/eighties,
/area/station/common/arcade)
"u" = (
/obj/structure/chair/comfy/black{
	dir = 8
	},
/turf/open/floor/eighties,
/area/station/common/arcade)
"v" = (
/obj/machinery/light{
	bulb_colour = "#A700FF";
	dir = 8
	},
/turf/open/floor/eighties,
/area/station/common/arcade)
"z" = (
/turf/closed/wall,
/area/station/service/chapel)
"B" = (
/obj/structure/chair/comfy/black,
/obj/effect/landmark/start/assistant,
/obj/machinery/light/small/blacklight{
	dir = 8
	},
/obj/machinery/airalarm/directional/west,
/turf/open/floor/eighties,
/area/station/common/arcade)
"C" = (
/obj/machinery/newscaster/directional/north,
/turf/open/floor/eighties,
/area/station/common/arcade)
"D" = (
/obj/effect/spawner/structure/window,
/turf/open/floor/plating,
/area/station/common/arcade)
"E" = (
/obj/machinery/vending/cart,
/turf/open/floor/eighties,
/area/station/common/arcade)
"G" = (
/obj/structure/cable,
/obj/structure/disposalpipe/segment{
	dir = 6
	},
/obj/machinery/atmospherics/pipe/smart/manifold4w/supply/hidden/layer4,
/obj/machinery/atmospherics/pipe/smart/manifold4w/scrubbers/hidden/layer2,
/turf/open/floor/eighties,
/area/station/common/arcade)
"I" = (
/obj/structure/disposalpipe/segment{
	dir = 4
	},
/turf/open/floor/eighties,
/area/station/common/arcade)
"L" = (
/obj/machinery/door/firedoor,
/obj/machinery/door/airlock/public/glass{
	name = "Arcade"
	},
/obj/structure/disposalpipe/segment,
/obj/structure/cable,
/obj/machinery/atmospherics/pipe/smart/manifold4w/supply/hidden/layer4,
/obj/machinery/atmospherics/pipe/smart/manifold4w/scrubbers/hidden/layer2,
/turf/open/floor/eighties,
/area/station/common/arcade)
"M" = (
/obj/structure/sign/poster/contraband/random{
	pixel_x = -32
	},
/turf/open/floor/eighties,
/area/station/common/arcade)
"O" = (
/obj/structure/cable,
/turf/open/floor/eighties,
/area/station/common/arcade)
"P" = (
/obj/structure/closet/lasertag/red,
/obj/structure/sign/poster/official/random{
	pixel_x = 32
	},
/turf/open/floor/eighties,
/area/station/common/arcade)
"Q" = (
/obj/structure/table,
/turf/open/floor/eighties,
/area/station/common/arcade)
"R" = (
/obj/machinery/atmospherics/components/unary/vent_scrubber/on/layer2{
	dir = 4
	},
/turf/open/floor/eighties,
/area/station/common/arcade)
"S" = (
/obj/structure/chair/comfy/black{
	dir = 4
	},
/obj/machinery/camera/autoname/directional/north,
/obj/machinery/firealarm/directional/north,
/turf/open/floor/eighties,
/area/station/common/arcade)
"T" = (
/turf/open/floor/eighties,
/area/station/common/arcade)
"V" = (
/obj/machinery/vending/snack,
/obj/machinery/light_switch/directional/east,
/turf/open/floor/eighties,
/area/station/common/arcade)
"W" = (
/obj/machinery/disposal/bin,
/obj/structure/disposalpipe/trunk{
	dir = 8
	},
/turf/open/floor/eighties,
/area/station/common/arcade)
"Y" = (
/turf/closed/wall,
/area/station/common/arcade)
"Z" = (
/obj/effect/spawner/random/entertainment/arcade,
/turf/open/floor/eighties,
/area/station/common/arcade)

(1,1,1) = {"
z
z
z
z
z
Q
v
D
"}
(2,1,1) = {"
Y
E
B
M
i
T
T
D
"}
(3,1,1) = {"
Y
d
T
T
R
T
T
D
"}
(4,1,1) = {"
Y
C
O
o
q
e
G
L
"}
(5,1,1) = {"
Y
S
O
Z
s
Z
I
D
"}
(6,1,1) = {"
Y
k
O
Z
T
Z
I
D
"}
(7,1,1) = {"
Y
u
O
p
T
m
I
D
"}
(8,1,1) = {"
Y
a
l
P
h
V
W
Y
"}
(9,1,1) = {"
Y
Y
Y
Y
Y
Y
Y
Y
"}
