//MAP CONVERTED BY dmm2tgm.py THIS HEADER COMMENT PREVENTS RECONVERSION, DO NOT REMOVE
"ak" = (
/obj/machinery/power/emitter/welded{
	dir = 1
	},
/obj/structure/cable,
/obj/effect/decal/cleanable/dirt/dust,
/obj/effect/turf_decal/stripes/end,
/turf/open/floor/plating,
/area/station/science/research/abandoned)
"bf" = (
/turf/open/misc/asteroid/snow/icemoon,
/area/icemoon/underground/explored)
"bz" = (
/obj/machinery/atmospherics/pipe/smart/manifold4w/scrubbers/hidden/layer2,
/obj/machinery/atmospherics/pipe/smart/manifold4w/supply/hidden/layer4,
/obj/effect/decal/cleanable/dirt/dust,
/turf/open/floor/catwalk_floor/iron_dark,
/area/station/science/research/abandoned)
"bD" = (
/obj/structure/disposalpipe/segment{
	dir = 4
	},
/obj/effect/spawner/structure/window/reinforced/plasma,
/turf/open/floor/plating,
/area/station/science/research/abandoned)
"bG" = (
/obj/machinery/power/apc/auto_name/directional/north,
/obj/structure/cable,
/obj/effect/decal/cleanable/dirt/dust,
/obj/machinery/atmospherics/pipe/smart/manifold4w/scrubbers/hidden/layer2,
/obj/machinery/atmospherics/pipe/smart/manifold4w/supply/hidden/layer4,
/turf/open/floor/catwalk_floor/iron_dark,
/area/station/science/research/abandoned)
"bK" = (
/obj/structure/frame/computer{
	anchored = 1;
	broken = 1;
	can_be_unanchored = 1
	},
/obj/effect/decal/cleanable/dirt/dust,
/turf/open/floor/iron/dark,
/area/station/science/research/abandoned)
"cc" = (
/obj/machinery/door/airlock/science{
	name = "Abandoned Warp Stone Lab"
	},
/obj/machinery/door/firedoor,
/obj/effect/mapping_helpers/airlock/locked,
/obj/machinery/atmospherics/pipe/smart/manifold4w/supply/hidden/layer4,
/obj/machinery/atmospherics/pipe/smart/manifold4w/scrubbers/hidden/layer2,
/obj/structure/cable,
/obj/effect/mapping_helpers/airlock/cyclelink_helper_multi{
	cycle_id = Warp_Lab
	},
/turf/open/floor/iron/dark/purple,
/area/station/science/research/abandoned)
"cv" = (
/obj/effect/mapping_helpers/airlock/cyclelink_helper{
	dir = 4
	},
/obj/machinery/door/airlock/plasma{
	name = "Outer Warpstone Lock"
	},
/obj/machinery/atmospherics/pipe/smart/manifold4w/scrubbers/hidden/layer2,
/obj/machinery/atmospherics/pipe/smart/manifold4w/supply/hidden/layer4,
/obj/effect/mapping_helpers/airlock/locked,
/turf/open/floor/iron/dark/purple,
/area/station/science/research/abandoned)
"cU" = (
/obj/machinery/atmospherics/pipe/smart/simple/dark/visible,
/turf/closed/wall/r_wall,
/area/station/science/ordnance/burnchamber)
"cZ" = (
/obj/machinery/atmospherics/pipe/smart/manifold4w/supply/hidden/layer4,
/obj/machinery/atmospherics/pipe/smart/manifold4w/scrubbers/hidden/layer2,
/obj/machinery/door/airlock/science{
	name = "Abandoned Warp Stone Lab"
	},
/obj/structure/cable,
/obj/effect/mapping_helpers/airlock/cyclelink_helper_multi{
	cycle_id = Warp_Lab
	},
/turf/open/floor/iron/white,
/area/station/science/research/abandoned)
"ef" = (
/obj/machinery/atmospherics/pipe/smart/manifold/yellow/visible{
	dir = 4
	},
/obj/machinery/meter,
/turf/open/floor/iron,
/area/station/science/ordnance)
"em" = (
/obj/machinery/door/firedoor/border_only,
/obj/machinery/atmospherics/pipe/smart/manifold4w/supply/hidden/layer4,
/obj/machinery/atmospherics/pipe/smart/manifold4w/scrubbers/hidden/layer2,
/obj/structure/cable,
/turf/open/floor/iron/white,
/area/station/science/ordnance)
"eE" = (
/obj/machinery/power/smes,
/obj/structure/cable,
/obj/effect/decal/cleanable/dirt/dust,
/turf/open/floor/iron/dark/purple/side{
	dir = 5
	},
/area/station/science/research/abandoned)
"gp" = (
/obj/machinery/atmospherics/components/binary/pump/off,
/obj/machinery/airlock_sensor/incinerator_ordmix{
	pixel_x = 24
	},
/obj/machinery/atmospherics/pipe/layer_manifold/scrubbers/hidden{
	dir = 8
	},
/turf/open/floor/engine,
/area/station/science/ordnance/burnchamber)
"gA" = (
/obj/machinery/portable_atmospherics/canister/plasma,
/turf/open/misc/asteroid/snow/icemoon,
/area/icemoon/underground/explored)
"he" = (
/turf/closed/wall,
/area/station/maintenance/starboard/aft)
"ia" = (
/obj/machinery/atmospherics/pipe/smart/manifold4w/supply/hidden/layer4,
/obj/machinery/atmospherics/pipe/smart/manifold4w/scrubbers/hidden/layer2,
/obj/structure/cable,
/turf/open/floor/iron/white,
/area/station/science/ordnance)
"id" = (
/obj/structure/table_frame,
/obj/machinery/light/cold{
	dir = 8
	},
/obj/effect/decal/cleanable/dirt/dust,
/turf/open/floor/iron/dark/purple/side{
	dir = 8
	},
/area/station/science/research/abandoned)
"in" = (
/obj/structure/cable,
/obj/effect/spawner/structure/window/reinforced,
/turf/open/floor/plating,
/area/station/science/research/abandoned)
"iq" = (
/obj/machinery/atmospherics/components/unary/portables_connector/visible{
	dir = 4
	},
/turf/open/floor/iron/dark,
/area/station/science/ordnance)
"iF" = (
/obj/effect/decal/cleanable/dirt/dust,
/turf/open/floor/iron/dark/purple/side{
	dir = 8
	},
/area/station/science/research/abandoned)
"jE" = (
/obj/structure/railing{
	dir = 4
	},
/turf/open/floor/plating,
/area/station/maintenance/starboard/aft)
"jG" = (
/obj/machinery/atmospherics/pipe/smart/manifold4w/supply/hidden/layer4,
/obj/machinery/atmospherics/pipe/smart/manifold4w/scrubbers/hidden/layer2,
/turf/open/floor/iron,
/area/station/science/ordnance)
"jV" = (
/turf/open/floor/engine/vacuum,
/area/station/science/ordnance/burnchamber)
"kd" = (
/obj/machinery/power/supermatter_crystal/shard/hugbox/fakecrystal{
	color = "green";
	name = "Synthetic Warp Stone Crystal"
	},
/turf/open/floor/engine/airless,
/area/station/science/research/abandoned)
"ku" = (
/obj/item/radio/intercom/directional/north,
/turf/open/floor/iron/white,
/area/station/science/ordnance)
"kJ" = (
/obj/effect/mapping_helpers/airlock/cyclelink_helper{
	dir = 8
	},
/obj/machinery/door/airlock/plasma{
	name = "Inner Warpstone Lock"
	},
/obj/structure/fans/tiny/invisible,
/obj/machinery/atmospherics/pipe/smart/manifold4w/scrubbers/hidden/layer2,
/obj/machinery/atmospherics/pipe/smart/manifold4w/supply/hidden/layer4,
/obj/effect/mapping_helpers/airlock/locked,
/turf/open/floor/catwalk_floor/iron_dark,
/area/station/science/research/abandoned)
"kN" = (
/obj/machinery/atmospherics/components/unary/vent_pump/layer4,
/turf/open/floor/engine/airless,
/area/station/science/research/abandoned)
"kZ" = (
/obj/machinery/atmospherics/components/unary/portables_connector/visible,
/obj/effect/turf_decal/box/red,
/obj/machinery/firealarm/directional/east,
/turf/open/floor/iron/dark,
/area/station/science/ordnance)
"la" = (
/obj/structure/fence,
/turf/open/misc/asteroid/snow/icemoon,
/area/icemoon/underground/explored)
"lj" = (
/obj/effect/decal/cleanable/dirt/dust,
/obj/structure/showcase/horrific_experiment,
/turf/open/floor/iron/dark/purple/side{
	dir = 1
	},
/area/station/science/research/abandoned)
"mc" = (
/obj/structure/table/reinforced/rglass,
/obj/item/scalpel/supermatter{
	name = "Warpstone Chisel"
	},
/obj/effect/decal/cleanable/dirt/dust,
/obj/item/multitool,
/obj/machinery/camera/autoname/directional/west,
/turf/open/floor/iron/dark/purple/side{
	dir = 8
	},
/area/station/science/research/abandoned)
"my" = (
/obj/machinery/atmospherics/components/binary/dp_vent_pump/high_volume/incinerator_ordmix{
	dir = 4
	},
/turf/open/floor/engine,
/area/station/science/ordnance/burnchamber)
"nH" = (
/obj/structure/closet/firecloset/wall{
	pixel_x = -28
	},
/turf/open/floor/iron/dark/purple/side{
	dir = 8
	},
/area/station/science/research/abandoned)
"nI" = (
/obj/effect/spawner/structure/window/reinforced/plasma,
/turf/open/floor/plating,
/area/station/science/research/abandoned)
"pa" = (
/obj/machinery/power/energy_accumulator/grounding_rod/anchored,
/obj/machinery/atmospherics/pipe/smart/manifold4w/scrubbers/hidden/layer2,
/obj/machinery/atmospherics/pipe/smart/manifold4w/supply/hidden/layer4,
/turf/open/floor/engine/airless,
/area/station/science/research/abandoned)
"ps" = (
/obj/effect/turf_decal/stripes/line,
/obj/machinery/atmospherics/components/tank,
/turf/open/floor/iron/dark,
/area/station/science/ordnance)
"pE" = (
/obj/machinery/atmospherics/components/binary/valve/digital{
	dir = 4
	},
/obj/effect/turf_decal/stripes/line{
	dir = 1
	},
/turf/open/floor/iron,
/area/station/science/ordnance)
"pK" = (
/obj/structure/cable,
/obj/effect/decal/cleanable/dirt/dust,
/obj/structure/extinguisher_cabinet/directional/north,
/turf/open/floor/catwalk_floor/iron_dark,
/area/station/science/research/abandoned)
"qj" = (
/obj/machinery/atmospherics/components/unary/vent_scrubber/on/layer2{
	dir = 1
	},
/turf/open/floor/iron/dark,
/area/station/science/ordnance)
"qq" = (
/obj/machinery/door/firedoor/border_only,
/turf/open/floor/iron/white,
/area/station/science/ordnance)
"qx" = (
/obj/effect/decal/cleanable/dirt/dust,
/obj/machinery/atmospherics/components/unary/vent_pump/on/layer4{
	dir = 4
	},
/turf/open/floor/iron/dark,
/area/station/science/research/abandoned)
"qz" = (
/obj/machinery/atmospherics/components/unary/vent_scrubber/on/layer2,
/turf/open/floor/engine/airless,
/area/station/science/research/abandoned)
"qP" = (
/obj/structure/cable,
/obj/effect/decal/cleanable/dirt/dust,
/obj/item/paper/crumpled,
/turf/open/floor/catwalk_floor/iron_dark,
/area/station/science/research/abandoned)
"rr" = (
/obj/machinery/light/cold/directional/south,
/obj/machinery/firealarm/directional/south,
/obj/effect/decal/cleanable/dirt/dust,
/turf/open/floor/iron/dark/purple/side,
/area/station/science/research/abandoned)
"rC" = (
/obj/structure/closet/firecloset,
/obj/machinery/light/small/directional/north,
/turf/open/floor/plating,
/area/station/maintenance/starboard/aft)
"sj" = (
/obj/machinery/atmospherics/components/tank,
/turf/open/floor/iron/dark,
/area/station/science/ordnance)
"sx" = (
/turf/open/floor/engine/airless,
/area/station/science/research/abandoned)
"sy" = (
/obj/machinery/atmospherics/components/unary/portables_connector/visible{
	dir = 1
	},
/obj/effect/turf_decal/box/red,
/obj/machinery/airalarm/mixingchamber{
	dir = 4;
	pixel_x = 24
	},
/turf/open/floor/iron/dark,
/area/station/science/ordnance/burnchamber)
"sN" = (
/obj/machinery/atmospherics/pipe/smart/manifold4w/scrubbers/hidden/layer2,
/obj/machinery/atmospherics/pipe/smart/manifold4w/supply/hidden/layer4,
/turf/open/floor/engine/airless,
/area/station/science/research/abandoned)
"sR" = (
/obj/effect/decal/cleanable/dirt/dust,
/obj/machinery/atmospherics/components/unary/vent_scrubber/on/layer2{
	dir = 8
	},
/turf/open/floor/iron/dark,
/area/station/science/research/abandoned)
"sZ" = (
/obj/machinery/light/red/directional/south,
/turf/open/floor/engine/airless,
/area/station/science/research/abandoned)
"tw" = (
/obj/structure/table/reinforced/rglass,
/obj/effect/decal/cleanable/dirt/dust,
/obj/item/paper,
/obj/item/disk{
	name = "Research Data";
	pixel_x = 7
	},
/obj/item/pen/fourcolor,
/turf/open/floor/iron/dark/purple/side{
	dir = 4
	},
/area/station/science/research/abandoned)
"tz" = (
/obj/structure/disposaloutlet{
	dir = 4
	},
/obj/structure/disposalpipe/trunk{
	dir = 8
	},
/turf/open/floor/engine/airless,
/area/station/science/research/abandoned)
"tR" = (
/obj/machinery/atmospherics/components/tank,
/obj/effect/turf_decal/stripes/line{
	dir = 4
	},
/obj/machinery/light/directional/north,
/turf/open/floor/iron/dark,
/area/station/science/ordnance)
"uj" = (
/obj/machinery/atmospherics/components/unary/portables_connector/visible{
	dir = 1
	},
/obj/effect/turf_decal/box,
/obj/machinery/atmospherics/pipe/smart/manifold4w/supply/hidden/layer4,
/obj/machinery/atmospherics/pipe/smart/manifold4w/scrubbers/hidden/layer2,
/obj/structure/cable,
/turf/open/floor/iron,
/area/station/science/ordnance)
"ur" = (
/obj/machinery/atmospherics/pipe/smart/manifold4w/scrubbers/hidden/layer2,
/obj/machinery/atmospherics/pipe/smart/manifold4w/supply/hidden/layer4,
/obj/structure/cable,
/turf/open/floor/iron,
/area/station/science/ordnance)
"uW" = (
/obj/structure/stairs/west,
/turf/open/floor/iron/white,
/area/station/science/ordnance)
"vf" = (
/obj/structure/table/reinforced/rglass,
/obj/item/modular_computer/laptop/preset/civilian,
/obj/effect/decal/cleanable/dirt/dust,
/obj/item/trash/can{
	pixel_y = 11
	},
/turf/open/floor/iron/dark/purple/side{
	dir = 6
	},
/area/station/science/research/abandoned)
"vs" = (
/obj/machinery/light/cold/directional/south,
/obj/machinery/light_switch/directional/south,
/obj/effect/decal/cleanable/dirt/dust,
/turf/open/floor/iron/dark/purple/side,
/area/station/science/research/abandoned)
"wd" = (
/obj/effect/spawner/random/trash,
/turf/open/floor/plating,
/area/station/maintenance/starboard/aft)
"wl" = (
/obj/structure/table_frame,
/obj/effect/decal/cleanable/dirt/dust,
/obj/structure/sign/poster/official/random{
	pixel_x = -32
	},
/turf/open/floor/iron/dark/purple/side{
	dir = 8
	},
/area/station/science/research/abandoned)
"wJ" = (
/obj/effect/decal/cleanable/dirt/dust,
/turf/open/floor/iron/dark,
/area/station/science/research/abandoned)
"wS" = (
/turf/open/floor/iron/dark,
/area/station/science/ordnance)
"xX" = (
/obj/machinery/air_sensor/ordnance_burn_chamber,
/turf/open/floor/engine/vacuum,
/area/station/science/ordnance/burnchamber)
"xZ" = (
/obj/effect/decal/cleanable/dirt/dust,
/obj/item/radio/intercom/directional/south,
/turf/open/floor/iron/dark/purple/side,
/area/station/science/research/abandoned)
"yc" = (
/obj/machinery/door/airlock/research/glass/incinerator/ordmix_exterior{
	name = "Burn Chamber Exterior Airlock"
	},
/obj/effect/mapping_helpers/airlock/locked,
/obj/effect/mapping_helpers/airlock/access/all/science/ordnance,
/turf/open/floor/engine/vacuum,
/area/station/science/ordnance/burnchamber)
"yi" = (
/obj/machinery/atmospherics/pipe/smart/simple/yellow/visible,
/turf/open/floor/iron,
/area/station/science/ordnance)
"yo" = (
/obj/effect/landmark/blobstart,
/obj/machinery/atmospherics/pipe/smart/manifold4w/supply/hidden/layer4,
/turf/open/floor/engine/airless,
/area/station/science/research/abandoned)
"Ak" = (
/obj/effect/turf_decal/stripes/line{
	dir = 8
	},
/obj/machinery/door/firedoor/heavy,
/obj/machinery/atmospherics/pipe/smart/manifold4w/supply/hidden/layer4,
/obj/machinery/atmospherics/pipe/smart/manifold4w/scrubbers/hidden/layer2,
/turf/open/floor/iron/dark,
/area/station/science/ordnance)
"AF" = (
/obj/effect/turf_decal/stripes/line{
	dir = 6
	},
/obj/machinery/atmospherics/components/tank,
/turf/open/floor/iron/dark,
/area/station/science/ordnance)
"AJ" = (
/obj/effect/decal/cleanable/dirt/dust,
/obj/machinery/portable_atmospherics/canister/freon,
/obj/effect/turf_decal/box,
/turf/open/floor/iron/dark/purple/side{
	dir = 10
	},
/area/station/science/research/abandoned)
"AN" = (
/obj/machinery/atmospherics/components/binary/pump/on{
	dir = 1
	},
/obj/machinery/atmospherics/pipe/layer_manifold/supply/hidden{
	dir = 4
	},
/turf/open/floor/engine,
/area/station/science/ordnance/burnchamber)
"Bq" = (
/obj/effect/decal/cleanable/dirt/dust,
/obj/machinery/atmospherics/pipe/smart/manifold4w/scrubbers/hidden/layer2,
/obj/machinery/atmospherics/pipe/smart/manifold4w/supply/hidden/layer4,
/turf/open/floor/catwalk_floor/iron_dark,
/area/station/science/research/abandoned)
"Cm" = (
/obj/machinery/door/poddoor/incinerator_ordmix,
/turf/open/openspace,
/area/station/science/ordnance/burnchamber)
"Dl" = (
/obj/structure/cable,
/obj/effect/decal/cleanable/dirt/dust,
/obj/machinery/atmospherics/pipe/smart/manifold4w/scrubbers/hidden/layer2,
/obj/machinery/atmospherics/pipe/smart/manifold4w/supply/hidden/layer4,
/turf/open/floor/catwalk_floor/iron_dark,
/area/station/science/research/abandoned)
"Dz" = (
/obj/machinery/atmospherics/components/unary/thermomachine/freezer{
	dir = 8
	},
/turf/open/floor/iron/dark,
/area/station/science/ordnance)
"DD" = (
/obj/effect/decal/cleanable/dirt/dust,
/obj/structure/closet/radiation,
/turf/open/floor/iron/dark/purple/side{
	dir = 4
	},
/area/station/science/research/abandoned)
"DZ" = (
/turf/closed/wall/r_wall,
/area/station/science/research/abandoned)
"Eu" = (
/obj/machinery/light/red/directional/north,
/turf/open/floor/engine/airless,
/area/station/science/research/abandoned)
"EG" = (
/obj/machinery/atmospherics/pipe/smart/manifold4w/scrubbers/hidden/layer2,
/turf/open/floor/iron/dark,
/area/station/science/ordnance)
"Fb" = (
/obj/machinery/disposal/bin,
/obj/structure/disposalpipe/trunk{
	dir = 4
	},
/obj/effect/decal/cleanable/dirt/dust,
/turf/open/floor/iron/dark/purple/side{
	dir = 6
	},
/area/station/science/research/abandoned)
"Fe" = (
/obj/effect/decal/cleanable/dirt/dust,
/turf/open/floor/iron/dark/purple/corner,
/area/station/science/research/abandoned)
"Fl" = (
/obj/structure/stairs/east,
/obj/structure/railing,
/obj/machinery/door/firedoor/border_only,
/turf/open/floor/iron/white,
/area/station/science/ordnance)
"FK" = (
/obj/machinery/atmospherics/pipe/smart/manifold4w/supply/hidden/layer4,
/turf/closed/wall/r_wall,
/area/station/science/ordnance/burnchamber)
"FL" = (
/obj/machinery/atmospherics/pipe/smart/simple/dark/visible{
	dir = 4
	},
/obj/effect/turf_decal/stripes/line{
	dir = 1
	},
/obj/machinery/atmospherics/pipe/smart/manifold4w/supply/hidden/layer4,
/obj/machinery/atmospherics/pipe/smart/manifold4w/scrubbers/hidden/layer2,
/obj/structure/cable,
/turf/open/floor/iron,
/area/station/science/ordnance)
"FY" = (
/obj/machinery/atmospherics/pipe/smart/manifold4w/supply/hidden/layer4,
/obj/machinery/atmospherics/pipe/smart/manifold4w/scrubbers/hidden/layer2,
/obj/structure/cable,
/obj/machinery/light/floor,
/turf/open/floor/iron/white,
/area/station/science/ordnance)
"Gc" = (
/obj/effect/spawner/structure/window/reinforced,
/turf/open/floor/plating,
/area/station/science/research/abandoned)
"GC" = (
/obj/effect/turf_decal/stripes/line{
	dir = 8
	},
/obj/machinery/door/firedoor/heavy,
/turf/open/floor/iron/dark,
/area/station/science/ordnance)
"GS" = (
/obj/machinery/atmospherics/pipe/smart/manifold4w/supply/hidden/layer4,
/obj/machinery/atmospherics/pipe/smart/manifold4w/scrubbers/hidden/layer2,
/obj/structure/cable,
/turf/open/floor/iron/white,
/area/station/science/research/abandoned)
"Hb" = (
/obj/machinery/door/airlock/maintenance_hatch{
	name = "Ordnance Lab Maintenance"
	},
/obj/machinery/door/firedoor/heavy,
/obj/effect/mapping_helpers/airlock/access/all/science/ordnance,
/turf/open/floor/plating,
/area/station/science/ordnance)
"Ig" = (
/obj/effect/decal/cleanable/dirt/dust,
/mob/living/simple_animal/hostile/rat,
/turf/open/floor/iron/dark,
/area/station/science/research/abandoned)
"Ii" = (
/obj/structure/fence/door/opened{
	dir = 4
	},
/turf/open/misc/asteroid/snow/icemoon,
/area/icemoon/underground/explored)
"Im" = (
/obj/machinery/igniter/incinerator_ordmix,
/turf/open/floor/engine/vacuum,
/area/station/science/ordnance/burnchamber)
"Iz" = (
/obj/effect/decal/cleanable/dirt/dust,
/obj/machinery/atmospherics/pipe/smart/manifold4w/scrubbers/hidden/layer2,
/obj/machinery/atmospherics/pipe/smart/manifold4w/supply/hidden/layer4,
/obj/effect/gibspawner/robot,
/turf/open/floor/catwalk_floor/iron_dark,
/area/station/science/research/abandoned)
"IK" = (
/obj/machinery/atmospherics/pipe/smart/manifold4w/scrubbers/hidden/layer2,
/obj/machinery/atmospherics/pipe/smart/manifold4w/supply/hidden/layer4,
/obj/effect/decal/cleanable/dirt/dust,
/obj/effect/turf_decal/caution{
	dir = 8
	},
/turf/open/floor/iron/dark/purple/side{
	dir = 4
	},
/area/station/science/research/abandoned)
"JR" = (
/obj/effect/decal/cleanable/dirt/dust,
/obj/machinery/atmospherics/pipe/smart/manifold4w/supply/hidden/layer4,
/obj/machinery/atmospherics/pipe/smart/manifold4w/scrubbers/hidden/layer2,
/obj/structure/cable,
/turf/open/floor/catwalk_floor/iron_dark,
/area/station/science/research/abandoned)
"JU" = (
/obj/machinery/atmospherics/pipe/smart/simple/yellow/visible,
/obj/machinery/atmospherics/pipe/smart/manifold4w/supply/hidden/layer4,
/obj/machinery/atmospherics/pipe/smart/manifold4w/scrubbers/hidden/layer2,
/obj/structure/cable,
/turf/open/floor/iron,
/area/station/science/ordnance)
"KG" = (
/obj/machinery/airalarm/all_access{
	dir = 1;
	pixel_y = 22
	},
/obj/structure/cable,
/obj/effect/decal/cleanable/dirt/dust,
/obj/item/storage/bag/trash/filled,
/turf/open/floor/catwalk_floor/iron_dark,
/area/station/science/research/abandoned)
"Lk" = (
/obj/machinery/power/energy_accumulator/tesla_coil/anchored,
/turf/open/floor/engine/airless,
/area/station/science/research/abandoned)
"LB" = (
/obj/structure/cable,
/obj/machinery/power/terminal{
	dir = 4
	},
/obj/effect/decal/cleanable/dirt/dust,
/obj/effect/turf_decal/stripes/line{
	dir = 4
	},
/obj/effect/turf_decal/stripes/line{
	dir = 8
	},
/turf/open/floor/catwalk_floor/iron_dark,
/area/station/science/research/abandoned)
"LI" = (
/turf/open/floor/iron,
/area/station/science/ordnance)
"MI" = (
/obj/machinery/atmospherics/components/unary/vent_pump/on/layer4,
/obj/structure/cable,
/turf/open/floor/iron,
/area/station/science/ordnance)
"Nb" = (
/obj/machinery/door/airlock/research/glass/incinerator/ordmix_interior{
	name = "Burn Chamber Interior Airlock"
	},
/obj/effect/mapping_helpers/airlock/locked,
/obj/machinery/embedded_controller/radio/airlock_controller/incinerator_ordmix{
	pixel_x = 24
	},
/obj/effect/mapping_helpers/airlock/access/all/science/ordnance,
/turf/open/floor/engine,
/area/station/science/ordnance/burnchamber)
"Nd" = (
/obj/machinery/requests_console/directional/north,
/obj/machinery/firealarm/directional/north{
	pixel_x = 21
	},
/turf/open/floor/iron/white,
/area/station/science/ordnance)
"NZ" = (
/obj/machinery/atmospherics/pipe/smart/simple/yellow/visible{
	dir = 6
	},
/obj/effect/turf_decal/stripes/line{
	dir = 1
	},
/turf/open/floor/iron,
/area/station/science/ordnance)
"Og" = (
/obj/machinery/atmospherics/pipe/smart/manifold4w/scrubbers/hidden/layer2,
/turf/closed/wall/r_wall,
/area/station/maintenance/starboard/aft)
"Ok" = (
/turf/open/genturf/alternative,
/area/icemoon/underground/unexplored/rivers/deep/shoreline)
"Ox" = (
/obj/machinery/atmospherics/pipe/smart/simple/dark/visible{
	dir = 9
	},
/obj/machinery/meter,
/obj/machinery/button/ignition/incinerator/ordmix{
	pixel_x = 8;
	pixel_y = 32
	},
/obj/machinery/button/door/incinerator_vent_ordmix{
	pixel_x = -8;
	pixel_y = 32
	},
/turf/open/floor/iron/dark,
/area/station/science/ordnance)
"Oz" = (
/obj/structure/stairs/west,
/obj/structure/railing,
/obj/machinery/door/firedoor/border_only,
/turf/open/floor/iron/white,
/area/station/science/ordnance)
"Qv" = (
/obj/effect/decal/cleanable/dirt/dust,
/turf/open/floor/iron/dark/purple/side,
/area/station/science/research/abandoned)
"QE" = (
/obj/effect/decal/cleanable/dirt/dust,
/obj/machinery/destructive_scanner,
/obj/effect/turf_decal/stripes/end,
/turf/open/floor/iron/dark/purple/side{
	dir = 1
	},
/area/station/science/research/abandoned)
"Rb" = (
/obj/structure/frame/machine,
/obj/effect/decal/cleanable/dirt/dust,
/turf/open/floor/iron/dark/purple/side{
	dir = 1
	},
/area/station/science/research/abandoned)
"Rc" = (
/obj/machinery/atmospherics/pipe/smart/manifold4w/supply/hidden/layer4,
/obj/machinery/atmospherics/pipe/smart/manifold4w/scrubbers/hidden/layer2,
/obj/structure/cable,
/turf/open/floor/iron,
/area/station/science/ordnance)
"Rr" = (
/obj/machinery/atmospherics/components/unary/outlet_injector/monitored/ordnance_burn_chamber_input,
/turf/open/floor/engine/vacuum,
/area/station/science/ordnance/burnchamber)
"RG" = (
/obj/machinery/atmospherics/pipe/smart/simple/dark/visible{
	dir = 4
	},
/obj/effect/turf_decal/stripes/line{
	dir = 1
	},
/turf/open/floor/iron,
/area/station/science/ordnance)
"RJ" = (
/obj/effect/decal/cleanable/dirt/dust,
/mob/living/simple_animal/hostile/rat,
/obj/machinery/atmospherics/pipe/smart/manifold4w/supply/hidden/layer4,
/obj/machinery/atmospherics/pipe/smart/manifold4w/scrubbers/hidden/layer2,
/obj/structure/cable,
/turf/open/floor/catwalk_floor/iron_dark,
/area/station/science/research/abandoned)
"RM" = (
/obj/effect/decal/cleanable/dirt/dust,
/obj/machinery/newscaster/directional/south,
/obj/item/trash/energybar,
/turf/open/floor/iron/dark/purple/side,
/area/station/science/research/abandoned)
"Sd" = (
/obj/machinery/atmospherics/pipe/smart/simple/dark/visible{
	dir = 4
	},
/obj/effect/turf_decal/stripes/line{
	dir = 8
	},
/obj/machinery/door/firedoor/heavy,
/obj/machinery/light/directional/north,
/obj/machinery/atmospherics/pipe/smart/manifold4w/supply/hidden/layer4,
/turf/open/floor/iron/dark,
/area/station/science/ordnance)
"Sv" = (
/obj/machinery/atmospherics/components/unary/vent_scrubber/on,
/turf/open/floor/engine/vacuum,
/area/station/science/ordnance/burnchamber)
"SG" = (
/turf/closed/wall/r_wall,
/area/station/science/ordnance)
"Ul" = (
/obj/machinery/atmospherics/pipe/smart/manifold4w/scrubbers/hidden/layer2,
/obj/item/clothing/glasses/welding,
/obj/effect/mob_spawn/corpse/human/charredskeleton,
/turf/open/floor/engine/airless,
/area/station/science/research/abandoned)
"Un" = (
/obj/machinery/shower/directional/west{
	name = "emergency shower"
	},
/obj/effect/decal/cleanable/dirt/dust,
/obj/machinery/atmospherics/components/unary/vent_pump/on/layer4,
/turf/open/floor/iron/dark/purple/side{
	dir = 4
	},
/area/station/science/research/abandoned)
"Ut" = (
/obj/machinery/light/cold/directional/south,
/obj/effect/decal/cleanable/dirt/dust,
/turf/open/floor/iron/dark/purple/side,
/area/station/science/research/abandoned)
"UL" = (
/obj/effect/decal/cleanable/dirt/dust,
/obj/machinery/portable_atmospherics/canister/halon,
/obj/effect/turf_decal/box,
/turf/open/floor/iron/dark/purple/side{
	dir = 8
	},
/area/station/science/research/abandoned)
"Vd" = (
/obj/machinery/door/airlock/external{
	glass = 1;
	name = "Xenobiology External Airlock";
	opacity = 0
	},
/obj/effect/mapping_helpers/airlock/cyclelink_helper_multi{
	cycle_id = Warp_Lab
	},
/obj/effect/mapping_helpers/airlock/access/any/science/maintenance,
/turf/open/floor/plating,
/area/station/science/research/abandoned)
"Vl" = (
/turf/open/floor/iron/white,
/area/station/science/ordnance)
"Vp" = (
/obj/effect/decal/cleanable/dirt/dust,
/obj/structure/trash_pile,
/turf/open/floor/iron/dark,
/area/station/science/research/abandoned)
"Vw" = (
/obj/structure/stairs/east,
/turf/open/floor/iron/white,
/area/station/science/ordnance)
"VE" = (
/obj/structure/sign/warning/fire/directional/east,
/turf/open/misc/asteroid/snow/icemoon,
/area/icemoon/underground/explored)
"VK" = (
/obj/machinery/atmospherics/pipe/smart/simple/scrubbers/visible,
/turf/closed/wall/r_wall,
/area/station/science/ordnance/burnchamber)
"VL" = (
/turf/open/floor/iron/dark/purple/side{
	dir = 9
	},
/area/station/science/research/abandoned)
"VZ" = (
/turf/closed/wall/r_wall,
/area/station/science/ordnance/burnchamber)
"Wj" = (
/obj/structure/table/reinforced/rglass,
/obj/effect/decal/cleanable/dirt/dust,
/obj/item/storage/box/gorillacubes,
/obj/item/analyzer/ranged,
/turf/open/floor/iron/dark/purple/side{
	dir = 5
	},
/area/station/science/research/abandoned)
"Wt" = (
/turf/closed/wall/r_wall,
/area/station/maintenance/starboard/aft)
"WK" = (
/obj/machinery/atmospherics/pipe/smart/manifold4w/scrubbers/hidden/layer2,
/obj/machinery/atmospherics/pipe/smart/manifold4w/supply/hidden/layer4,
/obj/machinery/door/firedoor/heavy,
/turf/open/floor/iron/dark/purple,
/area/station/science/research/abandoned)
"Xi" = (
/obj/effect/decal/cleanable/dirt/dust,
/obj/machinery/atmospherics/components/unary/vent_scrubber/on/layer2,
/turf/open/floor/iron/dark,
/area/station/science/research/abandoned)
"YW" = (
/obj/machinery/atmospherics/components/trinary/mixer{
	dir = 4
	},
/obj/effect/turf_decal/delivery,
/turf/open/floor/iron,
/area/station/science/ordnance)
"Zo" = (
/obj/structure/chair/office{
	dir = 1
	},
/obj/effect/decal/cleanable/dirt/dust,
/obj/machinery/requests_console/directional/south,
/turf/open/floor/iron/dark/purple/side,
/area/station/science/research/abandoned)
"Zq" = (
/obj/effect/spawner/structure/window/reinforced,
/turf/open/floor/plating,
/area/station/science/ordnance)
"ZJ" = (
/turf/open/floor/plating,
/area/station/maintenance/starboard/aft)

(1,1,1) = {"
DZ
DZ
DZ
DZ
DZ
DZ
DZ
Gc
Gc
DZ
bf
bf
VE
bf
bf
bf
bf
Zq
sj
ps
YW
uj
"}
(2,1,1) = {"
DZ
VL
iF
nH
id
mc
wl
UL
AJ
DZ
bf
bf
SG
SG
SG
SG
SG
SG
tR
AF
YW
uj
"}
(3,1,1) = {"
DZ
Rb
Vp
wJ
wJ
Ig
wJ
wJ
Qv
DZ
bf
bf
SG
uW
uW
uW
uW
Oz
NZ
yi
ef
JU
"}
(4,1,1) = {"
DZ
Rb
Ig
Xi
bz
Bq
Iz
wJ
Qv
DZ
in
in
DZ
ku
Vl
Vl
Vl
qq
pE
LI
LI
Rc
"}
(5,1,1) = {"
DZ
QE
Fe
Un
IK
DD
Dl
RJ
JR
cc
GS
GS
cZ
ia
ia
FY
ia
em
FL
Rc
MI
ur
"}
(6,1,1) = {"
DZ
lj
Ut
DZ
cv
DZ
Dl
qx
rr
DZ
Vd
in
DZ
Nd
Vl
Vl
Vl
qq
RG
jG
LI
jG
"}
(7,1,1) = {"
DZ
Wj
Fb
DZ
WK
DZ
bG
Bq
Qv
DZ
bf
bf
SG
Vw
Vw
Vw
Vw
Fl
RG
jG
jG
jG
"}
(8,1,1) = {"
DZ
nI
bD
DZ
kJ
DZ
KG
sR
vs
DZ
Ii
la
VZ
VZ
VZ
VZ
FK
FK
Sd
Ak
GC
GC
"}
(9,1,1) = {"
DZ
Lk
tz
sx
sN
DZ
pK
wJ
xZ
DZ
bf
bf
Cm
jV
Rr
cU
AN
cU
Ox
EG
qj
wS
"}
(10,1,1) = {"
DZ
Eu
kN
yo
pa
nI
qP
bK
RM
DZ
bf
bf
Cm
Im
xX
yc
my
Nb
wS
wS
iq
wS
"}
(11,1,1) = {"
DZ
sx
kd
qz
Ul
nI
LB
ak
Zo
DZ
bf
bf
Cm
jV
Sv
VK
gp
VK
sy
wS
Dz
kZ
"}
(12,1,1) = {"
DZ
sx
sx
sx
sZ
DZ
eE
tw
vf
DZ
gA
bf
Wt
Wt
Wt
Wt
Og
Wt
Wt
Hb
Wt
SG
"}
(13,1,1) = {"
DZ
DZ
DZ
DZ
DZ
DZ
DZ
DZ
DZ
DZ
he
he
he
rC
ZJ
ZJ
ZJ
ZJ
wd
jE
he
Ok
"}
