//MAP CONVERTED BY dmm2tgm.py THIS HEADER COMMENT PREVENTS RECONVERSION, DO NOT REMOVE
"a" = (
/turf/template_noop,
/area/template_noop)
"c" = (
/obj/structure/table/reinforced,
/turf/open/floor/iron/dark/blue/side{
	dir = 5
	},
/area/shuttle/supply)
"d" = (
/obj/machinery/light/directional/west,
/turf/open/floor/mineral/titanium/blue,
/area/shuttle/supply)
"e" = (
/obj/machinery/light/directional/west,
/obj/machinery/computer/cargo_shuttle_console,
/turf/open/floor/iron/dark/blue/side{
	dir = 9
	},
/area/shuttle/supply)
"f" = (
/obj/machinery/light/directional/north,
/turf/open/floor/mineral/titanium/blue,
/area/shuttle/supply)
"h" = (
/obj/structure/chair/comfy/shuttle{
	dir = 1
	},
/turf/open/floor/iron/dark/blue/side{
	dir = 6
	},
/area/shuttle/supply)
"i" = (
/obj/structure/shuttle/engine/propulsion/burst/right,
/turf/open/floor/plating/airless,
/area/shuttle/supply)
"l" = (
/obj/structure/window/reinforced{
	dir = 1
	},
/obj/structure/shuttle/engine/heater,
/turf/open/floor/plating/airless,
/area/shuttle/supply)
"m" = (
/obj/effect/spawner/structure/window/shuttle,
/turf/open/floor/plating,
/area/shuttle/supply)
"q" = (
/turf/closed/wall/mineral/titanium,
/area/shuttle/supply)
"r" = (
/obj/machinery/button/door/directional/east{
	id = "QMLoaddoor2";
	name = "Loading Doors";
	pixel_y = 8
	},
/obj/machinery/button/door/directional/east{
	id = "QMLoaddoor";
	name = "Loading Doors";
	pixel_y = -8
	},
/obj/machinery/light/directional/east,
/turf/open/floor/mineral/titanium/blue,
/area/shuttle/supply)
"t" = (
/obj/structure/shuttle/engine/propulsion,
/turf/open/floor/plating/airless,
/area/shuttle/supply)
"u" = (
/turf/open/floor/mineral/titanium/blue,
/area/shuttle/supply)
"w" = (
/obj/machinery/door/airlock/titanium{
	name = "Supply Shuttle Airlock";
	req_access_txt = "31"
	},
/obj/docking_port/mobile/supply,
/turf/open/floor/plating,
/area/shuttle/supply)
"z" = (
/obj/structure/shuttle/engine/propulsion/burst/left,
/turf/open/floor/plating/airless,
/area/shuttle/supply)
"C" = (
/obj/machinery/door/airlock/grunge{
	name = "cockpit";
	req_access_txt = "101"
	},
/turf/open/floor/mineral/titanium/blue,
/area/shuttle/supply)
"G" = (
/obj/machinery/door/airlock/titanium{
	name = "Supply Shuttle Airlock";
	req_access_txt = "31"
	},
/turf/open/floor/plating,
/area/shuttle/supply)
"K" = (
/obj/structure/chair/comfy/shuttle{
	dir = 1
	},
/obj/structure/closet/emcloset/wall{
	pixel_x = -28
	},
/turf/open/floor/iron/dark/blue/side{
	dir = 10
	},
/area/shuttle/supply)
"S" = (
/obj/machinery/conveyor{
	dir = 8;
	id = "QMLoad"
	},
/obj/machinery/door/poddoor{
	id = "QMLoaddoor";
	name = "supply dock loading door"
	},
/turf/open/floor/plating,
/area/shuttle/supply)
"T" = (
/turf/closed/wall/mineral/titanium/interior,
/area/shuttle/supply)
"U" = (
/obj/machinery/conveyor{
	dir = 4;
	id = "QMLoad2"
	},
/obj/machinery/door/poddoor{
	id = "QMLoaddoor2";
	name = "supply dock loading door"
	},
/turf/open/floor/plating,
/area/shuttle/supply)

(1,1,1) = {"
q
q
q
q
q
q
q
q
q
q
q
a
"}
(2,1,1) = {"
m
e
K
q
u
d
u
u
u
T
q
z
"}
(3,1,1) = {"
m
c
h
q
u
u
u
u
u
u
l
t
"}
(4,1,1) = {"
q
q
C
q
u
u
u
u
u
u
l
t
"}
(5,1,1) = {"
a
q
f
u
u
u
u
u
u
u
l
t
"}
(6,1,1) = {"
a
q
u
u
u
r
u
u
u
T
q
i
"}
(7,1,1) = {"
a
q
q
U
G
q
w
S
q
q
q
a
"}
