//MAP CONVERTED BY dmm2tgm.py THIS HEADER COMMENT PREVENTS RECONVERSION, DO NOT REMOVE
"a" = (
/turf/open/floor/plating,
/area/shuttle/platform)
"i" = (
/obj/docking_port/mobile{
	dir = 2;
	dwidth = 8;
	height = 15;
	id = "platform_large";
	launch_status = 0;
	name = "Platform Shuttle";
	port_direction = 8;
	preferred_direction = 4;
	width = 23
	},
/turf/open/floor/plating,
/area/shuttle/platform)
"k" = (
/obj/structure/closet/crate/large/air_can,
/turf/open/floor/plating,
/area/shuttle/platform)
"p" = (
/obj/structure/lattice,
/turf/template_noop,
/area/shuttle/platform)
"q" = (
/turf/template_noop,
/area/template_noop)
"D" = (
/obj/structure/closet/crate/build_your_shuttle,
/turf/open/floor/plating,
/area/shuttle/platform)
"S" = (
/obj/structure/closet/crate/build_your_shuttle_extra,
/turf/open/floor/plating,
/area/shuttle/platform)

(1,1,1) = {"
a
a
a
a
a
a
a
a
a
a
a
a
a
a
a
"}
(2,1,1) = {"
p
p
p
p
p
p
a
a
a
p
p
p
p
p
p
"}
(3,1,1) = {"
p
p
p
p
p
p
a
a
a
p
p
p
p
p
p
"}
(4,1,1) = {"
p
p
p
p
p
p
a
a
a
p
p
p
p
p
p
"}
(5,1,1) = {"
p
p
p
p
p
p
a
a
a
p
p
p
p
p
p
"}
(6,1,1) = {"
p
p
p
p
p
p
a
a
a
p
p
p
p
p
p
"}
(7,1,1) = {"
p
p
p
p
p
p
a
a
a
p
p
p
p
p
p
"}
(8,1,1) = {"
p
p
p
p
p
p
a
a
a
p
p
p
p
p
p
"}
(9,1,1) = {"
p
p
p
p
p
p
a
a
a
p
p
p
p
p
p
"}
(10,1,1) = {"
p
p
p
p
p
p
a
k
a
p
p
p
p
p
p
"}
(11,1,1) = {"
p
p
p
p
p
p
a
k
a
p
p
p
p
p
p
"}
(12,1,1) = {"
p
p
p
p
p
p
a
k
a
p
p
p
p
p
p
"}
(13,1,1) = {"
p
p
p
p
p
p
a
k
a
p
p
p
p
p
p
"}
(14,1,1) = {"
a
a
a
a
a
a
a
S
a
a
a
a
a
a
a
"}
(15,1,1) = {"
i
a
a
a
a
a
a
S
a
a
a
a
a
a
a
"}
(16,1,1) = {"
a
a
a
a
a
a
a
S
a
a
a
a
a
a
a
"}
(17,1,1) = {"
p
p
p
p
p
p
a
S
a
p
p
p
p
p
p
"}
(18,1,1) = {"
p
p
p
p
p
p
a
D
a
p
p
p
p
p
p
"}
(19,1,1) = {"
p
p
p
p
p
p
a
a
a
p
p
p
p
p
p
"}
(20,1,1) = {"
p
p
p
p
p
p
a
a
a
p
p
p
p
p
p
"}
(21,1,1) = {"
a
a
a
a
a
a
a
a
a
a
a
a
a
a
a
"}
(22,1,1) = {"
q
a
a
a
a
a
a
a
a
a
a
a
a
a
q
"}
(23,1,1) = {"
q
q
a
a
a
a
a
a
a
a
a
a
a
q
q
"}
