//MAP CONVERTED BY dmm2tgm.py THIS HEADER COMMENT PREVENTS RECONVERSION, DO NOT REMOVE
"aa" = (
/obj/structure/ore_box,
/obj/effect/decal/cleanable/dirt,
/turf/open/floor/iron,
/area/shuttle/vulture)
"ac" = (
/obj/effect/decal/cleanable/dirt,
/obj/structure/cable,
/obj/machinery/power/apc/auto_name/east,
/obj/machinery/atmospherics/components/unary/vent_pump/on{
	dir = 8
	},
/turf/open/floor/pod,
/area/shuttle/vulture/helm)
"am" = (
/obj/effect/decal/cleanable/dirt,
/obj/machinery/atmospherics/components/binary/pump,
/turf/open/floor/plating,
/area/shuttle/vulture)
"ar" = (
/obj/structure/closet/emcloset/anchored,
/turf/open/floor/iron,
/area/shuttle/vulture)
"aL" = (
/obj/machinery/transporter,
/obj/effect/turf_decal/box,
/turf/open/floor/iron,
/area/shuttle/vulture)
"bR" = (
/obj/structure/chair/wood{
	dir = 1
	},
/obj/machinery/atmospherics/components/unary/vent_pump/on{
	dir = 4
	},
/turf/open/floor/carpet,
/area/shuttle/vulture/dorm)
"cQ" = (
/obj/machinery/atmospherics/pipe/smart/manifold4w/supply/hidden,
/turf/open/floor/iron,
/area/shuttle/vulture)
"de" = (
/obj/effect/turf_decal/bot,
/obj/structure/reagent_dispensers/watertank,
/obj/item/reagent_containers/glass/bucket,
/obj/item/mop,
/obj/effect/decal/cleanable/dirt,
/obj/machinery/atmospherics/pipe/smart/manifold4w/scrubbers/hidden,
/turf/open/floor/iron,
/area/shuttle/vulture)
"do" = (
/obj/effect/decal/cleanable/dirt,
/obj/machinery/atmospherics/components/unary/portables_connector/visible,
/obj/machinery/portable_atmospherics/canister,
/turf/open/floor/plating,
/area/shuttle/vulture)
"dE" = (
/obj/effect/decal/cleanable/dirt,
/obj/machinery/door/firedoor,
/obj/machinery/power/terminal,
/obj/structure/cable,
/obj/structure/rack,
/obj/item/stack/sheet/iron/twenty,
/obj/item/stack/sheet/glass{
	amount = 30
	},
/obj/item/flashlight,
/obj/machinery/atmospherics/pipe/smart/manifold4w/supply/hidden,
/obj/effect/turf_decal/stripes/line,
/turf/open/floor/plating,
/area/shuttle/vulture)
"ee" = (
/obj/effect/decal/cleanable/dirt,
/obj/structure/cable,
/obj/machinery/atmospherics/pipe/smart/manifold4w/scrubbers/hidden,
/turf/open/floor/iron,
/area/shuttle/vulture)
"el" = (
/obj/machinery/atmospherics/components/unary/vent_scrubber/on{
	dir = 8
	},
/turf/open/floor/iron,
/area/shuttle/vulture)
"er" = (
/obj/structure/table/wood,
/obj/machinery/light/small/directional/west,
/turf/open/floor/carpet,
/area/shuttle/vulture/dorm)
"eN" = (
/obj/effect/decal/cleanable/dirt,
/obj/structure/cable,
/obj/machinery/atmospherics/pipe/smart/manifold4w/supply/hidden,
/turf/open/floor/pod,
/area/shuttle/vulture/helm)
"ff" = (
/obj/structure/table,
/turf/open/floor/iron,
/area/shuttle/vulture)
"fq" = (
/obj/structure/closet/crate/bin,
/obj/effect/decal/cleanable/dirt,
/obj/structure/cable,
/obj/effect/spawner/lootdrop/away_loot,
/obj/machinery/light/directional/east,
/obj/machinery/atmospherics/pipe/smart/manifold4w/supply/hidden,
/turf/open/floor/iron,
/area/shuttle/vulture)
"fG" = (
/obj/structure/cable,
/obj/machinery/atmospherics/pipe/smart/manifold4w/supply/hidden,
/turf/open/floor/iron,
/area/shuttle/vulture)
"fK" = (
/obj/effect/turf_decal/bot,
/obj/structure/reagent_dispensers/fueltank,
/obj/effect/decal/cleanable/dirt,
/obj/machinery/atmospherics/pipe/smart/manifold4w/orange/visible,
/turf/open/floor/iron,
/area/shuttle/vulture)
"fT" = (
/obj/effect/decal/cleanable/dirt,
/obj/item/storage/bag/ore,
/turf/open/floor/iron,
/area/shuttle/vulture)
"gl" = (
/obj/effect/decal/cleanable/dirt,
/obj/machinery/power/port_gen/pacman{
	anchored = 1
	},
/obj/structure/cable,
/obj/item/stack/sheet/mineral/plasma/five,
/obj/item/stack/sheet/mineral/plasma/five,
/obj/machinery/atmospherics/pipe/smart/manifold4w/supply/hidden,
/turf/open/floor/plating,
/area/shuttle/vulture)
"hl" = (
/obj/effect/turf_decal/bot,
/obj/effect/decal/cleanable/dirt,
/obj/machinery/portable_atmospherics/canister/oxygen,
/obj/machinery/atmospherics/pipe/smart/manifold4w/scrubbers/hidden,
/turf/open/floor/iron,
/area/shuttle/vulture)
"hr" = (
/obj/effect/decal/cleanable/dirt,
/obj/structure/toilet{
	dir = 8
	},
/obj/machinery/atmospherics/components/unary/vent_pump/on{
	dir = 8
	},
/turf/open/floor/iron/freezer,
/area/shuttle/vulture)
"hY" = (
/obj/machinery/door/airlock/external/glass,
/obj/machinery/door/firedoor,
/obj/effect/mapping_helpers/airlock/cyclelink_helper{
	dir = 8
	},
/turf/open/floor/plating,
/area/shuttle/vulture)
"iu" = (
/obj/effect/decal/cleanable/dirt,
/obj/machinery/atmospherics/components/unary/portables_connector/visible{
	dir = 4
	},
/obj/machinery/portable_atmospherics/canister/carbon_dioxide,
/turf/open/floor/iron,
/area/shuttle/vulture)
"iS" = (
/obj/effect/spawner/structure/window/shuttle,
/turf/open/floor/plating,
/area/shuttle/vulture/dorm)
"jB" = (
/obj/machinery/atmospherics/components/unary/engine,
/turf/closed/wall/mineral/titanium,
/area/shuttle/vulture)
"lK" = (
/obj/structure/bed,
/obj/item/bedsheet/dorms,
/obj/machinery/atmospherics/components/unary/vent_scrubber/on{
	dir = 4
	},
/turf/open/floor/carpet,
/area/shuttle/vulture/dorm)
"mg" = (
/obj/machinery/door/airlock/external/glass,
/obj/structure/fans/tiny,
/obj/docking_port/mobile{
	dir = 4;
	dwidth = 7;
	height = 11;
	id = "vulture";
	launch_status = 0;
	name = "MS Vulture";
	port_direction = 8;
	width = 15
	},
/obj/effect/mapping_helpers/airlock/cyclelink_helper{
	dir = 4
	},
/turf/open/floor/plating,
/area/shuttle/vulture)
"mA" = (
/obj/effect/decal/cleanable/dirt,
/obj/item/storage/firstaid/regular,
/obj/structure/table,
/turf/open/floor/pod,
/area/shuttle/vulture/helm)
"mB" = (
/obj/structure/table,
/obj/item/storage/cans/sixsoda,
/obj/structure/cable,
/obj/machinery/atmospherics/pipe/smart/manifold4w/supply/hidden,
/turf/open/floor/iron,
/area/shuttle/vulture)
"nz" = (
/obj/machinery/atmospherics/pipe/smart/manifold4w/scrubbers/hidden,
/turf/closed/wall/mineral/titanium,
/area/shuttle/vulture)
"nC" = (
/turf/closed/wall/mineral/titanium,
/area/shuttle/vulture/helm)
"nF" = (
/obj/structure/cable,
/obj/machinery/atmospherics/pipe/smart/manifold4w/supply/hidden,
/turf/open/floor/carpet,
/area/shuttle/vulture/dorm)
"nJ" = (
/obj/effect/decal/cleanable/dirt,
/obj/machinery/firealarm/directional/west,
/obj/structure/chair/comfy/shuttle{
	dir = 4
	},
/obj/machinery/light/directional/west,
/turf/open/floor/iron,
/area/shuttle/vulture)
"oz" = (
/obj/effect/turf_decal/bot,
/obj/effect/decal/cleanable/dirt,
/obj/machinery/atmospherics/pipe/smart/manifold4w/scrubbers/hidden,
/turf/open/floor/iron,
/area/shuttle/vulture)
"pE" = (
/obj/effect/spawner/lootdrop/maintenance,
/obj/effect/decal/cleanable/dirt,
/obj/structure/mirror/directional/west,
/obj/structure/sink{
	dir = 4;
	pixel_x = -12
	},
/obj/machinery/atmospherics/pipe/smart/manifold4w/supply/hidden,
/turf/open/floor/iron/freezer,
/area/shuttle/vulture)
"pG" = (
/obj/effect/decal/cleanable/dirt,
/obj/machinery/atmospherics/pipe/smart/manifold4w/scrubbers/hidden,
/turf/open/floor/iron,
/area/shuttle/vulture)
"rk" = (
/obj/effect/decal/cleanable/dirt,
/obj/machinery/atmospherics/components/unary/portables_connector/visible,
/obj/machinery/portable_atmospherics/canister/air,
/turf/open/floor/plating,
/area/shuttle/vulture)
"ry" = (
/obj/effect/decal/cleanable/dirt,
/obj/machinery/atmospherics/components/binary/pump{
	dir = 1
	},
/obj/machinery/light/small/directional/west,
/turf/open/floor/plating,
/area/shuttle/vulture)
"rI" = (
/obj/effect/decal/cleanable/dirt,
/obj/structure/cable,
/obj/machinery/atmospherics/pipe/smart/manifold4w/supply/hidden,
/obj/machinery/atmospherics/pipe/smart/manifold4w/scrubbers/hidden,
/turf/open/floor/iron,
/area/shuttle/vulture)
"so" = (
/obj/machinery/door/airlock,
/obj/effect/decal/cleanable/dirt,
/obj/machinery/door/firedoor,
/obj/machinery/atmospherics/pipe/smart/manifold4w/supply/hidden,
/turf/open/floor/iron/freezer,
/area/shuttle/vulture)
"sr" = (
/obj/structure/cable,
/obj/machinery/power/apc/auto_name/east,
/obj/machinery/light_switch/directional/south,
/obj/machinery/atmospherics/pipe/smart/manifold4w/scrubbers/hidden,
/turf/open/floor/carpet,
/area/shuttle/vulture/dorm)
"tS" = (
/obj/structure/cable,
/obj/machinery/atmospherics/pipe/smart/manifold4w/supply/hidden,
/obj/machinery/atmospherics/pipe/smart/manifold4w/scrubbers/hidden,
/turf/open/floor/iron,
/area/shuttle/vulture)
"vF" = (
/obj/structure/table,
/obj/effect/spawner/lootdrop/donkpockets,
/obj/effect/decal/cleanable/dirt,
/turf/open/floor/iron,
/area/shuttle/vulture)
"vS" = (
/obj/effect/decal/cleanable/dirt,
/obj/machinery/computer/shuttle/common_docks,
/turf/open/floor/pod,
/area/shuttle/vulture/helm)
"wA" = (
/obj/structure/chair/stool/bar{
	dir = 8
	},
/turf/open/floor/iron,
/area/shuttle/vulture)
"xG" = (
/obj/structure/shuttle/engine/heater,
/obj/structure/window/reinforced{
	dir = 1
	},
/obj/machinery/atmospherics/pipe/smart/manifold4w/orange/visible,
/turf/open/floor/plating,
/area/shuttle/vulture)
"ze" = (
/obj/effect/turf_decal/bot,
/obj/effect/decal/cleanable/dirt,
/turf/open/floor/iron,
/area/shuttle/vulture)
"zR" = (
/obj/effect/turf_decal/stripes/line{
	dir = 8
	},
/turf/open/floor/plating,
/area/shuttle/vulture)
"AU" = (
/obj/structure/chair/comfy/shuttle{
	dir = 1
	},
/turf/open/floor/pod,
/area/shuttle/vulture/helm)
"Bl" = (
/obj/structure/closet/crate,
/obj/effect/spawner/lootdrop/maintenance,
/obj/effect/decal/cleanable/dirt,
/turf/open/floor/iron,
/area/shuttle/vulture)
"Cu" = (
/obj/machinery/atmospherics/components/unary/vent_pump/on{
	dir = 1
	},
/turf/open/floor/iron,
/area/shuttle/vulture)
"CN" = (
/obj/structure/table,
/obj/machinery/microwave,
/obj/effect/decal/cleanable/dirt,
/turf/open/floor/iron,
/area/shuttle/vulture)
"ES" = (
/obj/structure/closet/crate,
/obj/effect/turf_decal/bot,
/obj/effect/decal/cleanable/dirt,
/turf/open/floor/iron,
/area/shuttle/vulture)
"FD" = (
/obj/structure/closet/crate,
/obj/effect/turf_decal/bot,
/obj/effect/spawner/lootdrop/maintenance/five,
/obj/effect/decal/cleanable/dirt,
/turf/open/floor/iron,
/area/shuttle/vulture)
"Gu" = (
/obj/effect/spawner/lootdrop/maintenance,
/turf/open/floor/iron,
/area/shuttle/vulture)
"GS" = (
/turf/open/floor/iron,
/area/shuttle/vulture)
"HJ" = (
/obj/effect/decal/cleanable/dirt,
/obj/structure/cable,
/obj/machinery/power/smes/engineering{
	charge = 1e+006
	},
/obj/machinery/atmospherics/pipe/smart/manifold4w/supply/hidden,
/turf/open/floor/iron,
/area/shuttle/vulture)
"Jw" = (
/obj/effect/decal/cleanable/dirt,
/obj/machinery/atmospherics/pipe/smart/manifold4w/scrubbers/hidden,
/turf/open/floor/plating,
/area/shuttle/vulture)
"JK" = (
/obj/effect/decal/cleanable/dirt,
/obj/effect/decal/cleanable/blood/old,
/obj/machinery/light/small/directional/west,
/obj/machinery/atmospherics/pipe/smart/manifold4w/scrubbers/hidden,
/turf/open/floor/iron/freezer,
/area/shuttle/vulture)
"KO" = (
/obj/machinery/airalarm/directional/east,
/obj/structure/closet/secure_closet/personal/cabinet,
/turf/open/floor/carpet,
/area/shuttle/vulture/dorm)
"Ld" = (
/obj/machinery/airalarm/directional/west,
/obj/structure/chair/comfy/shuttle{
	dir = 4
	},
/turf/open/floor/iron,
/area/shuttle/vulture)
"Ll" = (
/turf/template_noop,
/area/template_noop)
"Ls" = (
/obj/effect/spawner/structure/window/shuttle,
/obj/machinery/door/poddoor/shutters/preopen{
	id = "vulture_shutter"
	},
/turf/open/floor/plating,
/area/shuttle/vulture)
"LP" = (
/obj/machinery/atmospherics/pipe/smart/manifold4w/scrubbers/hidden,
/turf/closed/wall/mineral/titanium,
/area/shuttle/vulture/dorm)
"Mv" = (
/obj/machinery/atmospherics/pipe/smart/manifold4w/scrubbers/hidden,
/turf/closed/wall/mineral/titanium,
/area/shuttle/vulture/helm)
"MG" = (
/obj/machinery/atmospherics/pipe/smart/manifold4w/scrubbers/hidden,
/turf/open/floor/iron,
/area/shuttle/vulture)
"MT" = (
/obj/machinery/mining_laser{
	dir = 1
	},
/turf/closed/wall/mineral/titanium,
/area/shuttle/vulture)
"Ni" = (
/obj/effect/decal/cleanable/dirt,
/turf/open/floor/iron,
/area/shuttle/vulture)
"ND" = (
/obj/machinery/firealarm/directional/west,
/obj/machinery/light/small/directional/west,
/obj/machinery/atmospherics/components/unary/vent_scrubber/on,
/turf/open/floor/pod,
/area/shuttle/vulture/helm)
"OE" = (
/obj/effect/decal/cleanable/dirt,
/obj/structure/cable,
/obj/machinery/light_switch/directional/south,
/obj/machinery/atmospherics/pipe/smart/manifold4w/supply/hidden,
/obj/machinery/atmospherics/pipe/smart/manifold4w/scrubbers/hidden,
/turf/open/floor/pod,
/area/shuttle/vulture/helm)
"Pa" = (
/obj/item/storage/toolbox/mechanical,
/obj/effect/decal/cleanable/dirt,
/obj/machinery/power/apc/auto_name/west,
/obj/machinery/door/firedoor,
/obj/machinery/atmospherics/pipe/smart/manifold4w/scrubbers/hidden,
/obj/effect/turf_decal/stripes/line,
/turf/open/floor/plating,
/area/shuttle/vulture)
"PI" = (
/obj/structure/closet/firecloset/full,
/obj/machinery/atmospherics/pipe/smart/manifold4w/scrubbers/hidden,
/turf/open/floor/iron,
/area/shuttle/vulture)
"Qq" = (
/turf/closed/wall/mineral/titanium,
/area/shuttle/vulture/dorm)
"Qv" = (
/obj/structure/chair/stool/bar{
	dir = 8
	},
/obj/structure/cable,
/obj/machinery/atmospherics/pipe/smart/manifold4w/supply/hidden,
/turf/open/floor/iron,
/area/shuttle/vulture)
"QF" = (
/obj/structure/rack,
/obj/item/pickaxe,
/obj/item/storage/toolbox/emergency,
/turf/open/floor/plating,
/area/shuttle/vulture)
"Tt" = (
/obj/effect/decal/cleanable/dirt,
/obj/machinery/light_switch/directional/north,
/turf/open/floor/iron,
/area/shuttle/vulture)
"Ul" = (
/turf/closed/wall/mineral/titanium,
/area/shuttle/vulture)
"Ve" = (
/obj/effect/decal/cleanable/dirt,
/obj/machinery/atmospherics/pipe/smart/manifold4w/supply/hidden,
/turf/open/floor/iron,
/area/shuttle/vulture)
"Vg" = (
/obj/machinery/door/airlock,
/obj/structure/cable,
/obj/machinery/door/firedoor,
/obj/machinery/atmospherics/pipe/smart/manifold4w/supply/hidden,
/turf/open/floor/pod,
/area/shuttle/vulture/helm)
"Vu" = (
/obj/structure/closet/crate,
/obj/effect/turf_decal/bot,
/obj/effect/spawner/lootdrop/maintenance/seven,
/obj/effect/decal/cleanable/dirt,
/turf/open/floor/iron,
/area/shuttle/vulture)
"VX" = (
/obj/effect/decal/cleanable/dirt,
/obj/machinery/shower{
	dir = 8
	},
/obj/machinery/atmospherics/components/unary/vent_scrubber/on{
	dir = 8
	},
/turf/open/floor/iron/freezer,
/area/shuttle/vulture)
"Wx" = (
/obj/machinery/door/airlock,
/obj/effect/decal/cleanable/dirt,
/obj/structure/cable,
/obj/machinery/door/firedoor,
/obj/machinery/atmospherics/pipe/smart/manifold4w/supply/hidden,
/turf/open/floor/pod,
/area/shuttle/vulture/dorm)
"WF" = (
/obj/effect/spawner/structure/window/shuttle,
/obj/machinery/door/poddoor/shutters/preopen{
	id = "vulture_shutter"
	},
/turf/open/floor/plating,
/area/shuttle/vulture/helm)
"XG" = (
/obj/effect/spawner/lootdrop/maintenance,
/obj/machinery/atmospherics/pipe/smart/manifold4w/supply/hidden,
/turf/open/floor/iron,
/area/shuttle/vulture)
"XY" = (
/obj/effect/decal/cleanable/dirt,
/obj/structure/table,
/obj/machinery/button/door{
	id = "vulture_shutter";
	name = "safety shutters button"
	},
/turf/open/floor/pod,
/area/shuttle/vulture/helm)
"Yt" = (
/obj/item/storage/toolbox/emergency,
/obj/effect/decal/cleanable/dirt,
/obj/machinery/airalarm/directional/east,
/obj/structure/table,
/obj/machinery/light/small/directional/east,
/turf/open/floor/pod,
/area/shuttle/vulture/helm)

(1,1,1) = {"
Ll
Ll
Qq
Qq
iS
Qq
Qq
mg
Ul
Ul
Ls
Ls
Ls
Ul
Ul
"}
(2,1,1) = {"
MT
Ul
Qq
er
bR
lK
Qq
zR
QF
Ul
Bl
fT
aa
Vu
Ul
"}
(3,1,1) = {"
Ll
Ll
Qq
KO
nF
sr
Qq
hY
Ul
Ul
GS
aL
Ni
FD
Ul
"}
(4,1,1) = {"
Ll
WF
Qq
Qq
Wx
LP
Qq
Tt
Ld
nJ
Gu
GS
iu
Ul
Ul
"}
(5,1,1) = {"
Ll
WF
XY
ND
OE
Mv
PI
pG
cQ
Cu
GS
ze
fK
xG
jB
"}
(6,1,1) = {"
Ll
WF
vS
AU
eN
Vg
fG
rI
tS
MG
MG
oz
de
xG
jB
"}
(7,1,1) = {"
Ll
WF
mA
Yt
ac
nC
ar
MG
mB
ff
el
ES
hl
xG
jB
"}
(8,1,1) = {"
Ll
WF
nC
nC
nC
nC
Ul
ee
Qv
wA
GS
Ul
nz
nz
Ul
"}
(9,1,1) = {"
Ll
Ll
Ul
do
ry
Jw
Pa
MG
fG
XG
Ve
so
pE
JK
Ul
"}
(10,1,1) = {"
MT
Ul
Ul
rk
am
gl
dE
HJ
fq
vF
CN
Ul
hr
VX
Ul
"}
(11,1,1) = {"
Ll
Ll
Ul
Ul
Ul
Ul
Ul
Ul
Ul
Ls
Ul
Ul
Ul
Ul
Ul
"}
