//MAP CONVERTED BY dmm2tgm.py THIS HEADER COMMENT PREVENTS RECONVERSION, DO NOT REMOVE
"cA" = (
/obj/machinery/door/airlock/command/glass{
	name = "Cockpit"
	},
/obj/effect/mapping_helpers/airlock/access/all/command/general,
/turf/open/floor/iron/smooth_large,
/area/shuttle/escape)
"cM" = (
/obj/machinery/vending/wallmed/directional/south,
/turf/open/floor/mineral/titanium/white,
/area/shuttle/escape)
"ef" = (
/turf/open/floor/iron/dark/textured_large,
/area/shuttle/escape)
"ew" = (
/obj/machinery/door/airlock/engineering{
	name = "Shuttle Engineering"
	},
/obj/effect/mapping_helpers/airlock/access/all/engineering,
/turf/open/floor/iron/smooth_large,
/area/shuttle/escape)
"fh" = (
/obj/structure/closet/emcloset,
/turf/open/floor/iron/smooth_large,
/area/shuttle/escape)
"go" = (
/obj/effect/turf_decal/siding/thinplating_new/dark{
	dir = 1
	},
/turf/open/floor/iron/dark/textured_large,
/area/shuttle/escape)
"gZ" = (
/obj/machinery/suit_storage_unit/standard_unit,
/turf/open/floor/iron/smooth_large,
/area/shuttle/escape)
"he" = (
/obj/structure/table,
/obj/item/scalpel{
	pixel_y = 12
	},
/obj/item/circular_saw,
/obj/item/retractor{
	pixel_x = 4
	},
/obj/item/hemostat{
	pixel_x = -4
	},
/obj/item/clothing/gloves/latex,
/obj/item/clothing/mask/surgical,
/obj/item/surgicaldrill,
/obj/item/cautery,
/obj/machinery/light/directional/west{
	dir = 2
	},
/turf/open/floor/mineral/titanium/blue,
/area/shuttle/escape)
"hk" = (
/obj/machinery/door/airlock/external/glass,
/turf/template_noop,
/area/shuttle/escape)
"hJ" = (
/obj/machinery/stasis{
	dir = 1
	},
/obj/machinery/light/directional/west,
/obj/machinery/anesthetic_machine,
/turf/open/floor/mineral/titanium/blue,
/area/shuttle/escape)
"iD" = (
/obj/structure/table,
/obj/item/defibrillator/loaded,
/turf/open/floor/mineral/titanium/blue,
/area/shuttle/escape)
"iY" = (
/obj/machinery/computer/emergency_shuttle{
	dir = 8
	},
/turf/open/floor/iron/smooth_large,
/area/shuttle/escape)
"ji" = (
/turf/open/floor/iron/smooth_large,
/area/shuttle/escape)
"jz" = (
/obj/machinery/computer/operating{
	dir = 1
	},
/turf/open/floor/mineral/titanium/white,
/area/shuttle/escape)
"km" = (
/obj/structure/table/reinforced,
/obj/machinery/button{
	pixel_x = -8;
	pixel_y = 9;
	name = "Power to Shields"
	},
/obj/machinery/button{
	pixel_x = 2;
	pixel_y = 9;
	name = "Power to Weapons"
	},
/obj/machinery/button{
	pixel_x = -8;
	name = "Power to Thrusters"
	},
/turf/open/floor/iron/smooth_large,
/area/shuttle/escape)
"kE" = (
/obj/machinery/stasis{
	dir = 1
	},
/obj/machinery/anesthetic_machine,
/turf/open/floor/mineral/titanium/blue,
/area/shuttle/escape)
"kR" = (
/obj/structure/chair/comfy/shuttle{
	dir = 1
	},
/turf/open/floor/mineral/plastitanium/red,
/area/shuttle/escape/brig)
"lD" = (
/obj/structure/chair/comfy/shuttle{
	dir = 4
	},
/turf/open/floor/iron/dark/textured_large,
/area/shuttle/escape)
"nv" = (
/obj/structure/chair/comfy/shuttle,
/turf/open/floor/mineral/plastitanium/red,
/area/shuttle/escape/brig)
"oH" = (
/obj/machinery/power/shuttle_engine/heater{
	dir = 8
	},
/obj/structure/window/reinforced/plasma/spawner/directional/east,
/turf/open/floor/plating/airless,
/area/shuttle/escape)
"oW" = (
/obj/structure/closet/crate/freezer/blood,
/turf/open/floor/mineral/titanium/blue,
/area/shuttle/escape)
"py" = (
/obj/effect/turf_decal/siding/thinplating_new/dark,
/obj/machinery/suit_storage_unit/standard_unit,
/turf/open/floor/iron/dark/textured_large,
/area/shuttle/escape)
"re" = (
/obj/effect/turf_decal/siding/thinplating_new/dark,
/turf/open/floor/iron/dark/textured_large,
/area/shuttle/escape)
"rW" = (
/obj/structure/chair/comfy/shuttle{
	dir = 4
	},
/obj/effect/turf_decal/siding/thinplating_new/dark{
	dir = 1
	},
/turf/open/floor/iron/dark/textured_large,
/area/shuttle/escape)
"sg" = (
/obj/effect/turf_decal/stripes{
	dir = 4
	},
/obj/effect/turf_decal/stripes{
	dir = 8
	},
/turf/open/floor/iron/smooth_large,
/area/shuttle/escape)
"sl" = (
/obj/structure/chair/comfy/shuttle,
/turf/open/floor/iron/dark/textured_large,
/area/shuttle/escape/brig)
"sz" = (
/obj/machinery/door/airlock/medical/glass,
/obj/effect/turf_decal/stripes{
	dir = 4
	},
/obj/effect/turf_decal/stripes{
	dir = 8
	},
/turf/open/floor/iron/smooth_large,
/area/shuttle/escape)
"tY" = (
/obj/machinery/power/shuttle_engine/propulsion{
	dir = 8
	},
/turf/template_noop,
/area/shuttle/escape)
"vf" = (
/obj/machinery/door/airlock,
/turf/open/floor/iron/dark/textured_large,
/area/shuttle/escape)
"vG" = (
/obj/structure/chair/comfy/shuttle{
	dir = 8
	},
/obj/effect/turf_decal/siding/thinplating_new/dark{
	dir = 8
	},
/turf/open/floor/iron/dark/textured_large,
/area/shuttle/escape)
"wH" = (
/obj/machinery/shower/directional/north,
/obj/effect/turf_decal/delivery,
/turf/open/floor/mineral/titanium/blue,
/area/shuttle/escape)
"wO" = (
/obj/machinery/computer/communications{
	dir = 8
	},
/turf/open/floor/iron/smooth_large,
/area/shuttle/escape)
"wZ" = (
/turf/open/floor/mineral/plastitanium/red,
/area/shuttle/escape/brig)
"xl" = (
/obj/structure/chair/comfy/shuttle{
	dir = 4
	},
/obj/effect/turf_decal/siding/thinplating_new/dark{
	dir = 4
	},
/turf/open/floor/iron/dark/textured_large,
/area/shuttle/escape)
"xA" = (
/obj/machinery/door/airlock/security/glass{
	name = "Holding Area"
	},
/obj/effect/mapping_helpers/airlock/access/all/security/general,
/turf/open/floor/iron/dark/textured_large,
/area/shuttle/escape/brig)
"xR" = (
/obj/structure/chair/comfy/shuttle{
	dir = 8
	},
/turf/open/floor/iron/dark/textured_large,
/area/shuttle/escape)
"yb" = (
/obj/effect/turf_decal/siding/thinplating_new/dark,
/obj/effect/turf_decal/stripes/end,
/turf/open/floor/iron/smooth_large,
/area/shuttle/escape)
"yf" = (
/obj/structure/toilet,
/turf/open/floor/iron/dark/textured_large,
/area/shuttle/escape)
"yI" = (
/obj/structure/sink/directional/west,
/turf/open/floor/iron/dark/textured_large,
/area/shuttle/escape)
"zg" = (
/obj/effect/spawner/structure/window/reinforced/shuttle,
/turf/open/floor/plating,
/area/shuttle/escape)
"zv" = (
/obj/machinery/computer/station_alert{
	dir = 8
	},
/turf/open/floor/iron/smooth_large,
/area/shuttle/escape)
"Bw" = (
/obj/effect/turf_decal/siding/thinplating_new/dark,
/obj/structure/chair/comfy/shuttle,
/turf/open/floor/iron/dark/textured_large,
/area/shuttle/escape)
"CQ" = (
/obj/structure/chair/comfy/shuttle{
	dir = 4
	},
/obj/effect/turf_decal/siding/thinplating_new/dark{
	dir = 5
	},
/turf/open/floor/iron/dark/textured_large,
/area/shuttle/escape)
"CW" = (
/obj/structure/chair/comfy/shuttle,
/turf/open/floor/iron/dark/textured_large,
/area/shuttle/escape)
"Da" = (
/obj/machinery/door/airlock/external/glass,
/obj/docking_port/mobile/emergency{
	dir = 2;
	name = "Flandstation emergency shuttle"
	},
/turf/open/floor/iron/smooth_large,
/area/shuttle/escape)
"DQ" = (
/obj/effect/turf_decal/siding/thinplating_new/dark{
	dir = 1
	},
/obj/machinery/suit_storage_unit/standard_unit,
/turf/open/floor/iron/dark/textured_large,
/area/shuttle/escape)
"DZ" = (
/obj/structure/chair/comfy/shuttle{
	dir = 8
	},
/obj/effect/turf_decal/siding/thinplating_new/dark{
	dir = 1
	},
/turf/open/floor/iron/dark/textured_large,
/area/shuttle/escape)
"Ee" = (
/obj/structure/table/optable,
/obj/machinery/anesthetic_machine,
/turf/open/floor/mineral/titanium/white,
/area/shuttle/escape)
"ED" = (
/obj/effect/turf_decal/siding/thinplating_new/dark{
	dir = 1
	},
/obj/effect/turf_decal/stripes/end{
	dir = 1
	},
/turf/open/floor/iron/smooth_large,
/area/shuttle/escape)
"EK" = (
/obj/structure/closet/toolcloset,
/turf/open/floor/iron/smooth_large,
/area/shuttle/escape)
"FJ" = (
/obj/machinery/computer/security{
	dir = 8
	},
/turf/open/floor/iron/smooth_large,
/area/shuttle/escape)
"FS" = (
/turf/open/floor/mineral/titanium/blue,
/area/shuttle/escape)
"FW" = (
/obj/machinery/door/airlock/command,
/obj/effect/mapping_helpers/airlock/access/all/command/general,
/turf/open/floor/iron/smooth_large,
/area/shuttle/escape)
"Iu" = (
/turf/template_noop,
/area/template_noop)
"IE" = (
/obj/structure/chair/comfy/shuttle{
	dir = 8
	},
/obj/effect/turf_decal/siding/thinplating_new/dark{
	dir = 9
	},
/turf/open/floor/iron/dark/textured_large,
/area/shuttle/escape)
"MS" = (
/obj/structure/chair/comfy/shuttle{
	dir = 4
	},
/obj/effect/turf_decal/siding/thinplating_new/dark,
/turf/open/floor/iron/dark/textured_large,
/area/shuttle/escape)
"Pw" = (
/obj/structure/chair/comfy/shuttle,
/obj/effect/turf_decal/siding/thinplating_new/dark{
	dir = 8
	},
/turf/open/floor/iron/dark/textured_large,
/area/shuttle/escape)
"PV" = (
/obj/structure/tank_dispenser/oxygen,
/turf/open/floor/iron/smooth_large,
/area/shuttle/escape)
"RX" = (
/obj/machinery/computer/crew{
	dir = 8
	},
/turf/open/floor/iron/smooth_large,
/area/shuttle/escape)
"Se" = (
/turf/open/floor/iron/dark/textured_large,
/area/shuttle/escape/brig)
"Sp" = (
/obj/effect/turf_decal/stripes{
	dir = 8
	},
/obj/effect/turf_decal/stripes{
	dir = 4
	},
/turf/open/floor/iron/smooth_large,
/area/shuttle/escape)
"SN" = (
/obj/structure/chair/comfy/shuttle{
	dir = 4
	},
/turf/open/floor/iron/smooth_large,
/area/shuttle/escape)
"ST" = (
/obj/structure/chair/comfy/shuttle{
	dir = 8
	},
/obj/effect/turf_decal/siding/thinplating_new/dark{
	dir = 10
	},
/turf/open/floor/iron/dark/textured_large,
/area/shuttle/escape)
"SY" = (
/obj/effect/spawner/structure/window/reinforced/shuttle,
/obj/structure/window/reinforced/plasma/spawner/directional/east,
/turf/open/floor/plating,
/area/shuttle/escape)
"TG" = (
/turf/open/floor/catwalk_floor/iron_smooth,
/area/shuttle/escape)
"TU" = (
/obj/effect/turf_decal/siding/thinplating_new/dark{
	dir = 8
	},
/turf/open/floor/iron/dark/textured_large,
/area/shuttle/escape)
"Ur" = (
/obj/structure/chair/comfy/shuttle{
	dir = 4
	},
/obj/effect/turf_decal/siding/thinplating_new/dark{
	dir = 6
	},
/turf/open/floor/iron/dark/textured_large,
/area/shuttle/escape)
"UH" = (
/turf/closed/wall/mineral/titanium,
/area/shuttle/escape)
"Vt" = (
/obj/structure/chair/comfy/shuttle{
	dir = 1
	},
/turf/open/floor/iron/dark/textured_large,
/area/shuttle/escape/brig)
"VT" = (
/obj/effect/mapping_helpers/airlock/access/all/security/general,
/obj/machinery/door/airlock/security/glass{
	name = "Holding Area"
	},
/turf/open/floor/iron/smooth_large,
/area/shuttle/escape/brig)
"VW" = (
/obj/structure/chair/comfy/shuttle{
	dir = 8
	},
/obj/effect/turf_decal/siding/thinplating_new/dark,
/turf/open/floor/iron/dark/textured_large,
/area/shuttle/escape)
"Xa" = (
/obj/structure/table/reinforced,
/obj/machinery/button{
	pixel_x = -8;
	pixel_y = 9;
	name = "Raise Shields"
	},
/obj/machinery/button/curtain{
	pixel_x = 2;
	pixel_y = 9;
	name = "Fire Torpedos"
	},
/obj/machinery/button{
	pixel_x = -8;
	name = "Initiate landing procedures"
	},
/obj/machinery/button{
	pixel_x = 2;
	name = "Open communications"
	},
/obj/machinery/button/curtain{
	pixel_x = 12;
	pixel_y = 9;
	name = "Engage Turrets"
	},
/obj/machinery/button{
	pixel_x = 12;
	name = "Initiate Auto-pilot"
	},
/turf/open/floor/iron/smooth_large,
/area/shuttle/escape)
"XV" = (
/obj/machinery/door/airlock/external/glass,
/turf/open/floor/iron/smooth_large,
/area/shuttle/escape)
"Ys" = (
/obj/effect/turf_decal/stripes{
	dir = 4
	},
/obj/effect/turf_decal/stripes{
	dir = 8
	},
/obj/machinery/door/airlock,
/turf/open/floor/iron/smooth_large,
/area/shuttle/escape)
"YN" = (
/obj/effect/turf_decal/siding/thinplating_new/dark{
	dir = 1
	},
/obj/structure/chair/comfy/shuttle{
	dir = 1
	},
/turf/open/floor/iron/dark/textured_large,
/area/shuttle/escape)
"Zq" = (
/turf/open/floor/mineral/titanium/white,
/area/shuttle/escape)
"Zt" = (
/obj/machinery/power/shuttle_engine/propulsion{
	dir = 8
	},
/turf/open/floor/plating/airless,
/area/shuttle/escape)
"ZI" = (
/obj/machinery/door/airlock/medical/glass,
/obj/effect/mapping_helpers/airlock/access/all/medical,
/turf/open/floor/mineral/titanium/white,
/area/shuttle/escape)

(1,1,1) = {"
Iu
Iu
Iu
Zt
UH
Zt
UH
Zt
UH
Zt
Iu
Iu
Iu
"}
(2,1,1) = {"
Iu
Iu
tY
oH
UH
oH
UH
oH
UH
oH
Zt
Iu
Iu
"}
(3,1,1) = {"
Iu
Iu
oH
UH
UH
UH
UH
UH
UH
UH
oH
Iu
Iu
"}
(4,1,1) = {"
Iu
Iu
UH
UH
fh
EK
TG
gZ
PV
UH
UH
Iu
Iu
"}
(5,1,1) = {"
Iu
Iu
zg
ef
ef
ef
TG
ef
lD
lD
zg
Iu
Iu
"}
(6,1,1) = {"
Iu
Zt
SY
ji
ji
ji
TG
ji
ji
ji
zg
Zt
Iu
"}
(7,1,1) = {"
Iu
oH
UH
ef
xR
xR
TG
xR
xR
xR
UH
oH
Iu
"}
(8,1,1) = {"
UH
UH
UH
ew
UH
UH
UH
UH
UH
UH
UH
UH
UH
"}
(9,1,1) = {"
UH
ji
ji
ji
zg
sl
Se
Vt
UH
iD
hJ
kE
UH
"}
(10,1,1) = {"
UH
ji
ji
ji
VT
Se
Se
Vt
UH
Zq
Zq
Zq
UH
"}
(11,1,1) = {"
UH
ji
ji
UH
UH
zg
xA
zg
UH
Zq
Zq
jz
UH
"}
(12,1,1) = {"
hk
ji
ji
zg
nv
wZ
wZ
kR
UH
Zq
Zq
Ee
UH
"}
(13,1,1) = {"
zg
ji
ji
zg
nv
wZ
wZ
kR
UH
oW
Zq
he
UH
"}
(14,1,1) = {"
hk
ji
ji
UH
UH
UH
zg
UH
UH
UH
ZI
UH
UH
"}
(15,1,1) = {"
UH
ji
ji
UH
lD
MS
ji
rW
lD
UH
Zq
wH
UH
"}
(16,1,1) = {"
zg
ji
ji
UH
ef
re
ji
go
ef
UH
Zq
cM
UH
"}
(17,1,1) = {"
zg
ji
ji
zg
xR
VW
TG
DZ
xR
zg
Zq
Zq
zg
"}
(18,1,1) = {"
zg
ji
ji
zg
xl
Ur
TG
CQ
xl
zg
Zq
Zq
zg
"}
(19,1,1) = {"
UH
ji
ji
Ys
sg
yb
TG
ED
Sp
sz
Zq
Zq
UH
"}
(20,1,1) = {"
Da
ji
ji
zg
vG
ST
TG
IE
vG
UH
FS
FS
UH
"}
(21,1,1) = {"
zg
ji
ji
zg
lD
MS
TG
rW
lD
zg
Pw
TU
zg
"}
(22,1,1) = {"
XV
ji
ji
zg
ef
re
ji
go
ef
zg
CW
ef
zg
"}
(23,1,1) = {"
UH
UH
vf
UH
xR
VW
ji
DZ
xR
UH
CW
ef
UH
"}
(24,1,1) = {"
UH
yf
yI
UH
UH
UH
FW
UH
UH
UH
CW
ef
UH
"}
(25,1,1) = {"
UH
UH
UH
UH
UH
py
TG
DQ
UH
UH
zg
zg
UH
"}
(26,1,1) = {"
Iu
Iu
Iu
Iu
UH
Bw
TG
YN
UH
Iu
Iu
Iu
Iu
"}
(27,1,1) = {"
Iu
Iu
Iu
Iu
UH
re
TG
go
UH
Iu
Iu
Iu
Iu
"}
(28,1,1) = {"
Iu
Iu
Iu
Iu
UH
re
TG
go
UH
Iu
Iu
Iu
Iu
"}
(29,1,1) = {"
Iu
Iu
Iu
UH
UH
cA
UH
cA
UH
UH
Iu
Iu
Iu
"}
(30,1,1) = {"
Iu
Iu
Iu
zg
SN
ji
SN
ji
SN
zg
Iu
Iu
Iu
"}
(31,1,1) = {"
Iu
Iu
Iu
zg
RX
ji
zv
ji
FJ
zg
Iu
Iu
Iu
"}
(32,1,1) = {"
Iu
Iu
Iu
UH
UH
SN
km
SN
UH
UH
Iu
Iu
Iu
"}
(33,1,1) = {"
Iu
Iu
Iu
Iu
zg
iY
Xa
wO
zg
Iu
Iu
Iu
Iu
"}
(34,1,1) = {"
Iu
Iu
Iu
Iu
zg
zg
zg
zg
zg
Iu
Iu
Iu
Iu
"}
