//MAP CONVERTED BY dmm2tgm.py THIS HEADER COMMENT PREVENTS RECONVERSION, DO NOT REMOVE
"aF" = (
/obj/machinery/space_heater,
/turf/open/floor/plating,
/area/space)
"by" = (
/obj/structure/chair/comfy/shuttle{
	dir = 1
	},
/turf/open/floor/pod,
/area/space)
"bB" = (
/obj/structure/shuttle/engine/propulsion{
	dir = 8
	},
/turf/open/space/basic,
/area/space)
"cm" = (
/obj/structure/table/reinforced,
/obj/machinery/atmospherics/pipe/smart/manifold4w/supply/hidden,
/turf/open/floor/pod,
/area/space)
"cq" = (
/obj/structure/closet/secure_closet/freezer/fridge{
	req_access = null
	},
/turf/open/floor/iron/shuttle/ferry,
/area/space)
"cx" = (
/obj/structure/table/reinforced,
/obj/item/modular_computer/laptop,
/turf/open/floor/pod,
/area/space)
"dh" = (
/obj/structure/table/reinforced,
/obj/item/pickaxe/drill,
/obj/item/pickaxe/drill{
	pixel_y = 8
	},
/turf/open/floor/iron/shuttle/ferry,
/area/space)
"dn" = (
/obj/machinery/oven,
/obj/item/plate/oven_tray,
/obj/item/plate/oven_tray,
/turf/open/floor/pod,
/area/space)
"dH" = (
/obj/machinery/atmospherics/pipe/smart/manifold4w/supply/hidden,
/turf/open/floor/plating,
/area/space)
"eJ" = (
/obj/structure/cable,
/obj/machinery/shuttle_manipulator{
	desc = "A holographic display of the cruise shuttle we're on right now.";
	layer = 2.7;
	max_integrity = 99999;
	name = "shuttle holographic display"
	},
/turf/open/floor/pod,
/area/space)
"eO" = (
/obj/structure/closet/firecloset/wall{
	pixel_y = -30
	},
/obj/structure/table/reinforced,
/turf/open/floor/pod,
/area/space)
"eT" = (
/obj/machinery/shower{
	pixel_y = 15
	},
/obj/structure/drain,
/obj/machinery/door/window,
/obj/structure/window/reinforced/tinted{
	dir = 4;
	pixel_x = 2
	},
/obj/structure/window/reinforced/tinted{
	dir = 8
	},
/turf/open/floor/pod,
/area/space)
"fQ" = (
/obj/structure/cable,
/obj/machinery/power/apc/unlocked{
	pixel_x = 25
	},
/turf/open/floor/plating,
/area/space)
"ge" = (
/obj/structure/table/reinforced,
/obj/structure/closet/crate,
/obj/item/stack/sheet/rglass{
	amount = 30;
	pixel_x = 2;
	pixel_y = -2
	},
/obj/item/stack/rods/fifty,
/obj/item/stack/sheet/cloth/ten,
/obj/item/stack/sheet/iron/twenty,
/obj/item/stack/sheet/glass{
	amount = 30
	},
/obj/item/stack/sheet/plastic/five,
/turf/open/floor/iron/shuttle/ferry,
/area/space)
"gx" = (
/obj/machinery/door/airlock/external,
/obj/structure/fans/tiny/forcefield,
/turf/open/floor/plating,
/area/space)
"gA" = (
/obj/structure/table/reinforced,
/obj/item/paper,
/obj/item/paper{
	pixel_x = 4;
	pixel_y = 2
	},
/obj/item/pen,
/turf/open/floor/iron/shuttle/ferry,
/area/space)
"hf" = (
/turf/open/floor/plating,
/area/space)
"hz" = (
/obj/structure/table/reinforced,
/obj/item/pipe_dispenser{
	pixel_x = -3;
	pixel_y = -6
	},
/turf/open/floor/iron/shuttle/ferry,
/area/space)
"in" = (
/obj/structure/table/reinforced,
/obj/machinery/microwave,
/turf/open/floor/pod,
/area/space)
"ka" = (
/turf/closed/wall/mineral/titanium,
/area/space)
"ks" = (
/obj/structure/table/reinforced,
/obj/machinery/computer/med_data/laptop,
/turf/open/floor/pod,
/area/space)
"ku" = (
/obj/machinery/atmospherics/components/unary/vent_pump/on,
/turf/open/floor/iron/shuttle/ferry,
/area/space)
"lS" = (
/obj/structure/table/reinforced,
/obj/machinery/reagentgrinder,
/turf/open/floor/iron/shuttle/ferry,
/area/space)
"mj" = (
/obj/structure/table/reinforced,
/obj/item/folder/blue,
/obj/item/folder/red{
	pixel_x = 3;
	pixel_y = 2
	},
/turf/open/floor/pod,
/area/space)
"mO" = (
/obj/structure/cable,
/obj/machinery/atmospherics/components/unary/vent_pump/on,
/turf/open/floor/pod,
/area/space)
"nJ" = (
/obj/structure/window/reinforced/tinted{
	dir = 4;
	pixel_x = 2
	},
/obj/structure/curtain,
/turf/open/floor/pod,
/area/space)
"oc" = (
/obj/structure/table/reinforced,
/obj/structure/closet/crate/radiation,
/turf/open/floor/iron/shuttle/ferry,
/area/space)
"op" = (
/obj/structure/cable,
/obj/machinery/atmospherics/pipe/smart/manifold4w/supply/hidden,
/turf/open/floor/pod,
/area/space)
"or" = (
/obj/structure/cable,
/obj/structure/table/reinforced,
/obj/machinery/atmospherics/pipe/smart/manifold4w/supply/hidden,
/turf/open/floor/pod,
/area/space)
"oV" = (
/obj/machinery/smartfridge/chemistry/preloaded,
/turf/open/floor/pod,
/area/space)
"pf" = (
/obj/structure/table/reinforced,
/turf/open/floor/pod,
/area/space)
"pK" = (
/obj/machinery/door/airlock/medical,
/turf/open/floor/pod,
/area/space)
"qZ" = (
/obj/machinery/atmospherics/pipe/smart/manifold4w/supply/hidden,
/obj/structure/cable,
/turf/open/floor/plating,
/area/space)
"re" = (
/obj/machinery/atmospherics/components/tank/air,
/turf/open/floor/plating,
/area/space)
"rv" = (
/obj/structure/cable,
/obj/structure/table/reinforced,
/obj/item/paper_bin{
	pixel_x = 4;
	pixel_y = 6
	},
/obj/item/pen,
/turf/open/floor/pod,
/area/space)
"rw" = (
/obj/structure/bed,
/obj/item/bedsheet/random,
/turf/open/floor/pod,
/area/space)
"rJ" = (
/obj/structure/reagent_dispensers/watertank/high,
/obj/item/mop/advanced,
/obj/item/reagent_containers/glass/bucket,
/turf/open/floor/plating,
/area/space)
"sf" = (
/obj/structure/curtain,
/turf/open/floor/pod,
/area/space)
"sM" = (
/turf/open/space/basic,
/area/space)
"tf" = (
/obj/machinery/atmospherics/pipe/smart/manifold4w/supply/hidden,
/turf/open/floor/pod,
/area/space)
"tU" = (
/obj/machinery/power/terminal{
	dir = 1
	},
/obj/structure/cable,
/turf/open/floor/plating,
/area/space)
"uK" = (
/obj/structure/chair/comfy/shuttle{
	dir = 8
	},
/obj/machinery/atmospherics/components/unary/vent_pump/on,
/turf/open/floor/pod,
/area/space)
"vB" = (
/obj/structure/closet/crate/secure/science,
/turf/open/floor/plating,
/area/space)
"vV" = (
/obj/structure/table/reinforced,
/obj/item/food/rationpack,
/obj/item/food/rationpack{
	pixel_x = 4;
	pixel_y = 3
	},
/obj/item/food/rationpack{
	pixel_x = -4;
	pixel_y = -2
	},
/obj/item/food/rationpack{
	pixel_x = 6;
	pixel_y = -2
	},
/obj/item/food/rationpack,
/turf/open/floor/pod,
/area/space)
"wL" = (
/obj/machinery/stasis/survival_pod,
/turf/open/floor/pod,
/area/space)
"xZ" = (
/obj/machinery/door/airlock/shuttle,
/obj/machinery/atmospherics/pipe/smart/manifold4w/supply/hidden,
/obj/structure/cable,
/turf/open/floor/iron/shuttle/ferry,
/area/space)
"yd" = (
/obj/machinery/computer/crew/shuttle{
	dir = 8
	},
/turf/open/floor/pod,
/area/space)
"yf" = (
/obj/structure/table/reinforced,
/obj/item/modular_computer/laptop/preset,
/turf/open/floor/pod,
/area/space)
"yF" = (
/obj/structure/chair/comfy/shuttle{
	dir = 8
	},
/turf/open/floor/iron/shuttle/ferry,
/area/space)
"zb" = (
/obj/structure/table/reinforced,
/obj/item/modular_computer/tablet/preset/advanced,
/turf/open/floor/pod,
/area/space)
"zP" = (
/obj/machinery/holopad,
/obj/machinery/atmospherics/pipe/smart/manifold4w/supply/hidden,
/obj/structure/cable,
/turf/open/floor/iron/shuttle/ferry,
/area/space)
"zX" = (
/obj/machinery/airalarm/all_access{
	pixel_y = 25
	},
/turf/open/floor/iron/shuttle/ferry,
/area/space)
"Aq" = (
/obj/structure/shuttle/engine/propulsion{
	dir = 8
	},
/turf/open/floor/plating,
/area/space)
"AN" = (
/obj/structure/cable,
/obj/machinery/atmospherics/pipe/smart/manifold4w/supply/hidden,
/obj/machinery/door/airlock/mining,
/turf/open/floor/pod,
/area/space)
"Bv" = (
/obj/structure/table/reinforced,
/turf/open/floor/iron/shuttle/ferry,
/area/space)
"CI" = (
/obj/structure/table/reinforced,
/obj/item/folder{
	pixel_x = -6;
	pixel_y = -4
	},
/obj/item/folder{
	pixel_x = -4;
	pixel_y = 2
	},
/obj/item/folder/yellow{
	pixel_x = 3;
	pixel_y = -2
	},
/obj/item/folder/yellow{
	pixel_x = 4;
	pixel_y = 3
	},
/turf/open/floor/pod,
/area/space)
"Da" = (
/obj/structure/table/reinforced,
/obj/item/paper_bin,
/obj/item/paper_bin{
	pixel_x = 5;
	pixel_y = 3
	},
/obj/item/pen,
/turf/open/floor/iron/shuttle/ferry,
/area/space)
"Dc" = (
/obj/structure/chair/comfy/shuttle,
/turf/open/floor/pod,
/area/space)
"Dv" = (
/obj/effect/spawner/structure/window/plasma/reinforced,
/turf/open/floor/plating,
/area/space)
"DH" = (
/obj/machinery/atmospherics/pipe/smart/manifold4w/supply/hidden,
/obj/structure/cable,
/turf/open/floor/iron/shuttle/ferry,
/area/space)
"DL" = (
/obj/structure/fans,
/obj/structure/cable,
/turf/open/floor/pod,
/area/space)
"Ee" = (
/obj/structure/shuttle/engine/heater{
	dir = 8
	},
/turf/closed/wall/mineral/titanium,
/area/space)
"EF" = (
/obj/machinery/atmospherics/components/unary/vent_pump/on{
	dir = 1
	},
/turf/open/floor/pod,
/area/space)
"ER" = (
/obj/structure/closet/secure_closet/freezer/meat{
	req_access = null
	},
/turf/open/floor/iron/shuttle/ferry,
/area/space)
"Gl" = (
/turf/open/floor/pod,
/area/space)
"Gz" = (
/obj/machinery/atmospherics/pipe/smart/manifold4w/supply/hidden,
/obj/structure/cable,
/turf/open/floor/pod,
/area/space)
"GL" = (
/obj/structure/bed,
/obj/structure/window/reinforced/tinted{
	dir = 4;
	pixel_x = 2
	},
/obj/item/bedsheet/random,
/turf/open/floor/pod,
/area/space)
"GP" = (
/obj/machinery/smartfridge/survival_pod/preloaded,
/obj/structure/cable,
/turf/open/floor/pod,
/area/space)
"KH" = (
/obj/structure/table/reinforced,
/obj/structure/closet/crate/science,
/turf/open/floor/iron/shuttle/ferry,
/area/space)
"Lk" = (
/obj/machinery/iv_drip,
/obj/structure/bed/roller,
/turf/open/floor/pod,
/area/space)
"LJ" = (
/obj/structure/reagent_dispensers/fueltank/large,
/turf/open/floor/plating,
/area/space)
"LR" = (
/obj/structure/cable,
/obj/machinery/atmospherics/pipe/smart/manifold4w/supply/hidden,
/turf/open/floor/iron/shuttle/ferry,
/area/space)
"Mf" = (
/obj/structure/table/reinforced,
/obj/effect/spawner/lootdrop/donkpockets,
/obj/effect/spawner/lootdrop/donkpockets{
	pixel_x = 4;
	pixel_y = 3
	},
/turf/open/floor/pod,
/area/space)
"Mj" = (
/turf/open/floor/iron/shuttle/ferry,
/area/space)
"Mk" = (
/obj/machinery/computer/atmos_alert{
	dir = 8
	},
/turf/open/floor/iron/shuttle/ferry,
/area/space)
"Mq" = (
/obj/structure/table/reinforced,
/obj/item/plate,
/turf/open/floor/iron/shuttle/ferry,
/area/space)
"ME" = (
/obj/structure/chair/comfy/shuttle{
	dir = 4
	},
/obj/structure/cable,
/turf/open/floor/iron/shuttle/ferry,
/area/space)
"MI" = (
/obj/structure/table/reinforced,
/obj/item/storage/firstaid/regular{
	pixel_x = -4;
	pixel_y = -5
	},
/obj/item/storage/firstaid/emergency{
	pixel_x = 3;
	pixel_y = 6
	},
/turf/open/floor/pod,
/area/space)
"MM" = (
/obj/structure/table/reinforced,
/obj/machinery/processor,
/turf/open/floor/pod,
/area/space)
"MQ" = (
/obj/structure/closet/crate/secure/gear,
/turf/open/floor/plating,
/area/space)
"Ne" = (
/obj/machinery/atmospherics/pipe/smart/manifold4w/supply/hidden,
/turf/open/floor/iron/shuttle/ferry,
/area/space)
"NM" = (
/obj/machinery/griddle,
/turf/open/floor/pod,
/area/space)
"NP" = (
/obj/machinery/atmospherics/pipe/smart/manifold4w/supply/hidden,
/obj/structure/cable,
/obj/structure/chair/comfy/shuttle{
	dir = 8
	},
/turf/open/floor/iron/shuttle/ferry,
/area/space)
"NY" = (
/obj/structure/chair/office{
	dir = 1
	},
/turf/open/floor/iron/shuttle/ferry,
/area/space)
"OG" = (
/obj/machinery/airalarm/all_access{
	dir = 8;
	pixel_x = 24
	},
/obj/structure/cable,
/turf/open/floor/plating,
/area/space)
"PC" = (
/obj/machinery/door/airlock/mining,
/turf/open/floor/pod,
/area/space)
"PR" = (
/obj/machinery/computer/crew/shuttle,
/turf/open/floor/iron/shuttle/ferry,
/area/space)
"PS" = (
/obj/structure/closet/firecloset/full,
/turf/open/floor/iron/shuttle/ferry,
/area/space)
"QH" = (
/obj/machinery/power/port_gen/pacman,
/turf/open/floor/plating,
/area/space)
"QJ" = (
/obj/machinery/sleeper{
	dir = 8
	},
/turf/open/floor/pod,
/area/space)
"Rt" = (
/obj/structure/chair/comfy/shuttle{
	dir = 8
	},
/obj/machinery/atmospherics/pipe/smart/manifold4w/supply/hidden,
/obj/structure/cable,
/turf/open/floor/pod,
/area/space)
"Sa" = (
/obj/item/gps/computer,
/obj/structure/cable,
/turf/open/floor/pod,
/area/space)
"Ty" = (
/obj/machinery/power/smes,
/obj/structure/cable,
/turf/open/floor/plating,
/area/space)
"TI" = (
/obj/structure/table/reinforced,
/obj/item/modular_computer/tablet/preset/advanced,
/obj/machinery/atmospherics/components/unary/vent_pump/on{
	dir = 1
	},
/turf/open/floor/iron/shuttle/ferry,
/area/space)
"TU" = (
/obj/structure/closet/crate/freezer/blood,
/turf/open/floor/pod,
/area/space)
"Vr" = (
/obj/machinery/door/airlock/shuttle/glass,
/obj/machinery/atmospherics/pipe/smart/manifold4w/supply/hidden,
/obj/structure/cable,
/turf/open/floor/iron/shuttle/ferry,
/area/space)
"Vv" = (
/obj/structure/closet/firecloset/full,
/turf/open/floor/plating,
/area/space)
"VZ" = (
/obj/structure/closet/emcloset/anchored,
/turf/open/floor/iron/shuttle/ferry,
/area/space)
"Wm" = (
/obj/structure/window/reinforced/tinted{
	dir = 4;
	pixel_x = 2
	},
/turf/open/floor/pod,
/area/space)
"XW" = (
/obj/structure/table/reinforced,
/obj/item/storage/firstaid/brute{
	pixel_x = -3;
	pixel_y = -3
	},
/obj/item/storage/firstaid/advanced,
/obj/item/storage/firstaid/toxin{
	pixel_x = -4;
	pixel_y = 4
	},
/turf/open/floor/pod,
/area/space)
"YR" = (
/obj/machinery/atmospherics/pipe/smart/manifold4w/supply/hidden,
/obj/machinery/door/airlock/medical,
/turf/open/floor/pod,
/area/space)
"Zl" = (
/obj/structure/cable,
/turf/open/floor/plating,
/area/space)
"ZF" = (
/obj/machinery/modular_computer/console/preset/engineering{
	dir = 8
	},
/turf/open/floor/iron/shuttle/ferry,
/area/space)

(1,1,1) = {"
sM
sM
sM
sM
sM
sM
sM
sM
sM
sM
sM
sM
sM
sM
sM
sM
sM
sM
sM
sM
sM
sM
sM
sM
sM
sM
sM
sM
sM
sM
sM
sM
sM
sM
sM
"}
(2,1,1) = {"
sM
sM
sM
sM
sM
sM
sM
sM
sM
sM
sM
sM
sM
sM
sM
sM
sM
sM
sM
sM
sM
sM
sM
sM
sM
sM
sM
sM
sM
sM
sM
sM
sM
sM
sM
"}
(3,1,1) = {"
sM
sM
sM
sM
sM
sM
sM
sM
sM
sM
sM
sM
sM
sM
sM
sM
sM
sM
sM
sM
sM
sM
sM
sM
sM
sM
sM
sM
sM
sM
sM
sM
sM
sM
sM
"}
(4,1,1) = {"
sM
sM
sM
sM
sM
sM
sM
sM
sM
sM
sM
sM
sM
sM
sM
sM
sM
sM
sM
sM
sM
sM
sM
sM
sM
sM
sM
sM
sM
sM
sM
sM
sM
sM
sM
"}
(5,1,1) = {"
sM
sM
sM
sM
sM
sM
sM
sM
sM
sM
sM
sM
sM
sM
sM
sM
sM
sM
sM
sM
sM
sM
sM
sM
sM
sM
sM
sM
sM
sM
sM
sM
sM
sM
sM
"}
(6,1,1) = {"
sM
sM
sM
sM
sM
sM
sM
sM
sM
sM
sM
sM
sM
sM
sM
sM
sM
sM
sM
sM
sM
sM
sM
sM
sM
sM
sM
sM
sM
sM
sM
sM
sM
sM
sM
"}
(7,1,1) = {"
sM
sM
sM
sM
sM
sM
sM
sM
sM
sM
sM
sM
sM
sM
sM
sM
sM
sM
sM
sM
sM
sM
sM
sM
sM
sM
sM
sM
sM
sM
sM
sM
sM
sM
sM
"}
(8,1,1) = {"
sM
sM
sM
sM
sM
sM
sM
sM
sM
sM
sM
sM
sM
sM
sM
sM
sM
sM
sM
sM
sM
sM
sM
sM
sM
sM
sM
sM
sM
sM
sM
sM
sM
sM
sM
"}
(9,1,1) = {"
sM
sM
sM
sM
sM
sM
sM
sM
sM
sM
sM
sM
sM
sM
sM
sM
sM
sM
sM
sM
sM
sM
sM
sM
sM
sM
sM
sM
sM
sM
sM
sM
sM
sM
sM
"}
(10,1,1) = {"
sM
sM
sM
sM
sM
sM
sM
sM
sM
sM
sM
sM
Aq
Aq
bB
bB
ka
Aq
Aq
Aq
ka
bB
bB
Aq
Aq
sM
sM
sM
sM
sM
sM
sM
sM
sM
sM
"}
(11,1,1) = {"
sM
sM
sM
sM
sM
sM
sM
sM
sM
sM
sM
sM
Ee
Ee
Ee
Ee
ka
Ee
Ee
Ee
ka
Ee
Ee
Ee
Ee
sM
sM
sM
sM
sM
sM
sM
sM
sM
sM
"}
(12,1,1) = {"
sM
sM
sM
sM
sM
sM
sM
sM
sM
sM
sM
sM
ka
QH
hf
hf
QH
aF
Vv
re
re
vB
MQ
LJ
ka
sM
sM
sM
sM
sM
sM
sM
sM
sM
sM
"}
(13,1,1) = {"
sM
sM
sM
sM
sM
sM
sM
sM
sM
sM
sM
sM
ka
Ty
tU
Zl
Zl
OG
fQ
qZ
dH
hf
hf
rJ
ka
sM
sM
sM
sM
sM
sM
sM
sM
sM
sM
"}
(14,1,1) = {"
sM
sM
sM
sM
sM
sM
sM
sM
sM
sM
sM
sM
ka
ka
ka
ka
ka
ka
ka
xZ
ka
ka
ka
ka
ka
sM
sM
sM
sM
sM
sM
sM
sM
sM
sM
"}
(15,1,1) = {"
sM
sM
sM
sM
sM
sM
sM
sM
sM
sM
sM
ka
ka
Gl
Mj
oc
Mj
Gl
Bv
op
ka
cq
ER
pf
ka
sM
sM
sM
sM
sM
sM
sM
sM
sM
sM
"}
(16,1,1) = {"
sM
sM
sM
sM
sM
sM
sM
sM
sM
sM
ka
ka
ka
Gl
Mj
KH
Mj
Gl
dh
op
ka
Mj
Mj
MM
ka
sM
sM
sM
sM
sM
sM
sM
sM
sM
sM
"}
(17,1,1) = {"
sM
sM
sM
sM
sM
sM
sM
sM
sM
sM
gx
hf
gx
Gl
Gl
Gl
Gl
Gl
hz
op
Gl
Gl
Gl
in
ka
sM
sM
sM
sM
sM
sM
sM
sM
sM
sM
"}
(18,1,1) = {"
sM
sM
sM
sM
sM
sM
sM
sM
sM
sM
ka
ka
ka
Gl
Mj
Mj
ge
pf
Da
Gz
Mj
lS
Mj
NM
ka
sM
sM
sM
sM
sM
sM
sM
sM
sM
sM
"}
(19,1,1) = {"
sM
sM
sM
sM
sM
sM
sM
sM
sM
sM
sM
ka
eT
Gl
Mj
Mj
Mj
Gl
Mj
Gz
Mj
Mq
Mj
dn
ka
sM
sM
sM
sM
sM
sM
sM
sM
sM
sM
"}
(20,1,1) = {"
sM
sM
sM
sM
sM
sM
sM
sM
sM
sM
sM
ka
eT
Wm
ku
Ne
Ne
tf
Ne
Gz
DH
Mq
Mq
eO
ka
ka
sM
sM
sM
sM
sM
sM
sM
sM
sM
"}
(21,1,1) = {"
sM
sM
sM
sM
sM
sM
sM
sM
sM
sM
sM
ka
GL
nJ
Mj
Mj
Mj
by
ka
Dc
LR
Mj
Mj
Gl
in
ka
sM
sM
sM
sM
sM
sM
sM
sM
sM
"}
(22,1,1) = {"
sM
sM
sM
sM
sM
sM
sM
sM
sM
sM
sM
ka
GL
nJ
Mj
Mj
Mj
by
ka
Dc
LR
Mj
Mj
Gl
Mf
ka
sM
sM
sM
sM
sM
sM
sM
sM
sM
"}
(23,1,1) = {"
sM
sM
sM
sM
sM
sM
sM
sM
sM
sM
sM
ka
rw
sf
Mj
Mj
Mj
by
ka
Dc
LR
Ne
Ne
EF
vV
ka
sM
sM
sM
sM
sM
sM
sM
sM
sM
"}
(24,1,1) = {"
sM
sM
sM
sM
sM
sM
sM
sM
sM
sM
sM
ka
ka
ka
ka
zX
Mj
Gl
Gl
Gl
LR
Mj
ka
ka
ka
ka
sM
sM
sM
sM
sM
sM
sM
sM
sM
"}
(25,1,1) = {"
sM
sM
sM
sM
sM
sM
sM
sM
sM
sM
ka
ka
wL
wL
ka
Mj
Mj
cx
CI
mj
DH
Mj
ka
Lk
Lk
ka
ka
sM
sM
sM
sM
sM
sM
sM
sM
"}
(26,1,1) = {"
sM
sM
sM
sM
sM
sM
sM
sM
sM
sM
ka
GP
mO
op
AN
op
op
or
eJ
rv
Gz
Gl
pK
Gl
Gl
oV
ka
sM
sM
sM
sM
sM
sM
sM
sM
"}
(27,1,1) = {"
sM
sM
sM
sM
sM
sM
sM
sM
sM
sM
ka
DL
Gl
Mj
ka
Mj
Gl
cm
Gl
ks
Gz
Mj
ka
Mj
Gl
MI
ka
sM
sM
sM
sM
sM
sM
sM
sM
"}
(28,1,1) = {"
sM
sM
sM
sM
sM
sM
sM
sM
sM
sM
ka
Sa
Gl
Gl
PC
Gl
Gl
cm
zb
yf
Gz
tf
YR
EF
Gl
XW
ka
sM
sM
sM
sM
sM
sM
sM
sM
"}
(29,1,1) = {"
sM
sM
sM
sM
sM
sM
sM
sM
sM
sM
ka
ka
yd
Gl
ka
ku
Ne
tf
tf
tf
DH
Mj
ka
TU
QJ
ka
ka
sM
sM
sM
sM
sM
sM
sM
sM
"}
(30,1,1) = {"
sM
sM
sM
sM
sM
sM
sM
sM
sM
sM
sM
ka
ka
ka
ka
Mj
Mj
Gl
Gl
Gl
DH
Mj
ka
ka
ka
ka
sM
sM
sM
sM
sM
sM
sM
sM
sM
"}
(31,1,1) = {"
sM
sM
sM
sM
sM
sM
sM
sM
sM
sM
sM
sM
ka
ka
Mj
yF
yF
uK
DH
Rt
NP
yF
Mj
ka
ka
sM
sM
sM
sM
sM
sM
sM
sM
sM
sM
"}
(32,1,1) = {"
sM
sM
sM
sM
sM
sM
sM
sM
sM
sM
sM
sM
ka
ka
PS
ka
ka
ka
Vr
ka
ka
ka
VZ
ka
ka
sM
sM
sM
sM
sM
sM
sM
sM
sM
sM
"}
(33,1,1) = {"
sM
sM
sM
sM
sM
sM
sM
sM
sM
sM
sM
sM
sM
ka
ka
ka
PR
NY
zP
Ne
TI
ka
ka
ka
sM
sM
sM
sM
sM
sM
sM
sM
sM
sM
sM
"}
(34,1,1) = {"
sM
sM
sM
sM
sM
sM
sM
sM
sM
sM
sM
sM
sM
sM
sM
ka
gA
Mj
ME
Mj
Bv
ka
sM
sM
sM
sM
sM
sM
sM
sM
sM
sM
sM
sM
sM
"}
(35,1,1) = {"
sM
sM
sM
sM
sM
sM
sM
sM
sM
sM
sM
sM
sM
sM
sM
ka
ka
Mk
Mj
ZF
ka
ka
sM
sM
sM
sM
sM
sM
sM
sM
sM
sM
sM
sM
sM
"}
(36,1,1) = {"
sM
sM
sM
sM
sM
sM
sM
sM
sM
sM
sM
sM
sM
sM
sM
sM
ka
Dv
Dv
Dv
ka
sM
sM
sM
sM
sM
sM
sM
sM
sM
sM
sM
sM
sM
sM
"}
(37,1,1) = {"
sM
sM
sM
sM
sM
sM
sM
sM
sM
sM
sM
sM
sM
sM
sM
sM
sM
sM
sM
sM
sM
sM
sM
sM
sM
sM
sM
sM
sM
sM
sM
sM
sM
sM
sM
"}
(38,1,1) = {"
sM
sM
sM
sM
sM
sM
sM
sM
sM
sM
sM
sM
sM
sM
sM
sM
sM
sM
sM
sM
sM
sM
sM
sM
sM
sM
sM
sM
sM
sM
sM
sM
sM
sM
sM
"}
(39,1,1) = {"
sM
sM
sM
sM
sM
sM
sM
sM
sM
sM
sM
sM
sM
sM
sM
sM
sM
sM
sM
sM
sM
sM
sM
sM
sM
sM
sM
sM
sM
sM
sM
sM
sM
sM
sM
"}
(40,1,1) = {"
sM
sM
sM
sM
sM
sM
sM
sM
sM
sM
sM
sM
sM
sM
sM
sM
sM
sM
sM
sM
sM
sM
sM
sM
sM
sM
sM
sM
sM
sM
sM
sM
sM
sM
sM
"}
(41,1,1) = {"
sM
sM
sM
sM
sM
sM
sM
sM
sM
sM
sM
sM
sM
sM
sM
sM
sM
sM
sM
sM
sM
sM
sM
sM
sM
sM
sM
sM
sM
sM
sM
sM
sM
sM
sM
"}
(42,1,1) = {"
sM
sM
sM
sM
sM
sM
sM
sM
sM
sM
sM
sM
sM
sM
sM
sM
sM
sM
sM
sM
sM
sM
sM
sM
sM
sM
sM
sM
sM
sM
sM
sM
sM
sM
sM
"}
(43,1,1) = {"
sM
sM
sM
sM
sM
sM
sM
sM
sM
sM
sM
sM
sM
sM
sM
sM
sM
sM
sM
sM
sM
sM
sM
sM
sM
sM
sM
sM
sM
sM
sM
sM
sM
sM
sM
"}
(44,1,1) = {"
sM
sM
sM
sM
sM
sM
sM
sM
sM
sM
sM
sM
sM
sM
sM
sM
sM
sM
sM
sM
sM
sM
sM
sM
sM
sM
sM
sM
sM
sM
sM
sM
sM
sM
sM
"}
(45,1,1) = {"
sM
sM
sM
sM
sM
sM
sM
sM
sM
sM
sM
sM
sM
sM
sM
sM
sM
sM
sM
sM
sM
sM
sM
sM
sM
sM
sM
sM
sM
sM
sM
sM
sM
sM
sM
"}
