//MAP CONVERTED BY dmm2tgm.py THIS HEADER COMMENT PREVENTS RECONVERSION, DO NOT REMOVE
"ag" = (
/obj/structure/table/reinforced,
/obj/machinery/microwave,
/turf/open/floor/pod,
/area/shuttle/nexus)
"aH" = (
/obj/structure/closet/crate/freezer/blood,
/turf/open/floor/pod,
/area/shuttle/nexus)
"bd" = (
/obj/structure/table/reinforced,
/obj/item/storage/firstaid/regular{
	pixel_x = -4;
	pixel_y = -5
	},
/obj/item/storage/firstaid/emergency{
	pixel_x = 3;
	pixel_y = 6
	},
/turf/open/floor/pod,
/area/shuttle/nexus)
"by" = (
/turf/open/floor/plating,
/area/shuttle/nexus)
"cx" = (
/obj/machinery/button/door{
	id = "nexus_shuttle_mining";
	pixel_x = 25
	},
/turf/open/floor/pod,
/area/shuttle/nexus)
"cM" = (
/obj/machinery/sleeper{
	dir = 8
	},
/turf/open/floor/pod,
/area/shuttle/nexus)
"dH" = (
/obj/structure/bed,
/obj/structure/window/reinforced/tinted{
	dir = 4;
	pixel_x = 2
	},
/obj/item/bedsheet/random,
/turf/open/floor/pod,
/area/shuttle/nexus)
"eJ" = (
/obj/machinery/door/airlock/external,
/obj/structure/fans/tiny/forcefield,
/turf/open/floor/plating,
/area/shuttle/nexus)
"eO" = (
/obj/machinery/atmospherics/components/unary/vent_pump/on,
/turf/open/floor/iron/shuttle/ferry,
/area/shuttle/nexus)
"eT" = (
/obj/structure/bed,
/obj/item/bedsheet/random,
/turf/open/floor/pod,
/area/shuttle/nexus)
"fC" = (
/obj/machinery/door/airlock/external,
/obj/structure/fans/tiny/forcefield,
/obj/docking_port/mobile{
	dir = 2;
	dwidth = 12;
	height = 17;
	id = "nexus";
	launch_status = 0;
	name = "NXV Nexus";
	port_direction = 8;
	preferred_direction = 4;
	width = 27
	},
/turf/open/floor/plating,
/area/shuttle/nexus)
"fQ" = (
/obj/structure/ore_box,
/turf/open/floor/pod,
/area/shuttle/nexus)
"ge" = (
/obj/machinery/atmospherics/components/unary/portables_connector/visible,
/obj/machinery/portable_atmospherics/canister/carbon_dioxide,
/turf/open/floor/plating,
/area/shuttle/nexus)
"gx" = (
/obj/structure/cable,
/obj/machinery/power/smes/engineering{
	charge = 1e+006
	},
/turf/open/floor/plating,
/area/shuttle/nexus)
"gA" = (
/obj/machinery/light/warm/directional/north,
/turf/open/floor/pod,
/area/shuttle/nexus)
"hd" = (
/obj/structure/closet/firecloset/wall{
	pixel_y = -30
	},
/obj/structure/table/reinforced,
/turf/open/floor/pod,
/area/shuttle/nexus)
"hN" = (
/obj/machinery/iv_drip,
/obj/structure/bed/roller,
/obj/machinery/light/cold/directional/west,
/turf/open/floor/pod,
/area/shuttle/nexus)
"in" = (
/obj/machinery/atmospherics/pipe/smart/manifold4w/supply/hidden,
/turf/open/floor/pod,
/area/shuttle/nexus)
"jA" = (
/obj/machinery/mining_brace{
	dir = 8
	},
/turf/open/floor/pod,
/area/shuttle/nexus)
"ka" = (
/obj/machinery/shower{
	pixel_y = 15
	},
/obj/structure/drain,
/obj/machinery/door/window,
/obj/structure/window/reinforced/tinted{
	dir = 4;
	pixel_x = 2
	},
/obj/structure/window/reinforced/tinted{
	dir = 8
	},
/turf/open/floor/pod,
/area/shuttle/nexus)
"lS" = (
/obj/structure/ore_box,
/obj/machinery/light/red/directional/west,
/turf/open/floor/pod,
/area/shuttle/nexus)
"mj" = (
/obj/structure/table/reinforced,
/obj/item/stack/cable_coil,
/obj/machinery/light/red/directional/east,
/turf/open/floor/pod,
/area/shuttle/nexus)
"mH" = (
/obj/structure/table/reinforced,
/obj/item/plate,
/turf/open/floor/iron/shuttle/ferry,
/area/shuttle/nexus)
"mO" = (
/obj/machinery/mining_laser{
	dir = 4
	},
/turf/closed/wall/mineral/titanium/nodiagonal,
/area/shuttle/nexus)
"nJ" = (
/obj/machinery/atmospherics/pipe/smart/manifold4w/orange/visible,
/turf/open/floor/plating,
/area/shuttle/nexus)
"oc" = (
/obj/machinery/power/terminal{
	dir = 1
	},
/obj/structure/cable,
/turf/open/floor/plating,
/area/shuttle/nexus)
"oV" = (
/obj/machinery/computer/atmos_alert{
	dir = 8
	},
/turf/open/floor/iron/shuttle/ferry,
/area/shuttle/nexus)
"pf" = (
/obj/machinery/atmospherics/pipe/smart/manifold4w/supply/hidden,
/obj/machinery/door/airlock/mining/glass,
/turf/open/floor/pod,
/area/shuttle/nexus)
"pK" = (
/obj/machinery/door/airlock/mining/glass,
/turf/open/floor/pod,
/area/shuttle/nexus)
"rv" = (
/obj/structure/closet/firecloset/full,
/turf/open/floor/iron/shuttle/ferry,
/area/shuttle/nexus)
"rw" = (
/obj/machinery/atmospherics/pipe/smart/manifold4w/orange/visible,
/obj/machinery/meter,
/turf/open/floor/plating,
/area/shuttle/nexus)
"rJ" = (
/obj/structure/cable,
/turf/open/floor/plating,
/area/shuttle/nexus)
"sf" = (
/obj/structure/closet/crate/radiation,
/obj/machinery/light/cold/directional/west,
/turf/open/floor/iron/shuttle/ferry,
/area/shuttle/nexus)
"sM" = (
/turf/template_noop,
/area/template_noop)
"tf" = (
/obj/structure/closet/crate/science,
/turf/open/floor/iron/shuttle/ferry,
/area/shuttle/nexus)
"tU" = (
/obj/machinery/atmospherics/pipe/smart/manifold4w/supply/hidden,
/turf/open/floor/iron/shuttle/ferry,
/area/shuttle/nexus)
"ur" = (
/obj/machinery/transporter,
/obj/effect/turf_decal/box,
/turf/open/floor/iron/shuttle/ferry,
/area/shuttle/nexus)
"uK" = (
/obj/structure/chair/comfy/shuttle{
	dir = 8
	},
/turf/open/floor/iron/shuttle/ferry,
/area/shuttle/nexus)
"uX" = (
/obj/machinery/iv_drip,
/obj/structure/bed/roller,
/turf/open/floor/pod,
/area/shuttle/nexus)
"vf" = (
/obj/structure/table/reinforced,
/obj/item/storage/firstaid/brute{
	pixel_x = -3;
	pixel_y = -3
	},
/obj/item/storage/firstaid/advanced,
/obj/item/storage/firstaid/toxin{
	pixel_x = -4;
	pixel_y = 4
	},
/turf/open/floor/pod,
/area/shuttle/nexus)
"vz" = (
/obj/structure/table/reinforced,
/obj/effect/spawner/lootdrop/donkpockets,
/obj/effect/spawner/lootdrop/donkpockets{
	pixel_x = 4;
	pixel_y = 3
	},
/turf/open/floor/pod,
/area/shuttle/nexus)
"wL" = (
/obj/machinery/power/port_gen/pacman,
/obj/machinery/atmospherics/pipe/smart/manifold4w/orange/visible,
/obj/item/stack/sheet/mineral/plasma/five,
/turf/open/floor/plating,
/area/shuttle/nexus)
"xI" = (
/obj/machinery/oven,
/obj/item/plate/oven_tray,
/obj/item/plate/oven_tray,
/turf/open/floor/pod,
/area/shuttle/nexus)
"yd" = (
/obj/structure/cable,
/obj/machinery/light/small/directional/east,
/turf/open/floor/plating,
/area/shuttle/nexus)
"yf" = (
/obj/structure/table/reinforced,
/obj/item/stack/rods/fifty,
/obj/item/stack/sheet/cloth/ten,
/obj/item/stack/sheet/iron/twenty,
/obj/item/stack/sheet/glass{
	amount = 30
	},
/obj/item/stack/sheet/plastic/five,
/turf/open/floor/iron/shuttle/ferry,
/area/shuttle/nexus)
"yF" = (
/obj/machinery/computer/crew/shuttle,
/obj/machinery/light/cold/directional/west,
/turf/open/floor/iron/shuttle/ferry,
/area/shuttle/nexus)
"yW" = (
/obj/structure/reagent_dispensers/watertank/high,
/obj/item/mop/advanced,
/obj/item/reagent_containers/glass/bucket,
/turf/open/floor/plating,
/area/shuttle/nexus)
"zb" = (
/obj/structure/table/reinforced,
/obj/item/paper,
/obj/item/paper{
	pixel_x = 4;
	pixel_y = 2
	},
/obj/item/pen,
/turf/open/floor/iron/shuttle/ferry,
/area/shuttle/nexus)
"zP" = (
/obj/machinery/atmospherics/components/unary/engine{
	dir = 8
	},
/turf/open/floor/plating,
/area/shuttle/nexus)
"zX" = (
/obj/structure/shuttle/engine/heater{
	dir = 8
	},
/obj/machinery/atmospherics/pipe/smart/manifold4w/orange/visible,
/obj/structure/window/reinforced{
	dir = 4
	},
/turf/open/floor/plating,
/area/shuttle/nexus)
"AN" = (
/obj/machinery/space_heater,
/obj/machinery/atmospherics/pipe/smart/manifold4w/orange/visible,
/turf/open/floor/plating,
/area/shuttle/nexus)
"Bv" = (
/obj/machinery/airalarm/all_access{
	dir = 8;
	pixel_x = 24
	},
/obj/structure/cable,
/turf/open/floor/plating,
/area/shuttle/nexus)
"CI" = (
/obj/structure/table/reinforced,
/turf/open/floor/pod,
/area/shuttle/nexus)
"CY" = (
/obj/machinery/atmospherics/components/unary/vent_pump/on{
	dir = 1
	},
/turf/open/floor/pod,
/area/shuttle/nexus)
"Da" = (
/obj/structure/fans/tiny/forcefield,
/obj/machinery/door/poddoor{
	id = "nexus_shuttle_mining"
	},
/turf/open/floor/plating,
/area/shuttle/nexus)
"Dv" = (
/obj/structure/chair/comfy/shuttle{
	dir = 1
	},
/turf/open/floor/pod,
/area/shuttle/nexus)
"DH" = (
/obj/machinery/power/floodlight,
/turf/open/floor/pod,
/area/shuttle/nexus)
"DL" = (
/obj/structure/chair/comfy/shuttle{
	dir = 1
	},
/obj/machinery/light/cold/directional/south,
/turf/open/floor/pod,
/area/shuttle/nexus)
"DQ" = (
/obj/structure/closet/secure_closet/freezer/meat{
	req_access = null
	},
/turf/open/floor/iron/shuttle/ferry,
/area/shuttle/nexus)
"EE" = (
/obj/structure/curtain,
/obj/structure/window/reinforced/tinted{
	dir = 4;
	pixel_x = 2
	},
/turf/open/floor/pod,
/area/shuttle/nexus)
"EN" = (
/obj/effect/spawner/structure/window/shuttle,
/turf/open/floor/plating,
/area/shuttle/nexus)
"Gl" = (
/obj/machinery/atmospherics/components/unary/vent_pump/on,
/obj/machinery/mining_brace{
	dir = 4
	},
/turf/open/floor/pod,
/area/shuttle/nexus)
"Gz" = (
/turf/open/floor/pod,
/area/shuttle/nexus)
"GJ" = (
/obj/structure/table/reinforced,
/obj/item/food/rationpack,
/obj/item/food/rationpack{
	pixel_x = 4;
	pixel_y = 3
	},
/obj/item/food/rationpack{
	pixel_x = -4;
	pixel_y = -2
	},
/obj/item/food/rationpack{
	pixel_x = 6;
	pixel_y = -2
	},
/obj/item/food/rationpack,
/turf/open/floor/pod,
/area/shuttle/nexus)
"GL" = (
/obj/structure/table/reinforced,
/obj/machinery/atmospherics/pipe/smart/manifold4w/supply/hidden,
/turf/open/floor/pod,
/area/shuttle/nexus)
"GP" = (
/obj/structure/chair/comfy/shuttle{
	dir = 8
	},
/obj/machinery/atmospherics/components/unary/vent_pump/on,
/turf/open/floor/pod,
/area/shuttle/nexus)
"Hh" = (
/obj/machinery/atmospherics/pipe/smart/manifold4w/supply/hidden,
/obj/machinery/door/airlock/medical/glass,
/turf/open/floor/pod,
/area/shuttle/nexus)
"HJ" = (
/obj/machinery/smartfridge/chemistry/preloaded,
/turf/open/floor/pod,
/area/shuttle/nexus)
"IW" = (
/obj/structure/closet/crate/secure/gear,
/turf/open/floor/plating,
/area/shuttle/nexus)
"JQ" = (
/obj/machinery/door/airlock/medical/glass,
/turf/open/floor/pod,
/area/shuttle/nexus)
"KH" = (
/obj/structure/chair/office{
	dir = 1
	},
/turf/open/floor/iron/shuttle/ferry,
/area/shuttle/nexus)
"LJ" = (
/obj/structure/closet/firecloset/full,
/turf/open/floor/plating,
/area/shuttle/nexus)
"LR" = (
/turf/closed/wall/mineral/titanium/nodiagonal,
/area/shuttle/nexus)
"Mf" = (
/obj/structure/chair/comfy/shuttle{
	dir = 8
	},
/obj/machinery/light/cold/directional/east,
/turf/open/floor/iron/shuttle/ferry,
/area/shuttle/nexus)
"Mj" = (
/turf/open/floor/iron/shuttle/ferry,
/area/shuttle/nexus)
"Mk" = (
/obj/structure/cable,
/obj/machinery/power/apc/auto_name/east,
/turf/open/floor/plating,
/area/shuttle/nexus)
"Mq" = (
/obj/machinery/power/mining_drill,
/turf/open/floor/pod,
/area/shuttle/nexus)
"ME" = (
/obj/structure/table/reinforced,
/turf/open/floor/iron/shuttle/ferry,
/area/shuttle/nexus)
"MI" = (
/obj/effect/spawner/structure/window/plasma/reinforced,
/turf/open/floor/plating,
/area/shuttle/nexus)
"MM" = (
/obj/structure/table/reinforced,
/obj/item/pickaxe/drill,
/obj/item/pickaxe/drill{
	pixel_y = 8
	},
/turf/open/floor/iron/shuttle/ferry,
/area/shuttle/nexus)
"MQ" = (
/obj/structure/table/reinforced,
/obj/item/pipe_dispenser{
	pixel_x = -3;
	pixel_y = -6
	},
/turf/open/floor/iron/shuttle/ferry,
/area/shuttle/nexus)
"Ne" = (
/turf/closed/wall/mineral/titanium,
/area/shuttle/nexus)
"NM" = (
/obj/structure/table/reinforced,
/obj/item/paper_bin,
/obj/item/paper_bin{
	pixel_x = 5;
	pixel_y = 3
	},
/obj/item/pen,
/turf/open/floor/iron/shuttle/ferry,
/area/shuttle/nexus)
"NP" = (
/obj/structure/table/reinforced,
/obj/item/folder{
	pixel_x = -6;
	pixel_y = -4
	},
/obj/item/folder{
	pixel_x = -4;
	pixel_y = 2
	},
/obj/item/folder/yellow{
	pixel_x = 3;
	pixel_y = -2
	},
/obj/item/folder/yellow{
	pixel_x = 4;
	pixel_y = 3
	},
/turf/open/floor/pod,
/area/shuttle/nexus)
"NY" = (
/obj/machinery/shield_generator,
/turf/open/floor/pod,
/area/shuttle/nexus)
"OG" = (
/obj/structure/table/reinforced,
/obj/item/modular_computer/tablet/preset/advanced,
/turf/open/floor/pod,
/area/shuttle/nexus)
"Pp" = (
/obj/machinery/porta_turret,
/turf/closed/wall/mineral/titanium/nodiagonal,
/area/shuttle/nexus)
"PC" = (
/obj/machinery/door/airlock/shuttle/glass,
/obj/machinery/atmospherics/pipe/smart/manifold4w/supply/hidden,
/turf/open/floor/iron/shuttle/ferry,
/area/shuttle/nexus)
"PR" = (
/obj/machinery/holopad,
/obj/machinery/atmospherics/pipe/smart/manifold4w/supply/hidden,
/turf/open/floor/iron/shuttle/ferry,
/area/shuttle/nexus)
"PS" = (
/obj/structure/chair/comfy/shuttle{
	dir = 4
	},
/turf/open/floor/iron/shuttle/ferry,
/area/shuttle/nexus)
"PV" = (
/obj/structure/table/reinforced,
/obj/machinery/turretid{
	pixel_x = 25
	},
/turf/open/floor/iron/shuttle/ferry,
/area/shuttle/nexus)
"Qj" = (
/obj/structure/table/reinforced,
/obj/machinery/processor,
/turf/open/floor/pod,
/area/shuttle/nexus)
"QH" = (
/obj/machinery/atmospherics/components/tank/air,
/turf/open/floor/plating,
/area/shuttle/nexus)
"QJ" = (
/obj/machinery/atmospherics/pipe/smart/manifold4w/supply/hidden,
/turf/open/floor/plating,
/area/shuttle/nexus)
"QO" = (
/obj/machinery/griddle,
/turf/open/floor/pod,
/area/shuttle/nexus)
"Rt" = (
/obj/machinery/door/airlock/shuttle,
/obj/machinery/atmospherics/pipe/smart/manifold4w/supply/hidden,
/turf/open/floor/iron/shuttle/ferry,
/area/shuttle/nexus)
"Rx" = (
/obj/structure/closet/emcloset/anchored,
/turf/open/floor/iron/shuttle/ferry,
/area/shuttle/nexus)
"Sa" = (
/obj/structure/chair/comfy/shuttle,
/turf/open/floor/pod,
/area/shuttle/nexus)
"Tx" = (
/obj/structure/reagent_dispensers/fueltank/large,
/turf/open/floor/plating,
/area/shuttle/nexus)
"Ty" = (
/obj/structure/chair/comfy/shuttle,
/obj/machinery/light/cold/directional/north,
/turf/open/floor/pod,
/area/shuttle/nexus)
"TI" = (
/obj/item/pen,
/obj/structure/table/reinforced,
/turf/open/floor/pod,
/area/shuttle/nexus)
"TU" = (
/obj/structure/table/reinforced,
/obj/item/modular_computer/laptop/preset,
/turf/open/floor/pod,
/area/shuttle/nexus)
"Vr" = (
/obj/structure/chair/comfy/shuttle{
	dir = 8
	},
/obj/machinery/atmospherics/pipe/smart/manifold4w/supply/hidden,
/turf/open/floor/pod,
/area/shuttle/nexus)
"Vv" = (
/obj/machinery/modular_computer/console/preset/engineering{
	dir = 8
	},
/turf/open/floor/iron/shuttle/ferry,
/area/shuttle/nexus)
"VZ" = (
/obj/machinery/atmospherics/pipe/smart/manifold4w/supply/hidden,
/obj/structure/chair/comfy/shuttle{
	dir = 8
	},
/obj/machinery/light/cold/directional/east,
/turf/open/floor/iron/shuttle/ferry,
/area/shuttle/nexus)
"Wm" = (
/obj/structure/table/reinforced,
/obj/item/modular_computer/tablet/preset/advanced,
/obj/machinery/atmospherics/components/unary/vent_pump/on{
	dir = 1
	},
/obj/machinery/light/cold/directional/west,
/turf/open/floor/iron/shuttle/ferry,
/area/shuttle/nexus)
"XM" = (
/obj/machinery/atmospherics/components/unary/vent_pump/on{
	dir = 1
	},
/obj/machinery/light/cold/directional/east,
/turf/open/floor/pod,
/area/shuttle/nexus)
"XW" = (
/obj/structure/closet/crate/secure/science,
/turf/open/floor/plating,
/area/shuttle/nexus)
"YR" = (
/obj/machinery/light/small/directional/east,
/turf/open/floor/plating,
/area/shuttle/nexus)
"Zl" = (
/obj/structure/closet/secure_closet/freezer/fridge{
	req_access = null
	},
/obj/machinery/light/cold/directional/west,
/turf/open/floor/iron/shuttle/ferry,
/area/shuttle/nexus)
"ZF" = (
/obj/structure/table/reinforced,
/obj/machinery/reagentgrinder,
/turf/open/floor/iron/shuttle/ferry,
/area/shuttle/nexus)
"ZW" = (
/obj/machinery/computer/shuttle/exploration_nexus{
	dir = 8
	},
/turf/open/floor/iron/shuttle/ferry,
/area/shuttle/nexus)

(1,1,1) = {"
sM
sM
sM
sM
sM
sM
Ne
zP
zP
zP
Ne
sM
sM
sM
sM
sM
sM
"}
(2,1,1) = {"
sM
sM
Ne
EN
EN
EN
Ne
zX
zX
zX
Ne
EN
EN
EN
Ne
sM
sM
"}
(3,1,1) = {"
sM
sM
Ne
ge
nJ
rw
wL
AN
LJ
QH
QH
XW
IW
Tx
Ne
sM
sM
"}
(4,1,1) = {"
sM
sM
Ne
gx
oc
rJ
yd
Bv
Mk
QJ
QJ
YR
by
yW
Ne
sM
sM
"}
(5,1,1) = {"
sM
sM
Ne
LR
LR
LR
LR
LR
LR
Rt
LR
LR
LR
LR
Ne
sM
sM
"}
(6,1,1) = {"
sM
Ne
LR
Gz
Mj
sf
ur
Gz
ME
in
LR
Zl
DQ
CI
Ne
sM
sM
"}
(7,1,1) = {"
sM
Ne
ka
Gz
Mj
tf
Mj
Gz
MM
in
LR
Mj
Mj
Qj
Ne
sM
sM
"}
(8,1,1) = {"
sM
Ne
ka
Gz
Gz
Gz
Gz
Gz
MQ
in
Gz
Gz
Gz
ag
Ne
sM
sM
"}
(9,1,1) = {"
sM
EN
dH
EE
Mj
Mj
yf
CI
NM
in
Mj
ZF
Mj
QO
Ne
sM
sM
"}
(10,1,1) = {"
sM
EN
dH
EE
Mj
Mj
Mj
Gz
Mj
in
Mj
mH
Mj
xI
Ne
sM
sM
"}
(11,1,1) = {"
sM
EN
eT
EE
eO
tU
tU
in
tU
in
tU
mH
mH
hd
LR
Ne
sM
"}
(12,1,1) = {"
Ne
LR
LR
gA
Mj
Mj
Mj
Dv
Ne
Sa
tU
Mj
Mj
Gz
ag
EN
sM
"}
(13,1,1) = {"
fC
by
eJ
Gz
Mj
Mj
Mj
DL
Ne
Ty
tU
Mj
Mj
Gz
vz
EN
sM
"}
(14,1,1) = {"
Ne
LR
LR
gA
Mj
Mj
Mj
Dv
Ne
Sa
tU
tU
tU
XM
GJ
EN
sM
"}
(15,1,1) = {"
sM
Ne
LR
LR
LR
Mj
Mj
Gz
Gz
Gz
tU
Mj
LR
LR
LR
Ne
sM
"}
(16,1,1) = {"
Ne
Ne
fQ
lS
LR
Mj
Mj
Gz
Gz
Gz
tU
Mj
LR
hN
uX
LR
Ne
"}
(17,1,1) = {"
Da
Gz
Gl
in
pf
in
in
GL
NP
TI
in
Gz
JQ
Gz
Gz
HJ
EN
"}
(18,1,1) = {"
Da
Gz
Mq
Mj
LR
Mj
Gz
GL
NY
CI
in
Mj
LR
Mj
Gz
bd
EN
"}
(19,1,1) = {"
Da
cx
jA
Gz
pK
Gz
Gz
GL
OG
TU
in
in
Hh
CY
Gz
vf
EN
"}
(20,1,1) = {"
Ne
LR
DH
mj
LR
eO
tU
in
in
in
tU
Mj
LR
aH
cM
LR
Ne
"}
(21,1,1) = {"
sM
Ne
LR
LR
LR
Mj
Mj
Gz
Gz
Gz
tU
Mj
LR
LR
Ne
Ne
sM
"}
(22,1,1) = {"
sM
sM
Ne
LR
Mj
uK
Mf
GP
tU
Vr
VZ
uK
Mj
LR
Ne
sM
sM
"}
(23,1,1) = {"
sM
sM
Pp
LR
rv
LR
LR
EN
PC
EN
LR
LR
Rx
LR
Pp
sM
sM
"}
(24,1,1) = {"
sM
sM
sM
mO
EN
LR
yF
KH
PR
tU
Wm
LR
EN
mO
sM
sM
sM
"}
(25,1,1) = {"
sM
sM
sM
sM
sM
Ne
zb
Mj
PS
Mj
PV
Ne
sM
sM
sM
sM
sM
"}
(26,1,1) = {"
sM
sM
sM
sM
sM
Ne
LR
oV
ZW
Vv
LR
Ne
sM
sM
sM
sM
sM
"}
(27,1,1) = {"
sM
sM
sM
sM
sM
sM
Ne
MI
MI
MI
Ne
sM
sM
sM
sM
sM
sM
"}
