//MAP CONVERTED BY dmm2tgm.py THIS HEADER COMMENT PREVENTS RECONVERSION, DO NOT REMOVE
"bw" = (
/obj/effect/decal/cleanable/dirt,
/turf/open/floor/plating,
/area/shuttle/crow/engineering)
"bZ" = (
/obj/machinery/atmospherics/components/unary/portables_connector/visible,
/obj/machinery/portable_atmospherics/canister/carbon_dioxide,
/obj/structure/cable,
/obj/effect/decal/cleanable/dirt,
/turf/open/floor/plating,
/area/shuttle/crow/engineering)
"cS" = (
/obj/machinery/power/terminal{
	dir = 8
	},
/obj/structure/cable,
/obj/effect/decal/cleanable/dirt,
/obj/effect/spawner/lootdrop/maintenance,
/turf/open/floor/plating,
/area/shuttle/crow/engineering)
"dd" = (
/obj/machinery/atmospherics/pipe/smart/manifold4w/orange/visible,
/obj/effect/turf_decal/bot,
/obj/effect/decal/cleanable/dirt,
/obj/effect/spawner/lootdrop/maintenance,
/turf/open/floor/iron,
/area/shuttle/crow/cargo)
"dm" = (
/obj/effect/spawner/structure/window/shuttle,
/obj/machinery/door/poddoor/shutters/preopen{
	id = "crow_shutter"
	},
/turf/open/floor/plating,
/area/shuttle/crow/helm)
"eb" = (
/obj/structure/cable,
/obj/machinery/airalarm{
	dir = 1;
	pixel_y = -24
	},
/obj/machinery/atmospherics/pipe/smart/manifold4w/scrubbers/hidden,
/turf/open/floor/iron,
/area/shuttle/crow/cargo)
"ec" = (
/obj/machinery/door/airlock,
/obj/structure/cable,
/obj/machinery/door/firedoor,
/obj/machinery/atmospherics/pipe/smart/manifold4w/scrubbers/hidden,
/turf/open/floor/pod,
/area/shuttle/crow/helm)
"eT" = (
/obj/effect/spawner/structure/window/shuttle,
/obj/machinery/door/poddoor/shutters/preopen{
	id = "crow_shutter"
	},
/turf/open/floor/plating,
/area/shuttle/crow/cargo)
"fw" = (
/obj/structure/closet/excavation,
/turf/open/floor/pod,
/area/shuttle/crow)
"fJ" = (
/obj/effect/decal/cleanable/dirt,
/obj/machinery/atmospherics/pipe/smart/manifold4w/supply/visible,
/obj/item/stock_parts/cell/high,
/turf/open/floor/plating,
/area/shuttle/crow/engineering)
"fM" = (
/turf/open/floor/iron,
/area/shuttle/crow/cargo)
"gn" = (
/obj/machinery/atmospherics/components/unary/engine{
	dir = 8
	},
/turf/closed/wall/mineral/titanium,
/area/shuttle/crow/cargo)
"gD" = (
/obj/effect/decal/cleanable/dirt,
/obj/machinery/firealarm/directional/east,
/turf/open/floor/iron,
/area/shuttle/crow/cargo)
"gR" = (
/obj/machinery/atmospherics/components/unary/vent_scrubber/on{
	dir = 8
	},
/turf/open/floor/pod,
/area/shuttle/crow)
"gX" = (
/obj/effect/decal/cleanable/dirt,
/obj/effect/decal/cleanable/oil,
/turf/open/floor/iron,
/area/shuttle/crow/cargo)
"hk" = (
/obj/machinery/atmospherics/pipe/smart/manifold4w/supply/hidden,
/turf/closed/wall/mineral/titanium,
/area/shuttle/crow)
"hn" = (
/obj/structure/rack,
/obj/item/storage/bag/ore,
/obj/item/pickaxe,
/obj/item/flashlight,
/obj/item/mining_scanner,
/obj/item/pickaxe,
/obj/item/mining_scanner,
/obj/item/flashlight,
/obj/item/storage/bag/ore,
/obj/item/pickaxe,
/obj/item/gun/energy/kinetic_accelerator,
/turf/open/floor/pod,
/area/shuttle/crow)
"hB" = (
/obj/structure/cable,
/obj/machinery/power/apc/auto_name/south,
/obj/effect/decal/cleanable/dirt,
/obj/machinery/atmospherics/pipe/smart/manifold4w/scrubbers/hidden,
/turf/open/floor/iron,
/area/shuttle/crow/cargo)
"hD" = (
/obj/machinery/light/small/directional/west,
/obj/effect/decal/cleanable/dirt,
/obj/structure/table,
/obj/machinery/firealarm/directional/west,
/obj/item/storage/toolbox/emergency,
/obj/machinery/light_switch/directional/north,
/obj/machinery/atmospherics/components/unary/vent_pump/on,
/turf/open/floor/pod,
/area/shuttle/crow/helm)
"iP" = (
/obj/effect/decal/cleanable/dirt,
/turf/open/floor/iron,
/area/shuttle/crow/cargo)
"iX" = (
/obj/effect/decal/cleanable/dirt,
/obj/machinery/atmospherics/components/binary/pump{
	dir = 1
	},
/turf/open/floor/plating,
/area/shuttle/crow/engineering)
"jh" = (
/obj/effect/spawner/structure/window/shuttle,
/obj/machinery/door/poddoor/shutters/preopen{
	id = "crow_shutter"
	},
/turf/open/floor/plating,
/area/shuttle/crow)
"jH" = (
/obj/machinery/atmospherics/pipe/smart/manifold4w/orange/visible,
/obj/effect/spawner/lootdrop/maintenance,
/turf/open/floor/iron,
/area/shuttle/crow/cargo)
"jL" = (
/turf/template_noop,
/area/template_noop)
"kN" = (
/obj/machinery/atmospherics/components/unary/portables_connector/visible{
	dir = 1
	},
/obj/machinery/portable_atmospherics/canister,
/obj/effect/decal/cleanable/dirt,
/turf/open/floor/plating,
/area/shuttle/crow/engineering)
"lI" = (
/obj/effect/spawner/structure/window/shuttle,
/turf/open/floor/plating,
/area/shuttle/crow/helm)
"lR" = (
/obj/effect/turf_decal/bot,
/obj/effect/decal/cleanable/dirt,
/obj/structure/closet/crate,
/obj/item/reagent_containers/food/drinks/bottle/wine,
/obj/item/reagent_containers/food/drinks/drinkingglass,
/obj/item/reagent_containers/food/drinks/drinkingglass,
/turf/open/floor/iron,
/area/shuttle/crow/cargo)
"mR" = (
/obj/effect/decal/cleanable/dirt,
/obj/machinery/atmospherics/components/unary/vent_pump/on{
	dir = 8
	},
/turf/open/floor/pod,
/area/shuttle/crow)
"ne" = (
/obj/machinery/door/airlock,
/obj/structure/cable,
/obj/machinery/door/firedoor,
/obj/machinery/atmospherics/pipe/smart/manifold4w/scrubbers/hidden,
/turf/open/floor/iron,
/area/shuttle/crow/cargo)
"np" = (
/obj/effect/decal/cleanable/dirt,
/obj/structure/table,
/obj/item/storage/toolbox/emergency,
/obj/item/gps/mining,
/obj/item/clothing/mask/breath,
/obj/item/clothing/mask/breath,
/obj/item/clothing/mask/breath,
/obj/item/clothing/mask/breath,
/turf/open/floor/pod,
/area/shuttle/crow)
"nK" = (
/turf/open/floor/plating,
/area/shuttle/crow)
"og" = (
/obj/machinery/airalarm{
	dir = 4;
	pixel_x = -24
	},
/obj/effect/decal/cleanable/dirt,
/obj/machinery/atmospherics/pipe/smart/manifold4w/supply/hidden,
/turf/open/floor/pod,
/area/shuttle/crow/helm)
"oH" = (
/obj/machinery/door/airlock,
/obj/structure/cable,
/obj/effect/decal/cleanable/dirt,
/obj/machinery/atmospherics/pipe/smart/manifold4w/scrubbers/hidden,
/obj/machinery/meter,
/turf/open/floor/plating,
/area/shuttle/crow/engineering)
"pL" = (
/obj/machinery/computer/shuttle/exploration_crow{
	dir = 8
	},
/turf/open/floor/pod,
/area/shuttle/crow/helm)
"qb" = (
/obj/effect/decal/cleanable/dirt,
/obj/machinery/atmospherics/components/unary/vent_scrubber/on{
	dir = 4
	},
/turf/open/floor/iron,
/area/shuttle/crow/cargo)
"qM" = (
/obj/machinery/atmospherics/pipe/smart/manifold4w/orange/visible,
/obj/machinery/power/smes/engineering{
	charge = 1e+006
	},
/obj/structure/cable,
/obj/effect/decal/cleanable/dirt,
/turf/open/floor/plating,
/area/shuttle/crow/engineering)
"sB" = (
/obj/machinery/atmospherics/pipe/smart/manifold4w/orange/visible,
/obj/effect/decal/cleanable/dirt,
/turf/open/floor/iron,
/area/shuttle/crow/cargo)
"tN" = (
/obj/structure/table,
/obj/structure/extinguisher_cabinet{
	pixel_x = 27;
	pixel_y = 1
	},
/obj/item/storage/firstaid/regular{
	pixel_x = 1;
	pixel_y = -20
	},
/obj/machinery/recharger,
/turf/open/floor/pod,
/area/shuttle/crow)
"um" = (
/obj/machinery/light/small/directional/west,
/obj/effect/decal/cleanable/dirt,
/obj/structure/closet/excavation,
/turf/open/floor/pod,
/area/shuttle/crow)
"uo" = (
/obj/structure/tank_dispenser/oxygen,
/turf/open/floor/pod,
/area/shuttle/crow)
"uQ" = (
/obj/effect/decal/cleanable/dirt,
/obj/machinery/atmospherics/pipe/smart/manifold4w/supply/hidden,
/turf/open/floor/iron,
/area/shuttle/crow)
"uY" = (
/obj/effect/turf_decal/bot,
/obj/effect/decal/cleanable/dirt,
/obj/structure/closet/crate,
/obj/effect/spawner/lootdrop/maintenance/five,
/turf/open/floor/iron,
/area/shuttle/crow/cargo)
"vj" = (
/obj/structure/cable,
/obj/machinery/light/small/directional/west,
/obj/machinery/power/apc/auto_name/west,
/obj/effect/decal/cleanable/dirt,
/obj/machinery/atmospherics/components/unary/vent_scrubber/on,
/turf/open/floor/pod,
/area/shuttle/crow/helm)
"wt" = (
/obj/machinery/atmospherics/pipe/smart/manifold4w/orange/visible,
/obj/machinery/meter,
/obj/effect/decal/cleanable/dirt,
/turf/open/floor/iron,
/area/shuttle/crow/cargo)
"wM" = (
/obj/structure/shuttle/engine/heater{
	dir = 8
	},
/obj/structure/window/reinforced{
	dir = 4
	},
/obj/machinery/atmospherics/pipe/smart/manifold4w/orange/visible,
/turf/open/floor/plating,
/area/shuttle/crow/cargo)
"yZ" = (
/obj/machinery/light/small/directional/east,
/obj/effect/decal/cleanable/dirt,
/obj/machinery/light_switch/directional/east,
/turf/open/floor/iron,
/area/shuttle/crow/cargo)
"zn" = (
/obj/structure/cable,
/obj/effect/decal/cleanable/dirt,
/obj/effect/decal/cleanable/oil,
/obj/machinery/atmospherics/components/binary/pump,
/turf/open/floor/plating,
/area/shuttle/crow/engineering)
"zS" = (
/obj/machinery/light/small/directional/north,
/obj/effect/decal/cleanable/dirt,
/obj/machinery/light_switch/directional/east,
/obj/machinery/atmospherics/pipe/smart/manifold4w/supply/hidden,
/turf/open/floor/iron,
/area/shuttle/crow)
"AB" = (
/obj/effect/decal/cleanable/dirt,
/obj/structure/table,
/obj/item/paper_bin{
	pixel_x = -4
	},
/obj/item/pen{
	pixel_x = 4
	},
/obj/item/folder/white,
/turf/open/floor/pod,
/area/shuttle/crow/helm)
"AN" = (
/obj/effect/decal/cleanable/dirt,
/obj/machinery/atmospherics/pipe/smart/manifold4w/scrubbers/visible,
/turf/open/floor/plating,
/area/shuttle/crow/engineering)
"AU" = (
/obj/machinery/atmospherics/pipe/smart/manifold4w/orange/visible,
/obj/machinery/meter,
/turf/closed/wall/mineral/titanium,
/area/shuttle/crow/engineering)
"Bt" = (
/obj/structure/cable,
/obj/machinery/power/apc/auto_name/west,
/obj/effect/decal/cleanable/dirt,
/obj/structure/chair/comfy/shuttle{
	dir = 4
	},
/turf/open/floor/pod,
/area/shuttle/crow)
"Cc" = (
/obj/machinery/door/airlock,
/obj/machinery/door/firedoor,
/obj/machinery/atmospherics/pipe/smart/manifold4w/supply/hidden,
/turf/open/floor/iron,
/area/shuttle/crow/cargo)
"CG" = (
/obj/machinery/atmospherics/pipe/smart/manifold4w/supply/hidden,
/turf/open/floor/plating,
/area/shuttle/crow)
"CR" = (
/obj/machinery/atmospherics/pipe/smart/manifold4w/orange/visible,
/obj/structure/reagent_dispensers/fueltank,
/obj/effect/turf_decal/bot,
/obj/effect/decal/cleanable/dirt,
/turf/open/floor/iron,
/area/shuttle/crow/cargo)
"Dt" = (
/obj/structure/rack,
/obj/item/storage/toolbox/mechanical{
	pixel_y = 4
	},
/obj/item/flashlight{
	pixel_x = 3;
	pixel_y = 3
	},
/obj/item/storage/box/lights/bulbs,
/obj/structure/cable,
/obj/machinery/light/small/directional/north,
/obj/item/stack/sheet/mineral/plasma{
	amount = 10
	},
/obj/machinery/power/apc/auto_name/north,
/obj/effect/decal/cleanable/dirt,
/turf/open/floor/plating,
/area/shuttle/crow/engineering)
"Dy" = (
/obj/machinery/light/small/directional/east,
/obj/effect/turf_decal/bot,
/obj/effect/decal/cleanable/dirt,
/obj/structure/extinguisher_cabinet{
	pixel_x = 27
	},
/turf/open/floor/iron,
/area/shuttle/crow/cargo)
"DO" = (
/obj/effect/decal/cleanable/dirt,
/turf/open/floor/pod,
/area/shuttle/crow)
"DX" = (
/obj/effect/decal/cleanable/dirt,
/obj/effect/spawner/lootdrop/maintenance,
/turf/open/floor/plating,
/area/shuttle/crow/engineering)
"Eq" = (
/obj/machinery/door/airlock/external/glass,
/obj/structure/fans/tiny,
/turf/open/floor/plating,
/area/shuttle/crow)
"Fg" = (
/obj/machinery/airalarm{
	dir = 4;
	pixel_x = -24
	},
/obj/effect/decal/cleanable/dirt,
/obj/structure/chair/comfy/shuttle{
	dir = 4
	},
/turf/open/floor/pod,
/area/shuttle/crow)
"Fz" = (
/obj/effect/decal/cleanable/dirt,
/obj/machinery/atmospherics/pipe/smart/manifold4w/supply/hidden,
/obj/machinery/atmospherics/components/unary/vent_scrubber/on,
/turf/open/floor/iron,
/area/shuttle/crow)
"FP" = (
/obj/structure/cable,
/obj/machinery/atmospherics/pipe/smart/manifold4w/scrubbers/hidden,
/obj/machinery/atmospherics/pipe/smart/manifold4w/supply/hidden,
/turf/open/floor/iron,
/area/shuttle/crow)
"Gz" = (
/obj/machinery/door/airlock/external/glass,
/obj/structure/fans/tiny,
/obj/docking_port/mobile{
	dir = 2;
	dwidth = 7;
	height = 11;
	id = "crow";
	launch_status = 0;
	name = "ESS Crow";
	overmap_shuttle_type = /datum/overmap_object/shuttle/ess_crow;
	port_direction = 8;
	preferred_direction = 4;
	width = 15
	},
/turf/open/floor/plating,
/area/shuttle/crow)
"Hu" = (
/turf/open/floor/pod,
/area/shuttle/crow)
"HK" = (
/obj/machinery/atmospherics/components/unary/vent_pump/on{
	dir = 4
	},
/turf/open/floor/iron,
/area/shuttle/crow/cargo)
"HV" = (
/obj/structure/cable,
/obj/effect/decal/cleanable/dirt,
/obj/machinery/atmospherics/pipe/smart/manifold4w/scrubbers/hidden,
/turf/open/floor/pod,
/area/shuttle/crow)
"Ic" = (
/obj/machinery/atmospherics/pipe/smart/manifold4w/orange/visible,
/obj/machinery/light/small/directional/west,
/obj/effect/turf_decal/bot,
/obj/effect/decal/cleanable/dirt,
/turf/open/floor/iron,
/area/shuttle/crow/cargo)
"IN" = (
/obj/effect/decal/cleanable/dirt,
/turf/open/floor/pod,
/area/shuttle/crow/helm)
"JJ" = (
/obj/machinery/meter,
/obj/machinery/atmospherics/pipe/smart/manifold4w/supply/hidden,
/turf/closed/wall/mineral/titanium,
/area/shuttle/crow/engineering)
"KC" = (
/obj/structure/cable,
/obj/effect/decal/cleanable/dirt,
/obj/effect/spawner/lootdrop/maintenance,
/obj/machinery/light_switch/directional/north,
/obj/machinery/portable_atmospherics/canister/oxygen,
/turf/open/floor/plating,
/area/shuttle/crow/engineering)
"KJ" = (
/obj/effect/decal/cleanable/blood/old,
/turf/open/floor/iron,
/area/shuttle/crow/cargo)
"Lp" = (
/obj/machinery/atmospherics/pipe/smart/manifold4w/orange/visible,
/obj/effect/turf_decal/bot,
/obj/effect/decal/cleanable/dirt,
/turf/open/floor/iron,
/area/shuttle/crow/cargo)
"LG" = (
/obj/machinery/atmospherics/pipe/smart/manifold4w/supply/hidden,
/turf/closed/wall/mineral/titanium,
/area/shuttle/crow/helm)
"MH" = (
/obj/effect/decal/cleanable/dirt,
/obj/machinery/atmospherics/pipe/smart/manifold4w/supply/hidden,
/turf/open/floor/plating,
/area/shuttle/crow)
"NJ" = (
/obj/machinery/atmospherics/components/binary/pump,
/obj/structure/cable,
/obj/effect/decal/cleanable/dirt,
/turf/open/floor/plating,
/area/shuttle/crow/engineering)
"OI" = (
/turf/closed/wall/mineral/titanium,
/area/shuttle/crow/helm)
"OP" = (
/obj/machinery/atmospherics/components/unary/vent_pump/on{
	dir = 4
	},
/turf/open/floor/plating,
/area/shuttle/crow)
"Pc" = (
/obj/machinery/light/small/directional/west,
/turf/open/floor/plating,
/area/shuttle/crow)
"PR" = (
/obj/structure/table,
/obj/machinery/button/door{
	id = "crow_shutter";
	name = "safety shutters button"
	},
/turf/open/floor/pod,
/area/shuttle/crow/helm)
"Qy" = (
/turf/closed/wall/mineral/titanium,
/area/shuttle/crow/engineering)
"QL" = (
/obj/effect/turf_decal/bot,
/obj/effect/decal/cleanable/dirt,
/turf/open/floor/iron,
/area/shuttle/crow/cargo)
"Rh" = (
/turf/closed/wall/mineral/titanium,
/area/shuttle/crow)
"Rs" = (
/obj/machinery/door/airlock,
/obj/structure/cable,
/obj/machinery/door/firedoor,
/obj/machinery/atmospherics/pipe/smart/manifold4w/scrubbers/hidden,
/turf/open/floor/pod,
/area/shuttle/crow)
"RX" = (
/obj/machinery/atmospherics/pipe/smart/manifold4w/orange/visible,
/obj/structure/sign/poster/random{
	pixel_x = 32
	},
/turf/open/floor/iron,
/area/shuttle/crow/cargo)
"Sy" = (
/obj/machinery/atmospherics/pipe/smart/manifold4w/orange/visible,
/obj/effect/turf_decal/bot,
/obj/effect/decal/cleanable/dirt,
/obj/structure/closet/crate,
/turf/open/floor/iron,
/area/shuttle/crow/cargo)
"SC" = (
/obj/structure/cable,
/obj/effect/decal/cleanable/dirt,
/obj/machinery/atmospherics/pipe/smart/manifold4w/scrubbers/hidden,
/turf/open/floor/iron,
/area/shuttle/crow)
"SG" = (
/obj/structure/reagent_dispensers/watertank,
/obj/effect/turf_decal/bot,
/obj/effect/decal/cleanable/dirt,
/obj/item/mop,
/obj/item/reagent_containers/glass/bucket,
/turf/open/floor/iron,
/area/shuttle/crow/cargo)
"SL" = (
/obj/machinery/atmospherics/components/tank/air{
	dir = 1
	},
/obj/effect/decal/cleanable/dirt,
/turf/open/floor/plating,
/area/shuttle/crow/engineering)
"Vc" = (
/obj/machinery/door/airlock/external/glass,
/obj/machinery/door/firedoor,
/turf/open/floor/iron,
/area/shuttle/crow)
"VB" = (
/obj/structure/cable,
/obj/machinery/atmospherics/components/unary/vent_pump/on{
	dir = 1
	},
/obj/machinery/atmospherics/pipe/smart/manifold4w/scrubbers/hidden,
/turf/open/floor/iron,
/area/shuttle/crow)
"Wo" = (
/obj/effect/decal/cleanable/dirt,
/obj/machinery/atmospherics/components/unary/vent_pump/on{
	dir = 4
	},
/turf/open/floor/plating,
/area/shuttle/crow)
"Ww" = (
/obj/machinery/power/port_gen/pacman{
	anchored = 1
	},
/obj/structure/cable,
/obj/effect/decal/cleanable/dirt,
/turf/open/floor/plating,
/area/shuttle/crow/engineering)
"WL" = (
/obj/structure/cable,
/obj/machinery/light/small/directional/west,
/obj/effect/decal/cleanable/dirt,
/obj/structure/chair/comfy/shuttle{
	dir = 4
	},
/obj/machinery/firealarm/directional/west,
/obj/machinery/atmospherics/pipe/smart/manifold4w/supply/hidden,
/turf/open/floor/pod,
/area/shuttle/crow)
"WN" = (
/obj/machinery/atmospherics/pipe/smart/manifold4w/supply/hidden,
/turf/open/floor/iron,
/area/shuttle/crow/cargo)
"Zo" = (
/turf/closed/wall/mineral/titanium,
/area/shuttle/crow/cargo)
"ZC" = (
/obj/effect/decal/cleanable/dirt,
/obj/structure/chair/comfy/shuttle{
	dir = 4
	},
/turf/open/floor/pod,
/area/shuttle/crow/helm)

(1,1,1) = {"
Zo
gn
gn
Zo
jL
jL
jL
Zo
gn
gn
Zo
"}
(2,1,1) = {"
Zo
wM
wM
Zo
Zo
Zo
Zo
Zo
wM
wM
Zo
"}
(3,1,1) = {"
eT
lR
dd
Ic
sB
wt
Lp
Sy
CR
SG
Zo
"}
(4,1,1) = {"
eT
iP
KJ
fM
HK
qb
gX
yZ
RX
jH
Zo
"}
(5,1,1) = {"
eT
QL
QL
iP
WN
hB
Zo
Qy
Qy
AU
Zo
"}
(6,1,1) = {"
Zo
uY
Dy
gD
WN
eb
Zo
bZ
NJ
qM
Qy
"}
(7,1,1) = {"
Zo
Zo
Zo
Zo
Cc
ne
Qy
Dt
DX
cS
Qy
"}
(8,1,1) = {"
Gz
nK
Pc
Vc
uQ
VB
Qy
KC
bw
Ww
Qy
"}
(9,1,1) = {"
Eq
OP
Wo
Vc
Fz
SC
oH
zn
AN
kN
Qy
"}
(10,1,1) = {"
Rh
CG
MH
hk
zS
FP
JJ
iX
fJ
SL
Qy
"}
(11,1,1) = {"
OI
OI
LG
OI
OI
Rs
hk
Rh
Rh
Rh
Qy
"}
(12,1,1) = {"
OI
hD
og
vj
ec
HV
WL
Bt
Fg
um
Qy
"}
(13,1,1) = {"
dm
PR
ZC
IN
lI
gR
mR
DO
Hu
fw
jh
"}
(14,1,1) = {"
dm
dm
pL
AB
OI
tN
np
uo
hn
jh
jh
"}
(15,1,1) = {"
jL
dm
dm
OI
OI
Rh
jh
jh
jh
jh
jL
"}
