//MAP CONVERTED BY dmm2tgm.py THIS HEADER COMMENT PREVENTS RECONVERSION, DO NOT REMOVE
"cS" = (
/obj/structure/table/reinforced/plastitaniumglass,
/obj/machinery/cell_charger,
/obj/item/stock_parts/cell/high,
/turf/open/floor/iron/smooth_large,
/area/shuttle/crow)
"dd" = (
/obj/effect/turf_decal/bot,
/obj/structure/rack/shelf,
/obj/item/storage/toolbox/mechanical,
/obj/item/flashlight,
/obj/item/stack/sheet/mineral/titanium{
	amount = 30
	},
/obj/item/storage/box/lights/mixed,
/turf/open/floor/iron/smooth_large,
/area/shuttle/crow)
"dm" = (
/obj/structure/fluff/metalpole/end/right{
	dir = 1
	},
/obj/structure/fluff/metalpole,
/turf/template_noop,
/area/shuttle/crow)
"ec" = (
/obj/structure/closet/emcloset/anchored,
/obj/effect/turf_decal/bot,
/turf/open/floor/iron/shuttle/cargo,
/area/shuttle/crow)
"eT" = (
/obj/structure/fluff/metalpole/end/right,
/turf/template_noop,
/area/shuttle/crow)
"fw" = (
/obj/structure/chair/comfy/shuttle{
	dir = 4
	},
/turf/open/floor/iron/shuttle/cargo,
/area/shuttle/crow)
"fJ" = (
/obj/effect/turf_decal/delivery/white,
/obj/machinery/door/airlock/shuttle/glass,
/obj/machinery/door/firedoor,
/obj/machinery/atmospherics/pipe/smart/manifold4w/supply/hidden/layer4,
/obj/machinery/atmospherics/pipe/smart/manifold4w/scrubbers/hidden/layer2,
/turf/open/floor/iron/smooth_large,
/area/shuttle/crow)
"fM" = (
/obj/machinery/atmospherics/pipe/smart/manifold4w/supply/hidden/layer4,
/obj/machinery/atmospherics/components/unary/vent_scrubber/on/layer2{
	dir = 4
	},
/turf/open/floor/iron/shuttle/cargo,
/area/shuttle/crow)
"gn" = (
/turf/closed/wall/mineral/plastitanium,
/area/shuttle/crow)
"gR" = (
/obj/machinery/atmospherics/components/unary/engine{
	dir = 8
	},
/obj/effect/turf_decal/stripes/line{
	dir = 8
	},
/turf/open/floor/plating/airless,
/area/shuttle/crow)
"gX" = (
/obj/machinery/power/smes/engineering{
	charge = 1e+006
	},
/obj/structure/cable,
/obj/machinery/light/cold/directional/east,
/turf/open/floor/iron/smooth_large,
/area/shuttle/crow)
"hk" = (
/obj/structure/chair/comfy/shuttle{
	dir = 8
	},
/obj/effect/turf_decal/bot_white,
/obj/machinery/firealarm/directional/north,
/turf/open/floor/iron/smooth_large,
/area/shuttle/crow)
"hn" = (
/obj/machinery/modular_computer/console/preset/engineering,
/obj/effect/turf_decal/bot_white,
/turf/open/floor/iron/smooth_large,
/area/shuttle/crow)
"hB" = (
/obj/machinery/atmospherics/components/unary/vent_pump/on/layer4{
	dir = 1
	},
/turf/open/floor/iron/shuttle/cargo,
/area/shuttle/crow)
"jL" = (
/turf/template_noop,
/area/template_noop)
"kN" = (
/obj/structure/rack/shelf,
/obj/item/storage/firstaid/regular,
/obj/item/storage/inflatable,
/obj/item/clothing/mask/breath,
/obj/item/clothing/mask/breath,
/obj/item/clothing/mask/breath{
	pixel_y = 3
	},
/obj/item/clothing/mask/breath{
	pixel_y = 3
	},
/obj/effect/turf_decal/bot,
/obj/machinery/light/cold/directional/south,
/turf/open/floor/iron/smooth_large,
/area/shuttle/crow)
"lI" = (
/obj/structure/shuttle/engine/heater{
	dir = 8
	},
/obj/effect/spawner/structure/window/reinforced/plasma/plastitanium,
/obj/machinery/atmospherics/pipe/smart/manifold4w/orange/visible,
/turf/open/floor/plating,
/area/shuttle/crow)
"mR" = (
/obj/machinery/atmospherics/components/unary/portables_connector/visible,
/obj/machinery/portable_atmospherics/canister/carbon_dioxide,
/obj/effect/turf_decal/bot,
/obj/machinery/light/cold/directional/north,
/turf/open/floor/iron/smooth_large,
/area/shuttle/crow)
"np" = (
/obj/machinery/atmospherics/components/binary/pump,
/obj/machinery/atmospherics/pipe/smart/manifold4w/scrubbers/hidden/layer2,
/obj/machinery/airalarm/directional/east,
/turf/open/floor/iron/shuttle/cargo,
/area/shuttle/crow)
"nK" = (
/obj/effect/turf_decal/stripes/white/line{
	dir = 8
	},
/obj/effect/turf_decal/stripes/white/line{
	dir = 4
	},
/obj/machinery/atmospherics/components/unary/vent_pump/on/layer4,
/turf/open/floor/iron/smooth_half{
	dir = 1
	},
/area/shuttle/crow)
"og" = (
/obj/effect/turf_decal/delivery/white,
/obj/machinery/door/airlock/engineering/glass,
/obj/structure/cable,
/obj/machinery/atmospherics/pipe/smart/manifold4w/supply/hidden/layer4,
/obj/machinery/atmospherics/pipe/smart/manifold4w/scrubbers/hidden/layer2,
/turf/open/floor/iron/smooth_large,
/area/shuttle/crow)
"oH" = (
/obj/structure/extinguisher_cabinet/directional/east,
/turf/open/floor/iron/shuttle/cargo,
/area/shuttle/crow)
"qb" = (
/obj/structure/cable,
/turf/open/floor/iron/shuttle/cargo,
/area/shuttle/crow)
"sB" = (
/obj/machinery/atmospherics/pipe/smart/manifold4w/orange/visible,
/obj/machinery/atmospherics/components/unary/portables_connector/visible/layer2{
	dir = 4
	},
/obj/machinery/portable_atmospherics/canister/tier_2,
/obj/effect/turf_decal/bot,
/turf/open/floor/iron/smooth_large,
/area/shuttle/crow)
"tN" = (
/obj/structure/cable,
/obj/machinery/atmospherics/pipe/smart/manifold4w/supply/hidden/layer4,
/obj/machinery/atmospherics/pipe/smart/manifold4w/scrubbers/hidden/layer2,
/obj/structure/tank_dispenser/oxygen,
/obj/effect/turf_decal/bot_white,
/turf/open/floor/iron/smooth_large,
/area/shuttle/crow)
"um" = (
/obj/machinery/atmospherics/components/unary/vent_scrubber/on/layer2{
	dir = 1
	},
/turf/open/floor/iron/shuttle/cargo,
/area/shuttle/crow)
"vj" = (
/obj/machinery/computer/crew,
/obj/effect/turf_decal/bot_white,
/turf/open/floor/iron/smooth_large,
/area/shuttle/crow)
"wt" = (
/obj/machinery/atmospherics/pipe/smart/manifold4w/orange/visible,
/obj/machinery/meter,
/turf/open/floor/iron/shuttle/cargo,
/area/shuttle/crow)
"yZ" = (
/obj/machinery/power/terminal{
	dir = 1
	},
/obj/structure/cable,
/obj/machinery/firealarm/directional/east,
/turf/open/floor/catwalk_floor,
/area/shuttle/crow)
"zn" = (
/obj/structure/cable,
/obj/machinery/power/apc/auto_name/directional/east,
/turf/open/floor/iron/shuttle/cargo,
/area/shuttle/crow)
"zS" = (
/obj/structure/chair/comfy/shuttle{
	dir = 8
	},
/obj/effect/turf_decal/bot_white,
/obj/machinery/light/cold/directional/east,
/turf/open/floor/iron/smooth_large,
/area/shuttle/crow)
"AB" = (
/obj/structure/rack/shelf,
/obj/effect/turf_decal/bot,
/obj/item/storage/toolbox/emergency,
/obj/effect/spawner/random/engineering/tool,
/obj/effect/spawner/random/engineering/flashlight,
/obj/machinery/firealarm/directional/south,
/turf/open/floor/iron/smooth_large,
/area/shuttle/crow)
"AN" = (
/obj/machinery/atmospherics/pipe/smart/manifold4w/supply/hidden/layer4,
/obj/machinery/atmospherics/pipe/smart/manifold4w/scrubbers/hidden/layer2,
/turf/open/floor/iron/shuttle/cargo,
/area/shuttle/crow)
"Bt" = (
/obj/structure/table/reinforced/plastitaniumglass,
/obj/machinery/recharger,
/obj/machinery/airalarm/directional/north,
/turf/open/floor/iron/smooth_large,
/area/shuttle/crow)
"Cc" = (
/obj/structure/cable,
/obj/machinery/atmospherics/pipe/smart/manifold4w/supply/hidden/layer4,
/obj/machinery/atmospherics/pipe/smart/manifold4w/scrubbers/hidden/layer2,
/turf/open/floor/iron/shuttle/cargo,
/area/shuttle/crow)
"CR" = (
/obj/structure/rack/shelf,
/obj/item/stack/sheet/mineral/plasma/thirty,
/obj/effect/turf_decal/bot,
/turf/open/floor/iron/smooth_large,
/area/shuttle/crow)
"Fg" = (
/obj/machinery/atmospherics/components/unary/vent_pump/on/layer4{
	dir = 8
	},
/obj/machinery/atmospherics/pipe/smart/manifold4w/scrubbers/hidden/layer2,
/turf/open/floor/iron/shuttle/cargo,
/area/shuttle/crow)
"Fz" = (
/obj/machinery/atmospherics/components/unary/vent_scrubber/on/layer2{
	dir = 8
	},
/turf/open/floor/iron/shuttle/cargo,
/area/shuttle/crow)
"FP" = (
/obj/structure/chair/comfy/shuttle{
	dir = 8
	},
/obj/effect/turf_decal/bot_white,
/turf/open/floor/iron/smooth_large,
/area/shuttle/crow)
"Gz" = (
/obj/structure/fans/tiny,
/obj/docking_port/mobile{
	dir = 2;
	dwidth = 7;
	height = 11;
	id = "crow";
	launch_status = 0;
	name = "ESS Crow";
	overmap_shuttle_type = /datum/overmap_object/shuttle/ess_crow;
	port_direction = 8;
	preferred_direction = 4;
	width = 15
	},
/obj/effect/turf_decal/delivery/white,
/obj/machinery/door/airlock/external/glass,
/turf/open/floor/iron/smooth_large,
/area/shuttle/crow)
"Hu" = (
/obj/machinery/computer/shuttle/exploration_crow,
/obj/machinery/button/door{
	id = "crow_shutter";
	name = "safety shutters button";
	pixel_y = 24
	},
/obj/effect/turf_decal/bot_white,
/obj/machinery/light/cold/directional/north,
/turf/open/floor/iron/smooth_large,
/area/shuttle/crow)
"HK" = (
/obj/machinery/atmospherics/pipe/smart/manifold4w/orange/visible,
/obj/structure/cable,
/obj/machinery/atmospherics/pipe/smart/manifold4w/supply/hidden/layer4,
/obj/machinery/atmospherics/components/binary/pump/on/layer2{
	dir = 8
	},
/turf/open/floor/iron/shuttle/cargo,
/area/shuttle/crow)
"HV" = (
/obj/structure/table/reinforced/plastitaniumglass,
/obj/item/binoculars,
/turf/open/floor/iron/smooth_large,
/area/shuttle/crow)
"KC" = (
/obj/structure/cable,
/obj/machinery/atmospherics/pipe/smart/manifold4w/supply/hidden/layer4,
/obj/machinery/atmospherics/pipe/smart/manifold4w/scrubbers/hidden/layer2,
/obj/structure/rack,
/obj/item/pickaxe/mini,
/obj/item/pickaxe/mini{
	pixel_y = 3
	},
/obj/item/pickaxe/mini{
	pixel_y = 6
	},
/obj/effect/turf_decal/bot,
/turf/open/floor/iron/smooth_large,
/area/shuttle/crow)
"KJ" = (
/obj/machinery/atmospherics/components/tank/air{
	piping_layer = 4
	},
/obj/effect/turf_decal/bot_white,
/obj/structure/extinguisher_cabinet/directional/north,
/turf/open/floor/iron/smooth_large,
/area/shuttle/crow)
"NJ" = (
/obj/structure/closet/excavation,
/obj/effect/turf_decal/bot,
/turf/open/floor/iron/smooth_large,
/area/shuttle/crow)
"OP" = (
/obj/effect/turf_decal/bot,
/obj/machinery/portable_atmospherics/canister/oxygen,
/turf/open/floor/iron/shuttle/cargo,
/area/shuttle/crow)
"Pc" = (
/obj/effect/turf_decal/delivery/white,
/obj/machinery/door/airlock/external/glass,
/obj/machinery/atmospherics/pipe/smart/manifold4w/supply/hidden/layer4,
/turf/open/floor/iron/smooth_large,
/area/shuttle/crow)
"PR" = (
/obj/structure/fluff/metalpole,
/obj/structure/fluff/metalpole{
	dir = 1
	},
/turf/template_noop,
/area/shuttle/crow)
"Qy" = (
/obj/machinery/atmospherics/components/unary/vent_pump/on/layer4{
	dir = 4
	},
/obj/machinery/airalarm/directional/west,
/turf/open/floor/iron/shuttle/cargo,
/area/shuttle/crow)
"Rh" = (
/turf/closed/wall/mineral/titanium,
/area/shuttle/crow)
"RX" = (
/obj/structure/cable,
/obj/machinery/power/port_gen/pacman{
	anchored = 1
	},
/obj/effect/turf_decal/bot,
/turf/open/floor/iron/smooth_large,
/area/shuttle/crow)
"Sy" = (
/obj/machinery/atmospherics/pipe/smart/manifold4w/orange/visible,
/turf/open/floor/iron/shuttle/cargo,
/area/shuttle/crow)
"SC" = (
/turf/open/floor/iron/shuttle/cargo,
/area/shuttle/crow)
"SG" = (
/turf/closed/wall/mineral/plastitanium/nodiagonal,
/area/shuttle/crow)
"Vc" = (
/obj/machinery/atmospherics/pipe/smart/manifold4w/supply/hidden/layer4,
/turf/open/floor/iron/shuttle/cargo,
/area/shuttle/crow)
"VB" = (
/obj/structure/cable,
/obj/machinery/atmospherics/pipe/smart/manifold4w/supply/hidden/layer4,
/obj/machinery/atmospherics/pipe/smart/manifold4w/scrubbers/hidden/layer2,
/obj/structure/closet/syndicate,
/obj/item/storage/bag/ore,
/obj/item/mining_scanner,
/obj/item/flashlight,
/obj/effect/turf_decal/bot,
/turf/open/floor/iron/smooth_large,
/area/shuttle/crow)
"Wo" = (
/obj/effect/spawner/structure/window/reinforced/shuttle,
/obj/machinery/door/poddoor/preopen{
	id = "crow_shutter"
	},
/turf/open/floor/plating,
/area/shuttle/crow)
"Ww" = (
/obj/structure/table/reinforced/plastitaniumglass,
/obj/item/gps/mining,
/obj/machinery/firealarm/directional/south,
/turf/open/floor/iron/smooth_large,
/area/shuttle/crow)
"WN" = (
/obj/machinery/atmospherics/pipe/smart/manifold4w/orange/visible,
/obj/structure/cable,
/obj/machinery/atmospherics/pipe/smart/manifold4w/supply/hidden/layer4,
/obj/machinery/atmospherics/pipe/smart/manifold4w/scrubbers/hidden/layer2,
/turf/open/floor/catwalk_floor,
/area/shuttle/crow)
"Zo" = (
/turf/closed/wall/mineral/titanium/nodiagonal,
/area/shuttle/crow)
"ZC" = (
/obj/structure/fluff/metalpole/end/right{
	dir = 1
	},
/turf/template_noop,
/area/shuttle/crow)

(1,1,1) = {"
jL
gn
gR
gR
gn
jL
gn
gR
gR
gn
jL
"}
(2,1,1) = {"
jL
SG
lI
lI
SG
SG
SG
lI
lI
SG
jL
"}
(3,1,1) = {"
jL
SG
dd
Sy
sB
wt
Sy
Sy
CR
SG
jL
"}
(4,1,1) = {"
jL
Zo
KJ
fM
HK
qb
gX
yZ
RX
Zo
jL
"}
(5,1,1) = {"
jL
Zo
mR
np
WN
hB
Zo
Zo
Zo
Zo
jL
"}
(6,1,1) = {"
Rh
Zo
Zo
Zo
og
Wo
Zo
NJ
NJ
Zo
Rh
"}
(7,1,1) = {"
Zo
ec
Wo
SC
Cc
SC
Qy
SC
SC
cS
Zo
"}
(8,1,1) = {"
Gz
nK
Pc
Vc
VB
VB
tN
KC
AN
Ww
Zo
"}
(9,1,1) = {"
Zo
OP
Wo
SC
Fz
SC
oH
zn
AN
kN
Zo
"}
(10,1,1) = {"
Rh
Zo
Zo
hk
zS
FP
Zo
Zo
fJ
Wo
Zo
"}
(11,1,1) = {"
jL
Zo
Zo
Zo
Zo
Zo
Zo
vj
AN
AB
Zo
"}
(12,1,1) = {"
jL
Zo
Rh
jL
jL
jL
Zo
Bt
Fg
um
Wo
"}
(13,1,1) = {"
jL
PR
ZC
jL
jL
jL
Rh
Zo
Hu
fw
Wo
"}
(14,1,1) = {"
jL
dm
jL
jL
jL
jL
jL
Wo
hn
HV
Wo
"}
(15,1,1) = {"
jL
eT
jL
jL
jL
jL
jL
Zo
Wo
Wo
Rh
"}
