//MAP CONVERTED BY dmm2tgm.py THIS HEADER COMMENT PREVENTS RECONVERSION, DO NOT REMOVE
"bH" = (
/obj/machinery/door/firedoor,
/obj/structure/fans/tiny,
/turf/open/floor/iron/dark/textured_large,
/area/shuttle/syndicate/slaver)
"dT" = (
/obj/machinery/door/firedoor,
/obj/structure/fans/tiny,
/obj/docking_port/mobile/pirate{
	dheight = 1;
	dwidth = 12;
	height = 21;
	name = "EFSS 'Christian'";
	port_direction = 4;
	preferred_direction = 4;
	width = 40
	},
/turf/open/floor/iron/dark/textured_large,
/area/shuttle/syndicate/slaver)
"ef" = (
/obj/machinery/door/firedoor,
/obj/structure/fans/tiny,
/obj/machinery/door/airlock/external/glass{
	id_tag = "prisonshipwreckdock";
	req_one_access_txt = "150"
	},
/turf/open/floor/iron/dark,
/area/shuttle/syndicate/slaver)
"ei" = (
/turf/template_noop,
/area/template_noop)
"fg" = (
/obj/structure/shuttle/engine/propulsion/right{
	dir = 8
	},
/turf/open/floor/plating/airless,
/area/shuttle/syndicate/slaver)
"hd" = (
/obj/machinery/computer/camera_advanced{
	dir = 8
	},
/turf/open/floor/iron/dark,
/area/shuttle/syndicate/slaver)
"nK" = (
/obj/structure/window/shuttle/spaceship,
/obj/structure/grille,
/turf/open/floor/plating,
/area/shuttle/syndicate/slaver)
"sd" = (
/obj/machinery/door/firedoor,
/obj/structure/fans/tiny,
/turf/open/floor/iron/dark,
/area/shuttle/syndicate/slaver)
"tM" = (
/obj/machinery/computer/camera_advanced/shuttle_docker/syndicate/pirate{
	dir = 8
	},
/turf/open/floor/iron/dark,
/area/shuttle/syndicate/slaver)
"wd" = (
/turf/closed/wall/mineral/titanium/spaceship,
/area/shuttle/syndicate/slaver)
"Tb" = (
/obj/machinery/computer/shuttle/pirate{
	dir = 8
	},
/turf/open/floor/iron/dark,
/area/shuttle/syndicate/slaver)
"Ye" = (
/obj/structure/shuttle/engine/heater{
	dir = 8
	},
/obj/structure/window/reinforced{
	dir = 4
	},
/turf/open/floor/plating/airless,
/area/shuttle/syndicate/slaver)
"ZH" = (
/turf/closed/wall/mineral/titanium/spaceship/nodiagonal,
/area/shuttle/syndicate/slaver)
"ZR" = (
/turf/open/floor/iron/dark,
/area/shuttle/syndicate/slaver)

(1,1,1) = {"
ei
wd
fg
fg
fg
fg
fg
wd
ei
ei
ei
ei
ei
wd
fg
fg
fg
fg
fg
wd
ei
"}
(2,1,1) = {"
wd
ZH
Ye
Ye
Ye
Ye
Ye
ZH
wd
ei
ei
ei
wd
ZH
Ye
Ye
Ye
Ye
Ye
ZH
wd
"}
(3,1,1) = {"
ZH
ZR
ZR
ZR
ZR
ZR
ZR
ZR
ZH
ZH
ZH
ZH
ZH
ZR
ZR
ZR
ZR
ZR
ZR
ZR
ZH
"}
(4,1,1) = {"
ZH
ZR
ZR
ZR
ZR
ZR
ZR
ZR
ZR
ZR
ZR
ZR
ZR
ZR
ZR
ZR
ZR
ZR
ZR
ZR
ZH
"}
(5,1,1) = {"
ZH
ZR
ZR
ZR
ZR
ZR
ZR
ZR
ZR
ZR
ZR
ZR
ZR
ZR
ZR
ZR
ZR
ZR
ZR
ZR
ZH
"}
(6,1,1) = {"
ZH
ZR
ZR
ZR
ZR
ZR
ZR
ZR
ZR
ZR
ZR
ZR
ZR
ZR
ZR
ZR
ZR
ZR
ZR
ZR
ZH
"}
(7,1,1) = {"
ZH
ZR
ZR
ZR
ZR
ZR
ZR
ZR
ZR
ZR
ZR
ZR
ZR
ZR
ZR
ZR
ZR
ZR
ZR
ZR
ZH
"}
(8,1,1) = {"
ZH
ZR
ZR
ZR
ZR
ZR
ZR
ZR
ZR
ZR
ZR
ZR
ZR
ZR
ZR
ZR
ZR
ZR
ZR
ZR
ZH
"}
(9,1,1) = {"
ZH
ZR
ZR
ZR
ZR
ZR
ZR
ZR
ZR
ZR
ZR
ZR
ZR
ZR
ZR
ZR
ZR
ZR
ZR
ZR
ZH
"}
(10,1,1) = {"
ZH
ZR
ZR
ZR
ZR
ZR
ZR
ZR
ZR
ZR
ZR
ZR
ZR
ZR
ZR
ZR
ZR
ZR
ZR
ZR
ZH
"}
(11,1,1) = {"
wd
ZR
ZR
ZR
ZR
ZR
ZR
ZR
ZR
ZR
ZR
ZR
ZR
ZR
ZR
ZR
ZR
ZR
ZR
ZR
wd
"}
(12,1,1) = {"
ZH
ZR
ZR
ZR
ZR
ZR
ZR
ZR
ZR
ZR
ZR
ZR
ZR
ZR
ZR
ZR
ZR
ZR
ZR
ZR
ZH
"}
(13,1,1) = {"
bH
ZR
ZR
ZR
ZR
ZR
ZR
ZR
ZR
ZR
ZR
ZR
ZR
ZR
ZR
ZR
ZR
ZR
ZR
ZR
dT
"}
(14,1,1) = {"
ZH
ZH
ZR
ZR
ZR
ZR
ZR
ZR
ZR
ZR
ZR
ZR
ZR
ZR
ZR
ZR
ZR
ZR
ZR
ZH
ZH
"}
(15,1,1) = {"
ei
ZH
ZR
ZR
ZR
ZR
ZR
ZR
ZR
ZR
ZR
ZR
ZR
ZR
ZR
ZR
ZR
ZR
ZR
ZH
ei
"}
(16,1,1) = {"
ei
ZH
ZR
ZR
ZR
ZR
ZR
ZR
ZR
ZR
ZR
ZR
ZR
ZR
ZR
ZR
ZR
ZR
ZR
ZH
ei
"}
(17,1,1) = {"
ei
ZH
ZR
ZR
ZR
ZR
ZR
ZR
ZR
ZR
ZR
ZR
ZR
ZR
ZR
ZR
ZR
ZR
ZR
ZH
ei
"}
(18,1,1) = {"
ei
ZH
ZR
ZR
ZR
ZR
ZR
ZR
ZR
ZR
ZR
ZR
ZR
ZR
ZR
ZR
ZR
ZR
ZR
ZH
ei
"}
(19,1,1) = {"
ei
ZH
ZR
ZR
ZR
ZR
ZR
ZR
ZR
ZR
ZR
ZR
ZR
ZR
ZR
ZR
ZR
ZR
ZR
ZH
ei
"}
(20,1,1) = {"
ei
ZH
ZR
ZR
ZR
ZR
ZR
ZR
ZR
ZR
ZR
ZR
ZR
ZR
ZR
ZR
ZR
ZR
ZR
ZH
ei
"}
(21,1,1) = {"
wd
ZH
ZR
ZR
ZR
ZR
ZR
ZR
ZR
ZR
ZR
ZR
ZR
ZR
ZR
ZR
ZR
ZR
ZR
ZH
wd
"}
(22,1,1) = {"
ZH
ZR
ZR
ZR
ZR
ZR
ZR
ZR
ZR
ZR
ZR
ZR
ZR
ZR
ZR
ZR
ZR
ZR
ZR
ZR
ZH
"}
(23,1,1) = {"
ZH
ZR
ZR
ZR
ZR
ZR
ZR
ZR
ZR
ZR
ZR
ZR
ZR
ZR
ZR
ZR
ZR
ZR
ZR
ZR
ZH
"}
(24,1,1) = {"
ZH
ZR
ZR
ZR
ZR
ZR
ZR
ZR
ZR
ZR
ZR
ZR
ZR
ZR
ZR
ZR
ZR
ZR
ZR
ZR
ZH
"}
(25,1,1) = {"
ZH
ZR
ZR
ZR
ZR
ZR
ZR
ZR
ZR
ZR
ZR
ZR
ZR
ZR
ZR
ZR
ZR
ZR
ZR
ZR
ZH
"}
(26,1,1) = {"
ZH
ZR
ZR
ZR
ZR
ZR
ZR
ZR
ZR
ZR
ZR
ZR
ZR
ZR
ZR
ZR
ZR
ZR
ZR
ZR
ZH
"}
(27,1,1) = {"
ZH
ZR
ZR
ZR
ZR
ZR
ZR
ZR
ZR
ZR
ZR
ZR
ZR
ZR
ZR
ZR
ZR
ZR
ZR
ZR
ZH
"}
(28,1,1) = {"
ZH
ZR
ZR
ZR
ZR
ZR
ZR
ZR
ZR
ZR
ZR
ZR
ZR
ZR
ZR
ZR
ZR
ZR
ZR
ZR
ZH
"}
(29,1,1) = {"
ZH
ZR
ZR
ZR
ZR
ZR
ZR
ZR
ZR
ZR
ZR
ZR
ZR
ZR
ZR
ZR
ZR
ZR
ZR
ZR
ZH
"}
(30,1,1) = {"
wd
ZH
ZR
ZR
ZR
ZR
ZR
ZR
ZR
ZR
ZR
ZR
ZR
ZR
ZR
ZR
ZR
ZR
ZR
ZH
wd
"}
(31,1,1) = {"
ei
wd
ZH
ZR
ZR
ZR
ZR
ZR
ZR
ZR
ZR
ZR
ZR
ZR
ZR
ZR
ZR
ZR
ZH
wd
ei
"}
(32,1,1) = {"
ei
ei
ZH
ZH
ZR
ZH
ZH
ZH
ZH
ZR
ZR
ZR
ZH
ZH
ZH
ZH
ZR
ZH
ZH
ei
ei
"}
(33,1,1) = {"
ei
ei
ef
ZR
ZR
ZR
ZH
ZR
ZR
ZR
ZR
ZR
ZR
ZR
ZH
ZR
ZR
ZR
sd
ei
ei
"}
(34,1,1) = {"
ei
ei
ZH
ZR
ZR
ZR
ZH
ZR
ZR
ZR
ZR
ZR
ZR
ZR
ZH
ZR
ZR
ZR
ZH
ei
ei
"}
(35,1,1) = {"
ei
ei
ZH
ZR
ZR
ZR
ZR
ZR
ZR
ZR
ZR
ZR
ZR
ZR
ZR
ZR
ZR
ZR
ZH
ei
ei
"}
(36,1,1) = {"
ei
ei
ZH
ZR
ZR
ZR
ZH
ZR
ZR
ZR
ZR
ZR
ZR
ZR
ZH
ZR
ZR
ZR
ZH
ei
ei
"}
(37,1,1) = {"
ei
ei
ZH
ZR
ZR
ZR
ZH
ZR
ZR
ZR
ZR
ZR
ZR
ZR
ZH
ZR
ZR
ZR
ZH
ei
ei
"}
(38,1,1) = {"
ei
ei
wd
ZH
ZH
ZH
ZH
ZR
ZR
ZR
ZR
ZR
ZR
ZR
ZH
ZH
ZH
ZH
wd
ei
ei
"}
(39,1,1) = {"
ei
ei
ei
ei
ei
ei
wd
ZH
ZH
hd
Tb
tM
ZH
ZH
wd
ei
ei
ei
ei
ei
ei
"}
(40,1,1) = {"
ei
ei
ei
ei
ei
ei
ei
ei
wd
nK
nK
nK
wd
ei
ei
ei
ei
ei
ei
ei
ei
"}
