//MAP CONVERTED BY dmm2tgm.py THIS HEADER COMMENT PREVENTS RECONVERSION, DO NOT REMOVE
"ac" = (
/obj/structure/shuttle/engine/propulsion/left,
/obj/effect/turf_decal/stripes/full,
/turf/open/floor/plating,
/area/shuttle/syndicate/slaver)
"ao" = (
/obj/effect/spawner/structure/window/shuttle,
/obj/machinery/door/poddoor/shutters/window/preopen{
	id = "prisontransportcell3";
	name = "Lockdown"
	},
/turf/open/floor/plating,
/area/shuttle/syndicate/slaver)
"ay" = (
/turf/template_noop,
/area/template_noop)
"aH" = (
/obj/effect/turf_decal/trimline/brown/warning{
	dir = 1
	},
/obj/effect/turf_decal/vg_decals/numbers/one,
/turf/open/floor/iron/smooth_half,
/area/shuttle/syndicate/slaver)
"bD" = (
/obj/effect/spawner/structure/window/shuttle,
/obj/machinery/door/poddoor/shutters/window/preopen{
	id = "prisontransportcell9";
	name = "Lockdown"
	},
/turf/open/floor/plating,
/area/shuttle/syndicate/slaver)
"bR" = (
/obj/effect/turf_decal/trimline/brown/warning{
	dir = 1
	},
/turf/open/floor/iron/smooth_half,
/area/shuttle/syndicate/slaver)
"dx" = (
/obj/machinery/door/poddoor/shutters/window/preopen{
	id = "prisontransportcell11";
	name = "Lockdown"
	},
/obj/effect/turf_decal/loading_area/red{
	dir = 4
	},
/turf/open/floor/iron/smooth,
/area/shuttle/syndicate/slaver)
"dW" = (
/obj/effect/spawner/structure/window/shuttle,
/obj/machinery/door/poddoor/shutters/window/preopen{
	id = "prisontransportcell10";
	name = "Lockdown"
	},
/turf/open/floor/plating,
/area/shuttle/syndicate/slaver)
"ey" = (
/obj/effect/spawner/structure/window/shuttle,
/obj/machinery/door/poddoor/shutters/window/preopen{
	id = "prisontransportcell2";
	name = "Lockdown"
	},
/turf/open/floor/plating,
/area/shuttle/syndicate/slaver)
"fA" = (
/obj/machinery/door/poddoor/shutters/window/preopen{
	id = "prisontransportcell1";
	name = "Lockdown"
	},
/obj/effect/turf_decal/loading_area/red{
	dir = 8
	},
/turf/open/floor/iron/smooth,
/area/shuttle/syndicate/slaver)
"fE" = (
/obj/effect/turf_decal/trimline/brown/warning,
/obj/machinery/door/poddoor/shutters/window/preopen{
	id = "prisontransportlockdown";
	name = "Lockdown"
	},
/obj/machinery/button{
	id = "prisontransportcell6";
	name = "Cell Lockdown";
	pixel_x = -22
	},
/turf/open/floor/iron/smooth_half,
/area/shuttle/syndicate/slaver)
"fR" = (
/turf/closed/wall/mineral/titanium,
/area/shuttle/syndicate/slaver)
"gp" = (
/obj/structure/bed/maint,
/obj/machinery/light/cold/no_nightlight/directional/north,
/turf/open/floor/iron/shuttle/evac{
	icon_state = "floorsec2"
	},
/area/shuttle/syndicate/slaver)
"gS" = (
/obj/effect/turf_decal/trimline/brown/warning,
/obj/machinery/door/poddoor/shutters/window/preopen{
	id = "prisontransportlockdown";
	name = "Lockdown"
	},
/obj/machinery/button{
	id = "prisontransportcell13";
	name = "Cell Lockdown";
	pixel_x = 22
	},
/obj/machinery/light/cold/no_nightlight/directional/east,
/turf/open/floor/iron/smooth_half,
/area/shuttle/syndicate/slaver)
"hD" = (
/obj/effect/turf_decal/trimline/brown/warning{
	dir = 1
	},
/obj/effect/turf_decal/vg_decals/numbers/nine,
/turf/open/floor/iron/smooth_half,
/area/shuttle/syndicate/slaver)
"hE" = (
/turf/open/floor/iron/dark/blue,
/area/shuttle/syndicate/slaver)
"ik" = (
/obj/machinery/door/poddoor/shutters/window/preopen{
	id = "prisontransportcell13";
	name = "Lockdown"
	},
/obj/effect/turf_decal/loading_area/red{
	dir = 4
	},
/turf/open/floor/iron/smooth,
/area/shuttle/syndicate/slaver)
"iw" = (
/obj/structure/mirror/directional/south,
/obj/machinery/shower{
	dir = 1
	},
/obj/effect/turf_decal/weather/dirt,
/turf/open/floor/iron/shuttle/evac{
	icon_state = "floorsec2"
	},
/area/shuttle/syndicate/slaver)
"iX" = (
/obj/effect/turf_decal/trimline/brown/warning{
	dir = 1
	},
/obj/effect/turf_decal/vg_decals/numbers/three,
/turf/open/floor/iron/smooth_half,
/area/shuttle/syndicate/slaver)
"jn" = (
/obj/effect/turf_decal/trimline/brown/warning{
	dir = 1
	},
/obj/effect/turf_decal/vg_decals/numbers/seven,
/turf/open/floor/iron/smooth_half,
/area/shuttle/syndicate/slaver)
"jR" = (
/obj/effect/spawner/structure/window/shuttle,
/obj/machinery/door/poddoor/shutters/window/preopen{
	id = "prisontransportcell1";
	name = "Lockdown"
	},
/turf/open/floor/plating,
/area/shuttle/syndicate/slaver)
"lD" = (
/obj/machinery/computer/shuttle/white_ship/bridge{
	name = "Flight Control"
	},
/turf/open/floor/iron/dark/blue/side,
/area/shuttle/syndicate/slaver)
"mO" = (
/obj/structure/toilet{
	dir = 4
	},
/obj/effect/turf_decal/weather/dirt{
	dir = 10
	},
/turf/open/floor/iron/shuttle/evac{
	icon_state = "floorsec2"
	},
/area/shuttle/syndicate/slaver)
"mY" = (
/obj/effect/spawner/structure/window/shuttle,
/obj/machinery/door/poddoor/shutters/window/preopen{
	id = "prisontransportcell11";
	name = "Lockdown"
	},
/turf/open/floor/plating,
/area/shuttle/syndicate/slaver)
"nq" = (
/turf/closed/wall/mineral/titanium/nodiagonal,
/area/shuttle/syndicate/slaver)
"nF" = (
/obj/machinery/door/poddoor/shutters/window/preopen{
	id = "prisontransportcell2";
	name = "Lockdown"
	},
/obj/effect/turf_decal/loading_area/red{
	dir = 8
	},
/turf/open/floor/iron/smooth,
/area/shuttle/syndicate/slaver)
"nS" = (
/obj/effect/spawner/structure/window/shuttle,
/obj/machinery/door/poddoor/shutters/window/preopen{
	id = "prisontransportcell14";
	name = "Lockdown"
	},
/turf/open/floor/plating,
/area/shuttle/syndicate/slaver)
"ok" = (
/obj/effect/turf_decal/trimline/brown/warning,
/obj/machinery/door/poddoor/shutters/window/preopen{
	id = "prisontransportlockdown";
	name = "Lockdown"
	},
/obj/machinery/button{
	id = "prisontransportcell3";
	name = "Cell Lockdown";
	pixel_x = -22
	},
/obj/machinery/light/cold/no_nightlight/directional/west,
/turf/open/floor/iron/smooth_half,
/area/shuttle/syndicate/slaver)
"ol" = (
/obj/structure/chair/comfy/shuttle{
	dir = 1
	},
/turf/open/floor/iron/dark/blue,
/area/shuttle/syndicate/slaver)
"oA" = (
/obj/machinery/door/airlock/external/glass,
/turf/open/floor/iron/smooth,
/area/shuttle/syndicate/slaver)
"pc" = (
/obj/machinery/light/cold/no_nightlight/directional/west,
/obj/structure/rack/shelf,
/obj/item/shield/riot,
/obj/item/shield/riot,
/obj/item/shield/riot,
/obj/item/shield/riot,
/obj/item/melee/classic_baton/peacekeeper,
/obj/item/melee/classic_baton/peacekeeper,
/obj/item/melee/classic_baton/peacekeeper,
/obj/item/melee/classic_baton/peacekeeper,
/turf/open/floor/iron/dark,
/area/shuttle/syndicate/slaver)
"pi" = (
/obj/machinery/door/poddoor/shutters/window/preopen{
	id = "prisontransportcell3";
	name = "Lockdown"
	},
/obj/effect/turf_decal/loading_area/red{
	dir = 8
	},
/turf/open/floor/iron/smooth,
/area/shuttle/syndicate/slaver)
"pp" = (
/obj/structure/sign/nanotrasen,
/turf/closed/wall/mineral/titanium/nodiagonal,
/area/shuttle/syndicate/slaver)
"py" = (
/obj/machinery/door/poddoor/shutters/window/preopen{
	id = "prisontransportcell5";
	name = "Lockdown"
	},
/obj/effect/turf_decal/loading_area/red{
	dir = 8
	},
/turf/open/floor/iron/smooth,
/area/shuttle/syndicate/slaver)
"qf" = (
/obj/effect/turf_decal/trimline/brown/warning,
/obj/machinery/door/poddoor/shutters/window/preopen{
	id = "prisontransportlockdown";
	name = "Lockdown"
	},
/obj/machinery/button{
	id = "prisontransportcell12";
	name = "Cell Lockdown";
	pixel_x = 22
	},
/turf/open/floor/iron/smooth_half,
/area/shuttle/syndicate/slaver)
"ru" = (
/obj/structure/fence/door/opened{
	dir = 8
	},
/turf/open/floor/iron/dark/blue/side{
	dir = 4
	},
/area/shuttle/syndicate/slaver)
"rJ" = (
/obj/structure/tank_dispenser/oxygen,
/turf/open/floor/iron/smooth,
/area/shuttle/syndicate/slaver)
"rK" = (
/obj/effect/turf_decal/trimline/brown/warning{
	dir = 1
	},
/obj/effect/turf_decal/vg_decals/numbers/eight,
/turf/open/floor/iron/smooth_half,
/area/shuttle/syndicate/slaver)
"sf" = (
/obj/effect/turf_decal/trimline/brown/warning,
/obj/machinery/door/poddoor/shutters/window/preopen{
	id = "prisontransportlockdown";
	name = "Lockdown"
	},
/obj/machinery/button{
	id = "prisontransportcell2";
	name = "Cell Lockdown";
	pixel_x = -22
	},
/turf/open/floor/iron/smooth_half,
/area/shuttle/syndicate/slaver)
"sG" = (
/obj/structure/chair/greyscale,
/obj/effect/turf_decal/weather/dirt{
	dir = 5
	},
/obj/structure/sign/poster/official/no_erp{
	pixel_y = 32
	},
/turf/open/floor/iron/shuttle/evac{
	icon_state = "floorsec2"
	},
/area/shuttle/syndicate/slaver)
"sQ" = (
/obj/effect/turf_decal/trimline/brown/warning{
	dir = 1
	},
/obj/effect/turf_decal/vg_decals/numbers/five,
/turf/open/floor/iron/smooth_half,
/area/shuttle/syndicate/slaver)
"tl" = (
/obj/effect/turf_decal/trimline/brown/warning,
/obj/machinery/door/poddoor/shutters/window/preopen{
	id = "prisontransportlockdown";
	name = "Lockdown"
	},
/obj/machinery/button{
	id = "prisontransportcell7";
	name = "Cell Lockdown";
	pixel_x = -22
	},
/obj/machinery/light/cold/no_nightlight/directional/west,
/turf/open/floor/iron/smooth_half,
/area/shuttle/syndicate/slaver)
"tp" = (
/obj/machinery/door/poddoor/shutters/window/preopen{
	id = "prisontransportcell14";
	name = "Lockdown"
	},
/obj/effect/turf_decal/loading_area/red{
	dir = 4
	},
/turf/open/floor/iron/smooth,
/area/shuttle/syndicate/slaver)
"tC" = (
/obj/structure/table/reinforced,
/obj/item/paper/carbon,
/obj/item/pen,
/obj/effect/turf_decal/weather/dirt{
	dir = 6
	},
/turf/open/floor/iron/shuttle/evac{
	icon_state = "floorsec2"
	},
/area/shuttle/syndicate/slaver)
"tY" = (
/obj/machinery/light/red/directional/west,
/obj/structure/tank_dispenser/oxygen,
/turf/open/floor/iron/smooth,
/area/shuttle/syndicate/slaver)
"ua" = (
/obj/structure/chair/greyscale,
/obj/effect/turf_decal/weather/dirt{
	dir = 5
	},
/turf/open/floor/iron/shuttle/evac{
	icon_state = "floorsec2"
	},
/area/shuttle/syndicate/slaver)
"ub" = (
/obj/machinery/door/airlock/command{
	name = "Cockpit";
	req_access_txt = "101"
	},
/turf/open/floor/iron/dark/blue,
/area/shuttle/syndicate/slaver)
"ul" = (
/obj/effect/spawner/structure/window/shuttle,
/obj/machinery/door/poddoor/shutters/window/preopen{
	id = "prisontransportcell4";
	name = "Lockdown"
	},
/turf/open/floor/plating,
/area/shuttle/syndicate/slaver)
"vf" = (
/obj/machinery/light/cold/no_nightlight/directional/east,
/obj/structure/chair/comfy/shuttle,
/turf/open/floor/iron/dark/blue/side{
	dir = 8
	},
/area/shuttle/syndicate/slaver)
"vl" = (
/obj/effect/spawner/structure/window/shuttle,
/obj/machinery/door/poddoor/shutters/window/preopen{
	id = "prisontransportcell12";
	name = "Lockdown"
	},
/turf/open/floor/plating,
/area/shuttle/syndicate/slaver)
"vP" = (
/obj/machinery/door/airlock/command{
	name = "Flight Deck";
	req_access_txt = "101"
	},
/turf/open/floor/iron/dark/blue,
/area/shuttle/syndicate/slaver)
"wP" = (
/obj/effect/turf_decal/trimline/brown/warning,
/obj/machinery/door/poddoor/shutters/window/preopen{
	id = "prisontransportlockdown";
	name = "Lockdown"
	},
/obj/machinery/button{
	id = "prisontransportcell4";
	name = "Cell Lockdown";
	pixel_x = -22
	},
/turf/open/floor/iron/smooth_half,
/area/shuttle/syndicate/slaver)
"xc" = (
/obj/effect/turf_decal/trimline/brown/warning,
/obj/machinery/button{
	id = "prisontransportcell1";
	name = "Cell Lockdown";
	pixel_x = -22
	},
/obj/machinery/light/cold/no_nightlight/directional/west,
/turf/open/floor/iron/smooth_half,
/area/shuttle/syndicate/slaver)
"xG" = (
/turf/open/floor/iron/shuttle/evac{
	icon_state = "floorsec2"
	},
/area/shuttle/syndicate/slaver)
"xV" = (
/obj/effect/spawner/structure/window/shuttle,
/obj/machinery/door/poddoor/shutters/window/preopen{
	id = "prisontransportcell7";
	name = "Lockdown"
	},
/turf/open/floor/plating,
/area/shuttle/syndicate/slaver)
"yi" = (
/obj/structure/chair/comfy/shuttle,
/turf/open/floor/iron/dark/blue/side{
	dir = 8
	},
/area/shuttle/syndicate/slaver)
"yU" = (
/obj/effect/turf_decal/trimline/brown/warning,
/obj/machinery/door/poddoor/shutters/window/preopen{
	id = "prisontransportlockdown";
	name = "Lockdown"
	},
/obj/machinery/button{
	id = "prisontransportcell10";
	name = "Cell Lockdown";
	pixel_x = 22
	},
/turf/open/floor/iron/smooth_half,
/area/shuttle/syndicate/slaver)
"yX" = (
/obj/machinery/suit_storage_unit/mining/eva,
/turf/open/floor/iron/smooth,
/area/shuttle/syndicate/slaver)
"zq" = (
/obj/effect/turf_decal/trimline/brown/warning,
/obj/machinery/button{
	id = "prisontransportcell14";
	name = "Cell Lockdown";
	pixel_x = 22
	},
/turf/open/floor/iron/smooth_half,
/area/shuttle/syndicate/slaver)
"zF" = (
/obj/machinery/door/poddoor/shutters/window/preopen{
	id = "prisontransportcell9";
	name = "Lockdown"
	},
/obj/effect/turf_decal/loading_area/red{
	dir = 4
	},
/turf/open/floor/iron/smooth,
/area/shuttle/syndicate/slaver)
"Ab" = (
/obj/effect/turf_decal/trimline/brown/warning{
	dir = 1
	},
/obj/effect/turf_decal/vg_decals/numbers/four,
/turf/open/floor/iron/smooth_half,
/area/shuttle/syndicate/slaver)
"Am" = (
/obj/machinery/door/poddoor/shutters/window/preopen{
	id = "prisontransportcell7";
	name = "Lockdown"
	},
/obj/effect/turf_decal/loading_area/red{
	dir = 8
	},
/turf/open/floor/iron/smooth,
/area/shuttle/syndicate/slaver)
"AS" = (
/obj/structure/sign/warning/vacuum,
/turf/closed/wall/mineral/titanium,
/area/shuttle/syndicate/slaver)
"BN" = (
/obj/effect/spawner/structure/window/shuttle,
/obj/machinery/door/poddoor/shutters/window/preopen{
	id = "prisontransportcell8";
	name = "Lockdown"
	},
/turf/open/floor/plating,
/area/shuttle/syndicate/slaver)
"Ce" = (
/obj/machinery/door/poddoor/shutters/window/preopen{
	id = "prisontransportcell10";
	name = "Lockdown"
	},
/obj/effect/turf_decal/loading_area/red{
	dir = 4
	},
/turf/open/floor/iron/smooth,
/area/shuttle/syndicate/slaver)
"Cg" = (
/obj/effect/spawner/structure/window/shuttle,
/obj/machinery/door/poddoor/shutters/window/preopen{
	id = "prisontransportcell6";
	name = "Lockdown"
	},
/turf/open/floor/plating,
/area/shuttle/syndicate/slaver)
"CM" = (
/obj/effect/turf_decal/trimline/brown/warning{
	dir = 1
	},
/obj/effect/turf_decal/vg_decals/numbers/two,
/turf/open/floor/iron/smooth_half,
/area/shuttle/syndicate/slaver)
"DS" = (
/obj/structure/table/reinforced,
/obj/machinery/light/cold/no_nightlight/directional/north,
/obj/item/storage/box/handcuffs,
/turf/open/floor/iron/dark/blue/side{
	dir = 8
	},
/area/shuttle/syndicate/slaver)
"EN" = (
/obj/effect/turf_decal/stripes/full,
/obj/structure/shuttle/engine/propulsion/left,
/turf/open/floor/plating,
/area/shuttle/syndicate/slaver)
"EY" = (
/obj/structure/table/reinforced,
/obj/machinery/button{
	id = "prisontransportlockdown";
	name = "Interior Lockdown Shutters";
	pixel_x = -8;
	pixel_y = 8
	},
/obj/machinery/button{
	id = "prisontransportouter";
	name = "Exterior Blast Doors";
	pixel_x = 7;
	pixel_y = 8
	},
/turf/open/floor/iron/dark/blue/side,
/area/shuttle/syndicate/slaver)
"EZ" = (
/obj/effect/turf_decal/trimline/brown/warning,
/obj/effect/turf_decal/skyrat_decals/departments/bridge,
/turf/open/floor/iron/smooth_half,
/area/shuttle/syndicate/slaver)
"Fh" = (
/obj/machinery/door/airlock/external/glass,
/obj/machinery/door/poddoor/preopen{
	id = "prisontransportouter"
	},
/obj/docking_port/mobile{
	callTime = 250;
	dwidth = 11;
	height = 17;
	id = "prison_transport";
	launch_status = 0;
	movement_force = list("KNOCKDOWN" = 0, "THROW" = 0);
	name = "Prison Transporter NSS-74";
	preferred_direction = 2;
	width = 34
	},
/turf/open/floor/iron/dark/smooth_large,
/area/shuttle/syndicate/slaver)
"Fj" = (
/obj/structure/table/reinforced,
/obj/item/paper/carbon,
/obj/item/pen,
/obj/effect/turf_decal/weather/dirt{
	dir = 10
	},
/turf/open/floor/iron/shuttle/evac{
	icon_state = "floorsec2"
	},
/area/shuttle/syndicate/slaver)
"Fz" = (
/obj/effect/spawner/structure/window/shuttle,
/obj/machinery/door/poddoor/shutters/window/preopen{
	id = "prisontransportcell5";
	name = "Lockdown"
	},
/turf/open/floor/plating,
/area/shuttle/syndicate/slaver)
"FU" = (
/obj/effect/turf_decal/caution,
/turf/open/floor/iron/smooth,
/area/shuttle/syndicate/slaver)
"Gg" = (
/obj/machinery/light/red/directional/east,
/obj/machinery/suit_storage_unit/mining/eva,
/turf/open/floor/iron/smooth,
/area/shuttle/syndicate/slaver)
"Gp" = (
/obj/effect/spawner/structure/window/shuttle,
/obj/machinery/door/poddoor/preopen{
	id = "prisontransportouter"
	},
/turf/open/floor/plating,
/area/shuttle/syndicate/slaver)
"GF" = (
/obj/effect/turf_decal/trimline/brown/warning{
	dir = 1
	},
/obj/effect/turf_decal/vg_decals/numbers/six,
/turf/open/floor/iron/smooth_half,
/area/shuttle/syndicate/slaver)
"Ho" = (
/obj/machinery/door/poddoor/shutters/window/preopen{
	id = "prisontransportcell6";
	name = "Lockdown"
	},
/obj/effect/turf_decal/loading_area/red{
	dir = 8
	},
/turf/open/floor/iron/smooth,
/area/shuttle/syndicate/slaver)
"Hz" = (
/obj/structure/toilet{
	dir = 8
	},
/obj/effect/turf_decal/weather/dirt{
	dir = 6
	},
/turf/open/floor/iron/shuttle/evac{
	icon_state = "floorsec2"
	},
/area/shuttle/syndicate/slaver)
"IO" = (
/obj/effect/turf_decal/caution/stand_clear/red{
	dir = 4
	},
/obj/effect/turf_decal/bot_red,
/turf/open/floor/iron/smooth,
/area/shuttle/syndicate/slaver)
"Ke" = (
/obj/effect/turf_decal/caution/stand_clear/red{
	dir = 8
	},
/obj/effect/turf_decal/bot_red,
/turf/open/floor/iron/smooth,
/area/shuttle/syndicate/slaver)
"KJ" = (
/obj/structure/chair/greyscale,
/obj/effect/turf_decal/weather/dirt{
	dir = 9
	},
/obj/structure/sign/poster/official/no_erp{
	pixel_y = 32
	},
/turf/open/floor/iron/shuttle/evac{
	icon_state = "floorsec2"
	},
/area/shuttle/syndicate/slaver)
"ME" = (
/obj/effect/turf_decal/trimline/brown/warning,
/obj/machinery/door/poddoor/shutters/window/preopen{
	id = "prisontransportlockdown";
	name = "Lockdown"
	},
/obj/machinery/button{
	id = "prisontransportcell5";
	name = "Cell Lockdown";
	pixel_x = -22
	},
/obj/machinery/light/cold/no_nightlight/directional/west,
/turf/open/floor/iron/smooth_half,
/area/shuttle/syndicate/slaver)
"Nk" = (
/obj/effect/turf_decal/trimline/brown/warning{
	dir = 1
	},
/obj/effect/turf_decal/vg_decals/numbers/zero,
/turf/open/floor/iron/smooth_half,
/area/shuttle/syndicate/slaver)
"NO" = (
/obj/effect/turf_decal/trimline/brown/warning,
/obj/machinery/door/poddoor/shutters/window/preopen{
	id = "prisontransportlockdown";
	name = "Lockdown"
	},
/obj/machinery/button{
	id = "prisontransportcell9";
	name = "Cell Lockdown";
	pixel_x = 22
	},
/obj/machinery/light/cold/no_nightlight/directional/east,
/turf/open/floor/iron/smooth_half,
/area/shuttle/syndicate/slaver)
"Or" = (
/obj/structure/rack/shelf,
/obj/item/clothing/suit/armor/riot,
/obj/item/clothing/suit/armor/riot,
/obj/item/clothing/suit/armor/riot,
/obj/item/clothing/suit/armor/riot,
/obj/item/clothing/head/helmet/riot,
/obj/item/clothing/head/helmet/riot,
/obj/item/clothing/head/helmet/riot,
/obj/item/clothing/head/helmet/riot,
/turf/open/floor/iron/dark,
/area/shuttle/syndicate/slaver)
"Qw" = (
/obj/effect/spawner/structure/window/shuttle,
/obj/machinery/door/poddoor/shutters/window/preopen{
	id = "prisontransportcell13";
	name = "Lockdown"
	},
/turf/open/floor/plating,
/area/shuttle/syndicate/slaver)
"Rb" = (
/obj/effect/turf_decal/caution{
	dir = 1
	},
/turf/open/floor/iron/smooth,
/area/shuttle/syndicate/slaver)
"Ri" = (
/obj/structure/chair/greyscale,
/obj/effect/turf_decal/weather/dirt{
	dir = 9
	},
/turf/open/floor/iron/shuttle/evac{
	icon_state = "floorsec2"
	},
/area/shuttle/syndicate/slaver)
"RA" = (
/obj/machinery/door/poddoor/shutters/window/preopen{
	id = "prisontransportlockdown";
	name = "Lockdown"
	},
/turf/open/floor/iron/smooth,
/area/shuttle/syndicate/slaver)
"Sa" = (
/obj/structure/sign/poster/official/report_crimes,
/turf/closed/wall/mineral/titanium,
/area/shuttle/syndicate/slaver)
"St" = (
/turf/open/floor/iron/smooth,
/area/shuttle/syndicate/slaver)
"Su" = (
/obj/machinery/light/cold/no_nightlight/directional/north,
/obj/item/gun/ballistic/automatic/cfa_wildcat/no_mag,
/obj/item/ammo_box/magazine/multi_sprite/cfa_wildcat/rubber,
/obj/item/ammo_box/magazine/multi_sprite/cfa_wildcat/rubber,
/obj/item/ammo_box/magazine/multi_sprite/cfa_wildcat/rubber,
/obj/structure/rack/shelf,
/turf/open/floor/iron/dark/blue/side{
	dir = 4
	},
/area/shuttle/syndicate/slaver)
"SQ" = (
/obj/structure/chair/comfy/shuttle,
/turf/open/floor/iron/dark/blue,
/area/shuttle/syndicate/slaver)
"Tb" = (
/obj/machinery/shower{
	dir = 1
	},
/obj/structure/mirror/directional/south,
/obj/effect/turf_decal/weather/dirt,
/turf/open/floor/iron/shuttle/evac{
	icon_state = "floorsec2"
	},
/area/shuttle/syndicate/slaver)
"Tj" = (
/obj/machinery/door/poddoor/shutters/window/preopen{
	id = "prisontransportcell12";
	name = "Lockdown"
	},
/obj/effect/turf_decal/loading_area/red{
	dir = 4
	},
/turf/open/floor/iron/smooth,
/area/shuttle/syndicate/slaver)
"Tr" = (
/obj/machinery/computer/camera_advanced/shuttle_docker/whiteship{
	name = "Navigations"
	},
/turf/open/floor/iron/dark/blue/side,
/area/shuttle/syndicate/slaver)
"UG" = (
/obj/effect/turf_decal/trimline/brown/warning,
/obj/machinery/door/poddoor/shutters/window/preopen{
	id = "prisontransportlockdown";
	name = "Lockdown"
	},
/obj/machinery/button{
	id = "prisontransportcell8";
	name = "Cell Lockdown";
	pixel_x = 22
	},
/turf/open/floor/iron/smooth_half,
/area/shuttle/syndicate/slaver)
"Ws" = (
/obj/effect/turf_decal/trimline/brown/warning,
/obj/machinery/door/poddoor/shutters/window/preopen{
	id = "prisontransportlockdown";
	name = "Lockdown"
	},
/obj/machinery/button{
	id = "prisontransportcell11";
	name = "Cell Lockdown";
	pixel_x = 22
	},
/obj/machinery/light/cold/no_nightlight/directional/east,
/turf/open/floor/iron/smooth_half,
/area/shuttle/syndicate/slaver)
"WL" = (
/obj/machinery/door/poddoor/shutters/window/preopen{
	id = "prisontransportcell4";
	name = "Lockdown"
	},
/obj/effect/turf_decal/loading_area/red{
	dir = 8
	},
/turf/open/floor/iron/smooth,
/area/shuttle/syndicate/slaver)
"Xu" = (
/obj/effect/turf_decal/trimline/brown/warning,
/obj/machinery/door/poddoor/shutters/window/preopen{
	id = "prisontransportlockdown";
	name = "Lockdown"
	},
/turf/open/floor/iron/smooth_half,
/area/shuttle/syndicate/slaver)
"XB" = (
/obj/machinery/door/poddoor/shutters/window/preopen{
	id = "prisontransportcell8";
	name = "Lockdown"
	},
/obj/effect/turf_decal/loading_area/red{
	dir = 4
	},
/turf/open/floor/iron/smooth,
/area/shuttle/syndicate/slaver)
"Yw" = (
/obj/structure/sign/nanotrasen,
/turf/closed/wall/mineral/titanium,
/area/shuttle/syndicate/slaver)
"Zi" = (
/obj/machinery/door/poddoor/preopen{
	id = "prisontransportouter"
	},
/obj/effect/spawner/structure/window/shuttle,
/turf/open/floor/plating,
/area/shuttle/syndicate/slaver)
"ZF" = (
/obj/effect/turf_decal/delivery,
/turf/open/floor/iron/smooth,
/area/shuttle/syndicate/slaver)

(1,1,1) = {"
ay
ay
ay
ay
ay
ay
ay
fR
Gp
Gp
fR
Gp
Gp
fR
Gp
Gp
Yw
Gp
Gp
fR
Gp
Gp
fR
Gp
Gp
fR
Gp
Gp
nq
EN
ay
ay
ay
"}
(2,1,1) = {"
ay
ay
ay
ay
ay
ay
ay
Yw
Ri
Fj
fR
KJ
Fj
fR
Ri
Fj
fR
Ri
Fj
fR
Ri
Fj
fR
Ri
Fj
fR
KJ
Fj
fR
ac
ay
ay
ay
"}
(3,1,1) = {"
ay
ay
ay
ay
ay
ay
fR
fR
gp
iw
fR
gp
iw
fR
gp
iw
fR
gp
iw
fR
gp
iw
fR
gp
iw
fR
gp
iw
fR
ac
ay
ay
ay
"}
(4,1,1) = {"
ay
ay
ay
ay
ay
fR
nq
fR
xG
Hz
fR
xG
Hz
fR
xG
Hz
fR
xG
Hz
fR
xG
Hz
fR
xG
Hz
fR
xG
Hz
fR
EN
ay
ay
ay
"}
(5,1,1) = {"
ay
fR
Gp
fR
Gp
nq
nq
nq
fA
jR
nq
nF
ey
nq
pi
ao
nq
WL
ul
nq
py
Fz
nq
Ho
Cg
nq
Am
xV
nq
fR
fR
fR
ay
"}
(6,1,1) = {"
fR
nq
Su
fR
Or
pc
Sa
xc
IO
aH
sf
IO
CM
ok
IO
iX
wP
IO
Ab
ME
IO
sQ
fE
IO
GF
tl
IO
jn
nq
tY
rJ
nq
pp
"}
(7,1,1) = {"
Zi
Tr
ol
fR
ru
ru
fR
EZ
St
bR
Xu
St
bR
Xu
St
bR
Xu
St
bR
Xu
St
bR
Xu
St
bR
Xu
St
bR
Sa
ZF
ZF
St
AS
"}
(8,1,1) = {"
Gp
EY
hE
ub
hE
hE
vP
St
St
St
RA
St
St
RA
St
St
RA
St
St
RA
St
St
RA
St
St
RA
St
FU
oA
Rb
St
FU
Fh
"}
(9,1,1) = {"
Gp
lD
ol
fR
SQ
SQ
fR
EZ
St
aH
Xu
St
aH
Xu
St
aH
Xu
St
aH
Xu
St
aH
Xu
St
bR
Xu
St
bR
Sa
ZF
ZF
St
fR
"}
(10,1,1) = {"
fR
nq
DS
fR
yi
vf
Sa
zq
Ke
Ab
gS
Ke
iX
qf
Ke
CM
Ws
Ke
aH
yU
Ke
Nk
NO
Ke
hD
UG
Ke
rK
nq
Gg
yX
nq
pp
"}
(11,1,1) = {"
ay
fR
Gp
fR
Gp
nq
nq
nq
tp
nS
nq
ik
Qw
nq
Tj
vl
nq
dx
mY
nq
Ce
dW
nq
zF
bD
nq
XB
BN
nq
fR
fR
fR
ay
"}
(12,1,1) = {"
ay
ay
ay
ay
ay
fR
nq
fR
xG
mO
fR
xG
mO
fR
xG
mO
fR
xG
mO
fR
xG
mO
fR
xG
mO
fR
xG
mO
fR
EN
ay
ay
ay
"}
(13,1,1) = {"
ay
ay
ay
ay
ay
ay
fR
fR
gp
Tb
fR
gp
Tb
fR
gp
Tb
fR
gp
Tb
fR
gp
Tb
fR
gp
Tb
fR
gp
Tb
fR
ac
ay
ay
ay
"}
(14,1,1) = {"
ay
ay
ay
ay
ay
ay
ay
Yw
ua
tC
fR
ua
tC
fR
ua
tC
fR
ua
tC
fR
sG
tC
fR
ua
tC
fR
ua
tC
fR
EN
ay
ay
ay
"}
(15,1,1) = {"
ay
ay
ay
ay
ay
ay
ay
fR
Gp
Gp
fR
Gp
Gp
fR
Gp
Gp
Yw
Gp
Gp
fR
Gp
Gp
fR
Gp
Gp
fR
Gp
Gp
nq
EN
ay
ay
ay
"}
