//MAP CONVERTED BY dmm2tgm.py THIS HEADER COMMENT PREVENTS RECONVERSION, DO NOT REMOVE
"a" = (
/turf/open/space/basic,
/area/space)
"c" = (
/obj/machinery/computer/shuttle/trader{
	dir = 4;
	possible_destinations = "tradership;tradership_dock;tradership_home;tradership_custom;tradership_away;pirateship_away;pirateship_home;whiteship_away;whiteship_home;whiteship_z4;whiteship_lavaland"
	},
/turf/open/floor/mineral/titanium/yellow,
/area/shuttle/trader)
"d" = (
/obj/structure/chair{
	dir = 4
	},
/turf/open/floor/mineral/titanium/white,
/area/shuttle/trader)
"f" = (
/obj/structure/table/reinforced,
/obj/machinery/door/window{
	dir = 4;
	req_access_txt = "208"
	},
/obj/machinery/door/poddoor/shutters/preopen{
	id = "tradeship";
	name = "Tradeship Shutters"
	},
/turf/open/floor/mineral/titanium/white,
/area/shuttle/trader)
"i" = (
/obj/structure/chair{
	dir = 8
	},
/turf/open/floor/mineral/titanium/white,
/area/shuttle/trader)
"j" = (
/obj/machinery/computer/camera_advanced/shuttle_docker/trader{
	dir = 4
	},
/turf/open/floor/mineral/titanium/yellow,
/area/shuttle/trader)
"k" = (
/turf/closed/wall/mineral/titanium/nodiagonal,
/area/shuttle/trader)
"q" = (
/obj/structure/shuttle/engine/propulsion/burst{
	dir = 4
	},
/turf/open/space/basic,
/area/shuttle/trader)
"s" = (
/turf/closed/wall/mineral/titanium,
/area/shuttle/trader)
"t" = (
/obj/effect/spawner/structure/window/shuttle,
/turf/open/floor/plating,
/area/shuttle/trader)
"v" = (
/obj/structure/table/reinforced,
/obj/structure/window/reinforced{
	dir = 4
	},
/obj/structure/window/reinforced{
	dir = 1
	},
/obj/machinery/door/poddoor/shutters/preopen{
	id = "tradeship";
	name = "Tradeship Shutters"
	},
/turf/open/floor/mineral/titanium/white,
/area/shuttle/trader)
"w" = (
/obj/structure/table,
/obj/item/clothing/mask/cigarette/cigar,
/turf/open/floor/mineral/titanium/yellow,
/area/shuttle/trader)
"x" = (
/obj/structure/closet/crate,
/obj/item/rack_parts,
/obj/item/rack_parts,
/turf/open/floor/mineral/titanium/white,
/area/shuttle/trader)
"y" = (
/obj/item/radio/intercom{
	pixel_x = -26
	},
/turf/open/floor/mineral/titanium/white,
/area/shuttle/trader)
"A" = (
/obj/machinery/door/window{
	dir = 4;
	req_access_txt = "208"
	},
/obj/machinery/door/poddoor/shutters/preopen{
	id = "tradeship";
	name = "Tradeship Shutters"
	},
/obj/machinery/button/door{
	id = "tradeship";
	name = "Shutter Controls";
	pixel_y = -26;
	req_access_txt = "208"
	},
/turf/open/floor/mineral/titanium/white,
/area/shuttle/trader)
"B" = (
/obj/structure/table/reinforced,
/obj/structure/window/reinforced{
	dir = 4
	},
/obj/structure/window/reinforced,
/obj/machinery/door/poddoor/shutters/preopen{
	id = "tradeship";
	name = "Tradeship Shutters"
	},
/turf/open/floor/mineral/titanium/white,
/area/shuttle/trader)
"C" = (
/obj/machinery/door/airlock/external{
	name = "Tradeship Airlock";
	safety_mode = 1
	},
/obj/docking_port/mobile/tradership{
	dwidth = 3;
	height = 8;
	width = 11
	},
/turf/open/floor/mineral/titanium/white,
/area/shuttle/trader)
"H" = (
/obj/structure/table,
/obj/item/stack/sheet/iron/twenty,
/turf/open/floor/mineral/titanium/white,
/area/shuttle/trader)
"I" = (
/obj/structure/table/reinforced,
/obj/structure/window/reinforced{
	dir = 4
	},
/obj/machinery/door/poddoor/shutters/preopen{
	id = "tradeship";
	name = "Tradeship Shutters"
	},
/turf/open/floor/mineral/titanium/white,
/area/shuttle/trader)
"L" = (
/obj/structure/closet,
/turf/open/floor/mineral/titanium/white,
/area/shuttle/trader)
"O" = (
/obj/structure/shuttle/engine/heater{
	dir = 4
	},
/obj/structure/window/reinforced{
	dir = 8
	},
/turf/open/floor/plating,
/area/shuttle/trader)
"P" = (
/obj/structure/window/reinforced{
	dir = 4
	},
/turf/open/floor/mineral/titanium/yellow,
/area/shuttle/trader)
"Q" = (
/obj/structure/table,
/turf/open/floor/mineral/titanium/white,
/area/shuttle/trader)
"R" = (
/obj/structure/window/reinforced{
	dir = 4
	},
/obj/item/radio/intercom{
	pixel_y = -30
	},
/turf/open/floor/mineral/titanium/yellow,
/area/shuttle/trader)
"U" = (
/obj/machinery/door/airlock/external{
	name = "Tradeship Airlock";
	safety_mode = 1
	},
/turf/open/floor/mineral/titanium/white,
/area/shuttle/trader)
"V" = (
/obj/structure/chair{
	dir = 8
	},
/obj/machinery/door/window/eastleft,
/turf/open/floor/mineral/titanium/yellow,
/area/shuttle/trader)
"W" = (
/obj/item/kirbyplants/random,
/turf/open/floor/mineral/titanium/white,
/area/shuttle/trader)
"Z" = (
/turf/open/floor/mineral/titanium/white,
/area/shuttle/trader)

(1,1,1) = {"
a
a
s
t
t
t
s
a
"}
(2,1,1) = {"
a
a
t
w
c
j
t
a
"}
(3,1,1) = {"
a
s
k
P
V
R
k
s
"}
(4,1,1) = {"
a
t
L
d
Z
d
H
t
"}
(5,1,1) = {"
a
t
x
Z
Z
Z
Z
t
"}
(6,1,1) = {"
a
k
Q
Z
d
Z
Z
k
"}
(7,1,1) = {"
s
k
I
B
f
v
A
k
"}
(8,1,1) = {"
C
y
Z
Z
Z
Z
Z
k
"}
(9,1,1) = {"
U
Z
i
i
i
i
W
k
"}
(10,1,1) = {"
s
O
k
t
t
k
O
s
"}
(11,1,1) = {"
a
q
a
a
a
a
q
a
"}
