//MAP CONVERTED BY dmm2tgm.py THIS HEADER COMMENT PREVENTS RECONVERSION, DO NOT REMOVE
"an" = (
/obj/machinery/computer/security/shuttle,
/turf/open/floor/mineral/titanium,
/area/shuttle/transport)
"aO" = (
/turf/closed/wall/mineral/titanium/shuttle_wall/ferry{
	icon_state = "3,9"
	},
/area/shuttle/transport)
"aT" = (
/turf/closed/wall/mineral/titanium/shuttle_wall/ferry{
	icon_state = "16,6"
	},
/area/shuttle/transport)
"aY" = (
/turf/closed/wall/mineral/titanium/shuttle_wall/ferry{
	icon_state = "5,9"
	},
/area/shuttle/transport)
"bI" = (
/obj/machinery/door/airlock/command/glass{
	name = "Cockpit";
	req_access = list("cent_general")
	},
/turf/open/floor/iron/stairs{
	dir = 4
	},
/area/shuttle/transport)
"cb" = (
/obj/machinery/light/red/directional/north,
/obj/effect/turf_decal/caution,
/turf/open/floor/iron/shuttle/ferry,
/area/shuttle/transport)
"cp" = (
/turf/closed/wall/mineral/titanium/shuttle_wall/ferry{
	icon_state = "17,6"
	},
/area/shuttle/transport)
"do" = (
/turf/closed/wall/mineral/titanium/shuttle_wall/ferry,
/area/shuttle/transport)
"el" = (
/turf/closed/wall/mineral/titanium/shuttle_wall/ferry{
	icon_state = "13,3"
	},
/area/shuttle/transport)
"eu" = (
/turf/closed/wall/mineral/titanium/shuttle_wall/window/ferry{
	icon_state = "1,4"
	},
/area/shuttle/transport)
"eE" = (
/turf/closed/wall/mineral/titanium/shuttle_wall/ferry{
	icon_state = "8,8"
	},
/area/shuttle/transport)
"eR" = (
/turf/closed/wall/mineral/titanium/shuttle_wall/ferry{
	icon_state = "17,1"
	},
/area/shuttle/transport)
"fm" = (
/turf/closed/wall/mineral/titanium/shuttle_wall/ferry{
	icon_state = "2,3"
	},
/area/shuttle/transport)
"fn" = (
/turf/closed/wall/mineral/titanium/shuttle_wall/ferry{
	icon_state = "19,2"
	},
/area/shuttle/transport)
"fq" = (
/turf/closed/wall/mineral/titanium/shuttle_wall/ferry{
	icon_state = "14,4"
	},
/area/shuttle/transport)
"ft" = (
/turf/closed/wall/mineral/titanium/shuttle_wall/window/ferry{
	icon_state = "0,5"
	},
/area/shuttle/transport)
"fE" = (
/turf/closed/wall/mineral/titanium/shuttle_wall/ferry{
	icon_state = "2,2"
	},
/area/shuttle/transport)
"fX" = (
/turf/closed/wall/mineral/titanium/shuttle_wall/ferry{
	icon_state = "8,2"
	},
/area/shuttle/transport)
"ge" = (
/turf/closed/wall/mineral/titanium/shuttle_wall/ferry{
	icon_state = "16,5"
	},
/area/shuttle/transport)
"hd" = (
/turf/closed/wall/mineral/titanium/shuttle_wall/ferry{
	icon_state = "7,2"
	},
/area/shuttle/transport)
"hP" = (
/obj/structure/closet/shuttle/emergency{
	dir = 8
	},
/turf/open/floor/iron/shuttle/ferry,
/area/shuttle/transport)
"iG" = (
/turf/open/floor/iron/shuttle/ferry{
	icon_state = "sign_2"
	},
/area/shuttle/transport)
"iN" = (
/obj/structure/chair/comfy/shuttle{
	dir = 8
	},
/turf/open/floor/iron/shuttle/ferry{
	icon_state = "floor"
	},
/area/shuttle/transport)
"jc" = (
/turf/closed/wall/mineral/titanium/shuttle_wall/ferry{
	icon_state = "19,1"
	},
/area/shuttle/transport)
"jj" = (
/turf/closed/wall/mineral/titanium/shuttle_wall/ferry{
	icon_state = "2,8"
	},
/area/shuttle/transport)
"jo" = (
/turf/closed/wall/mineral/titanium/shuttle_wall/ferry{
	icon_state = "16,3"
	},
/area/shuttle/transport)
"kk" = (
/turf/closed/wall/mineral/titanium/shuttle_wall/ferry{
	icon_state = "7,8"
	},
/area/shuttle/transport)
"kE" = (
/obj/structure/table/reinforced,
/obj/item/paper_bin/carbon,
/turf/open/floor/iron/shuttle/ferry,
/area/shuttle/transport)
"kR" = (
/turf/closed/wall/mineral/titanium/shuttle_wall/ferry{
	icon_state = "13,7"
	},
/area/shuttle/transport)
"ls" = (
/turf/closed/wall/mineral/titanium/shuttle_wall/ferry{
	icon_state = "19,8"
	},
/area/shuttle/transport)
"lz" = (
/obj/effect/turf_decal/caution,
/turf/open/floor/iron/shuttle/ferry,
/area/shuttle/transport)
"mB" = (
/turf/closed/wall/mineral/titanium/shuttle_wall/ferry{
	icon_state = "14,5"
	},
/area/shuttle/transport)
"nt" = (
/obj/machinery/computer/crew/shuttle,
/turf/open/floor/mineral/titanium,
/area/shuttle/transport)
"oV" = (
/turf/closed/wall/mineral/titanium/shuttle_wall/ferry{
	icon_state = "18,3"
	},
/area/shuttle/transport)
"pX" = (
/turf/closed/wall/mineral/titanium/shuttle_wall/ferry{
	icon_state = "3,2"
	},
/area/shuttle/transport)
"qE" = (
/turf/closed/wall/mineral/titanium/shuttle_wall/window/ferry{
	icon_state = "1,7"
	},
/area/shuttle/transport)
"ra" = (
/turf/closed/wall/mineral/titanium/shuttle_wall/ferry{
	icon_state = "14,6"
	},
/area/shuttle/transport)
"rM" = (
/turf/closed/wall/mineral/titanium/shuttle_wall/ferry{
	icon_state = "19,7"
	},
/area/shuttle/transport)
"rP" = (
/turf/closed/wall/mineral/titanium/shuttle_wall/ferry{
	icon_state = "18,0"
	},
/area/shuttle/transport)
"sm" = (
/turf/closed/wall/mineral/titanium/shuttle_wall/ferry{
	icon_state = "19,0"
	},
/area/shuttle/transport)
"td" = (
/turf/closed/wall/mineral/titanium/shuttle_wall/ferry{
	icon_state = "13,6"
	},
/area/shuttle/transport)
"tp" = (
/obj/structure/chair/comfy/shuttle{
	dir = 8
	},
/obj/machinery/light/directional/south,
/turf/open/floor/iron/shuttle/ferry,
/area/shuttle/transport)
"ul" = (
/turf/closed/wall/mineral/titanium/shuttle_wall/ferry{
	icon_state = "12,7"
	},
/area/shuttle/transport)
"ut" = (
/turf/closed/wall/mineral/titanium/shuttle_wall/ferry{
	icon_state = "18,6"
	},
/area/shuttle/transport)
"uW" = (
/turf/closed/wall/mineral/titanium/shuttle_wall/ferry{
	icon_state = "18,10"
	},
/area/shuttle/transport)
"wX" = (
/turf/template_noop,
/area/template_noop)
"xq" = (
/turf/closed/wall/mineral/titanium/shuttle_wall/ferry{
	icon_state = "3,1"
	},
/area/shuttle/transport)
"xQ" = (
/turf/closed/wall/mineral/titanium/shuttle_wall/ferry{
	icon_state = "4,1"
	},
/area/shuttle/transport)
"yu" = (
/turf/closed/wall/mineral/titanium/shuttle_wall/ferry{
	icon_state = "17,2"
	},
/area/shuttle/transport)
"yz" = (
/obj/effect/turf_decal/caution{
	dir = 1
	},
/turf/open/floor/iron/shuttle/ferry,
/area/shuttle/transport)
"yF" = (
/turf/closed/wall/mineral/titanium/shuttle_wall/ferry{
	icon_state = "16,7"
	},
/area/shuttle/transport)
"zn" = (
/turf/closed/wall/mineral/titanium/shuttle_wall/ferry{
	icon_state = "18,4"
	},
/area/shuttle/transport)
"zV" = (
/obj/structure/chair/comfy/shuttle{
	dir = 1
	},
/turf/open/floor/iron/shuttle/ferry,
/area/shuttle/transport)
"BM" = (
/turf/closed/wall/mineral/titanium/shuttle_wall/ferry{
	icon_state = "8,7"
	},
/area/shuttle/transport)
"BP" = (
/turf/closed/wall/mineral/titanium/shuttle_wall/ferry{
	icon_state = "19,9"
	},
/area/shuttle/transport)
"Ck" = (
/turf/closed/wall/mineral/titanium/shuttle_wall/ferry{
	icon_state = "3,8"
	},
/area/shuttle/transport)
"Cy" = (
/turf/closed/wall/mineral/titanium/shuttle_wall/ferry{
	icon_state = "8,4"
	},
/area/shuttle/transport)
"CL" = (
/turf/closed/wall/mineral/titanium/shuttle_wall/ferry{
	icon_state = "6,8"
	},
/area/shuttle/transport)
"CR" = (
/turf/closed/wall/mineral/titanium/shuttle_wall/ferry{
	icon_state = "15,4"
	},
/area/shuttle/transport)
"Db" = (
/turf/closed/wall/mineral/titanium/shuttle_wall/ferry{
	icon_state = "18,5"
	},
/area/shuttle/transport)
"Dc" = (
/turf/closed/wall/mineral/titanium/shuttle_wall/ferry{
	icon_state = "8,3"
	},
/area/shuttle/transport)
"Dy" = (
/turf/open/floor/iron/shuttle/ferry,
/area/shuttle/transport)
"DO" = (
/turf/closed/wall/mineral/titanium/shuttle_wall/ferry{
	icon_state = "12,3"
	},
/area/shuttle/transport)
"Er" = (
/turf/closed/wall/mineral/titanium/shuttle_wall/ferry{
	icon_state = "15,6"
	},
/area/shuttle/transport)
"EI" = (
/turf/closed/wall/mineral/titanium/shuttle_wall/window/ferry{
	icon_state = "2,5"
	},
/area/shuttle/transport)
"EK" = (
/turf/closed/wall/mineral/titanium/shuttle_wall/ferry{
	icon_state = "17,8"
	},
/area/shuttle/transport)
"Fg" = (
/turf/closed/wall/mineral/titanium/shuttle_wall/ferry{
	icon_state = "8,6"
	},
/area/shuttle/transport)
"Fh" = (
/turf/closed/wall/mineral/titanium/shuttle_wall/window/ferry{
	icon_state = "2,4"
	},
/area/shuttle/transport)
"Gy" = (
/obj/docking_port/mobile{
	dheight = 7;
	dir = 2;
	dwidth = 8;
	height = 11;
	id = "ferry";
	name = "ferry shuttle";
	port_direction = 8;
	preferred_direction = 8;
	width = 20
	},
/obj/structure/fans/tiny/forcefield,
/obj/machinery/door/airlock/grunge,
/turf/open/floor/iron/shuttle/ferry{
	icon_state = "floor"
	},
/area/shuttle/transport)
"GF" = (
/turf/closed/wall/mineral/titanium/shuttle_wall/window/ferry{
	icon_state = "0,4"
	},
/area/shuttle/transport)
"Hx" = (
/turf/closed/wall/mineral/titanium/shuttle_wall/ferry{
	icon_state = "9,3"
	},
/area/shuttle/transport)
"Ia" = (
/turf/closed/wall/mineral/titanium/shuttle_wall/ferry{
	icon_state = "13,4"
	},
/area/shuttle/transport)
"IR" = (
/obj/item/clothing/suit/armor/bulletproof,
/obj/item/clothing/suit/armor/bulletproof,
/obj/item/clothing/suit/armor/bulletproof,
/obj/item/clothing/head/helmet/alt,
/obj/item/clothing/head/helmet/alt,
/obj/item/clothing/head/helmet/alt,
/obj/structure/closet/shuttle,
/turf/open/floor/iron/shuttle/ferry,
/area/shuttle/transport)
"Jc" = (
/turf/closed/wall/mineral/titanium/shuttle_wall/ferry{
	icon_state = "18,1"
	},
/area/shuttle/transport)
"Jw" = (
/turf/closed/wall/mineral/titanium/shuttle_wall/ferry{
	icon_state = "15,5"
	},
/area/shuttle/transport)
"JS" = (
/turf/closed/wall/mineral/titanium/shuttle_wall/ferry{
	icon_state = "6,1"
	},
/area/shuttle/transport)
"Kp" = (
/turf/closed/wall/mineral/titanium/shuttle_wall/window/ferry{
	icon_state = "1,5"
	},
/area/shuttle/transport)
"KH" = (
/turf/closed/wall/mineral/titanium/shuttle_wall/ferry{
	icon_state = "17,3"
	},
/area/shuttle/transport)
"KL" = (
/turf/closed/wall/mineral/titanium/shuttle_wall/window/ferry{
	icon_state = "1,3"
	},
/area/shuttle/transport)
"Lf" = (
/obj/structure/chair/comfy/shuttle{
	dir = 8
	},
/turf/open/floor/iron/shuttle/ferry,
/area/shuttle/transport)
"LB" = (
/turf/closed/wall/mineral/titanium/shuttle_wall/ferry{
	icon_state = "9,7"
	},
/area/shuttle/transport)
"Mf" = (
/turf/open/floor/iron/shuttle/ferry{
	icon_state = "sign_1"
	},
/area/shuttle/transport)
"Mw" = (
/turf/closed/wall/mineral/titanium/shuttle_wall/ferry{
	icon_state = "19,3"
	},
/area/shuttle/transport)
"Ne" = (
/turf/closed/wall/mineral/titanium/shuttle_wall/ferry{
	icon_state = "19,10"
	},
/area/shuttle/transport)
"NJ" = (
/turf/closed/wall/mineral/titanium/shuttle_wall/ferry{
	icon_state = "6,2"
	},
/area/shuttle/transport)
"NR" = (
/turf/closed/wall/mineral/titanium/shuttle_wall/ferry{
	icon_state = "18,8"
	},
/area/shuttle/transport)
"OF" = (
/obj/machinery/computer/crew/shuttle{
	dir = 4
	},
/turf/open/floor/iron/shuttle/ferry,
/area/shuttle/transport)
"Pk" = (
/turf/closed/wall/mineral/titanium/shuttle_wall/ferry{
	icon_state = "5,1"
	},
/area/shuttle/transport)
"Pm" = (
/turf/closed/wall/mineral/titanium/shuttle_wall/ferry{
	icon_state = "17,5"
	},
/area/shuttle/transport)
"PV" = (
/obj/machinery/computer/security/shuttle{
	dir = 4
	},
/turf/open/floor/iron/shuttle/ferry,
/area/shuttle/transport)
"PW" = (
/turf/closed/wall/mineral/titanium/shuttle_wall/ferry{
	icon_state = "2,7"
	},
/area/shuttle/transport)
"Qf" = (
/turf/closed/wall/mineral/titanium/shuttle_wall/ferry{
	icon_state = "18,9"
	},
/area/shuttle/transport)
"Qg" = (
/obj/structure/fans/tiny/forcefield,
/obj/machinery/door/airlock/grunge,
/turf/open/floor/iron/shuttle/ferry{
	icon_state = "floor"
	},
/area/shuttle/transport)
"Rb" = (
/turf/closed/wall/mineral/titanium/shuttle_wall/ferry{
	icon_state = "16,4"
	},
/area/shuttle/transport)
"Rh" = (
/turf/closed/wall/mineral/titanium/shuttle_wall/ferry{
	icon_state = "17,4"
	},
/area/shuttle/transport)
"RL" = (
/turf/closed/wall/mineral/titanium/shuttle_wall/ferry{
	icon_state = "18,7"
	},
/area/shuttle/transport)
"RM" = (
/turf/closed/wall/mineral/titanium/shuttle_wall/ferry{
	icon_state = "17,7"
	},
/area/shuttle/transport)
"Se" = (
/obj/structure/closet/shuttle/medical{
	dir = 1
	},
/turf/open/floor/iron/shuttle/ferry,
/area/shuttle/transport)
"Tg" = (
/turf/closed/wall/mineral/titanium/shuttle_wall/ferry{
	icon_state = "6,9"
	},
/area/shuttle/transport)
"Ti" = (
/turf/open/floor/iron/shuttle/ferry{
	icon_state = "floor"
	},
/area/shuttle/transport)
"To" = (
/turf/closed/wall/mineral/titanium/shuttle_wall/window/ferry{
	icon_state = "2,6"
	},
/area/shuttle/transport)
"Ui" = (
/turf/closed/wall/mineral/titanium/shuttle_wall/window/ferry{
	icon_state = "1,6"
	},
/area/shuttle/transport)
"Uk" = (
/turf/closed/wall/mineral/titanium/shuttle_wall/ferry{
	icon_state = "17,9"
	},
/area/shuttle/transport)
"VT" = (
/turf/closed/wall/mineral/titanium/shuttle_wall/ferry{
	icon_state = "4,9"
	},
/area/shuttle/transport)
"Xl" = (
/obj/item/mod/control/pre_equipped/responsory/security,
/obj/structure/closet/shuttle{
	dir = 1
	},
/turf/open/floor/iron/shuttle/ferry,
/area/shuttle/transport)
"Yd" = (
/obj/machinery/light/red/directional/south,
/obj/effect/turf_decal/caution{
	dir = 1
	},
/turf/open/floor/iron/shuttle/ferry,
/area/shuttle/transport)
"Ym" = (
/obj/machinery/computer/shuttle/ferry/shuttle{
	dir = 4
	},
/turf/open/floor/iron/shuttle/ferry,
/area/shuttle/transport)
"Yz" = (
/obj/item/gun/energy/e_gun/stun,
/obj/item/gun/energy/e_gun/stun,
/obj/item/gun/energy/e_gun/stun,
/obj/structure/closet/shuttle,
/obj/machinery/light/directional/north,
/turf/open/floor/iron/shuttle/ferry,
/area/shuttle/transport)

(1,1,1) = {"
wX
wX
wX
wX
wX
ft
GF
wX
wX
wX
wX
"}
(2,1,1) = {"
wX
wX
wX
qE
Ui
Kp
eu
KL
wX
wX
wX
"}
(3,1,1) = {"
wX
wX
jj
PW
To
EI
Fh
fm
fE
wX
wX
"}
(4,1,1) = {"
wX
aO
Ck
kE
PV
Ym
OF
kE
pX
xq
wX
"}
(5,1,1) = {"
wX
VT
nt
zV
Dy
iN
Dy
Mf
Se
xQ
wX
"}
(6,1,1) = {"
wX
aY
an
zV
Dy
Ti
Dy
Mf
Xl
Pk
wX
"}
(7,1,1) = {"
wX
Tg
CL
Yz
Mf
Ti
Lf
tp
NJ
JS
wX
"}
(8,1,1) = {"
wX
wX
kk
IR
Mf
Ti
Lf
Lf
hd
wX
wX
"}
(9,1,1) = {"
wX
wX
eE
BM
Fg
bI
Cy
Dc
fX
wX
wX
"}
(10,1,1) = {"
wX
wX
wX
LB
lz
Ti
yz
Hx
wX
wX
wX
"}
(11,1,1) = {"
wX
wX
wX
Qg
iG
Ti
iG
Qg
wX
wX
wX
"}
(12,1,1) = {"
wX
wX
wX
Gy
iG
Ti
iG
Qg
wX
wX
wX
"}
(13,1,1) = {"
wX
wX
wX
ul
cb
Ti
Yd
DO
wX
wX
wX
"}
(14,1,1) = {"
wX
wX
wX
kR
td
hP
Ia
el
wX
wX
wX
"}
(15,1,1) = {"
wX
wX
wX
wX
ra
mB
fq
wX
wX
wX
wX
"}
(16,1,1) = {"
wX
wX
wX
wX
Er
Jw
CR
wX
wX
wX
wX
"}
(17,1,1) = {"
wX
wX
wX
yF
aT
ge
Rb
jo
wX
wX
wX
"}
(18,1,1) = {"
wX
Uk
EK
RM
cp
Pm
Rh
KH
yu
eR
wX
"}
(19,1,1) = {"
uW
Qf
NR
RL
ut
Db
zn
oV
do
Jc
rP
"}
(20,1,1) = {"
Ne
BP
ls
rM
wX
wX
wX
Mw
fn
jc
sm
"}
