//MAP CONVERTED BY dmm2tgm.py THIS HEADER COMMENT PREVENTS RECONVERSION, DO NOT REMOVE
"aa" = (
/obj/structure/table/wood/shuttle_bar,
/obj/item/reagent_containers/cup/rag{
	pixel_x = 10;
	pixel_y = 1
	},
/turf/open/floor/holofloor{
	dir = 9;
	icon_state = "wood"
	},
/area/template_noop)
"ab" = (
/obj/structure/closet/crate/bin,
/turf/open/floor/holofloor{
	dir = 9;
	icon_state = "wood"
	},
/area/template_noop)
"ac" = (
/obj/machinery/door/window/right/directional/east,
/turf/open/floor/holofloor{
	dir = 9;
	icon_state = "wood"
	},
/area/template_noop)
"ad" = (
/obj/structure/table/wood/shuttle_bar,
/turf/open/floor/holofloor{
	dir = 9;
	icon_state = "wood"
	},
/area/template_noop)
"ae" = (
/obj/machinery/door/window/half/right/directional/east,
/turf/open/floor/holofloor/wood,
/area/template_noop)
"af" = (
/obj/structure/table/wood,
/obj/item/flashlight/lamp/green,
/turf/open/floor/holofloor{
	dir = 9;
	icon_state = "wood"
	},
/area/template_noop)
"ag" = (
/obj/structure/table/wood,
/obj/item/cigarette/pipe{
	pixel_y = 8
	},
/obj/effect/holodeck_effect/random_book{
	pixel_y = 8
	},
/turf/open/floor/holofloor/carpet,
/area/template_noop)
"ah" = (
/obj/structure/table/wood,
/obj/item/cigarette/pipe,
/obj/effect/holodeck_effect/random_book,
/turf/open/floor/holofloor/carpet,
/area/template_noop)
"ai" = (
/obj/structure/table/wood/shuttle_bar,
/obj/item/reagent_containers/cup/glass/shaker,
/turf/open/floor/holofloor{
	dir = 9;
	icon_state = "wood"
	},
/area/template_noop)
"aj" = (
/obj/structure/window/reinforced/spawner/directional/east,
/turf/open/floor/holofloor{
	dir = 9;
	icon_state = "wood"
	},
/area/template_noop)
"ak" = (
/obj/structure/table/wood/poker,
/obj/item/storage/box/matches,
/turf/open/floor/holofloor{
	dir = 9;
	icon_state = "wood"
	},
/area/template_noop)
"al" = (
/obj/structure/chair/stool/bar/directional/south,
/obj/structure/window/reinforced/spawner/directional/east,
/turf/open/floor/holofloor{
	dir = 9;
	icon_state = "wood"
	},
/area/template_noop)
"am" = (
/obj/structure/chair/wood,
/turf/open/floor/holofloor{
	dir = 9;
	icon_state = "wood"
	},
/area/template_noop)
"an" = (
/obj/structure/table/wood/shuttle_bar,
/obj/item/reagent_containers/cup/rag{
	pixel_x = 10;
	pixel_y = 9
	},
/turf/open/floor/holofloor/wood,
/area/template_noop)
"ao" = (
/obj/structure/chair/wood{
	dir = 1
	},
/turf/open/floor/holofloor{
	dir = 9;
	icon_state = "wood"
	},
/area/template_noop)
"ap" = (
/obj/structure/table/wood,
/obj/item/instrument/guitar,
/turf/open/floor/holofloor/carpet,
/area/template_noop)
"aq" = (
/turf/open/floor/holofloor/carpet,
/area/template_noop)
"ar" = (
/obj/structure/table/wood/shuttle_bar,
/obj/item/reagent_containers/cup/glass/shaker{
	pixel_y = 8
	},
/turf/open/floor/holofloor/wood,
/area/template_noop)
"as" = (
/obj/structure/sink/directional/east,
/turf/open/floor/holofloor/wood,
/area/template_noop)
"at" = (
/obj/structure/table/wood/shuttle_bar,
/obj/item/book/manual/wiki/barman_recipes,
/turf/open/floor/holofloor{
	dir = 9;
	icon_state = "wood"
	},
/area/template_noop)
"au" = (
/obj/structure/chair/wood{
	dir = 4
	},
/turf/open/floor/holofloor{
	dir = 9;
	icon_state = "wood"
	},
/area/template_noop)
"av" = (
/obj/structure/table/wood/shuttle_bar,
/turf/open/floor/holofloor/wood,
/area/template_noop)
"aw" = (
/obj/structure/table/wood,
/obj/item/instrument/saxophone,
/turf/open/floor/holofloor/carpet,
/area/template_noop)
"ax" = (
/obj/structure/table/wood,
/obj/item/instrument/violin,
/turf/open/floor/holofloor/carpet,
/area/template_noop)
"ay" = (
/obj/structure/table/wood/shuttle_bar,
/obj/item/book/manual/wiki/barman_recipes{
	pixel_y = 8
	},
/turf/open/floor/holofloor/wood,
/area/template_noop)
"az" = (
/turf/open/floor/holofloor{
	dir = 9;
	icon_state = "wood"
	},
/area/template_noop)
"aA" = (
/obj/structure/table/wood,
/obj/item/paper_bin,
/turf/open/floor/holofloor{
	dir = 9;
	icon_state = "wood"
	},
/area/template_noop)
"aB" = (
/obj/structure/window/reinforced/half/directional/east,
/obj/structure/table/wood/shuttle_bar,
/obj/item/storage/box/cups{
	pixel_y = 8
	},
/turf/open/floor/holofloor/wood,
/area/template_noop)
"aC" = (
/obj/structure/chair/stool/bar/directional/west,
/turf/open/floor/holofloor/carpet,
/area/template_noop)
"aD" = (
/obj/structure/table/wood,
/obj/item/kirbyplants/organic/plant5{
	pixel_y = 10
	},
/turf/open/floor/holofloor/carpet,
/area/template_noop)
"aE" = (
/obj/structure/chair/comfy/brown{
	dir = 8
	},
/turf/open/floor/holofloor/carpet,
/area/template_noop)
"aF" = (
/turf/open/floor/holofloor{
	icon_state = "stairs-r"
	},
/area/template_noop)
"aG" = (
/obj/structure/window/reinforced/spawner/directional/east,
/obj/structure/table/wood/shuttle_bar,
/obj/item/storage/box/cups,
/turf/open/floor/holofloor{
	dir = 9;
	icon_state = "wood"
	},
/area/template_noop)
"aH" = (
/obj/structure/sink/directional/east,
/turf/open/floor/holofloor{
	dir = 9;
	icon_state = "wood"
	},
/area/template_noop)
"aI" = (
/obj/structure/chair/wood{
	dir = 8
	},
/turf/open/floor/holofloor{
	dir = 9;
	icon_state = "wood"
	},
/area/template_noop)
"aJ" = (
/obj/structure/table/wood,
/obj/effect/holodeck_effect/random_book,
/turf/open/floor/holofloor/carpet,
/area/template_noop)
"aK" = (
/obj/structure/table/wood,
/obj/item/storage/fancy/cigarettes/cigars/cohiba,
/obj/item/lighter,
/turf/open/floor/holofloor{
	dir = 9;
	icon_state = "wood"
	},
/area/template_noop)
"aL" = (
/turf/open/floor/holofloor{
	icon_state = "stairs-l"
	},
/area/template_noop)
"aM" = (
/obj/structure/chair/comfy/brown{
	buildstackamount = 0;
	dir = 1
	},
/turf/open/floor/holofloor/carpet,
/area/template_noop)
"aN" = (
/obj/structure/table/wood,
/obj/item/instrument/piano_synth/headphones,
/turf/open/floor/holofloor/carpet,
/area/template_noop)
"aO" = (
/obj/structure/table/wood,
/obj/item/flashlight/lamp/green{
	pixel_y = 4
	},
/turf/open/floor/holofloor/carpet,
/area/template_noop)
"aP" = (
/obj/structure/table/wood/poker,
/obj/effect/holodeck_effect/cards,
/turf/open/floor/holofloor{
	dir = 9;
	icon_state = "wood"
	},
/area/template_noop)
"aQ" = (
/obj/structure/table/wood,
/obj/item/instrument/violin{
	pixel_y = 8
	},
/turf/open/floor/holofloor/carpet,
/area/template_noop)
"aR" = (
/obj/structure/window/reinforced/spawner/directional/south,
/turf/open/floor/holofloor{
	dir = 9;
	icon_state = "wood"
	},
/area/template_noop)
"aS" = (
/obj/structure/table/wood/poker,
/turf/open/floor/holofloor{
	dir = 9;
	icon_state = "wood"
	},
/area/template_noop)
"aT" = (
/obj/structure/table/wood/poker,
/obj/item/cigarette/pipe,
/turf/open/floor/holofloor{
	dir = 9;
	icon_state = "wood"
	},
/area/template_noop)
"aU" = (
/obj/structure/table/wood/poker,
/obj/item/storage/dice,
/turf/open/floor/holofloor{
	dir = 9;
	icon_state = "wood"
	},
/area/template_noop)
"aV" = (
/obj/structure/chair/stool/bar/directional/south,
/turf/open/floor/holofloor{
	dir = 9;
	icon_state = "wood"
	},
/area/template_noop)
"aW" = (
/turf/open/floor/holofloor/wood,
/area/template_noop)
"aX" = (
/obj/structure/table/wood,
/obj/item/instrument/guitar{
	pixel_y = 8
	},
/turf/open/floor/holofloor/carpet,
/area/template_noop)
"aY" = (
/obj/structure/table/wood/shuttle_bar,
/obj/structure/window/reinforced/spawner/directional/east,
/turf/open/floor/holofloor{
	dir = 9;
	icon_state = "wood"
	},
/area/template_noop)
"aZ" = (
/obj/structure/musician/piano,
/turf/open/floor/holofloor/carpet,
/area/template_noop)
"cD" = (
/obj/structure/table/wood,
/obj/item/kirbyplants/organic/plant5,
/turf/open/floor/holofloor/carpet,
/area/template_noop)
"jq" = (
/obj/structure/table/wood,
/obj/item/flashlight/lamp/green{
	pixel_y = 8
	},
/turf/open/floor/holofloor/wood,
/area/template_noop)
"kt" = (
/obj/structure/chair/wood,
/turf/open/floor/holofloor/wood,
/area/template_noop)
"mc" = (
/obj/structure/chair/stool/bar/directional/south,
/turf/open/floor/holofloor/wood,
/area/template_noop)
"mK" = (
/turf/open/floor/holofloor/stairs/left,
/area/template_noop)
"np" = (
/obj/structure/table/wood,
/obj/effect/holodeck_effect/random_book{
	pixel_y = 8
	},
/turf/open/floor/holofloor/carpet,
/area/template_noop)
"ur" = (
/obj/structure/table/wood/shuttle_bar,
/obj/structure/window/reinforced/half/directional/east,
/turf/open/floor/holofloor/wood,
/area/template_noop)
"yu" = (
/obj/structure/table/wood,
/obj/item/instrument/saxophone{
	pixel_y = 8
	},
/turf/open/floor/holofloor/carpet,
/area/template_noop)
"zN" = (
/obj/structure/table/wood,
/obj/item/storage/fancy/cigarettes/cigars/cohiba{
	pixel_y = 8
	},
/obj/item/lighter{
	pixel_y = 8
	},
/turf/open/floor/holofloor/wood,
/area/template_noop)
"BE" = (
/obj/structure/table/wood/poker,
/obj/item/storage/box/matches{
	pixel_y = 8
	},
/turf/open/floor/holofloor/wood,
/area/template_noop)
"BJ" = (
/obj/structure/window/reinforced/half/directional/south,
/turf/open/floor/holofloor/wood,
/area/template_noop)
"Ho" = (
/obj/structure/table/wood/poker,
/turf/open/floor/holofloor/wood,
/area/template_noop)
"MF" = (
/obj/structure/table/wood,
/obj/item/paper_bin{
	pixel_y = 8
	},
/turf/open/floor/holofloor/wood,
/area/template_noop)
"Nm" = (
/obj/structure/table/wood,
/obj/item/instrument/piano_synth/headphones{
	pixel_y = 8
	},
/turf/open/floor/holofloor/carpet,
/area/template_noop)
"OV" = (
/obj/structure/table/wood/poker,
/obj/item/cigarette/pipe{
	pixel_y = 8
	},
/turf/open/floor/holofloor/wood,
/area/template_noop)
"Pk" = (
/turf/open/floor/holofloor/stairs/right,
/area/template_noop)
"PC" = (
/obj/structure/chair/wood{
	dir = 1
	},
/turf/open/floor/holofloor/wood,
/area/template_noop)
"Qa" = (
/obj/structure/table/wood/poker,
/obj/effect/holodeck_effect/cards{
	pixel_y = 8
	},
/turf/open/floor/holofloor/wood,
/area/template_noop)
"Sl" = (
/obj/structure/table/wood/poker,
/obj/item/storage/dice{
	pixel_y = 8
	},
/turf/open/floor/holofloor/wood,
/area/template_noop)
"Tq" = (
/obj/structure/chair/wood{
	dir = 4
	},
/turf/open/floor/holofloor/wood,
/area/template_noop)
"UP" = (
/obj/structure/chair/stool/bar/directional/south,
/obj/structure/window/reinforced/half/directional/east,
/turf/open/floor/holofloor/wood,
/area/template_noop)
"XL" = (
/obj/structure/chair/wood{
	dir = 8
	},
/turf/open/floor/holofloor/wood,
/area/template_noop)
"Ys" = (
/obj/structure/closet/crate/bin,
/turf/open/floor/holofloor/wood,
/area/template_noop)
"YE" = (
/obj/structure/window/reinforced/half/directional/east,
/turf/open/floor/holofloor/wood,
/area/template_noop)

(1,1,1) = {"
zN
aW
aW
aW
aW
aW
mc
ay
as
an
"}
(2,1,1) = {"
jq
aW
aW
aW
aW
aW
mc
av
aW
ar
"}
(3,1,1) = {"
aW
Tq
Tq
aW
aW
YE
UP
ur
ae
aB
"}
(4,1,1) = {"
kt
Ho
Sl
PC
BJ
yu
Nm
aZ
aq
aQ
"}
(5,1,1) = {"
kt
BE
Ho
PC
aW
mK
aq
aC
aq
aX
"}
(6,1,1) = {"
kt
Qa
OV
PC
aW
Pk
aq
aq
aq
aM
"}
(7,1,1) = {"
aW
XL
XL
aW
BJ
np
aq
aq
aq
aM
"}
(8,1,1) = {"
Ys
aW
aW
aW
BJ
cD
aq
aq
aq
aM
"}
(9,1,1) = {"
MF
aW
aW
aW
BJ
aO
aq
aE
aE
ag
"}
