//MAP CONVERTED BY dmm2tgm.py THIS HEADER COMMENT PREVENTS RECONVERSION, DO NOT REMOVE
"aa" = (
/obj/effect/turf_decal/tile/neutral{
	dir = 4
	},
/obj/effect/turf_decal/tile/neutral{
	dir = 8
	},
/obj/structure/closet/secure_closet/courtroom,
/turf/open/floor/holofloor/dark,
/area/template_noop)
"ab" = (
/obj/effect/turf_decal/tile/neutral{
	dir = 4
	},
/obj/effect/turf_decal/tile/neutral{
	dir = 8
	},
/obj/structure/table/wood,
/obj/item/food/grown/harebell,
/obj/item/food/grown/harebell,
/obj/item/food/grown/harebell,
/obj/item/food/grown/harebell,
/obj/item/food/grown/harebell,
/turf/open/floor/holofloor/dark,
/area/template_noop)
"ac" = (
/obj/structure/chair{
	dir = 1
	},
/turf/open/floor/holofloor/chapel/bottom_left,
/area/template_noop)
"ad" = (
/obj/structure/table/wood/fancy,
/obj/item/clothing/suit/chaplainsuit/nun,
/obj/item/clothing/head/chaplain/nun_hood,
/obj/item/clothing/suit/chaplainsuit/holidaypriest,
/obj/effect/turf_decal/tile/neutral,
/obj/effect/turf_decal/tile/neutral{
	dir = 1
	},
/obj/effect/turf_decal/tile/neutral{
	dir = 4
	},
/obj/effect/turf_decal/tile/neutral{
	dir = 8
	},
/turf/open/floor/holofloor/dark,
/area/template_noop)
"af" = (
/turf/open/floor/holofloor/dark,
/area/template_noop)
"ag" = (
/turf/open/floor/holofloor/chapel/top_left,
/area/template_noop)
"ah" = (
/obj/effect/turf_decal/tile/neutral{
	dir = 4
	},
/obj/effect/turf_decal/tile/neutral{
	dir = 8
	},
/obj/structure/table/wood,
/obj/item/food/grown/poppy,
/obj/item/food/grown/poppy,
/obj/item/food/grown/poppy,
/obj/item/food/grown/poppy,
/obj/item/food/grown/poppy,
/turf/open/floor/holofloor/dark,
/area/template_noop)
"ai" = (
/turf/open/floor/holofloor/chapel/bottom_right,
/area/template_noop)
"ak" = (
/obj/structure/chair{
	dir = 1
	},
/turf/open/floor/holofloor/chapel/top_right,
/area/template_noop)
"al" = (
/obj/effect/turf_decal/tile/neutral{
	dir = 4
	},
/obj/effect/turf_decal/tile/neutral{
	dir = 8
	},
/obj/structure/table/wood,
/obj/item/folder/blue,
/obj/item/pen/red,
/turf/open/floor/holofloor/dark,
/area/template_noop)
"am" = (
/obj/item/clothing/head/helmet/chaplain/witchunter_hat,
/obj/effect/turf_decal/tile/neutral,
/obj/effect/turf_decal/tile/neutral{
	dir = 1
	},
/obj/effect/turf_decal/tile/neutral{
	dir = 4
	},
/obj/effect/turf_decal/tile/neutral{
	dir = 8
	},
/obj/structure/table/wood/fancy,
/turf/open/floor/holofloor/dark,
/area/template_noop)
"ao" = (
/obj/effect/turf_decal/tile/neutral{
	dir = 4
	},
/obj/effect/turf_decal/tile/neutral{
	dir = 8
	},
/obj/structure/table/wood,
/obj/item/storage/fancy/candle_box,
/turf/open/floor/holofloor/dark,
/area/template_noop)
"aq" = (
/obj/effect/turf_decal/tile/neutral{
	dir = 4
	},
/obj/effect/turf_decal/tile/neutral{
	dir = 8
	},
/obj/structure/table/wood,
/obj/item/folder/red,
/obj/item/pen/red,
/turf/open/floor/holofloor/dark,
/area/template_noop)
"as" = (
/obj/effect/turf_decal/tile/neutral{
	dir = 4
	},
/obj/effect/turf_decal/tile/neutral{
	dir = 8
	},
/turf/open/floor/holofloor/dark,
/area/template_noop)
"au" = (
/obj/structure/table/wood/fancy,
/obj/item/storage/book/bible,
/obj/effect/turf_decal/tile/neutral,
/obj/effect/turf_decal/tile/neutral{
	dir = 1
	},
/obj/effect/turf_decal/tile/neutral{
	dir = 4
	},
/obj/effect/turf_decal/tile/neutral{
	dir = 8
	},
/turf/open/floor/holofloor/dark,
/area/template_noop)
"ax" = (
/obj/effect/turf_decal/tile/neutral,
/obj/effect/turf_decal/tile/neutral{
	dir = 1
	},
/obj/effect/turf_decal/tile/neutral{
	dir = 4
	},
/obj/effect/turf_decal/tile/neutral{
	dir = 8
	},
/turf/open/floor/holofloor/dark,
/area/template_noop)
"ay" = (
/obj/item/toy/figure/chaplain,
/obj/effect/turf_decal/tile/neutral,
/obj/effect/turf_decal/tile/neutral{
	dir = 1
	},
/obj/effect/turf_decal/tile/neutral{
	dir = 4
	},
/obj/effect/turf_decal/tile/neutral{
	dir = 8
	},
/obj/structure/table/wood/fancy,
/turf/open/floor/holofloor/dark,
/area/template_noop)
"aA" = (
/turf/open/floor/holofloor/chapel/bottom_left,
/area/template_noop)
"aC" = (
/obj/structure/chair{
	dir = 1
	},
/turf/open/floor/holofloor/chapel,
/area/template_noop)
"aE" = (
/obj/structure/chair{
	dir = 1
	},
/turf/open/floor/holofloor/chapel/bottom_right,
/area/template_noop)
"aF" = (
/obj/item/clothing/suit/costume/judgerobe,
/obj/item/clothing/head/costume/powdered_wig,
/obj/effect/turf_decal/tile/neutral,
/obj/effect/turf_decal/tile/neutral{
	dir = 1
	},
/obj/effect/turf_decal/tile/neutral{
	dir = 4
	},
/obj/effect/turf_decal/tile/neutral{
	dir = 8
	},
/obj/structure/table/wood/fancy,
/turf/open/floor/holofloor/dark,
/area/template_noop)
"aH" = (
/obj/structure/table/wood/fancy,
/obj/item/book/manual/wiki/security_space_law,
/obj/effect/turf_decal/tile/neutral,
/obj/effect/turf_decal/tile/neutral{
	dir = 1
	},
/obj/effect/turf_decal/tile/neutral{
	dir = 4
	},
/obj/effect/turf_decal/tile/neutral{
	dir = 8
	},
/turf/open/floor/holofloor/dark,
/area/template_noop)
"aK" = (
/turf/open/floor/holofloor/chapel/top_right,
/area/template_noop)
"aL" = (
/obj/structure/chair{
	dir = 1
	},
/obj/effect/turf_decal/tile/neutral{
	dir = 4
	},
/obj/effect/turf_decal/tile/neutral{
	dir = 8
	},
/turf/open/floor/holofloor/dark,
/area/template_noop)
"aN" = (
/obj/effect/turf_decal/tile/neutral{
	dir = 8
	},
/obj/effect/turf_decal/tile/neutral{
	dir = 1
	},
/obj/effect/turf_decal/tile/neutral,
/turf/open/floor/holofloor/dark,
/area/template_noop)
"aO" = (
/obj/effect/turf_decal/tile/neutral{
	dir = 4
	},
/obj/effect/turf_decal/tile/neutral{
	dir = 8
	},
/obj/structure/table/wood,
/obj/item/paper_bin,
/turf/open/floor/holofloor/dark,
/area/template_noop)
"aQ" = (
/obj/structure/chair,
/turf/open/floor/holofloor/dark,
/area/template_noop)
"aS" = (
/obj/effect/turf_decal/tile/neutral{
	dir = 8
	},
/obj/effect/turf_decal/tile/neutral{
	dir = 1
	},
/obj/effect/turf_decal/tile/neutral{
	dir = 4
	},
/obj/effect/turf_decal/tile/neutral,
/turf/open/floor/holofloor/dark,
/area/template_noop)
"aT" = (
/obj/structure/chair{
	dir = 1
	},
/turf/open/floor/holofloor/chapel/top_left,
/area/template_noop)
"aU" = (
/obj/effect/turf_decal/tile/neutral{
	dir = 4
	},
/obj/effect/turf_decal/tile/neutral{
	dir = 8
	},
/obj/structure/table/wood,
/obj/item/hand_labeler,
/turf/open/floor/holofloor/dark,
/area/template_noop)
"aW" = (
/obj/effect/turf_decal/tile/neutral{
	dir = 8
	},
/obj/effect/turf_decal/tile/neutral,
/obj/effect/turf_decal/tile/neutral{
	dir = 4
	},
/turf/open/floor/holofloor/dark,
/area/template_noop)
"aX" = (
/obj/item/clothing/suit/chaplainsuit/bishoprobe,
/obj/effect/turf_decal/tile/neutral,
/obj/effect/turf_decal/tile/neutral{
	dir = 1
	},
/obj/effect/turf_decal/tile/neutral{
	dir = 4
	},
/obj/effect/turf_decal/tile/neutral{
	dir = 8
	},
/obj/structure/table/wood/fancy,
/turf/open/floor/holofloor/dark,
/area/template_noop)
"tx" = (
/obj/effect/turf_decal/tile/neutral{
	dir = 8
	},
/obj/effect/turf_decal/tile/neutral{
	dir = 1
	},
/obj/merge_conflict_marker{
	name = "---Merge Conflict Marker---";
	desc = "A best-effort merge was performed. You must resolve this conflict yourself (manually) and remove this object once complete."
	},
/obj/effect/turf_decal/tile/neutral/half/contrasted{
	dir = 8
	},
/turf/open/floor/holofloor/dark,
/area/template_noop)
"yE" = (
/obj/effect/turf_decal/tile/neutral,
/obj/effect/turf_decal/tile/neutral{
	dir = 4
	},
/obj/merge_conflict_marker{
	name = "---Merge Conflict Marker---";
	desc = "A best-effort merge was performed. You must resolve this conflict yourself (manually) and remove this object once complete."
	},
/obj/effect/turf_decal/tile/neutral/half/contrasted{
	dir = 4
	},
/turf/open/floor/holofloor/dark,
/area/template_noop)
"Nk" = (
/obj/item/gavelblock,
/obj/item/gavelhammer,
/obj/structure/table/wood,
/obj/effect/turf_decal/tile/neutral{
	dir = 8
	},
/obj/effect/turf_decal/tile/neutral,
/obj/merge_conflict_marker{
	name = "---Merge Conflict Marker---";
	desc = "A best-effort merge was performed. You must resolve this conflict yourself (manually) and remove this object once complete."
	},
/obj/item/gavelblock,
/obj/item/gavelhammer,
/obj/structure/table/wood,
/obj/effect/turf_decal/tile/neutral/half/contrasted,
/turf/open/floor/holofloor/dark,
/area/template_noop)
"ZF" = (
/obj/structure/table/wood,
/obj/effect/turf_decal/tile/neutral{
	dir = 8
	},
/obj/effect/turf_decal/tile/neutral,
/obj/merge_conflict_marker{
	name = "---Merge Conflict Marker---";
	desc = "A best-effort merge was performed. You must resolve this conflict yourself (manually) and remove this object once complete."
	},
/obj/structure/table/wood,
/obj/effect/turf_decal/tile/neutral/half/contrasted,
/turf/open/floor/holofloor/dark,
/area/template_noop)

(1,1,1) = {"
ax
ag
aA
ag
ac
aT
aA
aL
aL
aa
"}
(2,1,1) = {"
ay
aK
ai
aK
aC
ak
ai
aL
aL
aO
"}
(3,1,1) = {"
aF
tx
aN
ag
ac
aT
aA
aL
aL
aq
"}
(4,1,1) = {"
ad
af
ZF
aK
aC
ak
ai
aL
aL
al
"}
(5,1,1) = {"
au
aQ
Nk
aS
aS
aS
aS
as
as
ah
"}
(6,1,1) = {"
aH
af
ZF
ag
ac
aT
aA
aL
aL
ab
"}
(7,1,1) = {"
am
yE
aW
aK
aE
ak
ai
aL
aL
ao
"}
(8,1,1) = {"
aX
ag
aA
ag
ac
aT
aA
aL
aL
aU
"}
(9,1,1) = {"
ax
aK
ai
aK
aE
ak
ai
aL
aL
aa
"}
