//MAP CONVERTED BY dmm2tgm.py THIS HEADER COMMENT PREVENTS RECONVERSION, DO NOT REMOVE
"ak" = (
/obj/item/book/manual/wiki/barman_recipes,
/obj/item/reagent_containers/cup/glass/shaker,
/obj/item/reagent_containers/cup/rag,
/obj/structure/table/reinforced/plastitaniumglass,
/turf/open/floor/iron/kitchen,
/area/misc/survivalpod)
"br" = (
/obj/machinery/light/directional{
	dir = 8
	},
/turf/open/floor/wood/tile,
/area/misc/survivalpod)
"bO" = (
/obj/effect/turf_decal/mining/survival{
	dir = 4
	},
/turf/closed/wall/mineral/titanium/survival/pod,
/area/misc/survivalpod)
"bP" = (
/obj/machinery/vending/games,
/obj/machinery/light/directional{
	dir = 4
	},
/turf/open/floor/wood/tile,
/area/misc/survivalpod)
"cc" = (
/obj/structure/toilet{
	dir = 8
	},
/obj/machinery/light/small/directional/east,
/obj/structure/sink{
	pixel_y = 16
	},
/obj/structure/mirror/directional/north{
	pixel_y = 35
	},
/turf/open/floor/pod/dark,
/area/misc/survivalpod)
"cm" = (
/obj/structure/chair/comfy/black{
	dir = 1
	},
/turf/open/floor/wood/tile,
/area/misc/survivalpod)
"ct" = (
/obj/structure/chair/sofa/corp/left{
	dir = 4
	},
/turf/open/floor/carpet/black,
/area/misc/survivalpod)
"hg" = (
/obj/effect/spawner/random/vending/snackvend,
/turf/open/floor/wood/tile,
/area/misc/survivalpod)
"ia" = (
/turf/open/floor/iron/kitchen,
/area/misc/survivalpod)
"iP" = (
/turf/closed/wall/mineral/titanium/survival/nodiagonal,
/area/misc/survivalpod)
"jM" = (
/obj/machinery/vending/cigarette/beach,
/turf/open/floor/wood/tile,
/area/misc/survivalpod)
"kb" = (
/obj/structure/chair/comfy/black,
/turf/open/floor/wood/tile,
/area/misc/survivalpod)
"lb" = (
/obj/structure/disposalpipe/segment,
/turf/closed/wall/mineral/titanium/survival/pod,
/area/misc/survivalpod)
"lv" = (
/turf/open/floor/carpet/black,
/area/misc/survivalpod)
"nZ" = (
/obj/structure/chair/sofa/corp/right{
	dir = 4
	},
/turf/open/floor/carpet/black,
/area/misc/survivalpod)
"pj" = (
/obj/structure/closet/secure_closet/bar{
	req_one_access = list("bar","mining")
	},
/turf/open/floor/iron/kitchen,
/area/misc/survivalpod)
"qt" = (
/obj/effect/turf_decal/mining/survival{
	dir = 8
	},
/turf/closed/wall/mineral/titanium/survival/pod,
/area/misc/survivalpod)
"qI" = (
/obj/structure/chair/comfy/black{
	dir = 1
	},
/turf/open/floor/carpet/black,
/area/misc/survivalpod)
"rG" = (
/obj/structure/window/reinforced/survival_pod{
	dir = 8
	},
/obj/structure/window/reinforced/survival_pod{
	dir = 4
	},
/obj/structure/window/reinforced/survival_pod{
	dir = 1
	},
/obj/structure/window/reinforced/survival_pod,
/obj/structure/grille,
/turf/open/floor/pod/dark,
/area/misc/survivalpod)
"tb" = (
/turf/closed/wall/mineral/titanium/survival/pod,
/area/misc/survivalpod)
"tM" = (
/obj/machinery/chem_dispenser/drinks,
/obj/structure/table/reinforced/plastitaniumglass,
/turf/open/floor/iron/kitchen,
/area/misc/survivalpod)
"vx" = (
/obj/machinery/door/window/survival_pod{
	dir = 1
	},
/obj/machinery/jukebox,
/turf/open/floor/iron/kitchen,
/area/misc/survivalpod)
"wi" = (
/obj/effect/turf_decal/mining/survival{
	dir = 1
	},
/turf/closed/wall/mineral/titanium/survival/pod,
/area/misc/survivalpod)
"wF" = (
/obj/machinery/light/directional,
/turf/open/floor/wood/tile,
/area/misc/survivalpod)
"wR" = (
/turf/open/floor/wood/tile,
/area/misc/survivalpod)
"xD" = (
/obj/item/clipboard,
/obj/item/toy/figure/bartender,
/obj/structure/table/reinforced/plastitaniumglass,
/turf/open/floor/iron/kitchen,
/area/misc/survivalpod)
"yA" = (
/obj/machinery/door/airlock/survival_pod/glass,
/obj/effect/mapping_helpers/airlock/access/any/service/bar,
/obj/effect/mapping_helpers/airlock/access/any/supply/mining,
/obj/structure/fans/tiny,
/turf/open/floor/pod/dark,
/area/misc/survivalpod)
"yN" = (
/obj/effect/turf_decal/mining/survival{
	dir = 4
	},
/obj/structure/disposalpipe/segment{
	dir = 9
	},
/turf/closed/wall/mineral/titanium/survival/pod,
/area/misc/survivalpod)
"yV" = (
/obj/structure/disposalpipe/trunk{
	dir = 4
	},
/obj/machinery/disposal/bin,
/turf/open/floor/wood/tile,
/area/misc/survivalpod)
"Ar" = (
/obj/machinery/door/window/survival_pod{
	dir = 1
	},
/turf/open/floor/iron/kitchen,
/area/misc/survivalpod)
"AB" = (
/obj/machinery/chem_dispenser/drinks/beer,
/obj/machinery/light/directional/north,
/obj/structure/table/reinforced/plastitaniumglass,
/turf/open/floor/iron/kitchen,
/area/misc/survivalpod)
"CB" = (
/obj/effect/turf_decal/mining/survival{
	dir = 4
	},
/obj/structure/disposalpipe/junction{
	dir = 4
	},
/turf/closed/wall/mineral/titanium/survival/pod,
/area/misc/survivalpod)
"DP" = (
/obj/structure/chair/sofa/corp/right{
	dir = 8
	},
/turf/open/floor/carpet/black,
/area/misc/survivalpod)
"Ea" = (
/obj/item/toy/cards/deck,
/obj/structure/table/wood/fancy/purple,
/turf/open/floor/carpet/black,
/area/misc/survivalpod)
"Eq" = (
/obj/item/storage/fancy/cigarettes/cigars,
/obj/item/storage/fancy/cigarettes/cigars/cohiba{
	pixel_y = 4
	},
/obj/item/storage/fancy/cigarettes/cigars/havana{
	pixel_y = 8
	},
/obj/structure/table/reinforced/plastitaniumglass,
/obj/machinery/light_switch/directional/north,
/obj/item/storage/fancy/candle_box/amber,
/turf/open/floor/iron/kitchen,
/area/misc/survivalpod)
"Ft" = (
/obj/effect/turf_decal/mining/survival{
	dir = 4
	},
/obj/structure/disposalpipe/segment,
/turf/closed/wall/mineral/titanium/survival/pod,
/area/misc/survivalpod)
"Id" = (
/obj/structure/table/reinforced/plastitaniumglass,
/turf/open/floor/iron/kitchen,
/area/misc/survivalpod)
"If" = (
/obj/machinery/door/airlock/survival_pod,
/turf/open/floor/pod/dark,
/area/misc/survivalpod)
"JB" = (
/obj/machinery/door/airlock/survival_pod/glass,
/obj/effect/mapping_helpers/airlock/access/any/supply/mining,
/turf/open/floor/pod/dark,
/area/misc/survivalpod)
"JG" = (
/obj/structure/table/reinforced/plastitaniumglass,
/obj/item/lighter,
/obj/item/lighter{
	pixel_x = -4;
	pixel_y = 4
	},
/turf/open/floor/iron/kitchen,
/area/misc/survivalpod)
"Kf" = (
/obj/structure/table/reinforced/plastitaniumglass,
/obj/item/reagent_containers/cup/rag,
/obj/item/reagent_containers/cup/glass/bottle/beer,
/turf/open/floor/iron/kitchen,
/area/misc/survivalpod)
"Kp" = (
/obj/machinery/door/airlock/survival_pod/glass,
/obj/structure/fans/tiny,
/turf/open/floor/wood/tile,
/area/misc/survivalpod)
"Kz" = (
/obj/structure/table/wood/fancy/purple,
/turf/open/floor/carpet/black,
/area/misc/survivalpod)
"Ms" = (
/obj/effect/turf_decal/mining/survival,
/turf/closed/wall/mineral/titanium/survival/pod,
/area/misc/survivalpod)
"Nz" = (
/obj/structure/chair/sofa/corp/left{
	dir = 8
	},
/turf/open/floor/carpet/black,
/area/misc/survivalpod)
"PP" = (
/obj/machinery/vending/boozeomat/all_access,
/turf/open/floor/iron/kitchen,
/area/misc/survivalpod)
"Qg" = (
/obj/structure/table/reinforced/plastitaniumglass,
/turf/open/floor/wood/tile,
/area/misc/survivalpod)
"Rd" = (
/obj/machinery/smartfridge/drinks,
/turf/open/floor/iron/kitchen,
/area/misc/survivalpod)
"Se" = (
/obj/machinery/light/directional/south,
/obj/structure/bed/pillow_large,
/obj/item/toy/plush/beeplushie,
/turf/open/floor/wood/tile,
/area/misc/survivalpod)
"TU" = (
/obj/machinery/light/directional/north,
/obj/machinery/chem_master/condimaster,
/turf/open/floor/iron/kitchen,
/area/misc/survivalpod)
"UX" = (
/obj/structure/disposalpipe/trunk{
	dir = 4
	},
/obj/machinery/disposal/bin,
/turf/open/floor/iron/kitchen,
/area/misc/survivalpod)
"Vm" = (
/obj/structure/table/wood/fancy/purple,
/obj/item/reagent_containers/cup/glass/bottle/lizardwine,
/turf/open/floor/carpet/black,
/area/misc/survivalpod)
"VO" = (
/obj/structure/chair/stool/bar/directional/south{
	dir = 1
	},
/turf/open/floor/wood/tile,
/area/misc/survivalpod)
"WN" = (
/obj/machinery/light_switch/directional/south,
/turf/open/floor/wood/tile,
/area/misc/survivalpod)
"Za" = (
/obj/structure/chair/comfy/black,
/turf/open/floor/carpet/black,
/area/misc/survivalpod)

(1,1,1) = {"
tb
qt
yA
qt
tb
qt
rG
qt
tb
qt
tb
"}
(2,1,1) = {"
wi
tM
ia
Rd
br
kb
Qg
cm
wR
Se
Ms
"}
(3,1,1) = {"
tb
AB
ia
JG
VO
lv
lv
lv
lv
wR
tb
"}
(4,1,1) = {"
wi
PP
ia
Id
VO
lv
ct
nZ
lv
wF
Ms
"}
(5,1,1) = {"
tb
ak
ia
Id
VO
Za
Kz
Ea
qI
WN
tb
"}
(6,1,1) = {"
JB
ia
ia
vx
wR
Za
Vm
Kz
qI
wR
Kp
"}
(7,1,1) = {"
tb
Eq
ia
Kf
VO
lv
DP
Nz
lv
wR
tb
"}
(8,1,1) = {"
wi
TU
ia
Id
VO
lv
lv
lv
lv
wF
Ms
"}
(9,1,1) = {"
tb
xD
ia
Ar
wR
lv
lv
lv
iP
If
tb
"}
(10,1,1) = {"
wi
UX
pj
iP
jM
yV
bP
hg
tb
cc
Ms
"}
(11,1,1) = {"
tb
CB
lb
Ft
lb
yN
tb
bO
tb
bO
tb
"}
