//MAP CONVERTED BY dmm2tgm.py THIS HEADER COMMENT PREVENTS RECONVERSION, DO NOT REMOVE
"a" = (
/obj/machinery/atmospherics/pipe/smart/simple/cyan/visible{
	dir = 1
	},
/obj/machinery/atmospherics/pipe/smart/manifold4w/scrubbers/hidden/layer2,
/turf/closed/wall/r_wall,
/area/misc/survivalpod/atmosia_box)
"d" = (
/obj/machinery/atmospherics/pipe/smart/manifold4w/supply/hidden/layer4,
/obj/machinery/atmospherics/pipe/smart/simple/cyan/visible{
	dir = 4
	},
/obj/machinery/atmospherics/pipe/smart/manifold4w/scrubbers/hidden/layer2,
/obj/structure/cable,
/obj/effect/turf_decal/stripes/line,
/obj/effect/turf_decal/stripes/line{
	dir = 1
	},
/turf/open/floor/engine,
/area/misc/survivalpod/atmosia_box)
"e" = (
/obj/machinery/atmospherics/pipe/smart/manifold4w/scrubbers/hidden/layer2,
/turf/closed/wall/r_wall,
/area/misc/survivalpod/atmosia_box)
"g" = (
/obj/machinery/atmospherics/components/unary/passive_vent/layer2,
/turf/open/floor/plating/airless,
/area/misc/survivalpod/atmosia_box)
"j" = (
/obj/machinery/atmospherics/pipe/smart/simple/cyan/visible{
	dir = 6
	},
/obj/machinery/atmospherics/pipe/smart/manifold4w/scrubbers/hidden/layer2,
/turf/closed/wall/r_wall,
/area/misc/survivalpod/atmosia_box)
"k" = (
/obj/machinery/atmospherics/components/unary/outlet_injector/monitored/air_input,
/obj/effect/turf_decal/trimline/white/filled/end,
/turf/open/floor/engine/air,
/area/misc/survivalpod/atmosia_box)
"l" = (
/obj/machinery/atmospherics/components/trinary/filter/atmos/o2{
	dir = 8;
	piping_layer = 2
	},
/turf/closed/wall/r_wall,
/area/misc/survivalpod/atmosia_box)
"m" = (
/obj/structure/window/reinforced/plasma{
	dir = 8
	},
/obj/machinery/atmospherics/components/unary/outlet_injector/monitored/oxygen_input{
	piping_layer = 2
	},
/obj/effect/turf_decal/trimline/blue/filled/end,
/turf/open/floor/engine/o2,
/area/misc/survivalpod/atmosia_box)
"q" = (
/turf/open/floor/plating/airless,
/area/misc/survivalpod/atmosia_box)
"u" = (
/obj/machinery/atmospherics/pipe/smart/manifold4w/scrubbers/hidden/layer2,
/turf/open/floor/plating/airless,
/area/misc/survivalpod/atmosia_box)
"C" = (
/obj/machinery/atmospherics/pipe/smart/simple/cyan/visible{
	dir = 4
	},
/obj/machinery/atmospherics/components/trinary/filter/atmos/n2{
	dir = 8;
	piping_layer = 2
	},
/turf/closed/wall/r_wall,
/area/misc/survivalpod/atmosia_box)
"D" = (
/obj/structure/cable,
/obj/machinery/atmospherics/pipe/smart/manifold4w/supply/hidden/layer4,
/turf/open/floor/plating/airless,
/area/misc/survivalpod/atmosia_box)
"F" = (
/turf/closed/wall/r_wall,
/area/misc/survivalpod/atmosia_box)
"I" = (
/obj/machinery/atmospherics/components/unary/vent_pump/high_volume/siphon/monitored/air_output{
	dir = 1;
	piping_layer = 4
	},
/obj/structure/window/reinforced/plasma{
	dir = 1
	},
/obj/effect/turf_decal/trimline/white/filled/end{
	dir = 1
	},
/turf/open/floor/engine/air,
/area/misc/survivalpod/atmosia_box)
"M" = (
/obj/machinery/atmospherics/pipe/smart/simple/cyan/visible{
	dir = 9
	},
/obj/machinery/atmospherics/pipe/smart/manifold4w/scrubbers/hidden/layer2,
/turf/closed/wall/r_wall,
/area/misc/survivalpod/atmosia_box)
"N" = (
/obj/machinery/atmospherics/pipe/smart/manifold4w/scrubbers/hidden/layer2,
/obj/machinery/atmospherics/pipe/smart/manifold4w/supply/hidden/layer4,
/obj/machinery/door/airlock/atmos{
	name = "Atmospherics"
	},
/obj/structure/fans/tiny,
/obj/structure/cable,
/turf/open/floor/plating,
/area/misc/survivalpod/atmosia_box)
"P" = (
/obj/machinery/light/warm/directional/west,
/obj/machinery/light_switch/directional/west,
/obj/machinery/atmospherics/components/unary/vent_pump/on/layer4{
	dir = 4
	},
/obj/structure/cable,
/obj/effect/turf_decal/stripes/end{
	dir = 8
	},
/obj/machinery/atmospherics/components/trinary/mixer/airmix/flipped/inverse{
	dir = 4
	},
/turf/open/floor/engine,
/area/misc/survivalpod/atmosia_box)
"Q" = (
/obj/structure/window/reinforced/plasma{
	dir = 4
	},
/obj/machinery/atmospherics/components/unary/vent_pump/siphon/monitored/nitrogen_output{
	dir = 1
	},
/obj/structure/window/reinforced/plasma{
	dir = 1
	},
/obj/effect/turf_decal/trimline/dark_red/filled/end{
	dir = 1
	},
/turf/open/floor/engine/n2,
/area/misc/survivalpod/atmosia_box)
"S" = (
/obj/structure/window/reinforced/plasma{
	dir = 8
	},
/obj/machinery/atmospherics/components/unary/vent_pump/siphon/monitored/oxygen_output{
	dir = 1
	},
/obj/structure/window/reinforced/plasma{
	dir = 1
	},
/obj/effect/turf_decal/trimline/blue/filled/end{
	dir = 1
	},
/turf/open/floor/engine/o2,
/area/misc/survivalpod/atmosia_box)
"T" = (
/obj/machinery/atmospherics/pipe/smart/simple/cyan/visible{
	dir = 10
	},
/obj/machinery/atmospherics/components/unary/thermomachine{
	piping_layer = 4;
	on = 1
	},
/obj/machinery/atmospherics/components/unary/vent_scrubber/on/layer2{
	dir = 8
	},
/obj/effect/turf_decal/stripes/end{
	dir = 4
	},
/turf/open/floor/engine,
/area/misc/survivalpod/atmosia_box)
"U" = (
/obj/machinery/atmospherics/pipe/smart/simple/cyan/visible{
	dir = 5
	},
/obj/machinery/atmospherics/pipe/smart/manifold4w/scrubbers/hidden/layer2,
/turf/closed/wall/r_wall,
/area/misc/survivalpod/atmosia_box)
"Z" = (
/obj/structure/window/reinforced/plasma{
	dir = 4
	},
/obj/machinery/atmospherics/components/unary/outlet_injector/monitored/nitrogen_input{
	piping_layer = 2
	},
/obj/effect/turf_decal/trimline/dark_red/filled/end,
/turf/open/floor/engine/n2,
/area/misc/survivalpod/atmosia_box)

(1,1,1) = {"
g
e
j
a
a
U
"}
(2,1,1) = {"
q
F
P
Q
Z
C
"}
(3,1,1) = {"
D
N
d
I
k
M
"}
(4,1,1) = {"
q
e
T
S
m
l
"}
(5,1,1) = {"
u
e
e
e
e
e
"}
